,index,Season,seasonStart,seasonEnd,team,opposition,result,ho/Aw,date,teamPoints,team_form_2games,team_form_3games,team_form_4games,team_form_5games,opp_form_2games,opp_form_3games,opp_form_4games,opp_form_5games,diff_2_game_form,diff_3_game_form,diff_4_game_form,diff_5_game_form,ho/Aw_binary,py_T_Leag_Pos,py_O_Leag_Pos,leagueDifference,monthNumber
0,0,1993-94,1993,1994,Arsenal,Coventry,Loss,Home,1993-08-14,0,0,0,0,0,0,0,0,0,0,0,0,0,1,10.0,15.0,-5.0,1
1,1,1993-94,1993,1994,Arsenal,Tottenham,Win,Away,1993-08-16,3,0,0,0,0,3,3,3,3,-3,-3,-3,-3,0,10.0,8.0,2.0,1
2,2,1993-94,1993,1994,Arsenal,Sheffield Weds,Win,Away,1993-08-21,3,3,3,3,3,1,1,1,1,2,2,2,2,0,10.0,7.0,3.0,1
3,3,1993-94,1993,1994,Arsenal,Leeds,Win,Home,1993-08-24,3,6,6,6,6,3,4,4,4,3,2,2,2,1,10.0,17.0,-7.0,1
4,4,1993-94,1993,1994,Arsenal,Everton,Win,Home,1993-08-28,3,6,9,9,9,3,6,9,9,3,3,0,0,1,10.0,13.0,-3.0,1
5,5,1993-94,1993,1994,Arsenal,Blackburn,Draw,Away,1993-09-01,1,6,9,12,12,4,7,7,10,2,2,5,2,0,10.0,4.0,6.0,2
6,6,1993-94,1993,1994,Arsenal,Ipswich,Win,Home,1993-09-11,3,4,7,10,13,2,2,5,8,2,5,5,5,1,10.0,16.0,-6.0,2
7,7,1993-94,1993,1994,Arsenal,Man United,Loss,Away,1993-09-19,0,4,7,10,13,3,6,9,10,1,1,1,3,0,10.0,1.0,9.0,2
8,8,1993-94,1993,1994,Arsenal,Southampton,Win,Home,1993-09-25,3,3,4,7,10,0,0,0,3,3,4,7,7,1,10.0,18.0,-8.0,2
9,9,1993-94,1993,1994,Arsenal,Liverpool,Draw,Away,1993-10-02,1,3,6,7,10,0,0,0,3,3,6,7,7,0,10.0,6.0,4.0,3
10,10,1993-94,1993,1994,Arsenal,Man City,Draw,Home,1993-10-16,1,4,4,7,8,4,4,7,10,0,0,0,-2,1,10.0,9.0,1.0,3
11,11,1993-94,1993,1994,Arsenal,Oldham,Draw,Away,1993-10-23,1,2,5,5,8,1,2,2,2,1,3,3,6,0,10.0,19.0,-9.0,3
12,12,1993-94,1993,1994,Arsenal,Norwich,Draw,Home,1993-10-30,1,2,3,6,6,4,7,10,11,-2,-4,-4,-5,1,10.0,3.0,7.0,3
13,13,1993-94,1993,1994,Arsenal,Aston Villa,Loss,Home,1993-11-06,0,2,3,4,7,6,7,7,8,-4,-4,-3,-1,1,10.0,2.0,8.0,4
14,14,1993-94,1993,1994,Arsenal,Chelsea,Win,Away,1993-11-20,3,1,2,3,4,0,0,0,0,1,2,3,4,0,10.0,11.0,-1.0,4
15,15,1993-94,1993,1994,Arsenal,West Ham,Draw,Away,1993-11-24,1,3,4,5,6,3,6,7,8,0,-2,-2,-2,0,10.0,21.0,-11.0,4
16,16,1993-94,1993,1994,Arsenal,Newcastle,Win,Home,1993-11-27,3,4,4,5,6,6,9,12,12,-2,-5,-7,-6,1,10.0,21.0,-11.0,4
17,17,1993-94,1993,1994,Arsenal,Coventry,Loss,Away,1993-12-04,0,4,7,7,8,0,1,4,5,4,6,3,3,0,10.0,15.0,-5.0,5
18,18,1993-94,1993,1994,Arsenal,Tottenham,Draw,Home,1993-12-06,1,3,4,7,7,1,2,3,3,2,2,4,4,1,10.0,8.0,2.0,5
19,19,1993-94,1993,1994,Arsenal,Sheffield Weds,Win,Home,1993-12-12,3,1,4,5,8,4,7,10,11,-3,-3,-5,-3,1,10.0,7.0,3.0,5
20,20,1993-94,1993,1994,Arsenal,Leeds,Loss,Away,1993-12-18,0,4,4,7,8,3,6,9,10,1,-2,-2,-2,0,10.0,17.0,-7.0,5
21,21,1993-94,1993,1994,Arsenal,Swindon,Win,Away,1993-12-27,3,3,4,4,7,4,4,5,5,-1,0,-1,2,0,10.0,21.0,-11.0,5
22,22,1993-94,1993,1994,Arsenal,Sheffield United,Win,Home,1993-12-29,3,3,6,7,7,1,2,2,3,2,4,5,4,1,10.0,14.0,-4.0,5
23,23,1993-94,1993,1994,Arsenal,Wimbledon,Win,Away,1994-01-01,3,6,6,9,10,1,4,7,7,5,2,2,3,0,10.0,12.0,-2.0,6
24,24,1993-94,1993,1994,Arsenal,QPR,Draw,Home,1994-01-03,1,6,9,9,12,1,4,7,7,5,5,2,5,1,10.0,5.0,5.0,6
25,25,1993-94,1993,1994,Arsenal,Man City,Draw,Away,1994-01-15,1,4,7,10,10,1,1,1,4,3,6,9,6,0,10.0,9.0,1.0,6
26,26,1993-94,1993,1994,Arsenal,Oldham,Draw,Home,1994-01-22,1,2,5,8,11,0,0,0,1,2,5,8,10,1,10.0,19.0,-9.0,6
27,27,1993-94,1993,1994,Arsenal,Norwich,Draw,Away,1994-02-13,1,2,3,6,9,2,3,3,6,0,0,3,3,0,10.0,3.0,7.0,7
28,28,1993-94,1993,1994,Arsenal,Everton,Draw,Away,1994-02-19,1,2,3,4,7,4,4,7,7,-2,-1,-3,0,0,10.0,13.0,-3.0,7
29,29,1993-94,1993,1994,Arsenal,Blackburn,Win,Home,1994-02-26,3,2,3,4,5,4,7,10,13,-2,-4,-6,-8,1,10.0,4.0,6.0,7
30,30,1993-94,1993,1994,Arsenal,Ipswich,Win,Away,1994-03-05,3,4,5,6,7,4,4,4,5,0,1,2,2,0,10.0,16.0,-6.0,8
31,31,1993-94,1993,1994,Arsenal,Southampton,Win,Away,1994-03-19,3,6,7,8,9,2,5,8,8,4,2,0,1,0,10.0,18.0,-8.0,8
32,32,1993-94,1993,1994,Arsenal,Man United,Draw,Home,1994-03-22,1,6,9,10,11,4,4,5,8,2,5,5,3,1,10.0,1.0,9.0,8
33,33,1993-94,1993,1994,Arsenal,Liverpool,Win,Home,1994-03-26,3,4,7,10,11,6,6,9,9,-2,1,1,2,1,10.0,6.0,4.0,8
34,34,1993-94,1993,1994,Arsenal,Swindon,Draw,Home,1994-04-02,1,4,7,10,13,1,1,2,2,3,6,8,11,1,10.0,21.0,-11.0,9
35,35,1993-94,1993,1994,Arsenal,Sheffield United,Draw,Away,1994-04-04,1,4,5,8,11,6,7,8,9,-2,-2,0,2,0,10.0,14.0,-4.0,9
36,36,1993-94,1993,1994,Arsenal,Chelsea,Win,Home,1994-04-16,3,2,5,6,9,2,5,5,8,0,0,1,1,1,10.0,11.0,-1.0,9
37,37,1993-94,1993,1994,Arsenal,Wimbledon,Draw,Home,1994-04-19,1,4,5,8,9,4,7,10,13,0,-2,-2,-4,1,10.0,12.0,-2.0,9
38,38,1993-94,1993,1994,Arsenal,Aston Villa,Win,Away,1994-04-23,3,4,5,6,9,3,4,4,5,1,1,2,4,0,10.0,2.0,8.0,9
39,39,1993-94,1993,1994,Arsenal,QPR,Draw,Away,1994-04-27,1,4,7,8,9,4,5,5,5,0,2,3,4,0,10.0,5.0,5.0,9
40,40,1993-94,1993,1994,Arsenal,West Ham,Loss,Home,1994-04-30,0,4,5,8,9,0,3,3,6,4,2,5,3,1,10.0,21.0,-11.0,9
41,41,1993-94,1993,1994,Arsenal,Newcastle,Loss,Away,1994-05-07,0,1,4,5,8,3,6,9,9,-2,-2,-4,-1,0,10.0,21.0,-11.0,10
42,42,1994-95,1994,1995,Arsenal,Man City,Win,Home,1994-08-20,3,0,1,4,5,2,2,3,6,-2,-1,1,-1,1,4.0,16.0,-12.0,1
43,43,1994-95,1994,1995,Arsenal,Leeds,Loss,Away,1994-08-23,0,3,3,4,7,4,5,8,8,-1,-2,-4,-1,0,4.0,5.0,-1.0,1
44,44,1994-95,1994,1995,Arsenal,Liverpool,Loss,Away,1994-08-28,0,3,3,3,4,3,3,6,6,0,0,-3,-2,0,4.0,8.0,-4.0,1
45,45,1994-95,1994,1995,Arsenal,Blackburn,Draw,Home,1994-08-31,1,0,3,3,3,6,7,8,8,-6,-4,-5,-5,1,4.0,2.0,2.0,1
46,46,1994-95,1994,1995,Arsenal,Norwich,Draw,Away,1994-09-10,1,1,1,4,4,4,5,5,6,-3,-4,-1,-2,0,4.0,12.0,-8.0,2
47,47,1994-95,1994,1995,Arsenal,Newcastle,Loss,Home,1994-09-18,0,2,2,2,5,6,9,12,15,-4,-7,-10,-10,1,4.0,3.0,1.0,2
48,48,1994-95,1994,1995,Arsenal,West Ham,Win,Away,1994-09-25,3,1,2,2,2,4,4,4,4,-3,-2,-2,-2,0,4.0,13.0,-9.0,2
49,49,1994-95,1994,1995,Arsenal,Crystal Palace,Loss,Home,1994-10-01,0,3,4,5,5,1,2,2,3,2,2,3,2,1,4.0,21.0,-17.0,3
50,50,1994-95,1994,1995,Arsenal,Wimbledon,Win,Away,1994-10-08,3,3,3,4,5,3,4,7,7,0,-1,-3,-2,0,4.0,6.0,-2.0,3
51,51,1994-95,1994,1995,Arsenal,Chelsea,Win,Home,1994-10-15,3,3,6,6,7,3,6,6,6,0,0,0,1,1,4.0,14.0,-10.0,3
52,52,1994-95,1994,1995,Arsenal,Coventry,Win,Home,1994-10-23,3,6,6,9,9,6,7,7,10,0,-1,2,-1,1,4.0,11.0,-7.0,3
53,53,1994-95,1994,1995,Arsenal,Everton,Draw,Away,1994-10-29,1,6,9,9,12,0,0,0,1,6,9,9,11,0,4.0,17.0,-13.0,3
54,54,1994-95,1994,1995,Arsenal,Sheffield Weds,Draw,Home,1994-11-06,1,4,7,10,10,1,1,4,7,3,6,6,3,1,4.0,7.0,-3.0,4
55,55,1994-95,1994,1995,Arsenal,Southampton,Loss,Away,1994-11-19,0,2,5,8,11,2,2,2,2,0,3,6,9,0,4.0,18.0,-14.0,4
56,56,1994-95,1994,1995,Arsenal,Leicester,Loss,Away,1994-11-23,0,1,2,5,8,0,0,0,3,1,2,5,5,0,4.0,21.0,-17.0,4
57,57,1994-95,1994,1995,Arsenal,Man United,Draw,Home,1994-11-26,1,0,1,2,5,6,9,12,15,-6,-8,-10,-10,1,4.0,1.0,3.0,4
58,58,1994-95,1994,1995,Arsenal,Nott'm Forest,Draw,Away,1994-12-03,1,1,1,2,3,0,1,1,1,1,0,1,2,0,4.0,21.0,-17.0,5
59,59,1994-95,1994,1995,Arsenal,Man City,Win,Away,1994-12-12,3,2,2,2,3,6,9,9,10,-4,-7,-7,-7,0,4.0,16.0,-12.0,5
60,60,1994-95,1994,1995,Arsenal,Leeds,Loss,Home,1994-12-17,0,4,5,5,5,1,4,4,7,3,1,1,-2,1,4.0,5.0,-1.0,5
61,61,1994-95,1994,1995,Arsenal,Aston Villa,Draw,Home,1994-12-26,1,3,4,5,5,1,2,3,6,2,2,2,-1,1,4.0,10.0,-6.0,5
62,62,1994-95,1994,1995,Arsenal,Ipswich,Win,Away,1994-12-28,3,1,4,5,6,2,2,2,3,-1,2,3,3,0,4.0,19.0,-15.0,5
63,63,1994-95,1994,1995,Arsenal,QPR,Loss,Home,1994-12-31,0,4,4,7,8,2,5,5,8,2,-1,2,0,1,4.0,9.0,-5.0,5
64,64,1994-95,1994,1995,Arsenal,Tottenham,Loss,Away,1995-01-02,0,3,4,4,7,4,7,8,11,-1,-3,-4,-4,0,4.0,15.0,-11.0,6
65,65,1994-95,1994,1995,Arsenal,Everton,Draw,Home,1995-01-14,1,0,3,4,4,3,3,4,5,-3,0,0,-1,1,4.0,17.0,-13.0,6
66,66,1994-95,1994,1995,Arsenal,Coventry,Win,Away,1995-01-21,3,1,1,4,5,1,1,1,2,0,0,3,3,0,4.0,11.0,-7.0,6
67,67,1994-95,1994,1995,Arsenal,Southampton,Draw,Home,1995-01-24,1,4,4,4,7,2,3,4,4,2,1,0,3,1,4.0,18.0,-14.0,6
68,68,1994-95,1994,1995,Arsenal,Sheffield Weds,Loss,Away,1995-02-04,0,4,5,5,5,4,5,6,9,0,0,-1,-4,0,4.0,7.0,-3.0,7
69,69,1994-95,1994,1995,Arsenal,Leicester,Draw,Home,1995-02-11,1,1,4,5,5,3,3,3,3,-2,1,2,2,1,4.0,21.0,-17.0,7
70,70,1994-95,1994,1995,Arsenal,Nott'm Forest,Win,Home,1995-02-21,3,1,2,5,6,1,4,4,4,0,-2,1,2,1,4.0,21.0,-17.0,7
71,71,1994-95,1994,1995,Arsenal,Crystal Palace,Win,Away,1995-02-25,3,4,4,5,8,3,4,4,7,1,0,1,1,0,4.0,21.0,-17.0,7
72,72,1994-95,1994,1995,Arsenal,West Ham,Loss,Home,1995-03-05,0,6,7,7,8,0,1,4,4,6,6,3,4,1,4.0,13.0,-9.0,8
73,73,1994-95,1994,1995,Arsenal,Blackburn,Loss,Away,1995-03-08,0,3,6,7,7,4,7,10,10,-1,-1,-3,-3,0,4.0,2.0,2.0,8
74,74,1994-95,1994,1995,Arsenal,Newcastle,Loss,Away,1995-03-19,0,0,3,6,7,3,6,9,12,-3,-3,-3,-5,0,4.0,3.0,1.0,8
75,75,1994-95,1994,1995,Arsenal,Man United,Loss,Away,1995-03-22,0,0,0,3,6,1,4,7,7,-1,-4,-4,-1,0,4.0,1.0,3.0,8
76,76,1994-95,1994,1995,Arsenal,Norwich,Win,Home,1995-04-01,3,0,0,0,3,3,4,5,6,-3,-4,-5,-3,1,4.0,12.0,-8.0,9
77,77,1994-95,1994,1995,Arsenal,QPR,Loss,Away,1995-04-08,0,3,3,3,3,3,6,6,9,0,-3,-3,-6,0,4.0,9.0,-5.0,9
78,78,1994-95,1994,1995,Arsenal,Liverpool,Loss,Home,1995-04-12,0,3,3,3,3,3,4,7,7,0,-1,-4,-4,1,4.0,8.0,-4.0,9
79,79,1994-95,1994,1995,Arsenal,Ipswich,Win,Home,1995-04-15,3,0,3,3,3,0,0,0,0,0,3,3,3,1,4.0,19.0,-15.0,9
80,80,1994-95,1994,1995,Arsenal,Aston Villa,Win,Away,1995-04-17,3,3,3,6,6,1,4,4,5,2,-1,2,1,0,4.0,10.0,-6.0,9
81,81,1994-95,1994,1995,Arsenal,Tottenham,Draw,Home,1995-04-29,1,6,6,6,9,4,7,7,8,2,-1,-1,1,1,4.0,15.0,-11.0,9
82,82,1994-95,1994,1995,Arsenal,Wimbledon,Draw,Home,1995-05-04,1,4,7,7,7,2,2,2,3,2,5,5,4,1,4.0,6.0,-2.0,10
83,83,1994-95,1994,1995,Arsenal,Chelsea,Loss,Away,1995-05-14,0,2,5,8,8,2,5,6,9,0,0,2,-1,0,4.0,14.0,-10.0,10
84,84,1995-96,1995,1996,Arsenal,Middlesbrough,Draw,Home,1995-08-20,1,1,2,5,8,0,0,0,0,1,2,5,8,1,12.0,21.0,-9.0,1
85,85,1995-96,1995,1996,Arsenal,Everton,Win,Away,1995-08-23,3,1,2,3,6,2,5,6,7,-1,-3,-3,-1,0,12.0,15.0,-3.0,1
86,86,1995-96,1995,1996,Arsenal,Coventry,Draw,Away,1995-08-26,1,4,4,5,6,3,4,7,7,1,0,-2,-1,0,12.0,16.0,-4.0,1
87,87,1995-96,1995,1996,Arsenal,Nott'm Forest,Draw,Home,1995-08-29,1,4,5,5,6,2,5,6,9,2,0,-1,-3,1,12.0,3.0,9.0,1
88,88,1995-96,1995,1996,Arsenal,Man City,Win,Away,1995-09-10,3,2,5,6,6,0,0,1,1,2,5,5,5,0,12.0,17.0,-5.0,2
89,89,1995-96,1995,1996,Arsenal,West Ham,Win,Home,1995-09-16,3,4,5,8,9,1,2,2,2,3,3,6,7,1,12.0,14.0,-2.0,2
90,90,1995-96,1995,1996,Arsenal,Southampton,Win,Home,1995-09-23,3,6,7,8,11,1,4,5,5,5,3,3,6,1,12.0,10.0,2.0,2
91,91,1995-96,1995,1996,Arsenal,Chelsea,Loss,Away,1995-09-30,0,6,9,10,11,3,6,7,7,3,3,3,4,0,12.0,11.0,1.0,2
92,92,1995-96,1995,1996,Arsenal,Leeds,Win,Away,1995-10-14,3,3,6,9,10,6,6,6,7,-3,0,3,3,0,12.0,5.0,7.0,3
93,93,1995-96,1995,1996,Arsenal,Aston Villa,Win,Home,1995-10-21,3,3,6,9,12,3,4,7,8,0,2,2,4,1,12.0,18.0,-6.0,3
94,94,1995-96,1995,1996,Arsenal,Bolton,Loss,Away,1995-10-30,0,6,6,9,12,1,1,1,1,5,5,8,11,0,12.0,21.0,-9.0,3
95,95,1995-96,1995,1996,Arsenal,Man United,Win,Home,1995-11-04,3,3,6,6,9,6,9,10,11,-3,-3,-4,-2,1,12.0,2.0,10.0,4
96,96,1995-96,1995,1996,Arsenal,Tottenham,Loss,Away,1995-11-18,0,3,6,9,9,4,5,5,8,-1,1,4,1,0,12.0,7.0,5.0,4
97,97,1995-96,1995,1996,Arsenal,Sheffield Weds,Win,Home,1995-11-21,3,3,3,6,9,2,2,5,5,1,1,1,4,1,12.0,13.0,-1.0,4
98,98,1995-96,1995,1996,Arsenal,Blackburn,Draw,Home,1995-11-26,1,3,6,6,9,3,3,6,7,0,3,0,2,1,12.0,1.0,11.0,4
99,99,1995-96,1995,1996,Arsenal,Aston Villa,Draw,Away,1995-12-02,1,4,4,7,7,3,4,7,10,1,0,0,-3,0,12.0,18.0,-6.0,5
100,100,1995-96,1995,1996,Arsenal,Southampton,Draw,Away,1995-12-09,1,2,5,5,8,4,4,4,7,-2,1,1,1,0,12.0,10.0,2.0,5
101,101,1995-96,1995,1996,Arsenal,Chelsea,Draw,Home,1995-12-16,1,2,3,6,6,4,5,8,8,-2,-2,-2,-2,1,12.0,11.0,1.0,5
102,102,1995-96,1995,1996,Arsenal,Liverpool,Loss,Away,1995-12-23,0,2,3,4,7,6,7,7,8,-4,-4,-3,-1,0,12.0,4.0,8.0,5
103,103,1995-96,1995,1996,Arsenal,QPR,Win,Home,1995-12-26,3,1,2,3,4,6,6,7,7,-5,-4,-4,-3,1,12.0,8.0,4.0,5
104,104,1995-96,1995,1996,Arsenal,Wimbledon,Loss,Home,1995-12-30,0,3,4,5,6,4,4,5,6,-1,0,0,0,1,12.0,9.0,3.0,5
105,105,1995-96,1995,1996,Arsenal,Newcastle,Loss,Away,1996-01-02,0,3,3,4,5,3,6,6,7,0,-3,-2,-2,0,12.0,6.0,6.0,6
106,106,1995-96,1995,1996,Arsenal,Middlesbrough,Win,Away,1996-01-13,3,0,3,3,4,0,0,3,3,0,3,0,1,0,12.0,21.0,-9.0,6
107,107,1995-96,1995,1996,Arsenal,Everton,Loss,Home,1996-01-20,0,3,3,6,6,4,7,10,10,-1,-4,-4,-4,1,12.0,15.0,-3.0,6
108,108,1995-96,1995,1996,Arsenal,Coventry,Draw,Home,1996-02-03,1,3,3,3,6,1,1,2,5,2,2,1,1,1,12.0,16.0,-4.0,7
109,109,1995-96,1995,1996,Arsenal,Nott'm Forest,Win,Away,1996-02-10,3,1,4,4,4,3,3,6,6,-2,1,-2,-2,0,12.0,3.0,9.0,7
110,110,1995-96,1995,1996,Arsenal,West Ham,Win,Away,1996-02-24,3,4,4,7,7,6,9,12,15,-2,-5,-5,-8,0,12.0,14.0,-2.0,7
111,111,1995-96,1995,1996,Arsenal,QPR,Draw,Away,1996-03-02,1,6,7,7,10,3,3,3,3,3,4,4,7,0,12.0,8.0,4.0,8
112,112,1995-96,1995,1996,Arsenal,Man City,Win,Home,1996-03-05,3,4,7,8,8,2,2,5,6,2,5,3,2,1,12.0,17.0,-5.0,8
113,113,1995-96,1995,1996,Arsenal,Wimbledon,Win,Away,1996-03-16,3,4,7,10,11,2,3,3,3,2,4,7,8,0,12.0,9.0,3.0,8
114,114,1995-96,1995,1996,Arsenal,Man United,Loss,Away,1996-03-20,0,6,7,10,13,4,7,10,13,2,0,0,0,0,12.0,2.0,10.0,8
115,115,1995-96,1995,1996,Arsenal,Newcastle,Win,Home,1996-03-23,3,3,6,7,10,3,4,4,7,0,2,3,3,1,12.0,6.0,6.0,8
116,116,1995-96,1995,1996,Arsenal,Leeds,Win,Home,1996-04-06,3,3,6,9,10,3,4,4,7,0,2,5,3,1,12.0,5.0,7.0,9
117,117,1995-96,1995,1996,Arsenal,Sheffield Weds,Loss,Away,1996-04-08,0,6,6,9,12,0,3,6,6,6,3,3,6,0,12.0,13.0,-1.0,9
118,118,1995-96,1995,1996,Arsenal,Tottenham,Draw,Home,1996-04-15,1,3,6,6,9,1,4,4,7,2,2,2,2,1,12.0,7.0,5.0,9
119,119,1995-96,1995,1996,Arsenal,Blackburn,Draw,Away,1996-04-27,1,1,4,7,7,6,9,9,9,-5,-5,-2,-2,0,12.0,1.0,11.0,9
120,120,1995-96,1995,1996,Arsenal,Liverpool,Draw,Home,1996-05-01,1,2,2,5,8,4,7,7,10,-2,-5,-2,-2,1,12.0,4.0,8.0,10
121,121,1995-96,1995,1996,Arsenal,Bolton,Win,Home,1996-05-04,3,2,3,3,6,0,3,3,4,2,0,0,2,1,12.0,21.0,-9.0,10
122,122,1996-97,1996,1997,Arsenal,West Ham,Win,Home,1996-08-17,3,4,5,6,6,1,2,5,5,3,3,1,1,1,5.0,10.0,-5.0,1
123,123,1996-97,1996,1997,Arsenal,Liverpool,Loss,Away,1996-08-19,0,6,7,8,9,2,3,6,7,4,4,2,2,0,5.0,3.0,2.0,1
124,124,1996-97,1996,1997,Arsenal,Leicester,Win,Away,1996-08-24,3,3,6,7,8,4,5,6,9,-1,1,1,-1,0,5.0,21.0,-16.0,1
125,125,1996-97,1996,1997,Arsenal,Chelsea,Draw,Home,1996-09-04,1,3,6,9,10,6,7,7,8,-3,-1,2,2,1,5.0,11.0,-6.0,2
126,126,1996-97,1996,1997,Arsenal,Aston Villa,Draw,Away,1996-09-07,1,4,4,7,10,6,9,9,9,-2,-5,-2,1,0,5.0,4.0,1.0,2
127,127,1996-97,1996,1997,Arsenal,Sheffield Weds,Win,Home,1996-09-16,3,2,5,5,8,3,6,9,12,-1,-1,-4,-4,1,5.0,15.0,-10.0,2
128,128,1996-97,1996,1997,Arsenal,Middlesbrough,Win,Away,1996-09-21,3,4,5,8,8,6,9,10,10,-2,-4,-2,-2,0,5.0,12.0,-7.0,2
129,129,1996-97,1996,1997,Arsenal,Sunderland,Win,Home,1996-09-28,3,6,7,8,11,3,4,4,5,3,3,4,6,1,5.0,21.0,-16.0,2
130,130,1996-97,1996,1997,Arsenal,Blackburn,Win,Away,1996-10-12,3,6,9,10,11,2,2,2,2,4,7,8,9,0,5.0,7.0,-2.0,3
131,131,1996-97,1996,1997,Arsenal,Coventry,Draw,Home,1996-10-19,1,6,9,12,13,2,2,5,5,4,7,7,8,1,5.0,16.0,-11.0,3
132,132,1996-97,1996,1997,Arsenal,Leeds,Win,Home,1996-10-26,3,4,7,10,13,3,3,3,3,1,4,7,10,1,5.0,13.0,-8.0,3
133,133,1996-97,1996,1997,Arsenal,Wimbledon,Draw,Away,1996-11-02,1,4,7,10,13,4,7,10,13,0,0,0,0,0,5.0,14.0,-9.0,4
134,134,1996-97,1996,1997,Arsenal,Man United,Loss,Away,1996-11-16,0,4,5,8,11,0,0,3,6,4,5,5,5,0,5.0,1.0,4.0,4
135,135,1996-97,1996,1997,Arsenal,Tottenham,Win,Home,1996-11-24,3,1,4,5,8,6,6,9,12,-5,-2,-4,-4,1,5.0,8.0,-3.0,4
136,136,1996-97,1996,1997,Arsenal,Newcastle,Win,Away,1996-11-30,3,3,4,7,8,2,5,5,8,1,-1,2,0,0,5.0,2.0,3.0,4
137,137,1996-97,1996,1997,Arsenal,Southampton,Win,Home,1996-12-04,3,6,6,7,10,0,0,1,4,6,6,6,6,1,5.0,17.0,-12.0,5
138,138,1996-97,1996,1997,Arsenal,Derby,Draw,Home,1996-12-07,1,6,9,9,10,4,7,10,10,2,2,-1,0,1,5.0,21.0,-16.0,5
139,139,1996-97,1996,1997,Arsenal,Nott'm Forest,Loss,Away,1996-12-21,0,4,7,10,10,1,1,2,2,3,6,8,8,0,5.0,9.0,-4.0,5
140,140,1996-97,1996,1997,Arsenal,Sheffield Weds,Draw,Away,1996-12-26,1,1,4,7,10,2,5,6,7,-1,-1,1,3,0,5.0,15.0,-10.0,5
141,141,1996-97,1996,1997,Arsenal,Aston Villa,Draw,Home,1996-12-28,1,1,2,5,8,3,6,9,12,-2,-4,-4,-4,1,5.0,4.0,1.0,5
142,142,1996-97,1996,1997,Arsenal,Middlesbrough,Win,Home,1997-01-01,3,2,2,3,6,3,3,4,4,-1,-1,-1,2,1,5.0,12.0,-7.0,6
143,143,1996-97,1996,1997,Arsenal,Sunderland,Loss,Away,1997-01-11,0,4,5,5,6,1,4,4,7,3,1,1,-1,0,5.0,21.0,-16.0,6
144,144,1996-97,1996,1997,Arsenal,Everton,Win,Home,1997-01-19,3,3,4,5,5,0,0,0,1,3,4,5,4,1,5.0,6.0,-1.0,6
145,145,1996-97,1996,1997,Arsenal,West Ham,Win,Away,1997-01-29,3,3,6,7,8,1,1,4,4,2,5,3,4,0,5.0,10.0,-5.0,6
146,146,1996-97,1996,1997,Arsenal,Leeds,Draw,Away,1997-02-01,1,6,6,9,10,4,7,7,7,2,-1,2,3,0,5.0,13.0,-8.0,7
147,147,1996-97,1996,1997,Arsenal,Tottenham,Draw,Away,1997-02-15,1,4,7,7,10,3,3,3,3,1,4,4,7,0,5.0,8.0,-3.0,7
148,148,1996-97,1996,1997,Arsenal,Man United,Loss,Home,1997-02-19,0,2,5,8,8,6,9,12,13,-4,-4,-4,-5,1,5.0,1.0,4.0,7
149,149,1996-97,1996,1997,Arsenal,Wimbledon,Loss,Home,1997-02-23,0,1,2,5,8,1,1,2,5,0,1,3,3,1,5.0,14.0,-9.0,7
150,150,1996-97,1996,1997,Arsenal,Everton,Win,Away,1997-03-01,3,0,1,2,5,4,4,4,4,-4,-3,-2,1,0,5.0,6.0,-1.0,8
151,151,1996-97,1996,1997,Arsenal,Nott'm Forest,Win,Home,1997-03-08,3,3,3,4,5,3,4,4,4,0,-1,0,1,1,5.0,9.0,-4.0,8
152,152,1996-97,1996,1997,Arsenal,Southampton,Win,Away,1997-03-15,3,6,6,6,7,2,5,6,6,4,1,0,1,0,5.0,17.0,-12.0,8
153,153,1996-97,1996,1997,Arsenal,Liverpool,Loss,Home,1997-03-24,0,6,9,9,9,4,4,5,8,2,5,4,1,1,5.0,3.0,2.0,8
154,154,1996-97,1996,1997,Arsenal,Chelsea,Win,Away,1997-04-05,3,3,6,9,9,3,6,6,7,0,0,3,2,0,5.0,11.0,-6.0,9
155,155,1996-97,1996,1997,Arsenal,Leicester,Win,Home,1997-04-12,3,3,6,9,12,2,3,3,4,1,3,6,8,1,5.0,21.0,-16.0,9
156,156,1996-97,1996,1997,Arsenal,Blackburn,Draw,Home,1997-04-19,1,6,6,9,12,1,1,1,4,5,5,8,8,1,5.0,7.0,-2.0,9
157,157,1996-97,1996,1997,Arsenal,Coventry,Draw,Away,1997-04-21,1,4,7,7,10,4,7,7,7,0,0,0,3,0,5.0,16.0,-11.0,9
158,158,1996-97,1996,1997,Arsenal,Newcastle,Loss,Home,1997-05-03,0,2,5,8,8,6,7,8,9,-4,-2,0,-1,1,5.0,2.0,3.0,10
159,159,1996-97,1996,1997,Arsenal,Derby,Win,Away,1997-05-11,3,1,2,5,8,4,4,7,8,-3,-2,-2,0,0,5.0,21.0,-16.0,10
160,160,1997-98,1997,1998,Arsenal,Leeds,Draw,Away,1997-08-09,1,3,4,5,8,2,3,4,4,1,1,1,4,0,3.0,11.0,-8.0,1
161,161,1997-98,1997,1998,Arsenal,Coventry,Win,Home,1997-08-11,3,4,4,5,6,6,6,7,8,-2,-2,-2,-2,1,3.0,17.0,-14.0,1
162,162,1997-98,1997,1998,Arsenal,Southampton,Win,Away,1997-08-23,3,4,7,7,8,0,0,3,6,4,7,4,2,0,3.0,16.0,-13.0,1
163,163,1997-98,1997,1998,Arsenal,Leicester,Draw,Away,1997-08-27,1,6,7,10,10,4,7,10,13,2,0,0,-3,0,3.0,9.0,-6.0,1
164,164,1997-98,1997,1998,Arsenal,Tottenham,Draw,Home,1997-08-30,1,4,7,8,11,6,6,6,6,-2,1,2,5,1,3.0,10.0,-7.0,1
165,165,1997-98,1997,1998,Arsenal,Bolton,Win,Home,1997-09-13,3,2,5,8,9,1,2,5,5,1,3,3,4,1,3.0,21.0,-18.0,2
166,166,1997-98,1997,1998,Arsenal,Chelsea,Win,Away,1997-09-21,3,4,5,8,11,6,9,12,12,-2,-4,-4,-1,0,3.0,6.0,-3.0,2
167,167,1997-98,1997,1998,Arsenal,West Ham,Win,Home,1997-09-24,3,6,7,8,11,0,3,4,4,6,4,4,7,1,3.0,14.0,-11.0,2
168,168,1997-98,1997,1998,Arsenal,Everton,Draw,Away,1997-09-27,1,6,9,10,11,3,3,4,4,3,6,6,7,0,3.0,15.0,-12.0,2
169,169,1997-98,1997,1998,Arsenal,Barnsley,Win,Home,1997-10-04,3,4,7,10,11,0,0,0,0,4,7,10,11,1,3.0,21.0,-18.0,3
170,170,1997-98,1997,1998,Arsenal,Crystal Palace,Draw,Away,1997-10-18,1,4,7,10,13,1,2,5,5,3,5,5,8,0,3.0,21.0,-18.0,3
171,171,1997-98,1997,1998,Arsenal,Aston Villa,Draw,Home,1997-10-26,1,4,5,8,11,3,4,4,7,1,1,4,4,1,3.0,5.0,-2.0,3
172,172,1997-98,1997,1998,Arsenal,Derby,Loss,Away,1997-11-01,0,2,5,6,9,1,2,5,8,1,3,1,1,0,3.0,12.0,-9.0,4
173,173,1997-98,1997,1998,Arsenal,Man United,Win,Home,1997-11-09,3,1,2,5,6,6,7,10,10,-5,-5,-5,-4,1,3.0,1.0,2.0,4
174,174,1997-98,1997,1998,Arsenal,Sheffield Weds,Loss,Away,1997-11-22,0,3,4,5,8,3,3,3,6,0,1,2,2,0,3.0,7.0,-4.0,4
175,175,1997-98,1997,1998,Arsenal,Liverpool,Loss,Home,1997-11-30,0,3,3,4,5,3,4,7,7,0,-1,-3,-2,1,3.0,4.0,-1.0,4
176,176,1997-98,1997,1998,Arsenal,Newcastle,Win,Away,1997-12-06,3,0,3,3,4,3,6,7,8,-3,-3,-4,-4,0,3.0,2.0,1.0,5
177,177,1997-98,1997,1998,Arsenal,Blackburn,Loss,Home,1997-12-13,0,3,3,6,6,3,6,9,10,0,-3,-3,-4,1,3.0,13.0,-10.0,5
178,178,1997-98,1997,1998,Arsenal,Leicester,Win,Home,1997-12-26,3,3,3,3,6,0,1,4,5,3,2,-1,1,1,3.0,9.0,-6.0,5
179,179,1997-98,1997,1998,Arsenal,Tottenham,Draw,Away,1997-12-28,1,3,6,6,6,3,3,3,6,0,3,3,0,0,3.0,10.0,-7.0,5
180,180,1997-98,1997,1998,Arsenal,Leeds,Win,Home,1998-01-10,3,4,4,7,7,1,4,5,6,3,0,2,1,1,3.0,11.0,-8.0,6
181,181,1997-98,1997,1998,Arsenal,Coventry,Draw,Away,1998-01-17,1,4,7,7,10,3,3,3,6,1,4,4,4,0,3.0,17.0,-14.0,6
182,182,1997-98,1997,1998,Arsenal,Southampton,Win,Home,1998-01-31,3,4,5,8,8,4,7,8,9,0,-2,0,-1,1,3.0,16.0,-13.0,6
183,183,1997-98,1997,1998,Arsenal,Chelsea,Win,Home,1998-02-08,3,4,7,8,11,3,6,6,7,1,1,2,4,1,3.0,6.0,-3.0,7
184,184,1997-98,1997,1998,Arsenal,Crystal Palace,Win,Home,1998-02-21,3,6,7,10,11,0,0,0,1,6,7,10,10,1,3.0,21.0,-18.0,7
185,185,1997-98,1997,1998,Arsenal,West Ham,Draw,Away,1998-03-02,1,6,9,10,13,4,5,5,8,2,4,5,5,0,3.0,14.0,-11.0,8
186,186,1997-98,1997,1998,Arsenal,Wimbledon,Win,Away,1998-03-11,3,4,7,10,11,3,6,7,8,1,1,3,3,0,3.0,8.0,-5.0,8
187,187,1997-98,1997,1998,Arsenal,Man United,Win,Away,1998-03-14,3,4,7,10,13,1,4,7,10,3,3,3,3,0,3.0,1.0,2.0,8
188,188,1997-98,1997,1998,Arsenal,Sheffield Weds,Win,Home,1998-03-28,3,6,7,10,13,3,3,6,7,3,4,4,6,1,3.0,7.0,-4.0,8
189,189,1997-98,1997,1998,Arsenal,Bolton,Win,Away,1998-03-31,3,6,9,10,13,6,6,6,7,0,3,4,6,0,3.0,21.0,-18.0,8
190,190,1997-98,1997,1998,Arsenal,Newcastle,Win,Home,1998-04-11,3,6,9,12,13,1,1,2,3,5,8,10,10,1,3.0,2.0,1.0,9
191,191,1997-98,1997,1998,Arsenal,Blackburn,Win,Away,1998-04-13,3,6,9,12,15,0,3,3,3,6,6,9,12,0,3.0,13.0,-10.0,9
192,192,1997-98,1997,1998,Arsenal,Wimbledon,Win,Home,1998-04-18,3,6,9,12,15,4,5,6,6,2,4,6,9,1,3.0,8.0,-5.0,9
193,193,1997-98,1997,1998,Arsenal,Barnsley,Win,Away,1998-04-25,3,6,9,12,15,1,4,4,4,5,5,8,11,0,3.0,21.0,-18.0,9
194,194,1997-98,1997,1998,Arsenal,Derby,Win,Home,1998-04-29,3,6,9,12,15,0,3,4,4,6,6,8,11,1,3.0,12.0,-9.0,9
195,195,1997-98,1997,1998,Arsenal,Everton,Win,Home,1998-05-03,3,6,9,12,15,1,2,5,6,5,7,7,9,1,3.0,15.0,-12.0,10
196,196,1997-98,1997,1998,Arsenal,Liverpool,Loss,Away,1998-05-06,0,6,9,12,15,3,4,7,8,3,5,5,7,0,3.0,4.0,-1.0,10
197,197,1997-98,1997,1998,Arsenal,Aston Villa,Loss,Away,1998-05-10,0,3,6,9,12,3,6,9,12,0,0,0,0,0,3.0,5.0,-2.0,10
198,198,1998-99,1998,1999,Arsenal,Nott'm Forest,Win,Home,1998-08-17,3,0,3,6,9,1,2,3,3,-1,1,3,6,1,1.0,21.0,-20.0,1
199,199,1998-99,1998,1999,Arsenal,Liverpool,Draw,Away,1998-08-22,1,3,3,6,9,3,6,9,9,0,-3,-3,0,0,1.0,3.0,-2.0,1
200,200,1998-99,1998,1999,Arsenal,Charlton,Draw,Home,1998-08-29,1,4,4,4,7,4,4,4,4,0,0,0,3,1,1.0,21.0,-20.0,1
201,201,1998-99,1998,1999,Arsenal,Chelsea,Draw,Away,1998-09-09,1,2,5,5,5,1,4,4,4,1,1,1,1,0,1.0,4.0,-3.0,2
202,202,1998-99,1998,1999,Arsenal,Leicester,Draw,Away,1998-09-12,1,2,3,6,6,0,3,4,4,2,0,2,2,0,1.0,10.0,-9.0,2
203,203,1998-99,1998,1999,Arsenal,Man United,Win,Home,1998-09-20,3,2,3,4,7,6,7,8,11,-4,-4,-4,-4,1,1.0,2.0,-1.0,2
204,204,1998-99,1998,1999,Arsenal,Sheffield Weds,Loss,Away,1998-09-26,0,4,5,6,7,3,3,3,6,1,2,3,1,0,1.0,16.0,-15.0,2
205,205,1998-99,1998,1999,Arsenal,Newcastle,Win,Home,1998-10-04,3,3,4,5,6,6,9,9,9,-3,-5,-4,-3,1,1.0,13.0,-12.0,3
206,206,1998-99,1998,1999,Arsenal,Southampton,Draw,Home,1998-10-17,1,3,6,7,8,0,1,1,1,3,5,6,7,1,1.0,12.0,-11.0,3
207,207,1998-99,1998,1999,Arsenal,Blackburn,Win,Away,1998-10-25,3,4,4,7,8,3,4,4,4,1,0,3,4,0,1.0,6.0,-5.0,3
208,208,1998-99,1998,1999,Arsenal,Coventry,Win,Away,1998-10-31,3,4,7,7,10,3,3,4,4,1,4,3,6,0,1.0,11.0,-10.0,3
209,209,1998-99,1998,1999,Arsenal,Everton,Win,Home,1998-11-08,3,6,7,10,10,1,2,5,6,5,5,5,4,1,1.0,17.0,-16.0,4
210,210,1998-99,1998,1999,Arsenal,Tottenham,Draw,Home,1998-11-14,1,6,9,10,13,1,4,4,7,5,5,6,6,1,1.0,14.0,-13.0,4
211,211,1998-99,1998,1999,Arsenal,Wimbledon,Loss,Away,1998-11-21,0,4,7,10,11,3,4,5,5,1,3,5,6,0,1.0,15.0,-14.0,4
212,212,1998-99,1998,1999,Arsenal,Middlesbrough,Draw,Home,1998-11-29,1,1,4,7,10,4,5,6,7,-3,-1,1,3,1,1.0,21.0,-20.0,4
213,213,1998-99,1998,1999,Arsenal,Derby,Draw,Away,1998-12-05,1,1,2,5,8,3,4,7,8,-2,-2,-2,0,0,1.0,9.0,-8.0,5
214,214,1998-99,1998,1999,Arsenal,Aston Villa,Loss,Away,1998-12-13,0,2,2,3,6,1,2,2,5,1,0,1,1,0,1.0,7.0,-6.0,5
215,215,1998-99,1998,1999,Arsenal,Leeds,Win,Home,1998-12-20,3,1,2,2,3,6,6,9,12,-5,-4,-7,-9,1,1.0,5.0,-4.0,5
216,216,1998-99,1998,1999,Arsenal,West Ham,Win,Home,1998-12-26,3,3,4,5,5,3,3,6,9,0,1,-1,-4,1,1.0,8.0,-7.0,5
217,217,1998-99,1998,1999,Arsenal,Charlton,Win,Away,1998-12-28,3,6,6,7,8,0,0,0,0,6,6,7,8,0,1.0,21.0,-20.0,5
218,218,1998-99,1998,1999,Arsenal,Liverpool,Draw,Home,1999-01-09,1,6,9,9,10,6,9,9,9,0,0,0,1,1,1.0,3.0,-2.0,6
219,219,1998-99,1998,1999,Arsenal,Nott'm Forest,Win,Away,1999-01-16,3,4,7,10,10,1,1,2,2,3,6,8,8,0,1.0,21.0,-20.0,6
220,220,1998-99,1998,1999,Arsenal,Chelsea,Win,Home,1999-01-31,3,4,7,10,13,6,7,10,13,-2,0,0,0,1,1.0,4.0,-3.0,6
221,221,1998-99,1998,1999,Arsenal,West Ham,Win,Away,1999-02-06,3,6,7,10,13,1,1,4,4,5,6,6,9,0,1.0,8.0,-7.0,7
222,222,1998-99,1998,1999,Arsenal,Man United,Draw,Away,1999-02-17,1,6,9,10,13,6,9,12,15,0,0,-2,-2,0,1.0,2.0,-1.0,7
223,223,1998-99,1998,1999,Arsenal,Leicester,Win,Home,1999-02-20,3,4,7,10,11,1,1,2,3,3,6,8,8,1,1.0,10.0,-9.0,7
224,224,1998-99,1998,1999,Arsenal,Newcastle,Draw,Away,1999-02-28,1,4,7,10,13,3,6,9,10,1,1,1,3,0,1.0,13.0,-12.0,7
225,225,1998-99,1998,1999,Arsenal,Sheffield Weds,Win,Home,1999-03-09,3,4,5,8,11,3,6,9,9,1,-1,-1,2,1,1.0,16.0,-15.0,8
226,226,1998-99,1998,1999,Arsenal,Everton,Win,Away,1999-03-13,3,4,7,8,11,4,4,7,7,0,3,1,4,0,1.0,17.0,-16.0,8
227,227,1998-99,1998,1999,Arsenal,Coventry,Win,Home,1999-03-20,3,6,7,10,11,4,7,7,7,2,0,3,4,1,1.0,11.0,-10.0,8
228,228,1998-99,1998,1999,Arsenal,Southampton,Draw,Away,1999-04-03,1,6,9,10,13,3,6,6,6,3,3,4,7,0,1.0,12.0,-11.0,9
229,229,1998-99,1998,1999,Arsenal,Blackburn,Win,Home,1999-04-06,3,4,7,10,11,4,5,5,5,0,2,5,6,1,1.0,6.0,-5.0,9
230,230,1998-99,1998,1999,Arsenal,Wimbledon,Win,Home,1999-04-19,3,4,7,10,13,0,1,1,1,4,6,9,12,1,1.0,15.0,-14.0,9
231,231,1998-99,1998,1999,Arsenal,Middlesbrough,Win,Away,1999-04-24,3,6,7,10,13,4,7,10,11,2,0,0,2,0,1.0,21.0,-20.0,9
232,232,1998-99,1998,1999,Arsenal,Derby,Win,Home,1999-05-02,3,6,9,10,13,1,4,4,4,5,5,6,9,1,1.0,9.0,-8.0,10
233,233,1998-99,1998,1999,Arsenal,Tottenham,Win,Away,1999-05-05,3,6,9,12,13,0,3,6,7,6,6,6,6,0,1.0,14.0,-13.0,10
234,234,1998-99,1998,1999,Arsenal,Leeds,Loss,Away,1999-05-11,0,6,9,12,15,3,4,5,6,3,5,7,9,0,1.0,5.0,-4.0,10
235,235,1998-99,1998,1999,Arsenal,Aston Villa,Win,Home,1999-05-16,3,3,6,9,12,0,3,6,9,3,3,3,3,1,1.0,7.0,-6.0,10
236,236,1999-00,1999,2000,Arsenal,Leicester,Win,Home,1999-08-07,3,3,6,9,12,3,3,3,6,0,3,6,6,1,2.0,10.0,-8.0,1
237,237,1999-00,1999,2000,Arsenal,Derby,Win,Away,1999-08-10,3,6,6,9,12,1,2,5,5,5,4,4,7,0,2.0,8.0,-6.0,1
238,238,1999-00,1999,2000,Arsenal,Sunderland,Draw,Away,1999-08-14,1,6,9,9,12,3,3,6,6,3,6,3,6,0,2.0,21.0,-19.0,1
239,239,1999-00,1999,2000,Arsenal,Man United,Loss,Home,1999-08-22,0,4,7,10,10,6,7,10,11,-2,0,0,-1,1,2.0,1.0,1.0,1
240,240,1999-00,1999,2000,Arsenal,Bradford,Win,Home,1999-08-25,3,1,4,7,10,1,4,4,4,0,0,3,6,1,2.0,21.0,-19.0,1
241,241,1999-00,1999,2000,Arsenal,Liverpool,Loss,Away,1999-08-28,0,3,4,7,10,3,3,6,9,0,1,1,1,0,2.0,7.0,-5.0,1
242,242,1999-00,1999,2000,Arsenal,Aston Villa,Win,Home,1999-09-11,3,3,3,4,7,6,6,7,10,-3,-3,-3,-3,1,2.0,6.0,-4.0,2
243,243,1999-00,1999,2000,Arsenal,Southampton,Win,Away,1999-09-18,3,3,6,6,7,3,3,6,6,0,3,0,1,0,2.0,17.0,-15.0,2
244,244,1999-00,1999,2000,Arsenal,Watford,Win,Home,1999-09-25,3,6,6,9,9,3,3,3,6,3,3,6,3,1,2.0,21.0,-19.0,2
245,245,1999-00,1999,2000,Arsenal,West Ham,Loss,Away,1999-10-03,0,6,9,9,12,0,3,6,9,6,6,3,3,0,2.0,5.0,-3.0,3
246,246,1999-00,1999,2000,Arsenal,Everton,Win,Home,1999-10-16,3,3,6,9,9,4,7,10,10,-1,-1,-1,-1,1,2.0,14.0,-12.0,3
247,247,1999-00,1999,2000,Arsenal,Chelsea,Win,Away,1999-10-23,3,3,6,9,12,3,6,6,9,0,0,3,3,0,2.0,3.0,-1.0,3
248,248,1999-00,1999,2000,Arsenal,Newcastle,Draw,Home,1999-10-30,1,6,6,9,12,3,6,6,9,3,0,3,3,1,2.0,13.0,-11.0,3
249,249,1999-00,1999,2000,Arsenal,Tottenham,Loss,Away,1999-11-07,0,4,7,7,10,3,6,6,7,1,1,1,3,0,2.0,11.0,-9.0,4
250,250,1999-00,1999,2000,Arsenal,Middlesbrough,Win,Home,1999-11-20,3,1,4,7,7,4,7,10,10,-3,-3,-3,-3,1,2.0,9.0,-7.0,4
251,251,1999-00,1999,2000,Arsenal,Derby,Win,Home,1999-11-28,3,3,4,7,10,0,3,3,3,3,1,4,7,1,2.0,8.0,-6.0,4
252,252,1999-00,1999,2000,Arsenal,Leicester,Win,Away,1999-12-04,3,6,6,7,10,6,6,9,9,0,0,-2,1,0,2.0,10.0,-8.0,5
253,253,1999-00,1999,2000,Arsenal,Wimbledon,Draw,Home,1999-12-18,1,6,9,9,10,4,4,7,8,2,5,2,2,1,2.0,16.0,-14.0,5
254,254,1999-00,1999,2000,Arsenal,Coventry,Loss,Away,1999-12-26,0,4,7,10,10,1,1,4,5,3,6,6,5,0,2.0,15.0,-13.0,5
255,255,1999-00,1999,2000,Arsenal,Leeds,Win,Home,1999-12-28,3,1,4,7,10,6,9,12,15,-5,-5,-5,-5,1,2.0,4.0,-2.0,5
256,256,1999-00,1999,2000,Arsenal,Sheffield Weds,Draw,Away,2000-01-03,1,3,4,7,10,3,3,3,3,0,1,4,7,0,2.0,12.0,-10.0,6
257,257,1999-00,1999,2000,Arsenal,Sunderland,Win,Home,2000-01-15,3,4,4,5,8,1,1,4,7,3,3,1,1,1,2.0,21.0,-19.0,6
258,258,1999-00,1999,2000,Arsenal,Man United,Draw,Away,2000-01-24,1,4,7,7,8,4,7,10,13,0,0,-3,-5,0,2.0,1.0,1.0,6
259,259,1999-00,1999,2000,Arsenal,Bradford,Loss,Away,2000-02-05,0,4,5,8,8,3,4,4,5,1,1,4,3,0,2.0,21.0,-19.0,7
260,260,1999-00,1999,2000,Arsenal,Liverpool,Loss,Home,2000-02-13,0,1,4,5,8,4,7,7,10,-3,-3,-2,-2,1,2.0,7.0,-5.0,7
261,261,1999-00,1999,2000,Arsenal,Southampton,Win,Home,2000-02-26,3,0,1,4,5,6,9,9,12,-6,-8,-5,-7,1,2.0,17.0,-15.0,7
262,262,1999-00,1999,2000,Arsenal,Aston Villa,Draw,Away,2000-03-05,1,3,3,4,7,4,7,8,9,-1,-4,-4,-2,0,2.0,6.0,-4.0,8
263,263,1999-00,1999,2000,Arsenal,Middlesbrough,Loss,Away,2000-03-12,0,4,4,4,5,2,5,5,5,2,-1,-1,0,0,2.0,9.0,-7.0,8
264,264,1999-00,1999,2000,Arsenal,Tottenham,Win,Home,2000-03-19,3,1,4,4,4,4,7,7,7,-3,-3,-3,-3,1,2.0,11.0,-9.0,8
265,265,1999-00,1999,2000,Arsenal,Coventry,Win,Home,2000-03-26,3,3,4,7,7,6,6,6,6,-3,-2,1,1,1,2.0,15.0,-13.0,8
266,266,1999-00,1999,2000,Arsenal,Wimbledon,Win,Away,2000-04-01,3,6,6,7,10,0,3,3,4,6,3,4,6,0,2.0,16.0,-14.0,9
267,267,1999-00,1999,2000,Arsenal,Leeds,Win,Away,2000-04-16,3,6,9,9,10,0,0,3,6,6,9,6,4,0,2.0,4.0,-2.0,9
268,268,1999-00,1999,2000,Arsenal,Watford,Win,Away,2000-04-23,3,6,9,12,12,1,1,2,5,5,8,10,7,0,2.0,21.0,-19.0,9
269,269,1999-00,1999,2000,Arsenal,Everton,Win,Away,2000-04-29,3,6,9,12,15,4,5,8,8,2,4,4,7,0,2.0,14.0,-12.0,9
270,270,1999-00,1999,2000,Arsenal,West Ham,Win,Home,2000-05-02,3,6,9,12,15,3,6,9,9,3,3,3,6,1,2.0,5.0,-3.0,10
271,271,1999-00,1999,2000,Arsenal,Chelsea,Win,Home,2000-05-06,3,6,9,12,15,3,4,4,7,3,5,8,8,1,2.0,3.0,-1.0,10
272,272,1999-00,1999,2000,Arsenal,Sheffield Weds,Draw,Home,2000-05-09,1,6,9,12,15,0,0,3,6,6,9,9,9,1,2.0,12.0,-10.0,10
273,273,1999-00,1999,2000,Arsenal,Newcastle,Loss,Away,2000-05-14,0,4,7,10,13,2,5,6,6,2,2,4,7,0,2.0,13.0,-11.0,10
274,274,2000-01,2000,2001,Arsenal,Sunderland,Loss,Away,2000-08-19,0,1,4,7,10,3,4,4,7,-2,0,3,3,0,2.0,7.0,-5.0,1
275,275,2000-01,2000,2001,Arsenal,Liverpool,Win,Home,2000-08-21,3,0,1,4,7,3,4,4,4,-3,-3,0,3,1,2.0,4.0,-2.0,1
276,276,2000-01,2000,2001,Arsenal,Charlton,Win,Home,2000-08-26,3,3,3,4,7,3,3,6,7,0,0,-2,0,1,2.0,21.0,-19.0,1
277,277,2000-01,2000,2001,Arsenal,Chelsea,Draw,Away,2000-09-06,1,6,6,6,7,1,4,7,7,5,2,-1,0,0,2.0,5.0,-3.0,2
278,278,2000-01,2000,2001,Arsenal,Bradford,Draw,Away,2000-09-09,1,4,7,7,7,1,4,4,7,3,3,3,0,0,2.0,17.0,-15.0,2
279,279,2000-01,2000,2001,Arsenal,Coventry,Win,Home,2000-09-16,3,2,5,8,8,1,4,7,7,1,1,1,1,1,2.0,14.0,-12.0,2
280,280,2000-01,2000,2001,Arsenal,Ipswich,Draw,Away,2000-09-23,1,4,5,8,11,3,3,6,7,1,2,2,4,0,2.0,21.0,-19.0,2
281,281,2000-01,2000,2001,Arsenal,Man United,Win,Home,2000-10-01,3,4,5,6,9,4,7,10,11,0,-2,-4,-2,1,2.0,1.0,1.0,3
282,282,2000-01,2000,2001,Arsenal,Aston Villa,Win,Home,2000-10-14,3,4,7,8,9,4,7,10,10,0,0,-2,-1,1,2.0,6.0,-4.0,3
283,283,2000-01,2000,2001,Arsenal,West Ham,Win,Away,2000-10-21,3,6,7,10,11,2,5,6,6,4,2,4,5,0,2.0,9.0,-7.0,3
284,284,2000-01,2000,2001,Arsenal,Man City,Win,Home,2000-10-28,3,6,9,10,13,6,6,7,8,0,3,3,5,1,2.0,21.0,-19.0,3
285,285,2000-01,2000,2001,Arsenal,Middlesbrough,Win,Away,2000-11-04,3,6,9,12,13,0,0,3,4,6,9,9,9,0,2.0,12.0,-10.0,4
286,286,2000-01,2000,2001,Arsenal,Derby,Draw,Home,2000-11-11,1,6,9,12,15,1,1,1,1,5,8,11,14,1,2.0,16.0,-14.0,4
287,287,2000-01,2000,2001,Arsenal,Everton,Loss,Away,2000-11-18,0,4,7,10,13,3,3,6,7,1,4,4,6,0,2.0,13.0,-11.0,4
288,288,2000-01,2000,2001,Arsenal,Leeds,Loss,Away,2000-11-26,0,1,4,7,10,1,4,5,5,0,0,2,5,0,2.0,3.0,-1.0,4
289,289,2000-01,2000,2001,Arsenal,Southampton,Win,Home,2000-12-02,3,0,1,4,7,3,4,7,7,-3,-3,-3,0,1,2.0,15.0,-13.0,5
290,290,2000-01,2000,2001,Arsenal,Newcastle,Win,Home,2000-12-09,3,3,3,4,7,4,4,5,8,-1,-1,-1,-1,1,2.0,11.0,-9.0,5
291,291,2000-01,2000,2001,Arsenal,Tottenham,Draw,Away,2000-12-18,1,6,6,6,7,1,4,7,7,5,2,-1,0,0,2.0,10.0,-8.0,5
292,292,2000-01,2000,2001,Arsenal,Liverpool,Loss,Away,2000-12-23,0,4,7,7,7,3,6,6,6,1,1,1,1,0,2.0,4.0,-2.0,5
293,293,2000-01,2000,2001,Arsenal,Leicester,Win,Home,2000-12-26,3,1,4,7,7,6,6,9,9,-5,-2,-2,-2,1,2.0,8.0,-6.0,5
294,294,2000-01,2000,2001,Arsenal,Sunderland,Draw,Home,2000-12-30,1,3,4,7,10,6,6,9,12,-3,-2,-2,-2,1,2.0,7.0,-5.0,5
295,295,2000-01,2000,2001,Arsenal,Charlton,Loss,Away,2001-01-01,0,4,4,5,8,3,6,6,7,1,-2,-1,1,0,2.0,21.0,-19.0,6
296,296,2000-01,2000,2001,Arsenal,Chelsea,Draw,Home,2001-01-13,1,1,4,4,5,4,7,7,10,-3,-3,-3,-5,1,2.0,5.0,-3.0,6
297,297,2000-01,2000,2001,Arsenal,Leicester,Draw,Away,2001-01-20,1,1,2,5,5,0,0,3,6,1,2,2,-1,0,2.0,8.0,-6.0,6
298,298,2000-01,2000,2001,Arsenal,Bradford,Win,Home,2001-01-30,3,2,2,3,6,1,4,4,4,1,-2,-1,2,1,2.0,17.0,-15.0,6
299,299,2000-01,2000,2001,Arsenal,Coventry,Win,Away,2001-02-03,3,4,5,5,6,0,0,1,2,4,5,4,4,0,2.0,14.0,-12.0,7
300,300,2000-01,2000,2001,Arsenal,Ipswich,Win,Home,2001-02-10,3,6,7,8,8,0,3,3,6,6,4,5,2,1,2.0,21.0,-19.0,7
301,301,2000-01,2000,2001,Arsenal,Man United,Loss,Away,2001-02-25,0,6,9,10,11,4,7,10,13,2,2,0,-2,0,2.0,1.0,1.0,7
302,302,2000-01,2000,2001,Arsenal,West Ham,Win,Home,2001-03-03,3,3,6,9,10,4,4,5,6,-1,2,4,4,1,2.0,9.0,-7.0,8
303,303,2000-01,2000,2001,Arsenal,Aston Villa,Draw,Away,2001-03-18,1,3,6,9,12,4,4,5,8,-1,2,4,4,0,2.0,6.0,-4.0,8
304,304,2000-01,2000,2001,Arsenal,Tottenham,Win,Home,2001-03-31,3,4,4,7,10,3,3,6,7,1,1,1,3,1,2.0,10.0,-8.0,8
305,305,2000-01,2000,2001,Arsenal,Man City,Win,Away,2001-04-11,3,4,7,7,10,0,1,1,4,4,6,6,6,0,2.0,21.0,-19.0,9
306,306,2000-01,2000,2001,Arsenal,Middlesbrough,Loss,Home,2001-04-14,0,6,7,10,10,1,4,5,5,5,3,5,5,1,2.0,12.0,-10.0,9
307,307,2000-01,2000,2001,Arsenal,Everton,Win,Home,2001-04-21,3,3,6,7,10,0,3,6,6,3,3,1,4,1,2.0,13.0,-11.0,9
308,308,2000-01,2000,2001,Arsenal,Derby,Win,Away,2001-04-28,3,3,6,9,10,3,3,3,3,0,3,6,7,0,2.0,16.0,-14.0,9
309,309,2000-01,2000,2001,Arsenal,Leeds,Win,Home,2001-05-05,3,6,6,9,12,6,9,12,15,0,-3,-3,-3,1,2.0,3.0,-1.0,10
310,310,2000-01,2000,2001,Arsenal,Newcastle,Draw,Away,2001-05-15,1,6,9,9,12,1,4,5,8,5,5,4,4,0,2.0,11.0,-9.0,10
311,311,2000-01,2000,2001,Arsenal,Southampton,Loss,Away,2001-05-19,0,4,7,10,10,3,4,4,5,1,3,6,5,0,2.0,15.0,-13.0,10
312,312,2001-02,2001,2002,Arsenal,Middlesbrough,Win,Away,2001-08-18,3,1,4,7,10,4,4,7,7,-3,0,0,3,0,2.0,14.0,-12.0,1
313,313,2001-02,2001,2002,Arsenal,Leeds,Loss,Home,2001-08-21,0,3,4,7,10,6,9,9,12,-3,-5,-2,-2,1,2.0,4.0,-2.0,1
314,314,2001-02,2001,2002,Arsenal,Leicester,Win,Home,2001-08-25,3,3,3,4,7,0,3,3,3,3,0,1,4,1,2.0,13.0,-11.0,1
315,315,2001-02,2001,2002,Arsenal,Chelsea,Draw,Away,2001-09-08,1,3,6,6,7,4,7,8,11,-1,-1,-2,-4,0,2.0,6.0,-4.0,2
316,316,2001-02,2001,2002,Arsenal,Fulham,Win,Away,2001-09-15,3,4,4,7,7,2,5,5,5,2,-1,2,2,0,2.0,21.0,-19.0,2
317,317,2001-02,2001,2002,Arsenal,Bolton,Draw,Home,2001-09-22,1,4,7,7,10,1,2,5,8,3,5,2,2,1,2.0,21.0,-19.0,2
318,318,2001-02,2001,2002,Arsenal,Derby,Win,Away,2001-09-29,3,4,5,8,8,0,1,2,2,4,4,6,6,0,2.0,17.0,-15.0,2
319,319,2001-02,2001,2002,Arsenal,Southampton,Win,Away,2001-10-13,3,4,7,8,11,3,6,6,6,1,1,2,5,0,2.0,10.0,-8.0,3
320,320,2001-02,2001,2002,Arsenal,Blackburn,Draw,Home,2001-10-20,1,6,7,10,11,3,6,7,8,3,1,3,3,1,2.0,21.0,-19.0,3
321,321,2001-02,2001,2002,Arsenal,Sunderland,Draw,Away,2001-10-27,1,4,7,8,11,0,3,4,4,4,4,4,7,0,2.0,7.0,-5.0,3
322,322,2001-02,2001,2002,Arsenal,Charlton,Loss,Home,2001-11-04,0,2,5,8,9,0,1,2,5,2,4,6,4,1,2.0,9.0,-7.0,4
323,323,2001-02,2001,2002,Arsenal,Tottenham,Draw,Away,2001-11-17,1,1,2,5,8,3,6,9,9,-2,-4,-4,-1,0,2.0,12.0,-10.0,4
324,324,2001-02,2001,2002,Arsenal,Man United,Win,Home,2001-11-25,3,1,2,3,6,3,4,4,7,-2,-2,-1,-1,1,2.0,1.0,1.0,4
325,325,2001-02,2001,2002,Arsenal,Ipswich,Win,Away,2001-12-01,3,4,4,5,6,1,1,1,2,3,3,4,4,0,2.0,5.0,-3.0,5
326,326,2001-02,2001,2002,Arsenal,Aston Villa,Win,Home,2001-12-09,3,6,7,7,8,1,2,3,3,5,5,4,5,1,2.0,8.0,-6.0,5
327,327,2001-02,2001,2002,Arsenal,West Ham,Draw,Away,2001-12-15,1,6,9,10,10,4,4,4,5,2,5,6,5,0,2.0,15.0,-13.0,5
328,328,2001-02,2001,2002,Arsenal,Newcastle,Loss,Home,2001-12-18,0,4,7,10,11,6,7,10,10,-2,0,0,1,1,2.0,11.0,-9.0,5
329,329,2001-02,2001,2002,Arsenal,Liverpool,Win,Away,2001-12-23,3,1,4,7,10,1,4,7,10,0,0,0,0,0,2.0,3.0,-1.0,5
330,330,2001-02,2001,2002,Arsenal,Chelsea,Win,Home,2001-12-26,3,3,4,7,10,6,7,7,10,-3,-3,0,0,1,2.0,6.0,-4.0,5
331,331,2001-02,2001,2002,Arsenal,Middlesbrough,Win,Home,2001-12-29,3,6,6,7,10,0,0,3,4,6,6,4,6,1,2.0,14.0,-12.0,5
332,332,2001-02,2001,2002,Arsenal,Liverpool,Draw,Home,2002-01-13,1,6,9,9,10,1,2,5,5,5,7,4,5,1,2.0,3.0,-1.0,6
333,333,2001-02,2001,2002,Arsenal,Leeds,Draw,Away,2002-01-20,1,4,7,10,10,3,6,9,9,1,1,1,1,0,2.0,4.0,-2.0,6
334,334,2001-02,2001,2002,Arsenal,Leicester,Win,Away,2002-01-23,3,2,5,8,11,1,2,2,3,1,3,6,8,0,2.0,13.0,-11.0,6
335,335,2001-02,2001,2002,Arsenal,Blackburn,Win,Away,2002-01-30,3,4,5,8,11,3,3,3,3,1,2,5,8,0,2.0,21.0,-19.0,6
336,336,2001-02,2001,2002,Arsenal,Southampton,Draw,Home,2002-02-02,1,6,7,8,11,4,4,7,10,2,3,1,1,1,2.0,10.0,-8.0,7
337,337,2001-02,2001,2002,Arsenal,Everton,Win,Away,2002-02-10,3,4,7,8,9,1,2,5,5,3,5,3,4,0,2.0,16.0,-14.0,7
338,338,2001-02,2001,2002,Arsenal,Fulham,Win,Home,2002-02-23,3,4,7,10,11,3,4,4,5,1,3,6,6,1,2.0,21.0,-19.0,7
339,339,2001-02,2001,2002,Arsenal,Newcastle,Win,Away,2002-03-02,3,6,7,10,13,6,9,12,13,0,-2,-2,0,0,2.0,11.0,-9.0,8
340,340,2001-02,2001,2002,Arsenal,Derby,Win,Home,2002-03-05,3,6,9,10,13,4,4,7,7,2,5,3,6,1,2.0,17.0,-15.0,8
341,341,2001-02,2001,2002,Arsenal,Aston Villa,Win,Away,2002-03-17,3,6,9,12,13,3,3,4,5,3,6,8,8,0,2.0,8.0,-6.0,8
342,342,2001-02,2001,2002,Arsenal,Sunderland,Win,Home,2002-03-30,3,6,9,12,15,1,4,4,4,5,5,8,11,1,2.0,7.0,-5.0,8
343,343,2001-02,2001,2002,Arsenal,Charlton,Win,Away,2002-04-01,3,6,9,12,15,0,3,4,7,6,6,8,8,0,2.0,9.0,-7.0,9
344,344,2001-02,2001,2002,Arsenal,Tottenham,Win,Home,2002-04-06,3,6,9,12,15,4,7,7,7,2,2,5,8,1,2.0,12.0,-10.0,9
345,345,2001-02,2001,2002,Arsenal,Ipswich,Win,Home,2002-04-21,3,6,9,12,15,1,1,2,3,5,8,10,12,1,2.0,5.0,-3.0,9
346,346,2001-02,2001,2002,Arsenal,West Ham,Win,Home,2002-04-24,3,6,9,12,15,4,7,10,13,2,2,2,2,1,2.0,15.0,-13.0,9
347,347,2001-02,2001,2002,Arsenal,Bolton,Win,Away,2002-04-29,3,6,9,12,15,1,4,4,7,5,5,8,8,0,2.0,21.0,-19.0,9
348,348,2001-02,2001,2002,Arsenal,Man United,Win,Away,2002-05-08,3,6,9,12,15,6,9,12,12,0,0,0,3,0,2.0,1.0,1.0,10
349,349,2001-02,2001,2002,Arsenal,Everton,Win,Home,2002-05-11,3,6,9,12,15,3,4,4,7,3,5,8,8,1,2.0,16.0,-14.0,10
350,350,2002-03,2002,2003,Arsenal,Birmingham,Win,Home,2002-08-18,3,6,9,12,15,0,0,0,0,6,9,12,15,1,1.0,21.0,-20.0,1
351,351,2002-03,2002,2003,Arsenal,West Ham,Draw,Away,2002-08-24,1,6,9,12,15,3,3,3,6,3,6,9,9,0,1.0,7.0,-6.0,1
352,352,2002-03,2002,2003,Arsenal,West Brom,Win,Home,2002-08-27,3,4,7,10,13,0,0,0,0,4,7,10,13,1,1.0,21.0,-20.0,1
353,353,2002-03,2002,2003,Arsenal,Chelsea,Draw,Away,2002-09-01,1,4,7,10,13,2,5,5,8,2,2,5,5,0,1.0,6.0,-5.0,2
354,354,2002-03,2002,2003,Arsenal,Man City,Win,Home,2002-09-10,3,4,5,8,11,3,6,6,6,1,-1,2,5,1,1.0,21.0,-20.0,2
355,355,2002-03,2002,2003,Arsenal,Charlton,Win,Away,2002-09-14,3,4,7,8,11,3,3,6,6,1,4,2,5,0,1.0,14.0,-13.0,2
356,356,2002-03,2002,2003,Arsenal,Bolton,Win,Home,2002-09-21,3,6,7,10,11,3,6,6,6,3,1,4,5,1,1.0,16.0,-15.0,2
357,357,2002-03,2002,2003,Arsenal,Leeds,Win,Away,2002-09-28,3,6,9,10,13,3,6,6,6,3,3,4,7,0,1.0,5.0,-4.0,2
358,358,2002-03,2002,2003,Arsenal,Sunderland,Win,Home,2002-10-06,3,6,9,12,13,3,3,3,4,3,6,9,9,1,1.0,17.0,-16.0,3
359,359,2002-03,2002,2003,Arsenal,Everton,Loss,Away,2002-10-19,0,6,9,12,15,3,3,6,6,3,6,6,9,0,1.0,15.0,-14.0,3
360,360,2002-03,2002,2003,Arsenal,Blackburn,Loss,Home,2002-10-26,0,3,6,9,12,3,6,9,10,0,0,0,2,1,1.0,10.0,-9.0,3
361,361,2002-03,2002,2003,Arsenal,Fulham,Win,Away,2002-11-03,3,0,3,6,9,0,1,4,4,0,2,2,5,0,1.0,13.0,-12.0,4
362,362,2002-03,2002,2003,Arsenal,Newcastle,Win,Home,2002-11-09,3,3,3,6,9,6,6,9,12,-3,-3,-3,-3,1,1.0,4.0,-3.0,4
363,363,2002-03,2002,2003,Arsenal,Tottenham,Win,Home,2002-11-16,3,6,6,6,9,1,1,4,7,5,5,2,2,1,1.0,9.0,-8.0,4
364,364,2002-03,2002,2003,Arsenal,Southampton,Loss,Away,2002-11-23,0,6,9,9,9,1,1,4,7,5,8,5,2,0,1.0,11.0,-10.0,4
365,365,2002-03,2002,2003,Arsenal,Aston Villa,Win,Home,2002-11-30,3,3,6,9,9,4,7,8,9,-1,-1,1,0,1,1.0,8.0,-7.0,4
366,366,2002-03,2002,2003,Arsenal,Man United,Loss,Away,2002-12-07,0,3,6,9,12,6,7,7,10,-3,-1,2,2,0,1.0,3.0,-2.0,5
367,367,2002-03,2002,2003,Arsenal,Tottenham,Draw,Away,2002-12-15,1,3,3,6,9,4,7,7,7,-1,-4,-1,2,0,1.0,9.0,-8.0,5
368,368,2002-03,2002,2003,Arsenal,Middlesbrough,Win,Home,2002-12-21,3,1,4,4,7,2,2,5,5,-1,2,-1,2,1,1.0,12.0,-11.0,5
369,369,2002-03,2002,2003,Arsenal,West Brom,Win,Away,2002-12-26,3,4,4,7,7,1,1,4,4,3,3,3,3,0,1.0,21.0,-20.0,5
370,370,2002-03,2002,2003,Arsenal,Liverpool,Draw,Home,2002-12-29,1,6,7,7,10,2,2,2,2,4,5,5,8,1,1.0,2.0,-1.0,5
371,371,2002-03,2002,2003,Arsenal,Chelsea,Win,Home,2003-01-01,3,4,7,8,8,1,4,5,8,3,3,3,0,1,1.0,6.0,-5.0,6
372,372,2002-03,2002,2003,Arsenal,Birmingham,Win,Away,2003-01-12,3,4,7,10,11,0,1,2,5,4,6,8,6,0,1.0,21.0,-20.0,6
373,373,2002-03,2002,2003,Arsenal,West Ham,Win,Home,2003-01-19,3,6,7,10,13,2,3,4,4,4,4,6,9,1,1.0,7.0,-6.0,6
374,374,2002-03,2002,2003,Arsenal,Liverpool,Draw,Away,2003-01-29,1,6,9,10,13,4,4,5,6,2,5,5,7,0,1.0,2.0,-1.0,6
375,375,2002-03,2002,2003,Arsenal,Fulham,Win,Home,2003-02-01,3,4,7,10,11,3,4,4,5,1,3,6,6,1,1.0,13.0,-12.0,7
376,376,2002-03,2002,2003,Arsenal,Newcastle,Draw,Away,2003-02-09,1,4,7,10,13,6,9,10,13,-2,-2,0,0,0,1.0,4.0,-3.0,7
377,377,2002-03,2002,2003,Arsenal,Man City,Win,Away,2003-02-22,3,4,5,8,11,1,4,4,7,3,1,4,4,0,1.0,21.0,-20.0,7
378,378,2002-03,2002,2003,Arsenal,Charlton,Win,Home,2003-03-02,3,4,7,8,11,6,9,12,15,-2,-2,-4,-4,1,1.0,14.0,-13.0,8
379,379,2002-03,2002,2003,Arsenal,Blackburn,Loss,Away,2003-03-15,0,6,7,10,11,6,9,9,9,0,-2,1,2,0,1.0,10.0,-9.0,8
380,380,2002-03,2002,2003,Arsenal,Everton,Win,Home,2003-03-23,3,3,6,7,10,2,5,5,8,1,1,2,2,1,1.0,15.0,-14.0,8
381,381,2002-03,2002,2003,Arsenal,Aston Villa,Draw,Away,2003-04-05,1,3,6,9,10,1,1,1,1,2,5,8,9,0,1.0,8.0,-7.0,9
382,382,2002-03,2002,2003,Arsenal,Man United,Draw,Home,2003-04-16,1,4,4,7,10,6,9,12,15,-2,-5,-5,-5,1,1.0,3.0,-2.0,9
383,383,2002-03,2002,2003,Arsenal,Middlesbrough,Win,Away,2003-04-19,3,2,5,5,8,4,5,8,11,-2,0,-3,-3,0,1.0,12.0,-11.0,9
384,384,2002-03,2002,2003,Arsenal,Bolton,Draw,Away,2003-04-26,1,4,5,8,8,4,4,7,10,0,1,1,-2,0,1.0,16.0,-15.0,9
385,385,2002-03,2002,2003,Arsenal,Leeds,Loss,Home,2003-05-04,0,4,5,6,9,3,3,4,7,1,2,2,2,1,1.0,5.0,-4.0,10
386,386,2002-03,2002,2003,Arsenal,Southampton,Win,Home,2003-05-07,3,1,4,5,6,1,1,4,5,0,3,1,1,1,1.0,11.0,-10.0,10
387,387,2002-03,2002,2003,Arsenal,Sunderland,Win,Away,2003-05-11,3,3,4,7,8,0,0,0,0,3,4,7,8,0,1.0,17.0,-16.0,10
388,388,2003-04,2003,2004,Arsenal,Everton,Win,Home,2003-08-16,3,6,6,7,10,0,3,3,3,6,3,4,7,1,2.0,7.0,-5.0,1
389,389,2003-04,2003,2004,Arsenal,Middlesbrough,Win,Away,2003-08-24,3,6,9,9,10,0,0,0,0,6,9,9,10,0,2.0,11.0,-9.0,1
390,390,2003-04,2003,2004,Arsenal,Aston Villa,Win,Home,2003-08-27,3,6,9,12,12,1,1,4,4,5,8,8,8,1,2.0,16.0,-14.0,1
391,391,2003-04,2003,2004,Arsenal,Man City,Win,Away,2003-08-31,3,6,9,12,15,4,7,7,10,2,2,5,5,0,2.0,9.0,-7.0,1
392,392,2003-04,2003,2004,Arsenal,Portsmouth,Draw,Home,2003-09-13,1,6,9,12,15,4,5,8,8,2,4,4,7,1,2.0,21.0,-19.0,2
393,393,2003-04,2003,2004,Arsenal,Man United,Draw,Away,2003-09-21,1,4,7,10,13,3,6,9,12,1,1,1,1,0,2.0,1.0,1.0,2
394,394,2003-04,2003,2004,Arsenal,Newcastle,Win,Home,2003-09-26,3,2,5,8,11,2,2,2,3,0,3,6,8,1,2.0,3.0,-1.0,2
395,395,2003-04,2003,2004,Arsenal,Liverpool,Win,Away,2003-10-04,3,4,5,8,11,3,6,9,10,1,-1,-1,1,0,2.0,5.0,-3.0,3
396,396,2003-04,2003,2004,Arsenal,Chelsea,Win,Home,2003-10-18,3,6,7,8,11,4,7,10,13,2,0,-2,-2,1,2.0,4.0,-2.0,3
397,397,2003-04,2003,2004,Arsenal,Charlton,Draw,Away,2003-10-26,1,6,9,10,11,6,9,9,9,0,0,1,2,0,2.0,12.0,-10.0,3
398,398,2003-04,2003,2004,Arsenal,Leeds,Win,Away,2003-11-01,3,4,7,10,11,0,3,3,3,4,4,7,8,0,2.0,15.0,-13.0,4
399,399,2003-04,2003,2004,Arsenal,Tottenham,Win,Home,2003-11-08,3,4,7,10,13,1,4,7,8,3,3,3,5,1,2.0,10.0,-8.0,4
400,400,2003-04,2003,2004,Arsenal,Birmingham,Win,Away,2003-11-22,3,6,7,10,13,1,4,5,6,5,3,5,7,0,2.0,13.0,-11.0,4
401,401,2003-04,2003,2004,Arsenal,Fulham,Draw,Home,2003-11-30,1,6,9,10,13,3,3,6,6,3,6,4,7,1,2.0,14.0,-12.0,4
402,402,2003-04,2003,2004,Arsenal,Leicester,Draw,Away,2003-12-06,1,4,7,10,11,4,7,10,10,0,0,0,1,0,2.0,21.0,-19.0,5
403,403,2003-04,2003,2004,Arsenal,Blackburn,Win,Home,2003-12-14,3,2,5,8,11,6,6,9,9,-4,-1,-1,2,1,2.0,6.0,-4.0,5
404,404,2003-04,2003,2004,Arsenal,Bolton,Draw,Away,2003-12-20,1,4,5,8,11,3,6,9,10,1,-1,-1,1,0,2.0,17.0,-15.0,5
405,405,2003-04,2003,2004,Arsenal,Wolves,Win,Home,2003-12-26,3,4,5,6,9,0,1,1,2,4,4,5,7,1,2.0,21.0,-19.0,5
406,406,2003-04,2003,2004,Arsenal,Southampton,Win,Away,2003-12-29,3,4,7,8,9,3,6,9,9,1,1,-1,0,0,2.0,8.0,-6.0,5
407,407,2003-04,2003,2004,Arsenal,Everton,Draw,Away,2004-01-07,1,6,7,10,11,3,6,9,10,3,1,1,1,0,2.0,7.0,-5.0,6
408,408,2003-04,2003,2004,Arsenal,Middlesbrough,Win,Home,2004-01-10,3,4,7,8,11,3,4,5,6,1,3,3,5,1,2.0,11.0,-9.0,6
409,409,2003-04,2003,2004,Arsenal,Aston Villa,Win,Away,2004-01-18,3,4,7,10,11,3,6,7,10,1,1,3,1,0,2.0,16.0,-14.0,6
410,410,2003-04,2003,2004,Arsenal,Man City,Win,Home,2004-02-01,3,6,7,10,13,1,2,3,3,5,5,7,10,1,2.0,9.0,-7.0,7
411,411,2003-04,2003,2004,Arsenal,Wolves,Win,Away,2004-02-07,3,6,9,10,13,2,5,5,6,4,4,5,7,0,2.0,21.0,-19.0,7
412,412,2003-04,2003,2004,Arsenal,Southampton,Win,Home,2004-02-10,3,6,9,12,13,1,4,4,5,5,5,8,8,1,2.0,8.0,-6.0,7
413,413,2003-04,2003,2004,Arsenal,Chelsea,Win,Away,2004-02-21,3,6,9,12,15,6,9,10,13,0,0,2,2,0,2.0,4.0,-2.0,7
414,414,2003-04,2003,2004,Arsenal,Charlton,Win,Home,2004-02-28,3,6,9,12,15,3,3,3,6,3,6,9,9,1,2.0,12.0,-10.0,7
415,415,2003-04,2003,2004,Arsenal,Blackburn,Win,Away,2004-03-13,3,6,9,12,15,1,2,5,5,5,7,7,10,0,2.0,6.0,-4.0,8
416,416,2003-04,2003,2004,Arsenal,Bolton,Win,Home,2004-03-20,3,6,9,12,15,0,0,1,2,6,9,11,13,1,2.0,17.0,-15.0,8
417,417,2003-04,2003,2004,Arsenal,Man United,Draw,Home,2004-03-28,1,6,9,12,15,3,4,5,5,3,5,7,10,1,2.0,1.0,1.0,8
418,418,2003-04,2003,2004,Arsenal,Liverpool,Win,Home,2004-04-09,3,4,7,10,13,4,7,10,10,0,0,0,3,1,2.0,5.0,-3.0,9
419,419,2003-04,2003,2004,Arsenal,Newcastle,Draw,Away,2004-04-11,1,4,7,10,13,3,6,6,7,1,1,4,6,0,2.0,3.0,-1.0,9
420,420,2003-04,2003,2004,Arsenal,Leeds,Win,Home,2004-04-16,3,4,5,8,11,4,7,7,10,0,-2,1,1,1,2.0,15.0,-13.0,9
421,421,2003-04,2003,2004,Arsenal,Tottenham,Draw,Away,2004-04-25,1,4,7,8,11,1,1,1,1,3,6,7,10,0,2.0,10.0,-8.0,9
422,422,2003-04,2003,2004,Arsenal,Birmingham,Draw,Home,2004-05-01,1,4,5,8,9,2,2,2,3,2,3,6,6,1,2.0,13.0,-11.0,10
423,423,2003-04,2003,2004,Arsenal,Portsmouth,Draw,Away,2004-05-04,1,2,5,6,9,4,7,10,11,-2,-2,-4,-2,0,2.0,21.0,-19.0,10
424,424,2003-04,2003,2004,Arsenal,Fulham,Win,Away,2004-05-09,3,2,3,6,7,4,5,5,8,-2,-2,1,-1,0,2.0,14.0,-12.0,10
425,425,2003-04,2003,2004,Arsenal,Leicester,Win,Home,2004-05-15,3,4,5,6,9,4,5,5,5,0,0,1,4,1,2.0,21.0,-19.0,10
426,426,2004-05,2004,2005,Arsenal,Everton,Win,Away,2004-08-15,3,6,7,8,9,0,0,0,1,6,7,8,8,0,1.0,17.0,-16.0,1
427,427,2004-05,2004,2005,Arsenal,Middlesbrough,Win,Home,2004-08-22,3,6,9,10,11,1,4,4,4,5,5,6,7,1,1.0,11.0,-10.0,1
428,428,2004-05,2004,2005,Arsenal,Blackburn,Win,Home,2004-08-25,3,6,9,12,13,1,2,2,5,5,7,10,8,1,1.0,15.0,-14.0,1
429,429,2004-05,2004,2005,Arsenal,Norwich,Win,Away,2004-08-28,3,6,9,12,15,1,2,3,3,5,7,9,12,0,1.0,21.0,-20.0,1
430,430,2004-05,2004,2005,Arsenal,Fulham,Win,Away,2004-09-11,3,6,9,12,15,0,3,4,7,6,6,8,8,0,1.0,9.0,-8.0,2
431,431,2004-05,2004,2005,Arsenal,Bolton,Draw,Home,2004-09-18,1,6,9,12,15,4,7,7,10,2,2,5,5,1,1.0,8.0,-7.0,2
432,432,2004-05,2004,2005,Arsenal,Man City,Win,Away,2004-09-25,3,4,7,10,13,3,6,6,6,1,1,4,7,0,1.0,16.0,-15.0,2
433,433,2004-05,2004,2005,Arsenal,Charlton,Win,Home,2004-10-02,3,4,7,10,13,4,5,5,8,0,2,5,5,1,1.0,7.0,-6.0,3
434,434,2004-05,2004,2005,Arsenal,Aston Villa,Win,Home,2004-10-16,3,6,7,10,13,2,3,4,7,4,4,6,6,1,1.0,6.0,-5.0,3
435,435,2004-05,2004,2005,Arsenal,Man United,Loss,Away,2004-10-24,0,6,9,10,13,2,5,8,9,4,4,2,4,0,1.0,3.0,-2.0,3
436,436,2004-05,2004,2005,Arsenal,Southampton,Draw,Home,2004-10-30,1,3,6,9,10,1,2,2,2,2,4,7,8,1,1.0,12.0,-11.0,3
437,437,2004-05,2004,2005,Arsenal,Crystal Palace,Draw,Away,2004-11-06,1,1,4,7,10,6,6,9,10,-5,-2,-2,0,0,1.0,21.0,-20.0,4
438,438,2004-05,2004,2005,Arsenal,Tottenham,Win,Away,2004-11-13,3,2,2,5,8,0,0,0,3,2,2,5,5,0,1.0,14.0,-13.0,4
439,439,2004-05,2004,2005,Arsenal,West Brom,Draw,Home,2004-11-20,1,4,5,5,8,1,1,1,2,3,4,4,6,1,1.0,21.0,-20.0,4
440,440,2004-05,2004,2005,Arsenal,Liverpool,Loss,Away,2004-11-28,0,4,5,6,6,3,3,4,7,1,2,2,-1,0,1.0,4.0,-3.0,4
441,441,2004-05,2004,2005,Arsenal,Birmingham,Win,Home,2004-12-04,3,1,4,5,6,2,2,5,5,-1,2,0,1,1,1.0,10.0,-9.0,5
442,442,2004-05,2004,2005,Arsenal,Chelsea,Draw,Home,2004-12-12,1,3,4,7,8,6,7,10,13,-3,-3,-3,-5,1,1.0,2.0,-1.0,5
443,443,2004-05,2004,2005,Arsenal,Portsmouth,Win,Away,2004-12-19,3,4,4,5,8,2,5,8,8,2,-1,-3,0,0,1.0,13.0,-12.0,5
444,444,2004-05,2004,2005,Arsenal,Fulham,Win,Home,2004-12-26,3,4,7,7,8,1,4,4,4,3,3,3,4,1,1.0,9.0,-8.0,5
445,445,2004-05,2004,2005,Arsenal,Newcastle,Win,Away,2004-12-29,3,6,7,10,10,1,2,2,3,5,5,8,7,0,1.0,5.0,-4.0,5
446,446,2004-05,2004,2005,Arsenal,Charlton,Win,Away,2005-01-01,3,6,9,10,13,4,7,10,13,2,2,0,0,0,1.0,7.0,-6.0,6
447,447,2004-05,2004,2005,Arsenal,Man City,Draw,Home,2005-01-04,1,6,9,12,13,4,4,7,7,2,5,5,6,1,1.0,16.0,-15.0,6
448,448,2004-05,2004,2005,Arsenal,Bolton,Loss,Away,2005-01-15,0,4,7,10,13,4,4,4,4,0,3,6,9,0,1.0,8.0,-7.0,6
449,449,2004-05,2004,2005,Arsenal,Newcastle,Win,Home,2005-01-23,3,1,4,7,10,4,7,7,8,-3,-3,0,2,1,1.0,5.0,-4.0,6
450,450,2004-05,2004,2005,Arsenal,Man United,Loss,Home,2005-02-01,0,3,4,7,10,6,7,10,13,-3,-3,-3,-3,1,1.0,3.0,-2.0,7
451,451,2004-05,2004,2005,Arsenal,Aston Villa,Win,Away,2005-02-05,3,3,3,4,7,1,4,4,7,2,-1,0,0,0,1.0,6.0,-5.0,7
452,452,2004-05,2004,2005,Arsenal,Crystal Palace,Win,Home,2005-02-14,3,3,6,6,7,1,4,4,7,2,2,2,0,1,1.0,21.0,-20.0,7
453,453,2004-05,2004,2005,Arsenal,Southampton,Draw,Away,2005-02-26,1,6,6,9,9,2,2,5,5,4,4,4,4,0,1.0,12.0,-11.0,7
454,454,2004-05,2004,2005,Arsenal,Portsmouth,Win,Home,2005-03-05,3,4,7,7,10,0,0,3,3,4,7,4,7,1,1.0,13.0,-12.0,8
455,455,2004-05,2004,2005,Arsenal,Blackburn,Win,Away,2005-03-19,3,4,7,10,10,4,7,7,7,0,0,3,3,0,1.0,15.0,-14.0,8
456,456,2004-05,2004,2005,Arsenal,Norwich,Win,Home,2005-04-02,3,6,7,10,13,0,0,0,3,6,7,10,10,1,1.0,21.0,-20.0,9
457,457,2004-05,2004,2005,Arsenal,Middlesbrough,Win,Away,2005-04-09,3,6,9,10,13,3,3,4,5,3,6,6,8,0,1.0,11.0,-10.0,9
458,458,2004-05,2004,2005,Arsenal,Chelsea,Draw,Away,2005-04-20,1,6,9,12,13,4,7,10,13,2,2,2,0,0,1.0,2.0,-1.0,9
459,459,2004-05,2004,2005,Arsenal,Tottenham,Win,Home,2005-04-25,3,4,7,10,13,2,5,6,9,2,2,4,4,1,1.0,14.0,-13.0,9
460,460,2004-05,2004,2005,Arsenal,West Brom,Win,Away,2005-05-02,3,4,7,10,13,1,2,3,6,3,5,7,7,0,1.0,21.0,-20.0,10
461,461,2004-05,2004,2005,Arsenal,Liverpool,Win,Home,2005-05-08,3,6,7,10,13,1,4,5,5,5,3,5,8,1,1.0,4.0,-3.0,10
462,462,2004-05,2004,2005,Arsenal,Everton,Win,Home,2005-05-11,3,6,9,10,13,3,4,7,10,3,5,3,3,1,1.0,17.0,-16.0,10
463,463,2004-05,2004,2005,Arsenal,Birmingham,Loss,Away,2005-05-15,0,6,9,12,13,3,4,4,5,3,5,8,8,0,1.0,10.0,-9.0,10
464,464,2005-06,2005,2006,Arsenal,Newcastle,Win,Home,2005-08-14,3,3,6,9,12,1,4,5,6,2,2,4,6,1,2.0,14.0,-12.0,1
465,465,2005-06,2005,2006,Arsenal,Chelsea,Loss,Away,2005-08-21,0,3,6,9,12,4,7,10,13,-1,-1,-1,-1,0,2.0,1.0,1.0,1
466,466,2005-06,2005,2006,Arsenal,Fulham,Win,Home,2005-08-24,3,3,3,6,9,1,4,7,7,2,-1,-1,2,1,2.0,13.0,-11.0,1
467,467,2005-06,2005,2006,Arsenal,Middlesbrough,Loss,Away,2005-09-10,0,3,6,6,9,3,3,4,5,0,3,2,4,0,2.0,7.0,-5.0,2
468,468,2005-06,2005,2006,Arsenal,Everton,Win,Home,2005-09-19,3,3,3,6,6,0,3,3,3,3,0,3,3,1,2.0,4.0,-2.0,2
469,469,2005-06,2005,2006,Arsenal,West Ham,Draw,Away,2005-09-24,1,3,6,6,9,6,6,7,10,-3,0,-1,-1,0,2.0,21.0,-19.0,2
470,470,2005-06,2005,2006,Arsenal,Birmingham,Win,Home,2005-10-02,3,4,4,7,7,2,2,5,5,2,2,2,2,1,2.0,12.0,-10.0,3
471,471,2005-06,2005,2006,Arsenal,West Brom,Loss,Away,2005-10-15,0,4,7,7,10,0,1,1,1,4,6,6,9,0,2.0,17.0,-15.0,3
472,472,2005-06,2005,2006,Arsenal,Man City,Win,Home,2005-10-22,3,3,4,7,7,6,6,6,7,-3,-2,1,0,1,2.0,8.0,-6.0,3
473,473,2005-06,2005,2006,Arsenal,Tottenham,Draw,Away,2005-10-29,1,3,6,7,10,4,7,10,11,-1,-1,-3,-1,0,2.0,9.0,-7.0,3
474,474,2005-06,2005,2006,Arsenal,Sunderland,Win,Home,2005-11-05,3,4,4,7,8,0,0,1,4,4,4,6,4,1,2.0,21.0,-19.0,4
475,475,2005-06,2005,2006,Arsenal,Wigan,Win,Away,2005-11-19,3,4,7,7,10,6,9,12,15,-2,-2,-5,-5,0,2.0,21.0,-19.0,4
476,476,2005-06,2005,2006,Arsenal,Blackburn,Win,Home,2005-11-26,3,6,7,10,10,4,4,7,7,2,3,3,3,1,2.0,15.0,-13.0,4
477,477,2005-06,2005,2006,Arsenal,Bolton,Loss,Away,2005-12-03,0,6,9,10,13,3,6,9,9,3,3,1,4,0,2.0,6.0,-4.0,5
478,478,2005-06,2005,2006,Arsenal,Newcastle,Loss,Away,2005-12-10,0,3,6,9,10,1,1,4,7,2,5,5,3,0,2.0,14.0,-12.0,5
479,479,2005-06,2005,2006,Arsenal,Chelsea,Loss,Home,2005-12-18,0,0,3,6,9,6,9,12,12,-6,-6,-6,-3,1,2.0,1.0,1.0,5
480,480,2005-06,2005,2006,Arsenal,Charlton,Win,Away,2005-12-26,3,0,0,3,6,3,3,3,3,-3,-3,0,3,0,2.0,11.0,-9.0,5
481,481,2005-06,2005,2006,Arsenal,Portsmouth,Win,Home,2005-12-28,3,3,3,3,6,4,4,4,4,-1,-1,-1,2,1,2.0,16.0,-14.0,5
482,482,2005-06,2005,2006,Arsenal,Aston Villa,Draw,Away,2005-12-31,1,6,6,6,6,4,4,5,6,2,2,1,0,0,2.0,10.0,-8.0,5
483,483,2005-06,2005,2006,Arsenal,Man United,Draw,Home,2006-01-03,1,4,7,7,7,4,7,10,13,0,0,-3,-6,1,2.0,3.0,-1.0,6
484,484,2005-06,2005,2006,Arsenal,Middlesbrough,Win,Home,2006-01-14,3,2,5,8,8,2,2,3,3,0,3,5,5,1,2.0,7.0,-5.0,6
485,485,2005-06,2005,2006,Arsenal,Everton,Loss,Away,2006-01-21,0,4,5,8,11,6,9,9,9,-2,-4,-1,2,0,2.0,4.0,-2.0,6
486,486,2005-06,2005,2006,Arsenal,West Ham,Loss,Home,2006-02-01,0,3,4,5,8,6,6,6,6,-3,-2,-1,2,1,2.0,21.0,-19.0,7
487,487,2005-06,2005,2006,Arsenal,Birmingham,Win,Away,2006-02-04,3,0,3,4,5,4,4,7,7,-4,-1,-3,-2,0,2.0,12.0,-10.0,7
488,488,2005-06,2005,2006,Arsenal,Bolton,Draw,Home,2006-02-11,1,3,3,6,7,2,5,6,7,1,-2,0,0,1,2.0,6.0,-4.0,7
489,489,2005-06,2005,2006,Arsenal,Liverpool,Loss,Away,2006-02-14,0,4,4,4,7,3,3,4,4,1,1,0,3,0,2.0,5.0,-3.0,7
490,490,2005-06,2005,2006,Arsenal,Blackburn,Loss,Away,2006-02-25,0,1,4,4,4,3,3,6,9,-2,1,-2,-5,0,2.0,15.0,-13.0,7
491,491,2005-06,2005,2006,Arsenal,Fulham,Win,Away,2006-03-04,3,0,1,4,4,3,3,6,6,-3,-2,-2,-2,0,2.0,13.0,-11.0,8
492,492,2005-06,2005,2006,Arsenal,Liverpool,Win,Home,2006-03-12,3,3,3,4,7,4,7,10,10,-1,-4,-6,-3,1,2.0,5.0,-3.0,8
493,493,2005-06,2005,2006,Arsenal,Charlton,Win,Home,2006-03-18,3,6,6,6,7,4,5,6,6,2,1,0,1,1,2.0,11.0,-9.0,8
494,494,2005-06,2005,2006,Arsenal,Aston Villa,Win,Home,2006-04-01,3,6,9,9,9,1,1,4,5,5,8,5,4,1,2.0,10.0,-8.0,9
495,495,2005-06,2005,2006,Arsenal,Man United,Loss,Away,2006-04-09,0,6,9,12,12,6,9,12,15,0,0,0,-3,0,2.0,3.0,-1.0,9
496,496,2005-06,2005,2006,Arsenal,Portsmouth,Draw,Away,2006-04-12,1,3,6,9,12,4,7,10,10,-1,-1,-1,2,0,2.0,16.0,-14.0,9
497,497,2005-06,2005,2006,Arsenal,West Brom,Win,Home,2006-04-15,3,1,4,7,10,1,1,1,2,0,3,6,8,1,2.0,17.0,-15.0,9
498,498,2005-06,2005,2006,Arsenal,Tottenham,Draw,Home,2006-04-22,1,4,4,7,10,3,6,6,9,1,-2,1,1,1,2.0,9.0,-7.0,9
499,499,2005-06,2005,2006,Arsenal,Sunderland,Win,Away,2006-05-01,3,4,5,5,8,0,1,2,2,4,4,3,6,0,2.0,21.0,-19.0,10
500,500,2005-06,2005,2006,Arsenal,Man City,Win,Away,2006-05-04,3,4,7,8,8,3,3,3,3,1,4,5,5,0,2.0,8.0,-6.0,10
501,501,2005-06,2005,2006,Arsenal,Wigan,Win,Home,2006-05-07,3,6,7,10,11,0,3,3,4,6,4,7,7,1,2.0,21.0,-19.0,10
502,502,2006-07,2006,2007,Arsenal,Aston Villa,Draw,Home,2006-08-19,1,6,9,10,13,3,3,3,6,3,6,7,7,1,4.0,16.0,-12.0,1
503,503,2006-07,2006,2007,Arsenal,Man City,Loss,Away,2006-08-26,0,4,7,10,11,1,1,1,1,3,6,9,10,0,4.0,15.0,-11.0,1
504,504,2006-07,2006,2007,Arsenal,Middlesbrough,Draw,Home,2006-09-09,1,1,4,7,10,3,3,3,4,-2,1,4,6,1,4.0,14.0,-10.0,2
505,505,2006-07,2006,2007,Arsenal,Man United,Win,Away,2006-09-17,3,1,2,5,8,6,9,12,15,-5,-7,-7,-7,0,4.0,2.0,2.0,2
506,506,2006-07,2006,2007,Arsenal,Sheffield United,Win,Home,2006-09-23,3,4,4,5,8,1,1,1,2,3,3,4,6,1,4.0,21.0,-17.0,2
507,507,2006-07,2006,2007,Arsenal,Charlton,Win,Away,2006-09-30,3,6,7,7,8,0,0,3,3,6,7,4,5,0,4.0,13.0,-9.0,2
508,508,2006-07,2006,2007,Arsenal,Watford,Win,Home,2006-10-14,3,6,9,10,10,2,3,3,3,4,6,7,7,1,4.0,21.0,-17.0,3
509,509,2006-07,2006,2007,Arsenal,Reading,Win,Away,2006-10-22,3,6,9,12,13,3,4,7,10,3,5,5,3,0,4.0,21.0,-17.0,3
510,510,2006-07,2006,2007,Arsenal,Everton,Draw,Home,2006-10-28,1,6,9,12,15,3,4,5,6,3,5,7,9,1,4.0,11.0,-7.0,3
511,511,2006-07,2006,2007,Arsenal,West Ham,Loss,Away,2006-11-05,0,4,7,10,13,3,3,3,3,1,4,7,10,0,4.0,9.0,-5.0,4
512,512,2006-07,2006,2007,Arsenal,Liverpool,Win,Home,2006-11-12,3,1,4,7,10,6,6,7,7,-5,-2,0,3,1,4.0,3.0,1.0,4
513,513,2006-07,2006,2007,Arsenal,Newcastle,Draw,Home,2006-11-18,1,3,4,7,10,1,2,2,2,2,2,5,8,1,4.0,7.0,-3.0,4
514,514,2006-07,2006,2007,Arsenal,Bolton,Loss,Away,2006-11-25,0,4,4,5,8,1,1,1,4,3,3,4,4,0,4.0,8.0,-4.0,4
515,515,2006-07,2006,2007,Arsenal,Fulham,Loss,Away,2006-11-29,0,1,4,4,5,0,1,4,4,1,3,0,1,0,4.0,12.0,-8.0,4
516,516,2006-07,2006,2007,Arsenal,Tottenham,Win,Home,2006-12-02,3,0,1,4,4,4,4,7,8,-4,-3,-3,-4,1,4.0,5.0,-1.0,5
517,517,2006-07,2006,2007,Arsenal,Chelsea,Draw,Away,2006-12-10,1,3,3,4,7,4,7,10,10,-1,-4,-6,-3,0,4.0,1.0,3.0,5
518,518,2006-07,2006,2007,Arsenal,Wigan,Win,Away,2006-12-13,3,4,4,4,5,4,4,4,5,0,0,0,0,0,4.0,10.0,-6.0,5
519,519,2006-07,2006,2007,Arsenal,Portsmouth,Draw,Home,2006-12-16,1,4,7,7,7,4,5,5,8,0,2,2,-1,1,4.0,17.0,-13.0,5
520,520,2006-07,2006,2007,Arsenal,Blackburn,Win,Home,2006-12-23,3,4,5,8,8,3,3,6,7,1,2,2,1,1,4.0,6.0,-2.0,5
521,521,2006-07,2006,2007,Arsenal,Watford,Win,Away,2006-12-26,3,4,7,8,11,0,1,2,2,4,6,6,9,0,4.0,21.0,-17.0,5
522,522,2006-07,2006,2007,Arsenal,Sheffield United,Loss,Away,2006-12-30,0,6,7,10,11,0,3,4,7,6,4,6,4,0,4.0,21.0,-17.0,5
523,523,2006-07,2006,2007,Arsenal,Charlton,Win,Home,2007-01-02,3,3,6,7,10,4,4,4,4,-1,2,3,6,1,4.0,13.0,-9.0,6
524,524,2006-07,2006,2007,Arsenal,Blackburn,Win,Away,2007-01-13,3,3,6,9,10,6,9,9,12,-3,-3,0,-2,0,4.0,6.0,-2.0,6
525,525,2006-07,2006,2007,Arsenal,Man United,Win,Home,2007-01-21,3,6,6,9,12,4,7,10,13,2,-1,-1,-1,1,4.0,2.0,2.0,6
526,526,2006-07,2006,2007,Arsenal,Middlesbrough,Draw,Away,2007-02-03,1,6,9,9,12,4,7,10,10,2,2,-1,2,0,4.0,14.0,-10.0,7
527,527,2006-07,2006,2007,Arsenal,Wigan,Win,Home,2007-02-11,3,4,7,10,10,3,3,3,3,1,4,7,7,1,4.0,10.0,-6.0,7
528,528,2006-07,2006,2007,Arsenal,Reading,Win,Home,2007-03-03,3,4,7,10,13,3,6,9,12,1,1,1,1,1,4.0,21.0,-17.0,8
529,529,2006-07,2006,2007,Arsenal,Aston Villa,Win,Away,2007-03-14,3,6,7,10,13,1,4,4,7,5,3,6,6,0,4.0,16.0,-12.0,8
530,530,2006-07,2006,2007,Arsenal,Everton,Loss,Away,2007-03-18,0,6,9,10,13,4,4,7,8,2,5,3,5,0,4.0,11.0,-7.0,8
531,531,2006-07,2006,2007,Arsenal,Liverpool,Loss,Away,2007-03-31,0,3,6,9,10,1,4,4,5,2,2,5,5,0,4.0,3.0,1.0,8
532,532,2006-07,2006,2007,Arsenal,West Ham,Loss,Home,2007-04-07,0,0,3,6,9,6,6,6,6,-6,-3,0,3,1,4.0,9.0,-5.0,9
533,533,2006-07,2006,2007,Arsenal,Newcastle,Draw,Away,2007-04-09,1,0,0,3,6,3,3,4,4,-3,-3,-1,2,0,4.0,7.0,-3.0,9
534,534,2006-07,2006,2007,Arsenal,Bolton,Win,Home,2007-04-14,3,1,1,1,4,4,7,7,7,-3,-6,-6,-3,1,4.0,8.0,-4.0,9
535,535,2006-07,2006,2007,Arsenal,Man City,Win,Home,2007-04-17,3,4,4,4,4,4,5,8,11,0,-1,-4,-7,1,4.0,15.0,-11.0,9
536,536,2006-07,2006,2007,Arsenal,Tottenham,Draw,Away,2007-04-21,1,6,7,7,7,1,4,7,10,5,3,0,-3,0,4.0,5.0,-1.0,9
537,537,2006-07,2006,2007,Arsenal,Fulham,Win,Home,2007-04-29,3,4,7,8,8,1,1,1,2,3,6,7,6,1,4.0,12.0,-8.0,9
538,538,2006-07,2006,2007,Arsenal,Chelsea,Draw,Home,2007-05-06,1,4,7,10,11,2,5,8,11,2,2,2,0,1,4.0,1.0,3.0,10
539,539,2006-07,2006,2007,Arsenal,Portsmouth,Draw,Away,2007-05-13,1,4,5,8,11,3,4,7,7,1,1,1,4,0,4.0,17.0,-13.0,10
540,540,2007-08,2007,2008,Arsenal,Fulham,Win,Home,2007-08-12,3,2,5,6,9,3,3,4,4,-1,2,2,5,1,4.0,16.0,-12.0,1
541,541,2007-08,2007,2008,Arsenal,Blackburn,Draw,Away,2007-08-19,1,4,5,8,9,4,5,8,11,0,0,0,-2,0,4.0,10.0,-6.0,1
542,542,2007-08,2007,2008,Arsenal,Man City,Win,Home,2007-08-25,3,4,5,6,9,6,9,9,9,-2,-4,-3,0,1,4.0,14.0,-10.0,1
543,543,2007-08,2007,2008,Arsenal,Portsmouth,Win,Home,2007-09-02,3,4,7,8,9,3,4,5,6,1,3,3,3,1,4.0,9.0,-5.0,2
544,544,2007-08,2007,2008,Arsenal,Tottenham,Win,Away,2007-09-15,3,6,7,10,11,1,4,4,4,5,3,6,7,0,4.0,5.0,-1.0,2
545,545,2007-08,2007,2008,Arsenal,Derby,Win,Home,2007-09-22,3,6,9,10,13,3,3,3,3,3,6,7,10,1,4.0,21.0,-17.0,2
546,546,2007-08,2007,2008,Arsenal,West Ham,Win,Away,2007-09-29,3,6,9,12,13,3,6,7,10,3,3,5,3,0,4.0,15.0,-11.0,2
547,547,2007-08,2007,2008,Arsenal,Sunderland,Win,Home,2007-10-07,3,6,9,12,15,1,4,4,4,5,5,8,11,1,4.0,21.0,-17.0,3
548,548,2007-08,2007,2008,Arsenal,Bolton,Win,Home,2007-10-20,3,6,9,12,15,1,2,2,2,5,7,10,13,1,4.0,7.0,-3.0,3
549,549,2007-08,2007,2008,Arsenal,Liverpool,Draw,Away,2007-10-28,1,6,9,12,15,4,7,8,9,2,2,4,6,0,4.0,3.0,1.0,3
550,550,2007-08,2007,2008,Arsenal,Man United,Draw,Home,2007-11-03,1,4,7,10,13,6,9,12,15,-2,-2,-2,-2,1,4.0,1.0,3.0,4
551,551,2007-08,2007,2008,Arsenal,Reading,Win,Away,2007-11-12,3,2,5,8,11,3,3,6,6,-1,2,2,5,0,4.0,8.0,-4.0,4
552,552,2007-08,2007,2008,Arsenal,Wigan,Win,Home,2007-11-24,3,4,5,8,11,0,0,0,0,4,5,8,11,1,4.0,17.0,-13.0,4
553,553,2007-08,2007,2008,Arsenal,Aston Villa,Win,Away,2007-12-01,3,6,7,8,11,6,9,12,13,0,-2,-4,-2,0,4.0,11.0,-7.0,5
554,554,2007-08,2007,2008,Arsenal,Newcastle,Draw,Away,2007-12-05,1,6,9,10,11,0,1,1,1,6,8,9,10,0,4.0,13.0,-9.0,5
555,555,2007-08,2007,2008,Arsenal,Middlesbrough,Loss,Away,2007-12-09,0,4,7,10,11,1,2,3,3,3,5,7,8,0,4.0,12.0,-8.0,5
556,556,2007-08,2007,2008,Arsenal,Chelsea,Win,Home,2007-12-16,3,1,4,7,10,6,9,10,13,-5,-5,-3,-3,1,4.0,2.0,2.0,5
557,557,2007-08,2007,2008,Arsenal,Tottenham,Win,Home,2007-12-22,3,3,4,7,10,6,6,7,10,-3,-2,0,0,1,4.0,5.0,-1.0,5
558,558,2007-08,2007,2008,Arsenal,Portsmouth,Draw,Away,2007-12-26,1,6,6,7,10,0,3,4,7,6,3,3,3,0,4.0,9.0,-5.0,5
559,559,2007-08,2007,2008,Arsenal,Everton,Win,Away,2007-12-29,3,4,7,7,8,3,6,9,10,1,1,-2,-2,0,4.0,6.0,-2.0,5
560,560,2007-08,2007,2008,Arsenal,West Ham,Win,Home,2008-01-01,3,4,7,10,10,4,7,7,10,0,0,3,0,1,4.0,15.0,-11.0,6
561,561,2007-08,2007,2008,Arsenal,Birmingham,Draw,Home,2008-01-12,1,6,7,10,13,1,4,4,5,5,3,6,8,1,4.0,21.0,-17.0,6
562,562,2007-08,2007,2008,Arsenal,Fulham,Win,Away,2008-01-19,3,4,7,8,11,0,1,1,2,4,6,7,9,0,4.0,16.0,-12.0,6
563,563,2007-08,2007,2008,Arsenal,Newcastle,Win,Home,2008-01-29,3,4,7,10,11,1,1,1,1,3,6,9,10,1,4.0,13.0,-9.0,6
564,564,2007-08,2007,2008,Arsenal,Man City,Win,Away,2008-02-02,3,6,7,10,13,2,2,5,6,4,5,5,7,0,4.0,14.0,-10.0,7
565,565,2007-08,2007,2008,Arsenal,Blackburn,Win,Home,2008-02-11,3,6,9,10,13,2,3,6,9,4,6,4,4,1,4.0,10.0,-6.0,7
566,566,2007-08,2007,2008,Arsenal,Birmingham,Draw,Away,2008-02-23,1,6,9,12,13,2,2,2,3,4,7,10,10,0,4.0,21.0,-17.0,7
567,567,2007-08,2007,2008,Arsenal,Aston Villa,Draw,Home,2008-03-01,1,4,7,10,13,6,6,7,8,-2,1,3,5,1,4.0,11.0,-7.0,8
568,568,2007-08,2007,2008,Arsenal,Wigan,Draw,Away,2008-03-09,1,2,5,8,11,4,4,7,7,-2,1,1,4,0,4.0,17.0,-13.0,8
569,569,2007-08,2007,2008,Arsenal,Middlesbrough,Draw,Home,2008-03-15,1,2,3,6,9,1,1,4,5,1,2,2,4,1,4.0,12.0,-8.0,8
570,570,2007-08,2007,2008,Arsenal,Chelsea,Loss,Away,2008-03-23,0,2,3,4,7,4,7,10,11,-2,-4,-6,-4,0,4.0,2.0,2.0,8
571,571,2007-08,2007,2008,Arsenal,Bolton,Win,Away,2008-03-29,3,1,2,3,4,1,1,1,1,0,1,2,3,0,4.0,7.0,-3.0,8
572,572,2007-08,2007,2008,Arsenal,Liverpool,Draw,Home,2008-04-05,1,3,4,5,6,3,6,9,12,0,-2,-4,-6,1,4.0,3.0,1.0,9
573,573,2007-08,2007,2008,Arsenal,Man United,Loss,Away,2008-04-13,0,4,4,5,6,4,7,10,13,0,-3,-5,-7,0,4.0,1.0,3.0,9
574,574,2007-08,2007,2008,Arsenal,Reading,Win,Home,2008-04-19,3,1,4,4,5,0,1,4,4,1,3,0,1,1,4.0,8.0,-4.0,9
575,575,2007-08,2007,2008,Arsenal,Derby,Win,Away,2008-04-28,3,3,4,7,7,0,0,1,1,3,4,6,6,0,4.0,21.0,-17.0,9
576,576,2007-08,2007,2008,Arsenal,Everton,Win,Home,2008-05-04,3,6,6,7,10,1,2,5,5,5,4,2,5,1,4.0,6.0,-2.0,10
577,577,2007-08,2007,2008,Arsenal,Sunderland,Win,Away,2008-05-11,3,6,9,9,10,3,3,3,6,3,6,6,4,0,4.0,21.0,-17.0,10
578,578,2008-09,2008,2009,Arsenal,West Brom,Win,Home,2008-08-16,3,6,9,12,12,1,1,2,2,5,8,10,10,1,3.0,21.0,-18.0,1
579,579,2008-09,2008,2009,Arsenal,Fulham,Loss,Away,2008-08-23,0,6,9,12,15,3,6,9,9,3,3,3,6,0,3.0,17.0,-14.0,1
580,580,2008-09,2008,2009,Arsenal,Newcastle,Win,Home,2008-08-30,3,3,6,9,12,4,4,4,5,-1,2,5,7,1,3.0,12.0,-9.0,1
581,581,2008-09,2008,2009,Arsenal,Blackburn,Win,Away,2008-09-13,3,3,6,9,12,1,4,4,7,2,2,5,5,0,3.0,7.0,-4.0,2
582,582,2008-09,2008,2009,Arsenal,Bolton,Win,Away,2008-09-20,3,6,6,9,12,1,1,4,5,5,5,5,7,0,3.0,16.0,-13.0,2
583,583,2008-09,2008,2009,Arsenal,Hull,Loss,Home,2008-09-27,0,6,9,9,12,4,4,5,8,2,5,4,4,1,3.0,21.0,-18.0,2
584,584,2008-09,2008,2009,Arsenal,Sunderland,Draw,Away,2008-10-04,1,3,6,9,9,3,4,4,7,0,2,5,2,0,3.0,15.0,-12.0,3
585,585,2008-09,2008,2009,Arsenal,Everton,Win,Home,2008-10-18,3,1,4,7,10,1,2,5,5,0,2,2,5,1,3.0,5.0,-2.0,3
586,586,2008-09,2008,2009,Arsenal,West Ham,Win,Away,2008-10-26,3,4,4,7,10,0,3,6,6,4,1,1,4,0,3.0,10.0,-7.0,3
587,587,2008-09,2008,2009,Arsenal,Tottenham,Draw,Home,2008-10-29,1,6,7,7,10,3,3,3,4,3,4,4,6,1,3.0,11.0,-8.0,3
588,588,2008-09,2008,2009,Arsenal,Stoke,Loss,Away,2008-11-01,0,4,7,8,8,3,6,6,6,1,1,2,2,0,3.0,21.0,-18.0,4
589,589,2008-09,2008,2009,Arsenal,Man United,Win,Home,2008-11-08,3,1,4,7,8,6,7,10,13,-5,-3,-3,-5,1,3.0,1.0,2.0,4
590,590,2008-09,2008,2009,Arsenal,Aston Villa,Loss,Home,2008-11-15,0,3,4,7,10,0,3,6,7,3,1,1,3,1,3.0,6.0,-3.0,4
591,591,2008-09,2008,2009,Arsenal,Man City,Loss,Away,2008-11-22,0,3,3,4,7,1,1,1,4,2,2,3,3,0,3.0,9.0,-6.0,4
592,592,2008-09,2008,2009,Arsenal,Chelsea,Win,Away,2008-11-30,3,0,3,3,4,4,7,10,13,-4,-4,-7,-9,0,3.0,2.0,1.0,4
593,593,2008-09,2008,2009,Arsenal,Wigan,Win,Home,2008-12-06,3,3,3,6,6,6,7,8,11,-3,-4,-2,-5,1,3.0,14.0,-11.0,5
594,594,2008-09,2008,2009,Arsenal,Middlesbrough,Draw,Away,2008-12-13,1,6,6,6,9,1,1,2,5,5,5,4,4,0,3.0,13.0,-10.0,5
595,595,2008-09,2008,2009,Arsenal,Liverpool,Draw,Home,2008-12-21,1,4,7,7,7,4,5,6,9,0,2,1,-2,1,3.0,4.0,-1.0,5
596,596,2008-09,2008,2009,Arsenal,Aston Villa,Draw,Away,2008-12-26,1,2,5,8,8,6,9,10,11,-4,-4,-2,-3,0,3.0,6.0,-3.0,5
597,597,2008-09,2008,2009,Arsenal,Portsmouth,Win,Home,2008-12-28,3,2,3,6,9,0,0,1,4,2,3,5,5,1,3.0,8.0,-5.0,5
598,598,2008-09,2008,2009,Arsenal,Bolton,Win,Home,2009-01-10,3,4,5,6,9,0,3,3,3,4,2,3,6,1,3.0,16.0,-13.0,6
599,599,2008-09,2008,2009,Arsenal,Hull,Win,Away,2009-01-17,3,6,7,8,9,0,0,0,1,6,7,8,8,0,3.0,21.0,-18.0,6
600,600,2008-09,2008,2009,Arsenal,Everton,Draw,Away,2009-01-28,1,6,9,10,11,4,7,10,11,2,2,0,0,0,3.0,5.0,-2.0,6
601,601,2008-09,2008,2009,Arsenal,West Ham,Draw,Home,2009-01-31,1,4,7,10,11,6,7,10,13,-2,0,0,-2,1,3.0,10.0,-7.0,6
602,602,2008-09,2008,2009,Arsenal,Tottenham,Draw,Away,2009-02-08,1,2,5,8,11,3,4,4,4,-1,1,4,7,0,3.0,11.0,-8.0,7
603,603,2008-09,2008,2009,Arsenal,Sunderland,Draw,Home,2009-02-21,1,2,3,6,9,4,7,7,8,-2,-4,-1,1,1,3.0,15.0,-12.0,7
604,604,2008-09,2008,2009,Arsenal,Fulham,Draw,Home,2009-02-28,1,2,3,4,7,3,4,7,7,-1,-1,-3,0,1,3.0,17.0,-14.0,7
605,605,2008-09,2008,2009,Arsenal,West Brom,Win,Away,2009-03-03,3,2,3,4,5,0,0,1,1,2,3,3,4,0,3.0,21.0,-18.0,8
606,606,2008-09,2008,2009,Arsenal,Blackburn,Win,Home,2009-03-14,3,4,5,6,7,4,7,7,7,0,-2,-1,0,1,3.0,7.0,-4.0,8
607,607,2008-09,2008,2009,Arsenal,Newcastle,Win,Away,2009-03-21,3,6,7,8,9,1,1,2,5,5,6,6,4,0,3.0,12.0,-9.0,8
608,608,2008-09,2008,2009,Arsenal,Man City,Win,Home,2009-04-04,3,6,9,10,11,3,6,6,7,3,3,4,4,1,3.0,9.0,-6.0,9
609,609,2008-09,2008,2009,Arsenal,Wigan,Win,Away,2009-04-11,3,6,9,12,13,3,6,6,6,3,3,6,7,0,3.0,14.0,-11.0,9
610,610,2008-09,2008,2009,Arsenal,Liverpool,Draw,Away,2009-04-21,1,6,9,12,15,6,9,12,15,0,0,0,0,0,3.0,4.0,-1.0,9
611,611,2008-09,2008,2009,Arsenal,Middlesbrough,Win,Home,2009-04-26,3,4,7,10,13,4,4,4,5,0,3,6,8,1,3.0,13.0,-10.0,9
612,612,2008-09,2008,2009,Arsenal,Portsmouth,Win,Away,2009-05-02,3,4,7,10,13,1,4,5,6,3,3,5,7,0,3.0,8.0,-5.0,10
613,613,2008-09,2008,2009,Arsenal,Chelsea,Loss,Home,2009-05-10,0,6,7,10,13,6,7,10,13,0,0,0,0,1,3.0,2.0,1.0,10
614,614,2008-09,2008,2009,Arsenal,Man United,Draw,Away,2009-05-16,1,3,6,7,10,6,9,12,15,-3,-3,-5,-5,0,3.0,1.0,2.0,10
615,615,2008-09,2008,2009,Arsenal,Stoke,Win,Home,2009-05-24,3,1,4,7,8,6,6,6,9,-5,-2,1,-1,1,3.0,21.0,-18.0,10
616,616,2009-10,2009,2010,Arsenal,Everton,Win,Away,2009-08-15,3,4,4,7,10,6,7,10,10,-2,-3,-3,0,0,4.0,5.0,-1.0,1
617,617,2009-10,2009,2010,Arsenal,Portsmouth,Win,Home,2009-08-22,3,6,7,7,10,0,0,3,3,6,7,4,7,1,4.0,14.0,-10.0,1
618,618,2009-10,2009,2010,Arsenal,Man United,Loss,Away,2009-08-29,0,6,9,10,10,3,6,9,10,3,3,1,0,0,4.0,1.0,3.0,1
619,619,2009-10,2009,2010,Arsenal,Man City,Loss,Away,2009-09-12,0,3,6,9,10,6,9,12,12,-3,-3,-3,-2,0,4.0,10.0,-6.0,2
620,620,2009-10,2009,2010,Arsenal,Wigan,Win,Home,2009-09-19,3,0,3,6,9,3,3,3,6,-3,0,3,3,1,4.0,11.0,-7.0,2
621,621,2009-10,2009,2010,Arsenal,Fulham,Win,Away,2009-09-26,3,3,3,6,9,3,3,3,6,0,0,3,3,0,4.0,7.0,-3.0,2
622,622,2009-10,2009,2010,Arsenal,Blackburn,Win,Home,2009-10-04,3,6,6,6,9,3,6,7,7,3,0,-1,2,1,4.0,15.0,-11.0,3
623,623,2009-10,2009,2010,Arsenal,Birmingham,Win,Home,2009-10-17,3,6,9,9,9,0,3,3,3,6,6,6,6,1,4.0,21.0,-17.0,3
624,624,2009-10,2009,2010,Arsenal,West Ham,Draw,Away,2009-10-25,1,6,9,12,12,1,1,1,1,5,8,11,11,0,4.0,9.0,-5.0,3
625,625,2009-10,2009,2010,Arsenal,Tottenham,Win,Home,2009-10-31,3,4,7,10,13,3,4,7,7,1,3,3,6,1,4.0,8.0,-4.0,3
626,626,2009-10,2009,2010,Arsenal,Wolves,Win,Away,2009-11-07,3,4,7,10,13,2,3,3,3,2,4,7,10,0,4.0,21.0,-17.0,4
627,627,2009-10,2009,2010,Arsenal,Sunderland,Loss,Away,2009-11-21,0,6,7,10,13,1,1,4,5,5,6,6,8,0,4.0,16.0,-12.0,4
628,628,2009-10,2009,2010,Arsenal,Chelsea,Loss,Home,2009-11-29,0,3,6,7,10,6,9,12,12,-3,-3,-5,-2,1,4.0,3.0,1.0,4
629,629,2009-10,2009,2010,Arsenal,Stoke,Win,Home,2009-12-05,3,0,3,6,7,4,4,5,8,-4,-1,1,-1,1,4.0,12.0,-8.0,5
630,630,2009-10,2009,2010,Arsenal,Liverpool,Win,Away,2009-12-13,3,3,3,6,9,4,5,6,6,-1,-2,0,3,0,4.0,2.0,2.0,5
631,631,2009-10,2009,2010,Arsenal,Burnley,Draw,Away,2009-12-16,1,6,6,6,9,1,1,2,3,5,5,4,6,0,4.0,21.0,-17.0,5
632,632,2009-10,2009,2010,Arsenal,Hull,Win,Home,2009-12-19,3,4,7,7,7,1,2,5,6,3,5,2,1,1,4.0,17.0,-13.0,5
633,633,2009-10,2009,2010,Arsenal,Aston Villa,Win,Home,2009-12-27,3,4,7,10,10,6,9,12,13,-2,-2,-2,-3,1,4.0,6.0,-2.0,5
634,634,2009-10,2009,2010,Arsenal,Portsmouth,Win,Away,2009-12-30,3,6,7,10,13,3,3,4,7,3,4,6,6,0,4.0,14.0,-10.0,5
635,635,2009-10,2009,2010,Arsenal,Everton,Draw,Home,2010-01-09,1,6,9,10,13,4,5,6,7,2,4,4,6,1,4.0,5.0,-1.0,6
636,636,2009-10,2009,2010,Arsenal,Bolton,Win,Away,2010-01-17,3,4,7,10,11,2,5,6,6,2,2,4,5,0,4.0,13.0,-9.0,6
637,637,2009-10,2009,2010,Arsenal,Bolton,Win,Home,2010-01-20,3,4,7,10,13,1,2,5,6,3,5,5,7,1,4.0,13.0,-9.0,6
638,638,2009-10,2009,2010,Arsenal,Aston Villa,Draw,Away,2010-01-27,1,6,7,10,13,1,1,4,7,5,6,6,6,0,4.0,6.0,-2.0,6
639,639,2009-10,2009,2010,Arsenal,Man United,Loss,Home,2010-01-31,0,4,7,8,11,6,7,10,13,-2,0,-2,-2,1,4.0,1.0,3.0,6
640,640,2009-10,2009,2010,Arsenal,Chelsea,Loss,Away,2010-02-07,0,1,4,7,8,4,7,10,13,-3,-3,-3,-5,0,4.0,3.0,1.0,7
641,641,2009-10,2009,2010,Arsenal,Liverpool,Win,Home,2010-02-10,3,0,1,4,7,6,7,10,11,-6,-6,-6,-4,1,4.0,2.0,2.0,7
642,642,2009-10,2009,2010,Arsenal,Sunderland,Win,Home,2010-02-20,3,3,3,4,7,2,3,3,3,1,0,1,4,1,4.0,16.0,-12.0,7
643,643,2009-10,2009,2010,Arsenal,Stoke,Win,Away,2010-02-27,3,6,6,6,7,4,5,8,9,2,1,-2,-2,0,4.0,12.0,-8.0,7
644,644,2009-10,2009,2010,Arsenal,Burnley,Win,Home,2010-03-06,3,6,9,9,9,0,0,3,3,6,9,6,6,1,4.0,21.0,-17.0,8
645,645,2009-10,2009,2010,Arsenal,Hull,Win,Away,2010-03-13,3,6,9,12,12,0,0,3,4,6,9,9,8,0,4.0,17.0,-13.0,8
646,646,2009-10,2009,2010,Arsenal,West Ham,Win,Home,2010-03-20,3,6,9,12,15,0,0,3,6,6,9,9,9,1,4.0,9.0,-5.0,8
647,647,2009-10,2009,2010,Arsenal,Birmingham,Draw,Away,2010-03-27,1,6,9,12,15,0,1,4,7,6,8,8,8,0,4.0,21.0,-17.0,8
648,648,2009-10,2009,2010,Arsenal,Wolves,Win,Home,2010-04-03,3,4,7,10,13,4,5,8,8,0,2,2,5,1,4.0,21.0,-17.0,9
649,649,2009-10,2009,2010,Arsenal,Tottenham,Loss,Away,2010-04-14,0,4,7,10,13,3,6,9,12,1,1,1,1,0,4.0,8.0,-4.0,9
650,650,2009-10,2009,2010,Arsenal,Wigan,Loss,Away,2010-04-18,0,3,4,7,10,1,1,4,4,2,3,3,6,0,4.0,11.0,-7.0,9
651,651,2009-10,2009,2010,Arsenal,Man City,Draw,Home,2010-04-24,1,0,3,4,7,3,6,9,9,-3,-3,-5,-2,1,4.0,10.0,-6.0,9
652,652,2009-10,2009,2010,Arsenal,Blackburn,Loss,Away,2010-05-03,0,1,1,4,5,1,2,3,6,0,-1,1,-1,0,4.0,15.0,-11.0,10
653,653,2009-10,2009,2010,Arsenal,Fulham,Win,Home,2010-05-09,3,1,1,1,4,3,3,4,5,-2,-2,-3,-1,1,4.0,7.0,-3.0,10
654,654,2010-11,2010,2011,Arsenal,Liverpool,Draw,Away,2010-08-15,1,3,4,4,4,1,4,7,8,2,0,-3,-4,0,3.0,7.0,-4.0,1
655,655,2010-11,2010,2011,Arsenal,Blackpool,Win,Home,2010-08-21,3,4,4,5,5,3,3,3,3,1,1,2,2,1,3.0,21.0,-18.0,1
656,656,2010-11,2010,2011,Arsenal,Blackburn,Win,Away,2010-08-28,3,4,7,7,8,3,6,9,10,1,1,-2,-2,0,3.0,10.0,-7.0,1
657,657,2010-11,2010,2011,Arsenal,Bolton,Win,Home,2010-09-11,3,6,7,10,10,4,5,8,8,2,2,2,2,1,3.0,14.0,-11.0,2
658,658,2010-11,2010,2011,Arsenal,Sunderland,Draw,Away,2010-09-18,1,6,9,10,13,4,4,5,5,2,5,5,8,0,3.0,13.0,-10.0,2
659,659,2010-11,2010,2011,Arsenal,West Brom,Loss,Home,2010-09-25,0,4,7,10,11,4,4,7,7,0,3,3,4,1,3.0,21.0,-18.0,2
660,660,2010-11,2010,2011,Arsenal,Chelsea,Loss,Away,2010-10-03,0,1,4,7,10,3,6,9,12,-2,-2,-2,-2,0,3.0,1.0,2.0,3
661,661,2010-11,2010,2011,Arsenal,Birmingham,Win,Home,2010-10-16,3,0,1,4,7,1,1,2,3,-1,0,2,4,1,3.0,9.0,-6.0,3
662,662,2010-11,2010,2011,Arsenal,Man City,Win,Away,2010-10-24,3,3,3,4,7,6,9,12,13,-3,-6,-8,-6,0,3.0,5.0,-2.0,3
663,663,2010-11,2010,2011,Arsenal,West Ham,Win,Home,2010-10-30,3,6,6,6,7,1,2,5,6,5,4,1,1,1,3.0,17.0,-14.0,3
664,664,2010-11,2010,2011,Arsenal,Newcastle,Loss,Home,2010-11-07,0,6,9,9,9,6,7,7,7,0,2,2,2,1,3.0,21.0,-18.0,4
665,665,2010-11,2010,2011,Arsenal,Wolves,Win,Away,2010-11-10,3,3,6,9,9,3,3,4,4,0,3,5,5,0,3.0,15.0,-12.0,4
666,666,2010-11,2010,2011,Arsenal,Everton,Win,Away,2010-11-14,3,3,6,9,12,2,5,6,9,1,1,3,3,0,3.0,8.0,-5.0,4
667,667,2010-11,2010,2011,Arsenal,Tottenham,Loss,Home,2010-11-20,0,6,6,9,12,4,4,4,5,2,2,5,7,1,3.0,4.0,-1.0,4
668,668,2010-11,2010,2011,Arsenal,Aston Villa,Win,Away,2010-11-27,3,3,6,6,9,1,4,5,6,2,2,1,3,0,3.0,6.0,-3.0,4
669,669,2010-11,2010,2011,Arsenal,Fulham,Win,Home,2010-12-04,3,3,6,9,9,1,2,2,3,2,4,7,6,1,3.0,12.0,-9.0,5
670,670,2010-11,2010,2011,Arsenal,Man United,Loss,Away,2010-12-13,0,6,6,9,12,6,7,8,11,0,-1,1,1,0,3.0,2.0,1.0,5
671,671,2010-11,2010,2011,Arsenal,Chelsea,Win,Home,2010-12-27,3,3,6,6,9,2,3,3,3,1,3,3,6,1,3.0,1.0,2.0,5
672,672,2010-11,2010,2011,Arsenal,Wigan,Draw,Away,2010-12-29,1,3,6,9,9,4,5,5,5,-1,1,4,4,0,3.0,16.0,-13.0,5
673,673,2010-11,2010,2011,Arsenal,Birmingham,Win,Away,2011-01-01,3,4,4,7,10,1,2,3,6,3,2,4,4,0,3.0,9.0,-6.0,6
674,674,2010-11,2010,2011,Arsenal,Man City,Draw,Home,2011-01-05,1,4,7,7,10,6,9,9,12,-2,-2,-2,-2,1,3.0,5.0,-2.0,6
675,675,2010-11,2010,2011,Arsenal,West Ham,Win,Away,2011-01-15,3,4,5,8,8,3,4,7,8,1,1,1,0,0,3.0,17.0,-14.0,6
676,676,2010-11,2010,2011,Arsenal,Wigan,Win,Home,2011-01-22,3,4,7,8,11,2,2,3,6,2,5,5,5,1,3.0,16.0,-13.0,6
677,677,2010-11,2010,2011,Arsenal,Everton,Win,Home,2011-02-01,3,6,7,10,11,2,5,5,6,4,2,5,5,1,3.0,8.0,-5.0,7
678,678,2010-11,2010,2011,Arsenal,Newcastle,Draw,Away,2011-02-05,1,6,9,10,13,1,2,5,8,5,7,5,5,0,3.0,21.0,-18.0,7
679,679,2010-11,2010,2011,Arsenal,Wolves,Win,Home,2011-02-12,3,4,7,10,11,3,3,3,6,1,4,7,5,1,3.0,15.0,-12.0,7
680,680,2010-11,2010,2011,Arsenal,Stoke,Win,Home,2011-02-23,3,4,7,10,13,3,3,3,6,1,4,7,7,1,3.0,11.0,-8.0,7
681,681,2010-11,2010,2011,Arsenal,Sunderland,Draw,Home,2011-03-05,1,6,7,10,13,0,0,0,3,6,7,10,10,1,3.0,13.0,-10.0,8
682,682,2010-11,2010,2011,Arsenal,West Brom,Draw,Away,2011-03-19,1,4,7,8,11,4,5,6,6,0,2,2,5,0,3.0,21.0,-18.0,8
683,683,2010-11,2010,2011,Arsenal,Blackburn,Draw,Home,2011-04-02,1,2,5,8,9,1,1,2,2,1,4,6,7,1,3.0,10.0,-7.0,9
684,684,2010-11,2010,2011,Arsenal,Blackpool,Win,Away,2011-04-10,3,2,3,6,9,1,1,1,4,1,2,5,5,0,3.0,21.0,-18.0,9
685,685,2010-11,2010,2011,Arsenal,Liverpool,Draw,Home,2011-04-17,1,4,5,6,9,3,6,9,9,1,-1,-3,0,1,3.0,7.0,-4.0,9
686,686,2010-11,2010,2011,Arsenal,Tottenham,Draw,Away,2011-04-20,1,4,5,6,7,4,5,6,6,0,0,0,1,0,3.0,4.0,-1.0,9
687,687,2010-11,2010,2011,Arsenal,Bolton,Loss,Away,2011-04-24,0,2,5,6,7,3,3,6,7,-1,2,0,0,0,3.0,14.0,-11.0,9
688,688,2010-11,2010,2011,Arsenal,Man United,Win,Home,2011-05-01,3,1,2,5,6,4,7,10,13,-3,-5,-5,-7,1,3.0,2.0,1.0,10
689,689,2010-11,2010,2011,Arsenal,Stoke,Loss,Away,2011-05-08,0,3,4,5,8,4,5,5,6,-1,-1,0,2,0,3.0,11.0,-8.0,10
690,690,2010-11,2010,2011,Arsenal,Aston Villa,Loss,Home,2011-05-15,0,3,3,4,5,1,2,5,8,2,1,-1,-3,1,3.0,6.0,-3.0,10
691,691,2010-11,2010,2011,Arsenal,Fulham,Draw,Away,2011-05-22,1,0,3,3,4,3,6,9,10,-3,-3,-6,-6,0,3.0,12.0,-9.0,10
692,692,2011-12,2011,2012,Arsenal,Newcastle,Draw,Away,2011-08-13,1,1,1,4,4,2,5,5,6,-1,-4,-1,-2,0,4.0,12.0,-8.0,1
693,693,2011-12,2011,2012,Arsenal,Liverpool,Loss,Home,2011-08-20,0,2,2,2,5,1,1,4,7,1,1,-2,-2,1,4.0,6.0,-2.0,1
694,694,2011-12,2011,2012,Arsenal,Man United,Loss,Away,2011-08-28,0,1,2,2,2,6,9,10,13,-5,-7,-8,-11,0,4.0,1.0,3.0,1
695,695,2011-12,2011,2012,Arsenal,Swansea,Win,Home,2011-09-10,3,0,1,2,2,2,2,2,2,-2,-1,0,0,1,4.0,21.0,-17.0,2
696,696,2011-12,2011,2012,Arsenal,Blackburn,Loss,Away,2011-09-17,0,3,3,4,5,1,1,1,4,2,2,3,1,0,4.0,15.0,-11.0,2
697,697,2011-12,2011,2012,Arsenal,Bolton,Win,Home,2011-09-24,3,3,3,3,4,0,0,0,3,3,3,3,1,1,4.0,14.0,-10.0,2
698,698,2011-12,2011,2012,Arsenal,Tottenham,Loss,Away,2011-10-02,0,3,6,6,6,6,9,9,9,-3,-3,-3,-3,0,4.0,5.0,-1.0,3
699,699,2011-12,2011,2012,Arsenal,Sunderland,Win,Home,2011-10-16,3,3,3,6,6,1,4,4,5,2,-1,2,1,1,4.0,10.0,-6.0,3
700,700,2011-12,2011,2012,Arsenal,Stoke,Win,Home,2011-10-23,3,3,6,6,9,3,4,4,7,0,2,2,2,1,4.0,13.0,-9.0,3
701,701,2011-12,2011,2012,Arsenal,Chelsea,Win,Away,2011-10-29,3,6,6,9,9,3,6,9,9,3,0,0,0,0,4.0,2.0,2.0,3
702,702,2011-12,2011,2012,Arsenal,West Brom,Win,Home,2011-11-05,3,6,9,9,12,3,6,7,8,3,3,2,4,1,4.0,11.0,-7.0,4
703,703,2011-12,2011,2012,Arsenal,Norwich,Win,Away,2011-11-19,3,6,9,12,12,1,2,5,5,5,7,7,7,0,4.0,21.0,-17.0,4
704,704,2011-12,2011,2012,Arsenal,Fulham,Draw,Home,2011-11-26,1,6,9,12,15,1,4,4,4,5,5,8,11,1,4.0,8.0,-4.0,4
705,705,2011-12,2011,2012,Arsenal,Wigan,Win,Away,2011-12-03,3,4,7,10,13,4,4,4,4,0,3,6,9,0,4.0,16.0,-12.0,5
706,706,2011-12,2011,2012,Arsenal,Everton,Win,Home,2011-12-10,3,4,7,10,13,3,6,6,6,1,1,4,7,1,4.0,7.0,-3.0,5
707,707,2011-12,2011,2012,Arsenal,Man City,Loss,Away,2011-12-18,0,6,7,10,13,3,4,7,10,3,3,3,3,0,4.0,3.0,1.0,5
708,708,2011-12,2011,2012,Arsenal,Aston Villa,Win,Away,2011-12-21,3,3,6,7,10,3,3,4,4,0,3,3,6,0,4.0,9.0,-5.0,5
709,709,2011-12,2011,2012,Arsenal,Wolves,Draw,Home,2011-12-27,1,3,6,9,10,1,1,4,4,2,5,5,6,1,4.0,17.0,-13.0,5
710,710,2011-12,2011,2012,Arsenal,QPR,Win,Home,2011-12-31,3,4,4,7,10,1,1,1,2,3,3,6,8,1,4.0,21.0,-17.0,5
711,711,2011-12,2011,2012,Arsenal,Fulham,Loss,Away,2012-01-02,0,4,7,7,10,2,2,5,5,2,5,2,5,0,4.0,8.0,-4.0,6
712,712,2011-12,2011,2012,Arsenal,Swansea,Loss,Away,2012-01-15,0,3,4,7,7,4,5,5,6,-1,-1,2,1,0,4.0,21.0,-17.0,6
713,713,2011-12,2011,2012,Arsenal,Man United,Loss,Home,2012-01-22,0,0,3,4,7,3,3,6,9,-3,0,-2,-2,1,4.0,1.0,3.0,6
714,714,2011-12,2011,2012,Arsenal,Bolton,Draw,Away,2012-02-01,1,0,0,3,4,3,6,7,7,-3,-6,-4,-3,0,4.0,14.0,-10.0,7
715,715,2011-12,2011,2012,Arsenal,Blackburn,Win,Home,2012-02-04,3,1,1,1,4,1,4,4,7,0,-3,-3,-3,1,4.0,15.0,-11.0,7
716,716,2011-12,2011,2012,Arsenal,Sunderland,Win,Away,2012-02-11,3,4,4,4,4,6,9,9,12,-2,-5,-5,-8,0,4.0,10.0,-6.0,7
717,717,2011-12,2011,2012,Arsenal,Tottenham,Win,Home,2012-02-26,3,6,7,7,7,4,7,7,8,2,0,0,-1,1,4.0,5.0,-1.0,7
718,718,2011-12,2011,2012,Arsenal,Liverpool,Win,Away,2012-03-03,3,6,9,10,10,1,4,4,5,5,5,6,5,0,4.0,6.0,-2.0,8
719,719,2011-12,2011,2012,Arsenal,Newcastle,Win,Home,2012-03-12,3,6,9,12,13,2,2,5,8,4,7,7,5,1,4.0,12.0,-8.0,8
720,720,2011-12,2011,2012,Arsenal,Everton,Win,Away,2012-03-21,3,6,9,12,15,3,4,7,8,3,5,5,7,0,4.0,7.0,-3.0,8
721,721,2011-12,2011,2012,Arsenal,Aston Villa,Win,Home,2012-03-24,3,6,9,12,15,4,5,5,5,2,4,7,10,1,4.0,9.0,-5.0,8
722,722,2011-12,2011,2012,Arsenal,QPR,Loss,Away,2012-03-31,0,6,9,12,15,3,3,4,4,3,6,8,11,0,4.0,21.0,-17.0,8
723,723,2011-12,2011,2012,Arsenal,Man City,Win,Home,2012-04-08,3,3,6,9,12,2,5,5,8,1,1,4,4,1,4.0,3.0,1.0,9
724,724,2011-12,2011,2012,Arsenal,Wolves,Win,Away,2012-04-11,3,3,6,9,12,0,0,0,0,3,6,9,12,0,4.0,17.0,-13.0,9
725,725,2011-12,2011,2012,Arsenal,Wigan,Loss,Home,2012-04-16,0,6,6,9,12,3,6,9,10,3,0,0,2,1,4.0,16.0,-12.0,9
726,726,2011-12,2011,2012,Arsenal,Chelsea,Draw,Home,2012-04-21,1,3,6,6,9,4,7,8,8,-1,-1,-2,1,1,4.0,2.0,2.0,9
727,727,2011-12,2011,2012,Arsenal,Stoke,Draw,Away,2012-04-28,1,1,4,7,7,1,4,4,5,0,0,3,2,0,4.0,13.0,-9.0,9
728,728,2011-12,2011,2012,Arsenal,Norwich,Draw,Home,2012-05-05,1,2,2,5,8,0,0,3,4,2,2,2,4,1,4.0,21.0,-17.0,10
729,729,2011-12,2011,2012,Arsenal,West Brom,Win,Away,2012-05-13,3,2,3,3,6,2,5,8,8,0,-2,-5,-2,0,4.0,11.0,-7.0,10
730,730,2012-13,2012,2013,Arsenal,Sunderland,Draw,Home,2012-08-18,1,4,5,6,6,0,1,2,3,4,4,4,3,1,3.0,13.0,-10.0,1
731,731,2012-13,2012,2013,Arsenal,Stoke,Draw,Away,2012-08-26,1,4,5,6,7,2,2,3,4,2,3,3,3,0,3.0,14.0,-11.0,1
732,732,2012-13,2012,2013,Arsenal,Liverpool,Win,Away,2012-09-02,3,2,5,6,7,1,1,4,4,1,4,2,3,0,3.0,8.0,-5.0,2
733,733,2012-13,2012,2013,Arsenal,Southampton,Win,Home,2012-09-15,3,4,5,8,9,0,0,0,1,4,5,8,8,1,3.0,21.0,-18.0,2
734,734,2012-13,2012,2013,Arsenal,Man City,Draw,Away,2012-09-23,1,6,7,8,11,4,5,8,11,2,2,0,0,0,3.0,1.0,2.0,2
735,735,2012-13,2012,2013,Arsenal,Chelsea,Loss,Home,2012-09-29,0,4,7,8,9,4,7,10,13,0,0,-2,-4,1,3.0,6.0,-3.0,2
736,736,2012-13,2012,2013,Arsenal,West Ham,Win,Away,2012-10-06,3,1,4,7,8,4,5,8,8,-3,-1,-1,0,0,3.0,21.0,-18.0,3
737,737,2012-13,2012,2013,Arsenal,Norwich,Loss,Away,2012-10-20,0,3,4,7,10,0,0,1,2,3,4,6,8,0,3.0,12.0,-9.0,3
738,738,2012-13,2012,2013,Arsenal,QPR,Win,Home,2012-10-27,3,3,3,4,7,1,1,1,2,2,2,3,5,1,3.0,17.0,-14.0,3
739,739,2012-13,2012,2013,Arsenal,Man United,Loss,Away,2012-11-03,0,3,6,6,7,6,9,9,12,-3,-3,-3,-5,0,3.0,2.0,1.0,4
740,740,2012-13,2012,2013,Arsenal,Fulham,Draw,Home,2012-11-10,1,3,3,6,6,2,5,6,6,1,-2,0,0,1,3.0,9.0,-6.0,4
741,741,2012-13,2012,2013,Arsenal,Tottenham,Win,Home,2012-11-17,3,1,4,4,7,0,3,3,6,1,1,1,1,1,3.0,4.0,-1.0,4
742,742,2012-13,2012,2013,Arsenal,Aston Villa,Draw,Away,2012-11-24,1,4,4,7,7,0,3,4,4,4,1,3,3,0,3.0,16.0,-13.0,4
743,743,2012-13,2012,2013,Arsenal,Everton,Draw,Away,2012-11-28,1,4,5,5,8,1,4,5,6,3,1,0,2,0,3.0,7.0,-4.0,4
744,744,2012-13,2012,2013,Arsenal,Swansea,Loss,Home,2012-12-01,0,2,5,6,6,4,7,8,9,-2,-2,-2,-3,1,3.0,11.0,-8.0,5
745,745,2012-13,2012,2013,Arsenal,West Brom,Win,Home,2012-12-08,3,1,2,5,6,0,3,6,9,1,-1,-1,-3,1,3.0,10.0,-7.0,5
746,746,2012-13,2012,2013,Arsenal,Reading,Win,Away,2012-12-17,3,3,4,5,8,0,0,0,0,3,4,5,8,0,3.0,21.0,-18.0,5
747,747,2012-13,2012,2013,Arsenal,Wigan,Win,Away,2012-12-22,3,6,6,7,8,1,1,1,4,5,5,6,4,0,3.0,15.0,-12.0,5
748,748,2012-13,2012,2013,Arsenal,Newcastle,Win,Home,2012-12-29,3,6,9,9,10,3,3,3,6,3,6,6,4,1,3.0,5.0,-2.0,5
749,749,2012-13,2012,2013,Arsenal,Southampton,Draw,Away,2013-01-01,1,6,9,12,12,2,2,5,5,4,7,7,7,0,3.0,21.0,-18.0,6
750,750,2012-13,2012,2013,Arsenal,Man City,Loss,Home,2013-01-13,0,4,7,10,13,6,6,9,12,-2,1,1,1,1,3.0,1.0,2.0,6
751,751,2012-13,2012,2013,Arsenal,Chelsea,Loss,Away,2013-01-20,0,1,4,7,10,4,4,7,10,-3,0,0,0,0,3.0,6.0,-3.0,6
752,752,2012-13,2012,2013,Arsenal,West Ham,Win,Home,2013-01-23,3,0,1,4,7,1,4,4,4,-1,-3,0,3,1,3.0,21.0,-18.0,6
753,753,2012-13,2012,2013,Arsenal,Liverpool,Draw,Home,2013-01-30,1,3,3,4,7,3,6,9,9,0,-3,-5,-2,1,3.0,8.0,-5.0,6
754,754,2012-13,2012,2013,Arsenal,Stoke,Win,Home,2013-02-02,3,4,4,4,5,1,1,1,2,3,3,3,3,1,3.0,14.0,-11.0,7
755,755,2012-13,2012,2013,Arsenal,Sunderland,Win,Away,2013-02-09,3,4,7,7,7,1,4,7,7,3,3,0,0,0,3.0,13.0,-10.0,7
756,756,2012-13,2012,2013,Arsenal,Aston Villa,Win,Home,2013-02-23,3,6,7,10,10,4,4,5,5,2,3,5,5,1,3.0,16.0,-13.0,7
757,757,2012-13,2012,2013,Arsenal,Tottenham,Loss,Away,2013-03-03,0,6,9,10,13,6,9,10,11,0,0,0,2,0,3.0,4.0,-1.0,8
758,758,2012-13,2012,2013,Arsenal,Swansea,Win,Away,2013-03-16,3,3,6,9,10,3,3,6,6,0,3,3,4,0,3.0,11.0,-8.0,8
759,759,2012-13,2012,2013,Arsenal,Reading,Win,Home,2013-03-30,3,3,6,9,12,0,0,0,0,3,6,9,12,1,3.0,21.0,-18.0,8
760,760,2012-13,2012,2013,Arsenal,West Brom,Win,Away,2013-04-06,3,6,6,9,12,1,4,4,7,5,2,5,5,0,3.0,10.0,-7.0,9
761,761,2012-13,2012,2013,Arsenal,Norwich,Win,Home,2013-04-13,3,6,9,9,12,1,2,3,3,5,7,6,9,1,3.0,12.0,-9.0,9
762,762,2012-13,2012,2013,Arsenal,Everton,Draw,Home,2013-04-16,1,6,9,12,12,4,7,10,13,2,2,2,-1,1,3.0,7.0,-4.0,9
763,763,2012-13,2012,2013,Arsenal,Fulham,Win,Away,2013-04-20,3,4,7,10,13,1,1,4,7,3,6,6,6,0,3.0,9.0,-6.0,9
764,764,2012-13,2012,2013,Arsenal,Man United,Draw,Home,2013-04-28,1,4,7,10,13,4,7,7,10,0,0,3,3,1,3.0,2.0,1.0,9
765,765,2012-13,2012,2013,Arsenal,QPR,Win,Away,2013-05-04,3,4,5,8,11,1,1,2,2,3,4,6,9,0,3.0,17.0,-14.0,10
766,766,2012-13,2012,2013,Arsenal,Wigan,Win,Home,2013-05-14,3,4,7,8,11,3,4,4,4,1,3,4,7,1,3.0,15.0,-12.0,10
767,767,2012-13,2012,2013,Arsenal,Newcastle,Win,Away,2013-05-19,3,6,7,10,11,4,4,5,5,2,3,5,6,0,3.0,5.0,-2.0,10
768,768,2013-14,2013,2014,Arsenal,Aston Villa,Loss,Home,2013-08-17,0,6,9,10,13,1,4,7,7,5,5,3,6,1,4.0,15.0,-11.0,1
769,769,2013-14,2013,2014,Arsenal,Fulham,Win,Away,2013-08-24,3,3,6,9,10,6,6,6,6,-3,0,3,4,0,4.0,12.0,-8.0,1
770,770,2013-14,2013,2014,Arsenal,Tottenham,Win,Home,2013-09-01,3,3,6,9,12,6,9,12,13,-3,-3,-3,-1,1,4.0,5.0,-1.0,2
771,771,2013-14,2013,2014,Arsenal,Sunderland,Win,Away,2013-09-14,3,6,6,9,12,1,1,1,2,5,5,8,10,0,4.0,17.0,-13.0,2
772,772,2013-14,2013,2014,Arsenal,Stoke,Win,Home,2013-09-22,3,6,9,9,12,4,7,7,8,2,2,2,4,1,4.0,13.0,-9.0,2
773,773,2013-14,2013,2014,Arsenal,Swansea,Win,Away,2013-09-28,3,6,9,12,12,4,7,7,7,2,2,5,5,0,4.0,9.0,-5.0,2
774,774,2013-14,2013,2014,Arsenal,West Brom,Draw,Away,2013-10-06,1,6,9,12,15,6,7,7,8,0,2,5,7,0,4.0,8.0,-4.0,3
775,775,2013-14,2013,2014,Arsenal,Norwich,Win,Home,2013-10-19,3,4,7,10,13,3,3,3,6,1,4,7,7,1,4.0,11.0,-7.0,3
776,776,2013-14,2013,2014,Arsenal,Crystal Palace,Win,Away,2013-10-26,3,4,7,10,13,0,0,0,0,4,7,10,13,0,4.0,21.0,-17.0,3
777,777,2013-14,2013,2014,Arsenal,Liverpool,Win,Home,2013-11-02,3,6,7,10,13,4,7,10,10,2,0,0,3,1,4.0,7.0,-3.0,4
778,778,2013-14,2013,2014,Arsenal,Man United,Loss,Away,2013-11-10,0,6,9,10,13,6,7,10,10,0,2,0,3,0,4.0,1.0,3.0,4
779,779,2013-14,2013,2014,Arsenal,Southampton,Win,Home,2013-11-23,3,3,6,9,10,4,7,8,11,-1,-1,1,-1,1,4.0,14.0,-10.0,4
780,780,2013-14,2013,2014,Arsenal,Cardiff,Win,Away,2013-11-30,3,3,6,9,12,1,4,5,5,2,2,4,7,0,4.0,21.0,-17.0,4
781,781,2013-14,2013,2014,Arsenal,Hull,Win,Home,2013-12-04,3,6,6,9,12,3,3,6,6,3,3,3,6,1,4.0,21.0,-17.0,5
782,782,2013-14,2013,2014,Arsenal,Everton,Draw,Home,2013-12-08,1,6,9,9,12,6,7,8,9,0,2,1,3,1,4.0,6.0,-2.0,5
783,783,2013-14,2013,2014,Arsenal,Man City,Loss,Away,2013-12-14,0,4,7,10,10,4,7,10,10,0,0,0,0,0,4.0,2.0,2.0,5
784,784,2013-14,2013,2014,Arsenal,Chelsea,Draw,Home,2013-12-23,1,1,4,7,10,3,6,9,12,-2,-2,-2,-2,1,4.0,3.0,1.0,5
785,785,2013-14,2013,2014,Arsenal,West Ham,Win,Away,2013-12-26,3,1,2,5,8,1,1,1,4,0,1,4,4,0,4.0,10.0,-6.0,5
786,786,2013-14,2013,2014,Arsenal,Newcastle,Win,Away,2013-12-29,3,4,4,5,8,6,7,10,10,-2,-3,-5,-2,0,4.0,16.0,-12.0,5
787,787,2013-14,2013,2014,Arsenal,Cardiff,Win,Home,2014-01-01,3,6,7,7,8,1,1,4,4,5,6,3,4,1,4.0,21.0,-17.0,6
788,788,2013-14,2013,2014,Arsenal,Aston Villa,Win,Away,2014-01-13,3,6,9,10,10,4,4,4,4,2,5,6,6,0,4.0,15.0,-11.0,6
789,789,2013-14,2013,2014,Arsenal,Fulham,Win,Home,2014-01-18,3,6,9,12,13,3,3,6,6,3,6,6,7,1,4.0,12.0,-8.0,6
790,790,2013-14,2013,2014,Arsenal,Southampton,Draw,Away,2014-01-28,1,6,9,12,15,4,4,4,7,2,5,8,8,0,4.0,14.0,-10.0,6
791,791,2013-14,2013,2014,Arsenal,Crystal Palace,Win,Home,2014-02-02,3,4,7,10,13,6,6,7,7,-2,1,3,6,1,4.0,21.0,-17.0,7
792,792,2013-14,2013,2014,Arsenal,Liverpool,Loss,Away,2014-02-08,0,4,7,10,13,4,5,8,11,0,2,2,2,0,4.0,7.0,-3.0,7
793,793,2013-14,2013,2014,Arsenal,Man United,Draw,Home,2014-02-12,1,3,4,7,10,1,4,4,7,2,0,3,3,1,4.0,1.0,3.0,7
794,794,2013-14,2013,2014,Arsenal,Sunderland,Win,Home,2014-02-22,3,1,4,5,8,3,6,7,10,-2,-2,-2,-2,1,4.0,17.0,-13.0,7
795,795,2013-14,2013,2014,Arsenal,Stoke,Loss,Away,2014-03-01,0,4,4,7,8,1,2,5,5,3,2,2,3,0,4.0,13.0,-9.0,8
796,796,2013-14,2013,2014,Arsenal,Tottenham,Win,Away,2014-03-16,3,3,4,4,7,3,3,6,9,0,1,-2,-2,0,4.0,5.0,-1.0,8
797,797,2013-14,2013,2014,Arsenal,Chelsea,Loss,Away,2014-03-22,0,3,6,7,7,3,6,9,10,0,0,-2,-3,0,4.0,3.0,1.0,8
798,798,2013-14,2013,2014,Arsenal,Swansea,Draw,Home,2014-03-25,1,3,3,6,7,0,1,1,2,3,2,5,5,1,4.0,9.0,-5.0,8
799,799,2013-14,2013,2014,Arsenal,Man City,Draw,Home,2014-03-29,1,1,4,4,7,6,9,12,13,-5,-5,-8,-6,1,4.0,2.0,2.0,8
800,800,2013-14,2013,2014,Arsenal,Everton,Loss,Away,2014-04-06,0,2,2,5,5,6,9,12,15,-4,-7,-7,-10,0,4.0,6.0,-2.0,9
801,801,2013-14,2013,2014,Arsenal,West Ham,Win,Home,2014-04-15,3,1,2,2,5,3,6,6,6,-2,-4,-4,-1,1,4.0,10.0,-6.0,9
802,802,2013-14,2013,2014,Arsenal,Hull,Win,Away,2014-04-20,3,3,4,5,5,3,3,6,6,0,1,-1,-1,0,4.0,21.0,-17.0,9
803,803,2013-14,2013,2014,Arsenal,Newcastle,Win,Home,2014-04-28,3,6,6,7,8,0,0,0,0,6,6,7,8,1,4.0,16.0,-12.0,9
804,804,2013-14,2013,2014,Arsenal,West Brom,Win,Home,2014-05-04,3,6,9,9,10,3,4,7,8,3,5,2,2,1,4.0,8.0,-4.0,10
805,805,2013-14,2013,2014,Arsenal,Norwich,Win,Away,2014-05-11,3,6,9,12,12,1,1,1,1,5,8,11,11,0,4.0,11.0,-7.0,10
806,806,2014-15,2014,2015,Arsenal,Crystal Palace,Win,Home,2014-08-16,3,6,9,12,15,2,2,5,8,4,7,7,7,1,4.0,11.0,-7.0,1
807,807,2014-15,2014,2015,Arsenal,Everton,Draw,Away,2014-08-23,1,6,9,12,15,4,4,4,7,2,5,8,8,0,4.0,5.0,-1.0,1
808,808,2014-15,2014,2015,Arsenal,Leicester,Draw,Away,2014-08-31,1,4,7,10,13,1,1,4,5,3,6,6,8,0,4.0,21.0,-17.0,1
809,809,2014-15,2014,2015,Arsenal,Man City,Draw,Home,2014-09-13,1,2,5,8,11,3,6,9,12,-1,-1,-1,-1,1,4.0,1.0,3.0,2
810,810,2014-15,2014,2015,Arsenal,Aston Villa,Win,Away,2014-09-20,3,2,3,6,9,6,7,10,10,-4,-4,-4,-1,0,4.0,15.0,-11.0,2
811,811,2014-15,2014,2015,Arsenal,Tottenham,Draw,Home,2014-09-27,1,4,5,6,9,1,1,4,7,3,4,2,2,1,4.0,6.0,-2.0,2
812,812,2014-15,2014,2015,Arsenal,Chelsea,Loss,Away,2014-10-05,0,4,5,6,7,4,7,10,13,0,-2,-4,-6,0,4.0,3.0,1.0,3
813,813,2014-15,2014,2015,Arsenal,Hull,Draw,Home,2014-10-18,1,1,4,5,6,3,4,5,5,-2,0,0,1,1,4.0,16.0,-12.0,3
814,814,2014-15,2014,2015,Arsenal,Sunderland,Win,Away,2014-10-25,3,1,2,5,6,3,4,5,6,-2,-2,0,0,0,4.0,14.0,-10.0,3
815,815,2014-15,2014,2015,Arsenal,Burnley,Win,Home,2014-11-01,3,4,4,5,8,0,1,1,2,4,3,4,6,1,4.0,21.0,-17.0,4
816,816,2014-15,2014,2015,Arsenal,Swansea,Loss,Away,2014-11-09,0,6,7,7,8,4,4,5,6,2,3,2,2,0,4.0,12.0,-8.0,4
817,817,2014-15,2014,2015,Arsenal,Man United,Loss,Home,2014-11-22,0,3,6,7,7,3,4,5,8,0,2,2,-1,1,4.0,7.0,-3.0,4
818,818,2014-15,2014,2015,Arsenal,West Brom,Win,Away,2014-11-29,3,0,3,6,7,0,3,4,5,0,0,2,2,0,4.0,17.0,-13.0,4
819,819,2014-15,2014,2015,Arsenal,Southampton,Win,Home,2014-12-03,3,3,3,6,9,1,4,7,10,2,-1,-1,-1,1,4.0,8.0,-4.0,5
820,820,2014-15,2014,2015,Arsenal,Stoke,Loss,Away,2014-12-06,0,6,6,6,9,0,0,3,4,6,6,3,5,0,4.0,9.0,-5.0,5
821,821,2014-15,2014,2015,Arsenal,Newcastle,Win,Home,2014-12-13,3,3,6,6,6,4,4,7,10,-1,2,-1,-4,1,4.0,10.0,-6.0,5
822,822,2014-15,2014,2015,Arsenal,Liverpool,Draw,Away,2014-12-21,1,3,6,9,9,1,4,7,7,2,2,2,2,0,4.0,2.0,2.0,5
823,823,2014-15,2014,2015,Arsenal,QPR,Win,Home,2014-12-26,3,4,4,7,10,3,6,6,9,1,-2,1,1,1,4.0,21.0,-17.0,5
824,824,2014-15,2014,2015,Arsenal,West Ham,Win,Away,2014-12-28,3,4,7,7,10,3,4,7,10,1,3,0,0,0,4.0,13.0,-9.0,5
825,825,2014-15,2014,2015,Arsenal,Southampton,Loss,Away,2015-01-01,0,6,7,10,10,4,7,7,7,2,0,3,3,0,4.0,8.0,-4.0,6
826,826,2014-15,2014,2015,Arsenal,Stoke,Win,Home,2015-01-11,3,3,6,7,10,4,7,7,8,-1,-1,0,2,1,4.0,9.0,-5.0,6
827,827,2014-15,2014,2015,Arsenal,Man City,Win,Away,2015-01-18,3,3,6,9,10,4,5,8,11,-1,1,1,-1,0,4.0,1.0,3.0,6
828,828,2014-15,2014,2015,Arsenal,Aston Villa,Win,Home,2015-02-01,3,6,6,9,12,0,1,2,2,6,5,7,10,1,4.0,15.0,-11.0,7
829,829,2014-15,2014,2015,Arsenal,Tottenham,Loss,Away,2015-02-07,0,6,9,9,12,6,6,9,10,0,3,0,2,0,4.0,6.0,-2.0,7
830,830,2014-15,2014,2015,Arsenal,Leicester,Win,Home,2015-02-10,3,3,6,9,9,0,0,3,4,3,6,6,5,1,4.0,21.0,-17.0,7
831,831,2014-15,2014,2015,Arsenal,Crystal Palace,Win,Away,2015-02-21,3,3,6,9,12,4,4,7,10,-1,2,2,2,0,4.0,11.0,-7.0,7
832,832,2014-15,2014,2015,Arsenal,Everton,Win,Home,2015-03-01,3,6,6,9,12,1,2,5,6,5,4,4,6,1,4.0,5.0,-1.0,8
833,833,2014-15,2014,2015,Arsenal,QPR,Win,Away,2015-03-04,3,6,9,9,12,3,3,3,3,3,6,6,9,0,4.0,21.0,-17.0,8
834,834,2014-15,2014,2015,Arsenal,West Ham,Win,Home,2015-03-14,3,6,9,12,12,0,1,2,3,6,8,10,9,1,4.0,13.0,-9.0,8
835,835,2014-15,2014,2015,Arsenal,Newcastle,Win,Away,2015-03-21,3,6,9,12,15,0,3,3,4,6,6,9,11,0,4.0,10.0,-6.0,8
836,836,2014-15,2014,2015,Arsenal,Liverpool,Win,Home,2015-04-04,3,6,9,12,15,3,6,9,12,3,3,3,3,1,4.0,2.0,2.0,9
837,837,2014-15,2014,2015,Arsenal,Burnley,Win,Away,2015-04-11,3,6,9,12,15,1,4,4,4,5,5,8,11,0,4.0,21.0,-17.0,9
838,838,2014-15,2014,2015,Arsenal,Chelsea,Draw,Home,2015-04-26,1,6,9,12,15,6,9,12,13,0,0,0,2,1,4.0,3.0,1.0,9
839,839,2014-15,2014,2015,Arsenal,Hull,Win,Away,2015-05-04,3,4,7,10,13,6,6,6,6,-2,1,4,7,0,4.0,16.0,-12.0,10
840,840,2014-15,2014,2015,Arsenal,Swansea,Loss,Home,2015-05-11,0,4,7,10,13,6,6,7,10,-2,1,3,3,1,4.0,12.0,-8.0,10
841,841,2014-15,2014,2015,Arsenal,Man United,Draw,Away,2015-05-17,1,3,4,7,10,3,3,3,6,0,1,4,4,0,4.0,7.0,-3.0,10
842,842,2014-15,2014,2015,Arsenal,Sunderland,Draw,Home,2015-05-20,1,1,4,5,8,4,7,8,8,-3,-3,-3,0,1,4.0,14.0,-10.0,10
843,843,2014-15,2014,2015,Arsenal,West Brom,Win,Home,2015-05-24,3,2,2,5,6,4,7,8,11,-2,-5,-3,-5,1,4.0,17.0,-13.0,10
844,844,2015-16,2015,2016,Arsenal,West Ham,Loss,Home,2015-08-09,0,4,5,5,8,0,0,3,4,4,5,2,4,1,3.0,12.0,-9.0,1
845,845,2015-16,2015,2016,Arsenal,Crystal Palace,Win,Away,2015-08-16,3,3,4,5,5,6,9,9,9,-3,-5,-4,-4,0,3.0,10.0,-7.0,1
846,846,2015-16,2015,2016,Arsenal,Liverpool,Draw,Home,2015-08-24,1,3,6,7,8,6,6,6,7,-3,0,1,1,1,3.0,6.0,-3.0,1
847,847,2015-16,2015,2016,Arsenal,Newcastle,Win,Away,2015-08-29,3,4,4,7,8,1,2,5,5,3,2,2,3,0,3.0,15.0,-12.0,1
848,848,2015-16,2015,2016,Arsenal,Stoke,Win,Home,2015-09-12,3,4,7,7,10,1,2,2,5,3,5,5,5,1,3.0,9.0,-6.0,2
849,849,2015-16,2015,2016,Arsenal,Chelsea,Loss,Away,2015-09-19,0,6,7,10,10,0,3,3,4,6,4,7,6,0,3.0,1.0,2.0,2
850,850,2015-16,2015,2016,Arsenal,Leicester,Win,Away,2015-09-26,3,3,6,7,10,4,5,6,9,-1,1,1,1,0,3.0,14.0,-11.0,2
851,851,2015-16,2015,2016,Arsenal,Man United,Win,Home,2015-10-04,3,3,6,9,10,6,9,9,10,-3,-3,0,0,1,3.0,4.0,-1.0,3
852,852,2015-16,2015,2016,Arsenal,Watford,Win,Away,2015-10-17,3,6,6,9,12,1,4,7,7,5,2,2,5,0,3.0,21.0,-18.0,3
853,853,2015-16,2015,2016,Arsenal,Everton,Win,Home,2015-10-24,3,6,9,9,12,1,4,5,8,5,5,4,4,1,3.0,11.0,-8.0,3
854,854,2015-16,2015,2016,Arsenal,Swansea,Win,Away,2015-10-31,3,6,9,12,12,3,4,4,5,3,5,8,7,0,3.0,8.0,-5.0,3
855,855,2015-16,2015,2016,Arsenal,Tottenham,Draw,Home,2015-11-08,1,6,9,12,15,6,7,8,11,0,2,4,4,1,3.0,5.0,-2.0,4
856,856,2015-16,2015,2016,Arsenal,West Brom,Loss,Away,2015-11-21,0,4,7,10,13,0,3,6,6,4,4,4,7,0,3.0,13.0,-10.0,4
857,857,2015-16,2015,2016,Arsenal,Norwich,Draw,Away,2015-11-29,1,1,4,7,10,3,3,3,3,-2,1,4,7,0,3.0,21.0,-18.0,4
858,858,2015-16,2015,2016,Arsenal,Sunderland,Win,Home,2015-12-05,3,1,2,5,8,6,6,6,9,-5,-4,-1,-1,1,3.0,16.0,-13.0,5
859,859,2015-16,2015,2016,Arsenal,Aston Villa,Win,Away,2015-12-13,3,4,4,5,8,1,1,2,2,3,3,3,6,0,3.0,17.0,-14.0,5
860,860,2015-16,2015,2016,Arsenal,Man City,Win,Home,2015-12-21,3,6,7,7,8,3,6,6,7,3,1,1,1,1,3.0,2.0,1.0,5
861,861,2015-16,2015,2016,Arsenal,Southampton,Loss,Away,2015-12-26,0,6,9,10,10,0,1,1,1,6,8,9,9,0,3.0,7.0,-4.0,5
862,862,2015-16,2015,2016,Arsenal,Bournemouth,Win,Home,2015-12-28,3,3,6,9,10,4,7,10,11,-1,-1,-1,-1,1,3.0,21.0,-18.0,5
863,863,2015-16,2015,2016,Arsenal,Newcastle,Win,Home,2016-01-02,3,3,6,9,12,0,1,4,7,3,5,5,5,1,3.0,15.0,-12.0,6
864,864,2015-16,2015,2016,Arsenal,Liverpool,Draw,Away,2016-01-13,1,6,6,9,12,3,6,6,7,3,0,3,5,0,3.0,6.0,-3.0,6
865,865,2015-16,2015,2016,Arsenal,Stoke,Draw,Away,2016-01-17,1,4,7,7,10,3,6,9,9,1,1,-2,1,0,3.0,9.0,-6.0,6
866,866,2015-16,2015,2016,Arsenal,Chelsea,Loss,Home,2016-01-24,0,2,5,8,8,2,5,6,7,0,0,2,1,1,3.0,1.0,2.0,6
867,867,2015-16,2015,2016,Arsenal,Southampton,Draw,Home,2016-02-02,1,1,2,5,8,6,9,9,9,-5,-7,-4,-1,1,3.0,7.0,-4.0,7
868,868,2015-16,2015,2016,Arsenal,Bournemouth,Win,Away,2016-02-07,3,1,2,3,6,4,7,7,8,-3,-5,-4,-2,0,3.0,21.0,-18.0,7
869,869,2015-16,2015,2016,Arsenal,Leicester,Win,Home,2016-02-14,3,4,4,5,6,6,9,10,13,-2,-5,-5,-7,1,3.0,14.0,-11.0,7
870,870,2015-16,2015,2016,Arsenal,Man United,Loss,Away,2016-02-28,0,6,7,7,8,1,4,4,7,5,3,3,1,0,3.0,4.0,-1.0,7
871,871,2015-16,2015,2016,Arsenal,Swansea,Loss,Home,2016-03-02,0,3,6,7,7,0,1,2,5,3,5,5,2,1,3.0,8.0,-5.0,8
872,872,2015-16,2015,2016,Arsenal,Tottenham,Draw,Away,2016-03-05,1,0,3,6,7,3,6,9,12,-3,-3,-3,-5,0,3.0,5.0,-2.0,8
873,873,2015-16,2015,2016,Arsenal,Everton,Win,Away,2016-03-19,3,1,1,4,7,3,3,6,9,-2,-2,-2,-2,0,3.0,11.0,-8.0,8
874,874,2015-16,2015,2016,Arsenal,Watford,Win,Home,2016-04-02,3,4,4,4,7,0,0,1,4,4,4,3,3,1,3.0,21.0,-18.0,9
875,875,2015-16,2015,2016,Arsenal,West Ham,Draw,Away,2016-04-09,1,6,7,7,7,2,5,8,11,4,2,-1,-4,0,3.0,12.0,-9.0,9
876,876,2015-16,2015,2016,Arsenal,Crystal Palace,Draw,Home,2016-04-17,1,4,7,8,8,4,5,5,5,0,2,3,3,1,3.0,10.0,-7.0,9
877,877,2015-16,2015,2016,Arsenal,West Brom,Win,Home,2016-04-21,3,2,5,8,9,0,1,1,4,2,4,7,5,1,3.0,13.0,-10.0,9
878,878,2015-16,2015,2016,Arsenal,Sunderland,Draw,Away,2016-04-24,1,4,5,8,11,3,4,5,6,1,1,3,5,0,3.0,16.0,-13.0,9
879,879,2015-16,2015,2016,Arsenal,Norwich,Win,Home,2016-04-30,3,4,5,6,9,0,3,6,7,4,2,0,2,1,3.0,21.0,-18.0,9
880,880,2015-16,2015,2016,Arsenal,Man City,Draw,Away,2016-05-08,1,4,7,8,9,3,4,7,10,1,3,1,-1,0,3.0,2.0,1.0,10
881,881,2015-16,2015,2016,Arsenal,Aston Villa,Win,Home,2016-05-15,3,4,5,8,9,1,1,1,1,3,4,7,8,1,3.0,17.0,-14.0,10
882,882,2016-17,2016,2017,Arsenal,Liverpool,Loss,Home,2016-08-14,0,4,7,8,11,2,5,5,6,2,2,3,5,1,2.0,8.0,-6.0,1
883,883,2016-17,2016,2017,Arsenal,Leicester,Draw,Away,2016-08-20,1,3,4,7,8,1,4,5,8,2,0,2,0,0,2.0,1.0,1.0,1
884,884,2016-17,2016,2017,Arsenal,Watford,Win,Away,2016-08-27,3,1,4,5,8,1,2,2,2,0,2,3,6,0,2.0,13.0,-11.0,1
885,885,2016-17,2016,2017,Arsenal,Southampton,Win,Home,2016-09-10,3,4,4,7,8,1,2,5,8,3,2,2,0,1,2.0,6.0,-4.0,2
886,886,2016-17,2016,2017,Arsenal,Hull,Win,Away,2016-09-17,3,6,7,7,10,1,4,7,8,5,3,0,2,0,2.0,21.0,-19.0,2
887,887,2016-17,2016,2017,Arsenal,Chelsea,Win,Home,2016-09-24,3,6,9,10,10,1,4,7,10,5,5,3,0,1,2.0,10.0,-8.0,2
888,888,2016-17,2016,2017,Arsenal,Burnley,Win,Away,2016-10-02,3,6,9,12,13,3,4,4,7,3,5,8,6,0,2.0,21.0,-19.0,3
889,889,2016-17,2016,2017,Arsenal,Swansea,Win,Home,2016-10-15,3,6,9,12,15,0,0,1,1,6,9,11,14,1,2.0,12.0,-10.0,3
890,890,2016-17,2016,2017,Arsenal,Middlesbrough,Draw,Home,2016-10-22,1,6,9,12,15,1,1,1,1,5,8,11,14,1,2.0,21.0,-19.0,3
891,891,2016-17,2016,2017,Arsenal,Sunderland,Win,Away,2016-10-29,3,4,7,10,13,0,1,1,1,4,6,9,12,0,2.0,17.0,-15.0,3
892,892,2016-17,2016,2017,Arsenal,Tottenham,Draw,Home,2016-11-06,1,4,7,10,13,2,3,6,9,2,4,4,4,1,2.0,3.0,-1.0,4
893,893,2016-17,2016,2017,Arsenal,Man United,Draw,Away,2016-11-19,1,4,5,8,11,4,4,5,6,0,1,3,5,0,2.0,5.0,-3.0,4
894,894,2016-17,2016,2017,Arsenal,Bournemouth,Win,Home,2016-11-27,3,2,5,6,9,3,3,4,7,-1,2,2,2,1,2.0,16.0,-14.0,4
895,895,2016-17,2016,2017,Arsenal,West Ham,Win,Away,2016-12-03,3,4,5,8,9,1,2,2,5,3,3,6,4,0,2.0,7.0,-5.0,5
896,896,2016-17,2016,2017,Arsenal,Stoke,Win,Home,2016-12-10,3,6,7,8,11,6,6,7,10,0,1,1,1,1,2.0,9.0,-7.0,5
897,897,2016-17,2016,2017,Arsenal,Everton,Loss,Away,2016-12-13,0,6,9,10,11,1,1,2,2,5,8,8,9,0,2.0,11.0,-9.0,5
898,898,2016-17,2016,2017,Arsenal,Man City,Loss,Away,2016-12-18,0,3,6,9,10,3,3,6,9,0,3,3,1,0,2.0,4.0,-2.0,5
899,899,2016-17,2016,2017,Arsenal,West Brom,Win,Home,2016-12-26,3,0,3,6,9,3,3,6,7,-3,0,0,2,1,2.0,14.0,-12.0,5
900,900,2016-17,2016,2017,Arsenal,Crystal Palace,Win,Home,2017-01-01,3,3,3,6,9,1,1,2,5,2,2,4,4,1,2.0,15.0,-13.0,6
901,901,2016-17,2016,2017,Arsenal,Bournemouth,Draw,Away,2017-01-03,1,6,6,6,9,3,3,6,6,3,3,0,3,0,2.0,16.0,-14.0,6
902,902,2016-17,2016,2017,Arsenal,Swansea,Win,Away,2017-01-14,3,4,7,7,7,3,3,3,3,1,4,4,4,0,2.0,12.0,-10.0,6
903,903,2016-17,2016,2017,Arsenal,Burnley,Win,Home,2017-01-22,3,4,7,10,10,3,6,9,9,1,1,1,1,1,2.0,21.0,-19.0,6
904,904,2016-17,2016,2017,Arsenal,Watford,Loss,Home,2017-01-31,0,6,7,10,13,2,2,2,3,4,5,8,10,1,2.0,13.0,-11.0,6
905,905,2016-17,2016,2017,Arsenal,Chelsea,Loss,Away,2017-02-04,0,3,6,7,10,4,7,7,10,-1,-1,0,0,0,2.0,10.0,-8.0,7
906,906,2016-17,2016,2017,Arsenal,Hull,Win,Home,2017-02-11,3,0,3,6,7,4,4,7,7,-4,-1,-1,0,1,2.0,21.0,-19.0,7
907,907,2016-17,2016,2017,Arsenal,Liverpool,Loss,Away,2017-03-04,0,3,3,6,9,3,3,4,4,0,0,2,5,0,2.0,8.0,-6.0,8
908,908,2016-17,2016,2017,Arsenal,West Brom,Loss,Away,2017-03-18,0,3,3,3,6,0,3,4,7,3,0,-1,-1,0,2.0,14.0,-12.0,8
909,909,2016-17,2016,2017,Arsenal,Man City,Draw,Home,2017-04-02,1,0,3,3,3,2,5,8,11,-2,-2,-5,-8,1,2.0,4.0,-2.0,9
910,910,2016-17,2016,2017,Arsenal,West Ham,Win,Home,2017-04-05,3,1,1,4,4,0,0,0,1,1,1,4,3,1,2.0,7.0,-5.0,9
911,911,2016-17,2016,2017,Arsenal,Crystal Palace,Loss,Away,2017-04-10,0,4,4,4,7,3,6,9,12,1,-2,-5,-5,0,2.0,15.0,-13.0,9
912,912,2016-17,2016,2017,Arsenal,Middlesbrough,Win,Away,2017-04-17,3,3,4,4,4,1,2,2,2,2,2,2,2,0,2.0,21.0,-19.0,9
913,913,2016-17,2016,2017,Arsenal,Leicester,Win,Home,2017-04-26,3,3,6,7,7,1,4,7,10,2,2,0,-3,1,2.0,1.0,1.0,9
914,914,2016-17,2016,2017,Arsenal,Tottenham,Loss,Away,2017-04-30,0,6,6,9,10,6,9,12,15,0,-3,-3,-5,0,2.0,3.0,-1.0,9
915,915,2016-17,2016,2017,Arsenal,Man United,Win,Home,2017-05-07,3,3,6,6,9,2,5,8,11,1,1,-2,-2,1,2.0,5.0,-3.0,10
916,916,2016-17,2016,2017,Arsenal,Southampton,Win,Away,2017-05-10,3,3,6,9,9,2,2,2,5,1,4,7,4,0,2.0,6.0,-4.0,10
917,917,2016-17,2016,2017,Arsenal,Stoke,Win,Away,2017-05-13,3,6,6,9,12,2,2,5,5,4,4,4,7,0,2.0,9.0,-7.0,10
918,918,2016-17,2016,2017,Arsenal,Sunderland,Win,Home,2017-05-16,3,6,9,9,12,3,3,3,4,3,6,6,8,1,2.0,17.0,-15.0,10
919,919,2016-17,2016,2017,Arsenal,Everton,Win,Home,2017-05-21,3,6,9,12,12,3,3,4,7,3,6,8,5,1,2.0,11.0,-9.0,10
920,920,2017-18,2017,2018,Arsenal,Leicester,Win,Home,2017-08-11,3,6,9,12,15,1,1,4,7,5,8,8,8,1,5.0,12.0,-7.0,1
921,921,2017-18,2017,2018,Arsenal,Stoke,Loss,Away,2017-08-19,0,6,9,12,15,3,3,4,5,3,6,8,10,0,5.0,13.0,-8.0,1
922,922,2017-18,2017,2018,Arsenal,Liverpool,Loss,Away,2017-08-27,0,3,6,9,12,4,7,10,11,-1,-1,-1,1,0,5.0,4.0,1.0,1
923,923,2017-18,2017,2018,Arsenal,Bournemouth,Win,Home,2017-09-09,3,0,3,6,9,0,0,1,4,0,3,5,5,1,5.0,9.0,-4.0,2
924,924,2017-18,2017,2018,Arsenal,Chelsea,Draw,Away,2017-09-17,1,3,3,6,9,6,9,9,12,-3,-6,-3,-3,0,5.0,1.0,4.0,2
925,925,2017-18,2017,2018,Arsenal,West Brom,Win,Home,2017-09-25,3,4,4,4,7,1,2,5,8,3,2,-1,-1,1,5.0,10.0,-5.0,2
926,926,2017-18,2017,2018,Arsenal,Brighton,Win,Home,2017-10-01,3,4,7,7,7,3,6,7,7,1,1,0,0,1,5.0,21.0,-16.0,3
927,927,2017-18,2017,2018,Arsenal,Watford,Loss,Away,2017-10-14,0,6,7,10,10,4,4,7,8,2,3,3,2,0,5.0,17.0,-12.0,3
928,928,2017-18,2017,2018,Arsenal,Everton,Win,Away,2017-10-22,3,3,6,7,10,1,4,4,4,2,2,3,6,0,5.0,7.0,-2.0,3
929,929,2017-18,2017,2018,Arsenal,Swansea,Win,Home,2017-10-28,3,3,6,9,10,3,3,3,4,0,3,6,6,1,5.0,15.0,-10.0,3
930,930,2017-18,2017,2018,Arsenal,Man City,Loss,Away,2017-11-05,0,6,6,9,12,6,9,12,15,0,-3,-3,-3,0,5.0,3.0,2.0,4
931,931,2017-18,2017,2018,Arsenal,Tottenham,Win,Home,2017-11-18,3,3,6,6,9,3,6,9,12,0,0,-3,-3,1,5.0,2.0,3.0,4
932,932,2017-18,2017,2018,Arsenal,Burnley,Win,Away,2017-11-26,3,3,6,9,9,6,9,9,10,-3,-3,0,-1,0,5.0,16.0,-11.0,4
933,933,2017-18,2017,2018,Arsenal,Huddersfield,Win,Home,2017-11-29,3,6,6,9,12,0,3,3,6,6,3,6,6,1,5.0,21.0,-16.0,4
934,934,2017-18,2017,2018,Arsenal,Man United,Loss,Home,2017-12-02,0,6,9,9,12,6,9,9,12,0,0,0,0,1,5.0,6.0,-1.0,5
935,935,2017-18,2017,2018,Arsenal,Southampton,Draw,Away,2017-12-10,1,3,6,9,9,1,4,4,4,2,2,5,5,0,5.0,8.0,-3.0,5
936,936,2017-18,2017,2018,Arsenal,West Ham,Draw,Away,2017-12-13,1,1,4,7,10,3,3,4,4,-2,1,3,6,0,5.0,11.0,-6.0,5
937,937,2017-18,2017,2018,Arsenal,Newcastle,Win,Home,2017-12-16,3,2,2,5,8,0,0,1,1,2,2,4,7,1,5.0,21.0,-16.0,5
938,938,2017-18,2017,2018,Arsenal,Liverpool,Draw,Home,2017-12-22,1,4,5,5,8,4,5,8,11,0,0,-3,-3,1,5.0,4.0,1.0,5
939,939,2017-18,2017,2018,Arsenal,Crystal Palace,Win,Away,2017-12-28,3,4,5,6,6,4,7,8,9,0,-2,-2,-3,0,5.0,14.0,-9.0,5
940,940,2017-18,2017,2018,Arsenal,West Brom,Draw,Away,2017-12-31,1,4,7,8,9,1,1,2,2,3,6,6,7,0,5.0,10.0,-5.0,5
941,941,2017-18,2017,2018,Arsenal,Chelsea,Draw,Home,2018-01-03,1,4,5,8,9,6,7,10,13,-2,-2,-2,-4,1,5.0,1.0,4.0,6
942,942,2017-18,2017,2018,Arsenal,Bournemouth,Loss,Away,2018-01-14,0,2,5,6,9,4,5,5,5,-2,0,1,4,0,5.0,9.0,-4.0,6
943,943,2017-18,2017,2018,Arsenal,Crystal Palace,Win,Home,2018-01-20,3,1,2,5,6,6,7,7,8,-5,-5,-2,-2,1,5.0,14.0,-9.0,6
944,944,2017-18,2017,2018,Arsenal,Swansea,Loss,Away,2018-01-30,0,3,4,5,8,4,4,7,7,-1,0,-2,1,0,5.0,15.0,-10.0,6
945,945,2017-18,2017,2018,Arsenal,Everton,Win,Home,2018-02-03,3,3,3,4,5,4,4,4,4,-1,-1,0,1,1,5.0,7.0,-2.0,7
946,946,2017-18,2017,2018,Arsenal,Tottenham,Loss,Away,2018-02-10,0,3,6,6,7,4,5,8,9,-1,1,-2,-2,0,5.0,2.0,3.0,7
947,947,2017-18,2017,2018,Arsenal,Man City,Loss,Home,2018-03-01,0,3,3,6,6,4,7,10,10,-1,-4,-4,-4,1,5.0,3.0,2.0,8
948,948,2017-18,2017,2018,Arsenal,Brighton,Loss,Away,2018-03-04,0,0,3,3,6,4,7,8,8,-4,-4,-5,-2,0,5.0,21.0,-16.0,8
949,949,2017-18,2017,2018,Arsenal,Watford,Win,Home,2018-03-11,3,0,0,3,3,6,6,9,10,-6,-6,-6,-7,1,5.0,17.0,-12.0,8
950,950,2017-18,2017,2018,Arsenal,Stoke,Win,Home,2018-04-01,3,3,3,3,6,0,1,2,3,3,2,1,3,1,5.0,13.0,-8.0,9
951,951,2017-18,2017,2018,Arsenal,Southampton,Win,Home,2018-04-08,3,6,6,6,6,0,1,2,2,6,5,4,4,1,5.0,8.0,-3.0,9
952,952,2017-18,2017,2018,Arsenal,Newcastle,Loss,Away,2018-04-15,0,6,9,9,9,6,9,9,10,0,0,0,-1,0,5.0,21.0,-16.0,9
953,953,2017-18,2017,2018,Arsenal,West Ham,Win,Home,2018-04-22,3,3,6,9,9,2,5,5,5,1,1,4,4,1,5.0,11.0,-6.0,9
954,954,2017-18,2017,2018,Arsenal,Man United,Loss,Away,2018-04-29,0,3,6,9,12,3,6,9,12,0,0,0,0,0,5.0,6.0,-1.0,9
955,955,2017-18,2017,2018,Arsenal,Burnley,Win,Home,2018-05-06,3,3,3,6,9,2,2,5,8,1,1,1,1,1,5.0,16.0,-11.0,10
956,956,2017-18,2017,2018,Arsenal,Leicester,Loss,Away,2018-05-09,0,3,6,6,9,0,1,1,1,3,5,5,8,0,5.0,12.0,-7.0,10
957,957,2017-18,2017,2018,Arsenal,Huddersfield,Win,Away,2018-05-13,3,3,3,6,6,2,2,5,6,1,1,1,0,0,5.0,21.0,-16.0,10
958,958,1993-94,1993,1994,Aston Villa,QPR,Win,Home,1993-08-14,3,0,0,0,0,0,0,0,0,0,0,0,0,1,2.0,5.0,-3.0,1
959,959,1993-94,1993,1994,Aston Villa,Sheffield Weds,Draw,Away,1993-08-18,1,3,3,3,3,0,0,0,0,3,3,3,3,0,2.0,7.0,-5.0,1
960,960,1993-94,1993,1994,Aston Villa,Wimbledon,Draw,Away,1993-08-21,1,4,4,4,4,4,4,4,4,0,0,0,0,0,2.0,12.0,-10.0,1
961,961,1993-94,1993,1994,Aston Villa,Man United,Loss,Home,1993-08-23,0,2,5,5,5,4,7,7,7,-2,-2,-2,-2,1,2.0,1.0,1.0,1
962,962,1993-94,1993,1994,Aston Villa,Tottenham,Win,Home,1993-08-28,3,1,2,5,5,6,6,9,9,-5,-4,-4,-4,1,2.0,8.0,-6.0,1
963,963,1993-94,1993,1994,Aston Villa,Everton,Win,Away,1993-08-31,3,3,4,5,8,0,3,6,9,3,1,-1,-1,0,2.0,13.0,-11.0,1
964,964,1993-94,1993,1994,Aston Villa,Coventry,Draw,Home,1993-09-11,1,6,6,7,8,4,5,6,9,2,1,1,-1,1,2.0,15.0,-13.0,2
965,965,1993-94,1993,1994,Aston Villa,Ipswich,Win,Away,1993-09-18,3,4,7,7,8,1,2,2,5,3,5,5,3,0,2.0,16.0,-14.0,2
966,966,1993-94,1993,1994,Aston Villa,Oldham,Draw,Away,1993-09-25,1,4,7,10,10,0,0,1,2,4,7,9,8,0,2.0,19.0,-17.0,2
967,967,1993-94,1993,1994,Aston Villa,Newcastle,Loss,Home,1993-10-02,0,4,5,8,11,4,7,8,9,0,-2,0,2,1,2.0,21.0,-19.0,3
968,968,1993-94,1993,1994,Aston Villa,West Ham,Draw,Away,1993-10-16,1,1,4,5,8,3,6,7,7,-2,-2,-2,1,0,2.0,21.0,-19.0,3
969,969,1993-94,1993,1994,Aston Villa,Chelsea,Win,Home,1993-10-23,3,1,2,5,6,0,3,4,7,1,-1,1,-1,1,2.0,11.0,-9.0,3
970,970,1993-94,1993,1994,Aston Villa,Swindon,Win,Away,1993-10-30,3,4,4,5,8,2,2,2,3,2,2,3,5,0,2.0,21.0,-19.0,3
971,971,1993-94,1993,1994,Aston Villa,Arsenal,Win,Away,1993-11-06,3,6,7,7,8,2,3,4,7,4,4,3,1,0,2.0,10.0,-8.0,4
972,972,1993-94,1993,1994,Aston Villa,Sheffield United,Win,Home,1993-11-20,3,6,9,10,10,1,2,3,4,5,7,7,6,1,2.0,14.0,-12.0,4
973,973,1993-94,1993,1994,Aston Villa,Southampton,Loss,Home,1993-11-24,0,6,9,12,13,3,3,6,7,3,6,6,6,1,2.0,18.0,-16.0,4
974,974,1993-94,1993,1994,Aston Villa,Liverpool,Loss,Away,1993-11-28,0,3,6,9,12,3,6,7,10,0,0,2,2,0,2.0,6.0,-4.0,4
975,975,1993-94,1993,1994,Aston Villa,QPR,Draw,Away,1993-12-04,1,0,3,6,9,1,4,7,7,-1,-1,-1,2,0,2.0,5.0,-3.0,5
976,976,1993-94,1993,1994,Aston Villa,Sheffield Weds,Draw,Home,1993-12-08,1,1,1,4,7,6,9,10,13,-5,-8,-6,-6,1,2.0,7.0,-5.0,5
977,977,1993-94,1993,1994,Aston Villa,Wimbledon,Loss,Home,1993-12-11,0,2,2,2,5,1,2,2,5,1,0,0,0,1,2.0,12.0,-10.0,5
978,978,1993-94,1993,1994,Aston Villa,Man United,Loss,Away,1993-12-19,0,1,2,2,2,4,5,8,9,-3,-3,-6,-7,0,2.0,1.0,1.0,5
979,979,1993-94,1993,1994,Aston Villa,Norwich,Win,Away,1993-12-29,3,0,1,2,2,3,6,7,7,-3,-5,-5,-5,0,2.0,3.0,-1.0,5
980,980,1993-94,1993,1994,Aston Villa,Blackburn,Loss,Home,1994-01-01,0,3,3,4,5,4,7,10,13,-1,-4,-6,-8,1,2.0,4.0,-2.0,6
981,981,1993-94,1993,1994,Aston Villa,West Ham,Win,Home,1994-01-15,3,3,3,3,4,4,4,5,5,-1,-1,-2,-1,1,2.0,21.0,-19.0,6
982,982,1993-94,1993,1994,Aston Villa,Chelsea,Draw,Away,1994-01-22,1,3,6,6,6,4,7,10,10,-1,-1,-4,-4,0,2.0,11.0,-9.0,6
983,983,1993-94,1993,1994,Aston Villa,Leeds,Win,Home,1994-02-06,3,4,4,7,7,1,2,3,4,3,2,4,3,1,2.0,17.0,-15.0,7
984,984,1993-94,1993,1994,Aston Villa,Swindon,Win,Home,1994-02-12,3,4,7,7,10,6,6,7,7,-2,1,0,3,1,2.0,21.0,-19.0,7
985,985,1993-94,1993,1994,Aston Villa,Man City,Draw,Home,1994-02-22,1,6,7,10,10,1,4,4,5,5,3,6,5,1,2.0,9.0,-7.0,7
986,986,1993-94,1993,1994,Aston Villa,Tottenham,Draw,Away,1994-03-02,1,4,7,8,11,0,0,0,0,4,7,8,11,0,2.0,8.0,-6.0,8
987,987,1993-94,1993,1994,Aston Villa,Coventry,Win,Away,1994-03-06,3,2,5,8,9,0,3,4,4,2,2,4,5,0,2.0,15.0,-13.0,8
988,988,1993-94,1993,1994,Aston Villa,Ipswich,Loss,Home,1994-03-12,0,4,5,8,11,3,4,4,4,1,1,4,7,1,2.0,16.0,-14.0,8
989,989,1993-94,1993,1994,Aston Villa,Leeds,Loss,Away,1994-03-16,0,3,4,5,8,2,3,6,6,1,1,-1,2,0,2.0,17.0,-15.0,8
990,990,1993-94,1993,1994,Aston Villa,Oldham,Loss,Home,1994-03-19,0,0,3,4,5,1,4,7,8,-1,-1,-3,-3,1,2.0,19.0,-17.0,8
991,991,1993-94,1993,1994,Aston Villa,Everton,Draw,Home,1994-03-30,1,0,0,3,4,0,0,3,4,0,0,0,0,1,2.0,13.0,-11.0,8
992,992,1993-94,1993,1994,Aston Villa,Man City,Loss,Away,1994-04-02,0,1,1,1,4,2,3,3,4,-1,-2,-2,0,0,2.0,9.0,-7.0,9
993,993,1993-94,1993,1994,Aston Villa,Norwich,Draw,Home,1994-04-04,1,1,1,1,1,0,0,3,3,1,1,-2,-2,1,2.0,3.0,-1.0,9
994,994,1993-94,1993,1994,Aston Villa,Blackburn,Loss,Away,1994-04-11,0,1,2,2,2,6,6,9,12,-5,-4,-7,-10,0,2.0,4.0,-2.0,9
995,995,1993-94,1993,1994,Aston Villa,Sheffield United,Win,Away,1994-04-16,3,1,1,2,2,4,7,8,9,-3,-6,-6,-7,0,2.0,14.0,-12.0,9
996,996,1993-94,1993,1994,Aston Villa,Arsenal,Loss,Home,1994-04-23,0,3,4,4,5,4,5,6,9,-1,-1,-2,-4,1,2.0,10.0,-8.0,9
997,997,1993-94,1993,1994,Aston Villa,Newcastle,Loss,Away,1994-04-27,0,3,3,4,4,6,6,7,8,-3,-3,-3,-4,0,2.0,21.0,-19.0,9
998,998,1993-94,1993,1994,Aston Villa,Southampton,Loss,Away,1994-04-30,0,0,3,3,4,3,6,6,6,-3,-3,-3,-2,0,2.0,18.0,-16.0,9
999,999,1993-94,1993,1994,Aston Villa,Liverpool,Win,Home,1994-05-07,3,0,0,3,3,3,3,6,7,-3,-3,-3,-4,1,2.0,6.0,-4.0,10
1000,1000,1994-95,1994,1995,Aston Villa,Everton,Draw,Away,1994-08-20,1,3,3,3,6,3,4,4,7,0,-1,-1,-1,0,10.0,17.0,-7.0,1
1001,1001,1994-95,1994,1995,Aston Villa,Southampton,Draw,Home,1994-08-24,1,4,4,4,4,2,2,5,5,2,2,-1,-1,1,10.0,18.0,-8.0,1
1002,1002,1994-95,1994,1995,Aston Villa,Crystal Palace,Draw,Home,1994-08-27,1,2,5,5,5,1,1,1,1,1,4,4,4,1,10.0,21.0,-11.0,1
1003,1003,1994-95,1994,1995,Aston Villa,Coventry,Win,Away,1994-08-29,3,2,3,6,6,0,1,2,5,2,2,4,1,0,10.0,11.0,-1.0,1
1004,1004,1994-95,1994,1995,Aston Villa,Ipswich,Win,Home,1994-09-10,3,4,5,6,9,3,4,4,5,1,1,2,4,1,10.0,19.0,-9.0,2
1005,1005,1994-95,1994,1995,Aston Villa,West Ham,Loss,Away,1994-09-17,0,6,7,8,9,1,1,1,2,5,6,7,7,0,10.0,13.0,-3.0,2
1006,1006,1994-95,1994,1995,Aston Villa,Blackburn,Loss,Away,1994-09-24,0,3,6,7,8,6,7,10,13,-3,-1,-3,-5,0,10.0,2.0,8.0,2
1007,1007,1994-95,1994,1995,Aston Villa,Newcastle,Loss,Home,1994-10-01,0,0,3,6,7,4,7,10,13,-4,-4,-4,-6,1,10.0,3.0,7.0,3
1008,1008,1994-95,1994,1995,Aston Villa,Liverpool,Loss,Away,1994-10-08,0,0,0,3,6,4,4,5,8,-4,-4,-2,-2,0,10.0,8.0,2.0,3
1009,1009,1994-95,1994,1995,Aston Villa,Norwich,Draw,Home,1994-10-15,1,0,0,0,3,6,6,9,10,-6,-6,-9,-7,1,10.0,12.0,-2.0,3
1010,1010,1994-95,1994,1995,Aston Villa,Nott'm Forest,Loss,Home,1994-10-22,0,1,1,1,1,4,7,10,11,-3,-6,-9,-10,1,10.0,21.0,-11.0,3
1011,1011,1994-95,1994,1995,Aston Villa,QPR,Loss,Away,1994-10-29,0,1,1,1,1,0,1,1,1,1,0,0,0,0,10.0,9.0,1.0,3
1012,1012,1994-95,1994,1995,Aston Villa,Man United,Loss,Home,1994-11-06,0,0,1,1,1,6,9,9,12,-6,-8,-8,-11,1,10.0,1.0,9.0,4
1013,1013,1994-95,1994,1995,Aston Villa,Wimbledon,Loss,Away,1994-11-09,0,0,0,1,1,3,3,3,3,-3,-3,-2,-2,0,10.0,6.0,4.0,4
1014,1014,1994-95,1994,1995,Aston Villa,Tottenham,Win,Away,1994-11-19,3,0,0,0,1,3,3,4,5,-3,-3,-4,-4,0,10.0,15.0,-5.0,4
1015,1015,1994-95,1994,1995,Aston Villa,Sheffield Weds,Draw,Home,1994-11-27,1,3,3,3,3,4,4,5,5,-1,-1,-2,-2,1,10.0,7.0,3.0,4
1016,1016,1994-95,1994,1995,Aston Villa,Leicester,Draw,Away,1994-12-03,1,4,4,4,4,3,3,3,3,1,1,1,1,0,10.0,21.0,-11.0,5
1017,1017,1994-95,1994,1995,Aston Villa,Everton,Draw,Home,1994-12-10,1,2,5,5,5,6,9,10,13,-4,-4,-5,-8,1,10.0,17.0,-7.0,5
1018,1018,1994-95,1994,1995,Aston Villa,Southampton,Loss,Away,1994-12-19,0,2,3,6,6,0,1,4,5,2,2,2,1,0,10.0,18.0,-8.0,5
1019,1019,1994-95,1994,1995,Aston Villa,Arsenal,Draw,Away,1994-12-26,1,1,2,3,6,3,4,5,5,-2,-2,-2,1,0,10.0,4.0,6.0,5
1020,1020,1994-95,1994,1995,Aston Villa,Chelsea,Win,Home,1994-12-28,3,1,2,3,4,1,1,4,4,0,1,-1,0,1,10.0,14.0,-4.0,5
1021,1021,1994-95,1994,1995,Aston Villa,Man City,Draw,Away,1994-12-31,1,4,4,5,6,0,0,0,3,4,4,5,3,0,10.0,16.0,-6.0,5
1022,1022,1994-95,1994,1995,Aston Villa,Leeds,Draw,Home,1995-01-02,1,4,5,5,6,1,4,5,5,3,1,0,1,1,10.0,5.0,5.0,6
1023,1023,1994-95,1994,1995,Aston Villa,QPR,Win,Home,1995-01-14,3,2,5,6,6,4,5,8,8,-2,0,-2,-2,1,10.0,9.0,1.0,6
1024,1024,1994-95,1994,1995,Aston Villa,Nott'm Forest,Win,Away,1995-01-21,3,4,5,8,9,3,3,6,7,1,2,2,2,0,10.0,21.0,-11.0,6
1025,1025,1994-95,1994,1995,Aston Villa,Tottenham,Win,Home,1995-01-25,3,6,7,8,11,6,9,10,13,0,-2,-2,-2,1,10.0,15.0,-5.0,6
1026,1026,1994-95,1994,1995,Aston Villa,Man United,Loss,Away,1995-02-04,0,6,9,10,11,4,5,8,9,2,4,2,2,0,10.0,1.0,9.0,7
1027,1027,1994-95,1994,1995,Aston Villa,Wimbledon,Win,Home,1995-02-11,3,3,6,9,10,1,4,7,8,2,2,2,2,1,10.0,6.0,4.0,7
1028,1028,1994-95,1994,1995,Aston Villa,Sheffield Weds,Win,Away,1995-02-18,3,3,6,9,12,3,6,7,8,0,0,2,4,0,10.0,7.0,3.0,7
1029,1029,1994-95,1994,1995,Aston Villa,Leicester,Draw,Home,1995-02-22,1,6,6,9,12,1,4,4,4,5,2,5,8,1,10.0,21.0,-11.0,7
1030,1030,1994-95,1994,1995,Aston Villa,Newcastle,Loss,Away,1995-02-25,0,4,7,7,10,3,6,9,10,1,1,-2,0,0,10.0,3.0,7.0,7
1031,1031,1994-95,1994,1995,Aston Villa,Blackburn,Loss,Home,1995-03-04,0,1,4,7,7,4,7,7,8,-3,-3,0,-1,1,10.0,2.0,8.0,8
1032,1032,1994-95,1994,1995,Aston Villa,Coventry,Draw,Home,1995-03-06,1,0,1,4,7,4,7,10,11,-4,-6,-6,-4,1,10.0,11.0,-1.0,8
1033,1033,1994-95,1994,1995,Aston Villa,West Ham,Loss,Home,1995-03-18,0,1,1,2,5,2,2,5,5,-1,-1,-3,0,1,10.0,13.0,-3.0,8
1034,1034,1994-95,1994,1995,Aston Villa,Ipswich,Win,Away,1995-04-01,3,1,1,1,2,0,0,0,3,1,1,1,-1,0,10.0,19.0,-9.0,9
1035,1035,1994-95,1994,1995,Aston Villa,Crystal Palace,Draw,Away,1995-04-04,1,3,4,4,4,3,6,7,7,0,-2,-3,-3,0,10.0,21.0,-11.0,9
1036,1036,1994-95,1994,1995,Aston Villa,Chelsea,Loss,Away,1995-04-15,0,4,4,5,5,1,2,2,2,3,2,3,3,0,10.0,14.0,-4.0,9
1037,1037,1994-95,1994,1995,Aston Villa,Arsenal,Loss,Home,1995-04-17,0,1,4,4,5,3,3,6,6,-2,1,-2,-1,1,10.0,4.0,6.0,9
1038,1038,1994-95,1994,1995,Aston Villa,Leeds,Loss,Away,1995-04-29,0,0,1,4,4,4,7,10,11,-4,-6,-6,-7,0,10.0,5.0,5.0,9
1039,1039,1994-95,1994,1995,Aston Villa,Man City,Draw,Home,1995-05-03,1,0,0,1,4,4,7,7,7,-4,-7,-6,-3,1,10.0,16.0,-6.0,10
1040,1040,1994-95,1994,1995,Aston Villa,Liverpool,Win,Home,1995-05-06,3,1,1,1,2,4,7,7,10,-3,-6,-6,-8,1,10.0,8.0,2.0,10
1041,1041,1994-95,1994,1995,Aston Villa,Norwich,Draw,Away,1995-05-14,1,4,4,4,4,0,0,0,0,4,4,4,4,0,10.0,12.0,-2.0,10
1042,1042,1995-96,1995,1996,Aston Villa,Man United,Win,Home,1995-08-19,3,4,5,5,5,4,7,10,11,0,-2,-5,-6,1,18.0,2.0,16.0,1
1043,1043,1995-96,1995,1996,Aston Villa,Tottenham,Win,Away,1995-08-23,3,4,7,8,8,2,2,2,3,2,5,6,5,0,18.0,7.0,11.0,1
1044,1044,1995-96,1995,1996,Aston Villa,Leeds,Loss,Away,1995-08-26,0,6,7,10,11,6,7,10,13,0,0,0,-2,0,18.0,5.0,13.0,1
1045,1045,1995-96,1995,1996,Aston Villa,Bolton,Win,Home,1995-08-30,3,3,6,7,10,3,3,3,3,0,3,4,7,1,18.0,21.0,-3.0,1
1046,1046,1995-96,1995,1996,Aston Villa,Blackburn,Draw,Away,1995-09-09,1,3,6,9,10,0,0,3,3,3,6,6,7,0,18.0,1.0,17.0,2
1047,1047,1995-96,1995,1996,Aston Villa,Wimbledon,Win,Home,1995-09-16,3,4,4,7,10,4,4,7,10,0,0,0,0,1,18.0,9.0,9.0,2
1048,1048,1995-96,1995,1996,Aston Villa,Nott'm Forest,Draw,Home,1995-09-23,1,4,7,7,10,4,5,6,7,0,2,1,3,1,18.0,3.0,15.0,2
1049,1049,1995-96,1995,1996,Aston Villa,Coventry,Win,Away,1995-09-30,3,4,5,8,8,0,1,2,3,4,4,6,5,0,18.0,16.0,2.0,2
1050,1050,1995-96,1995,1996,Aston Villa,Chelsea,Loss,Home,1995-10-14,0,4,7,8,11,3,6,9,10,1,1,-1,1,1,18.0,11.0,7.0,3
1051,1051,1995-96,1995,1996,Aston Villa,Arsenal,Loss,Away,1995-10-21,0,3,4,7,8,3,6,9,12,0,-2,-2,-4,0,18.0,12.0,6.0,3
1052,1052,1995-96,1995,1996,Aston Villa,Everton,Win,Home,1995-10-28,3,0,3,4,7,2,2,2,2,-2,1,2,5,1,18.0,15.0,3.0,3
1053,1053,1995-96,1995,1996,Aston Villa,West Ham,Win,Away,1995-11-04,3,3,3,6,7,4,7,8,11,-1,-4,-2,-4,0,18.0,14.0,4.0,4
1054,1054,1995-96,1995,1996,Aston Villa,Newcastle,Draw,Home,1995-11-18,1,6,6,6,9,6,7,10,13,0,-1,-4,-4,1,18.0,6.0,12.0,4
1055,1055,1995-96,1995,1996,Aston Villa,Southampton,Win,Away,1995-11-20,3,4,7,7,7,3,6,6,6,1,1,1,1,0,18.0,10.0,8.0,4
1056,1056,1995-96,1995,1996,Aston Villa,Man City,Loss,Away,1995-11-25,0,4,7,10,10,4,7,7,8,0,0,3,2,0,18.0,17.0,1.0,4
1057,1057,1995-96,1995,1996,Aston Villa,Arsenal,Draw,Home,1995-12-02,1,3,4,7,10,4,4,7,7,-1,0,0,3,1,18.0,12.0,6.0,5
1058,1058,1995-96,1995,1996,Aston Villa,Nott'm Forest,Draw,Away,1995-12-10,1,1,4,5,8,2,2,5,6,-1,2,0,2,0,18.0,3.0,15.0,5
1059,1059,1995-96,1995,1996,Aston Villa,Coventry,Win,Home,1995-12-16,3,2,2,5,6,3,4,4,5,-1,-2,1,1,1,18.0,16.0,2.0,5
1060,1060,1995-96,1995,1996,Aston Villa,QPR,Loss,Away,1995-12-23,0,4,5,5,8,3,4,4,4,1,1,1,4,0,18.0,8.0,10.0,5
1061,1061,1995-96,1995,1996,Aston Villa,Middlesbrough,Win,Away,1996-01-01,3,3,4,5,5,0,3,3,6,3,1,2,-1,0,18.0,21.0,-3.0,6
1062,1062,1995-96,1995,1996,Aston Villa,Man United,Draw,Away,1996-01-13,1,3,6,7,8,3,6,6,6,0,0,1,2,0,18.0,2.0,16.0,6
1063,1063,1995-96,1995,1996,Aston Villa,Tottenham,Win,Home,1996-01-21,3,4,4,7,8,6,6,7,8,-2,-2,0,0,1,18.0,7.0,11.0,6
1064,1064,1995-96,1995,1996,Aston Villa,Liverpool,Loss,Home,1996-01-31,0,4,7,7,10,4,7,8,11,0,0,-1,-1,1,18.0,4.0,14.0,6
1065,1065,1995-96,1995,1996,Aston Villa,Leeds,Win,Home,1996-02-03,3,3,4,7,7,0,3,4,4,3,1,3,3,1,18.0,5.0,13.0,7
1066,1066,1995-96,1995,1996,Aston Villa,Bolton,Win,Away,1996-02-10,3,3,6,7,10,0,3,3,3,3,3,4,7,0,18.0,21.0,-3.0,7
1067,1067,1995-96,1995,1996,Aston Villa,Wimbledon,Draw,Away,1996-02-24,1,6,6,9,10,0,3,3,3,6,3,6,7,0,18.0,9.0,9.0,7
1068,1068,1995-96,1995,1996,Aston Villa,Blackburn,Win,Home,1996-02-28,3,4,7,7,10,0,3,6,9,4,4,1,1,1,18.0,1.0,17.0,7
1069,1069,1995-96,1995,1996,Aston Villa,Liverpool,Loss,Away,1996-03-03,0,4,7,10,10,6,7,10,13,-2,0,0,-3,0,18.0,4.0,14.0,8
1070,1070,1995-96,1995,1996,Aston Villa,Sheffield Weds,Win,Home,1996-03-06,3,3,4,7,10,0,0,3,3,3,4,4,7,1,18.0,13.0,5.0,8
1071,1071,1995-96,1995,1996,Aston Villa,QPR,Win,Home,1996-03-09,3,3,6,7,10,1,4,4,4,2,2,3,6,1,18.0,8.0,10.0,8
1072,1072,1995-96,1995,1996,Aston Villa,Sheffield Weds,Loss,Away,1996-03-16,0,6,6,9,10,0,0,0,3,6,6,9,7,0,18.0,13.0,5.0,8
1073,1073,1995-96,1995,1996,Aston Villa,Middlesbrough,Draw,Home,1996-03-19,1,3,6,6,9,1,1,2,2,2,5,4,7,1,18.0,21.0,-3.0,8
1074,1074,1995-96,1995,1996,Aston Villa,Chelsea,Win,Away,1996-04-06,3,1,4,7,7,1,2,3,6,0,2,4,1,0,18.0,11.0,7.0,9
1075,1075,1995-96,1995,1996,Aston Villa,Southampton,Win,Home,1996-04-08,3,4,4,7,10,3,3,6,6,1,1,1,4,1,18.0,10.0,8.0,9
1076,1076,1995-96,1995,1996,Aston Villa,Newcastle,Loss,Away,1996-04-14,0,6,7,7,10,3,3,3,6,3,4,4,4,0,18.0,6.0,12.0,9
1077,1077,1995-96,1995,1996,Aston Villa,West Ham,Draw,Home,1996-04-17,1,3,6,7,7,3,4,7,7,0,2,0,0,1,18.0,14.0,4.0,9
1078,1078,1995-96,1995,1996,Aston Villa,Man City,Loss,Home,1996-04-27,0,1,4,7,8,3,3,4,4,-2,1,3,4,1,18.0,17.0,1.0,9
1079,1079,1995-96,1995,1996,Aston Villa,Everton,Loss,Away,1996-05-04,0,1,1,4,7,4,4,7,10,-3,-3,-3,-3,0,18.0,15.0,3.0,10
1080,1080,1996-97,1996,1997,Aston Villa,Sheffield Weds,Loss,Away,1996-08-17,0,0,1,1,4,1,2,2,5,-1,-1,-1,-1,0,4.0,15.0,-11.0,1
1081,1081,1996-97,1996,1997,Aston Villa,Blackburn,Win,Home,1996-08-21,3,0,0,1,1,3,4,7,10,-3,-4,-6,-9,1,4.0,7.0,-3.0,1
1082,1082,1996-97,1996,1997,Aston Villa,Derby,Win,Home,1996-08-24,3,3,3,3,4,2,2,2,2,1,1,1,2,1,4.0,21.0,-17.0,1
1083,1083,1996-97,1996,1997,Aston Villa,Everton,Win,Away,1996-09-04,3,6,6,6,6,2,5,8,11,4,1,-2,-5,0,4.0,6.0,-2.0,2
1084,1084,1996-97,1996,1997,Aston Villa,Arsenal,Draw,Home,1996-09-07,1,6,9,9,9,4,4,7,10,2,5,2,-1,1,4.0,5.0,-1.0,2
1085,1085,1996-97,1996,1997,Aston Villa,Chelsea,Draw,Away,1996-09-15,1,4,7,10,10,4,7,10,11,0,0,0,-1,0,4.0,11.0,-7.0,2
1086,1086,1996-97,1996,1997,Aston Villa,Man United,Draw,Home,1996-09-21,1,2,5,8,11,6,7,8,9,-4,-2,0,2,1,4.0,1.0,3.0,2
1087,1087,1996-97,1996,1997,Aston Villa,Newcastle,Loss,Away,1996-09-30,0,2,3,6,9,6,9,12,12,-4,-6,-6,-3,0,4.0,2.0,2.0,2
1088,1088,1996-97,1996,1997,Aston Villa,Tottenham,Loss,Away,1996-10-12,0,1,2,3,6,0,3,3,3,1,-1,0,3,0,4.0,8.0,-4.0,3
1089,1089,1996-97,1996,1997,Aston Villa,Leeds,Win,Home,1996-10-19,3,0,1,2,3,3,3,3,3,-3,-2,-1,0,1,4.0,13.0,-9.0,3
1090,1090,1996-97,1996,1997,Aston Villa,Sunderland,Loss,Away,1996-10-26,0,3,3,4,5,1,1,4,4,2,2,0,1,0,4.0,21.0,-17.0,3
1091,1091,1996-97,1996,1997,Aston Villa,Nott'm Forest,Win,Home,1996-11-02,3,3,3,3,4,1,1,2,2,2,2,1,2,1,4.0,9.0,-5.0,4
1092,1092,1996-97,1996,1997,Aston Villa,Leicester,Loss,Home,1996-11-16,0,3,6,6,6,3,3,3,6,0,3,3,0,1,4.0,21.0,-17.0,4
1093,1093,1996-97,1996,1997,Aston Villa,Coventry,Win,Away,1996-11-23,3,3,3,6,6,2,3,4,5,1,0,2,1,0,4.0,16.0,-12.0,4
1094,1094,1996-97,1996,1997,Aston Villa,Middlesbrough,Win,Home,1996-11-30,3,3,6,6,9,1,1,2,2,2,5,4,7,1,4.0,12.0,-8.0,4
1095,1095,1996-97,1996,1997,Aston Villa,West Ham,Win,Away,1996-12-04,3,6,6,9,9,2,3,3,6,4,3,6,3,0,4.0,10.0,-6.0,5
1096,1096,1996-97,1996,1997,Aston Villa,Southampton,Win,Away,1996-12-07,3,6,9,9,12,0,0,0,1,6,9,9,11,0,4.0,17.0,-13.0,5
1097,1097,1996-97,1996,1997,Aston Villa,Wimbledon,Win,Home,1996-12-22,3,6,9,12,12,6,9,10,11,0,0,2,1,1,4.0,14.0,-10.0,5
1098,1098,1996-97,1996,1997,Aston Villa,Chelsea,Loss,Home,1996-12-26,0,6,9,12,15,3,4,4,5,3,5,8,10,1,4.0,11.0,-7.0,5
1099,1099,1996-97,1996,1997,Aston Villa,Arsenal,Draw,Away,1996-12-28,1,3,6,9,12,1,2,5,8,2,4,4,4,0,4.0,5.0,-1.0,5
1100,1100,1996-97,1996,1997,Aston Villa,Man United,Draw,Away,1997-01-01,1,1,4,7,10,6,9,10,11,-5,-5,-3,-1,0,4.0,1.0,3.0,6
1101,1101,1996-97,1996,1997,Aston Villa,Newcastle,Draw,Home,1997-01-11,1,2,2,5,8,6,6,7,7,-4,-4,-2,1,1,4.0,2.0,2.0,6
1102,1102,1996-97,1996,1997,Aston Villa,Liverpool,Loss,Away,1997-01-18,0,2,3,3,6,1,4,5,6,1,-1,-2,0,0,4.0,3.0,1.0,6
1103,1103,1996-97,1996,1997,Aston Villa,Sheffield Weds,Loss,Home,1997-01-29,0,1,2,3,3,3,4,5,6,-2,-2,-2,-3,1,4.0,15.0,-11.0,6
1104,1104,1996-97,1996,1997,Aston Villa,Sunderland,Win,Home,1997-02-01,3,0,1,2,3,2,5,6,6,-2,-4,-4,-3,1,4.0,21.0,-17.0,7
1105,1105,1996-97,1996,1997,Aston Villa,Coventry,Win,Home,1997-02-19,3,3,3,4,5,4,4,4,5,-1,-1,0,0,1,4.0,16.0,-12.0,7
1106,1106,1996-97,1996,1997,Aston Villa,Nott'm Forest,Draw,Away,1997-02-22,1,6,6,6,7,0,3,6,9,6,3,0,-2,0,4.0,9.0,-5.0,7
1107,1107,1996-97,1996,1997,Aston Villa,Liverpool,Win,Home,1997-03-02,3,4,7,7,7,4,7,10,11,0,0,-3,-4,1,4.0,3.0,1.0,8
1108,1108,1996-97,1996,1997,Aston Villa,Leicester,Loss,Away,1997-03-05,0,4,7,10,10,6,6,7,10,-2,1,3,0,0,4.0,21.0,-17.0,8
1109,1109,1996-97,1996,1997,Aston Villa,West Ham,Draw,Home,1997-03-15,1,3,4,7,10,3,6,6,6,0,-2,1,4,1,4.0,10.0,-6.0,8
1110,1110,1996-97,1996,1997,Aston Villa,Blackburn,Win,Away,1997-03-22,3,1,4,5,8,3,4,5,8,-2,0,0,0,0,4.0,7.0,-3.0,8
1111,1111,1996-97,1996,1997,Aston Villa,Everton,Win,Home,1997-04-05,3,4,4,7,8,3,3,4,4,1,1,3,4,1,4.0,6.0,-2.0,9
1112,1112,1996-97,1996,1997,Aston Villa,Wimbledon,Win,Away,1997-04-09,3,6,7,7,10,1,2,2,3,5,5,5,7,0,4.0,14.0,-10.0,9
1113,1113,1996-97,1996,1997,Aston Villa,Derby,Loss,Away,1997-04-12,0,6,9,10,10,4,7,7,7,2,2,3,3,0,4.0,21.0,-17.0,9
1114,1114,1996-97,1996,1997,Aston Villa,Tottenham,Draw,Home,1997-04-19,1,3,6,9,10,0,3,3,4,3,3,6,6,1,4.0,8.0,-4.0,9
1115,1115,1996-97,1996,1997,Aston Villa,Leeds,Draw,Away,1997-04-22,1,1,4,7,10,1,2,3,3,0,2,4,7,0,4.0,13.0,-9.0,9
1116,1116,1996-97,1996,1997,Aston Villa,Middlesbrough,Loss,Away,1997-05-03,0,2,2,5,8,0,1,2,5,2,1,3,3,0,4.0,12.0,-8.0,10
1117,1117,1996-97,1996,1997,Aston Villa,Southampton,Win,Home,1997-05-11,3,1,2,2,5,6,7,10,11,-5,-5,-8,-6,1,4.0,17.0,-13.0,10
1118,1118,1997-98,1997,1998,Aston Villa,Leicester,Loss,Away,1997-08-09,0,3,4,5,5,6,7,7,7,-3,-3,-2,-2,0,5.0,9.0,-4.0,1
1119,1119,1997-98,1997,1998,Aston Villa,Blackburn,Loss,Home,1997-08-13,0,3,3,4,5,3,4,4,7,0,-1,0,-2,1,5.0,13.0,-8.0,1
1120,1120,1997-98,1997,1998,Aston Villa,Newcastle,Loss,Away,1997-08-23,0,0,3,3,4,6,7,8,11,-6,-4,-5,-7,0,5.0,2.0,3.0,1
1121,1121,1997-98,1997,1998,Aston Villa,Tottenham,Loss,Away,1997-08-27,0,0,0,3,3,3,3,3,3,-3,-3,0,0,0,5.0,10.0,-5.0,1
1122,1122,1997-98,1997,1998,Aston Villa,Leeds,Win,Home,1997-08-30,3,0,0,0,3,0,3,4,5,0,-3,-4,-2,1,5.0,11.0,-6.0,1
1123,1123,1997-98,1997,1998,Aston Villa,Barnsley,Win,Away,1997-09-13,3,3,3,3,3,3,3,6,6,0,0,-3,-3,0,5.0,21.0,-16.0,2
1124,1124,1997-98,1997,1998,Aston Villa,Derby,Win,Home,1997-09-20,3,6,6,6,6,6,6,6,6,0,0,0,0,1,5.0,12.0,-7.0,2
1125,1125,1997-98,1997,1998,Aston Villa,Liverpool,Loss,Away,1997-09-22,0,6,9,9,9,4,7,8,8,2,2,1,1,0,5.0,4.0,1.0,2
1126,1126,1997-98,1997,1998,Aston Villa,Sheffield Weds,Draw,Home,1997-09-27,1,3,6,9,9,1,1,4,4,2,5,5,5,1,5.0,7.0,-2.0,2
1127,1127,1997-98,1997,1998,Aston Villa,Bolton,Win,Away,1997-10-04,3,1,4,7,10,2,3,3,4,-1,1,4,6,0,5.0,21.0,-16.0,3
1128,1128,1997-98,1997,1998,Aston Villa,Wimbledon,Loss,Home,1997-10-18,0,4,4,7,10,1,4,4,7,3,0,3,3,1,5.0,8.0,-3.0,3
1129,1129,1997-98,1997,1998,Aston Villa,Arsenal,Draw,Away,1997-10-26,1,3,4,4,7,4,5,8,11,-1,-1,-4,-4,0,5.0,3.0,2.0,3
1130,1130,1997-98,1997,1998,Aston Villa,Chelsea,Loss,Home,1997-11-01,0,1,4,5,5,3,3,6,7,-2,1,-1,-2,1,5.0,6.0,-1.0,4
1131,1131,1997-98,1997,1998,Aston Villa,Crystal Palace,Draw,Away,1997-11-08,1,1,1,4,5,4,4,5,6,-3,-3,-1,-1,0,5.0,21.0,-16.0,4
1132,1132,1997-98,1997,1998,Aston Villa,Everton,Win,Home,1997-11-22,3,1,2,2,5,0,1,4,4,1,1,-2,1,1,5.0,15.0,-10.0,4
1133,1133,1997-98,1997,1998,Aston Villa,West Ham,Loss,Away,1997-11-29,0,4,4,5,5,0,0,3,3,4,4,2,2,0,5.0,14.0,-9.0,4
1134,1134,1997-98,1997,1998,Aston Villa,Coventry,Win,Home,1997-12-06,3,3,4,4,5,0,1,4,5,3,3,0,0,1,5.0,17.0,-12.0,5
1135,1135,1997-98,1997,1998,Aston Villa,Man United,Loss,Away,1997-12-15,0,3,6,7,7,6,9,9,12,-3,-3,-2,-5,0,5.0,1.0,4.0,5
1136,1136,1997-98,1997,1998,Aston Villa,Southampton,Draw,Home,1997-12-20,1,3,3,6,7,3,3,3,6,0,0,3,1,1,5.0,16.0,-11.0,5
1137,1137,1997-98,1997,1998,Aston Villa,Tottenham,Win,Home,1997-12-26,3,1,4,4,7,3,3,6,6,-2,1,-2,1,1,5.0,10.0,-5.0,5
1138,1138,1997-98,1997,1998,Aston Villa,Leeds,Draw,Away,1997-12-28,1,4,4,7,7,3,4,5,8,1,0,2,-1,0,5.0,11.0,-6.0,5
1139,1139,1997-98,1997,1998,Aston Villa,Leicester,Draw,Home,1998-01-10,1,4,5,5,8,1,1,1,2,3,4,4,6,1,5.0,9.0,-4.0,6
1140,1140,1997-98,1997,1998,Aston Villa,Blackburn,Loss,Away,1998-01-17,0,2,5,6,6,1,2,5,8,1,3,1,-2,0,5.0,13.0,-8.0,6
1141,1141,1997-98,1997,1998,Aston Villa,Newcastle,Loss,Home,1998-02-01,0,1,2,5,6,3,3,3,3,-2,-1,2,3,1,5.0,2.0,3.0,7
1142,1142,1997-98,1997,1998,Aston Villa,Derby,Win,Away,1998-02-07,3,0,1,2,5,4,7,7,10,-4,-6,-5,-5,0,5.0,12.0,-7.0,7
1143,1143,1997-98,1997,1998,Aston Villa,Man United,Loss,Home,1998-02-18,0,3,3,4,5,1,1,4,4,2,2,0,1,1,5.0,1.0,4.0,7
1144,1144,1997-98,1997,1998,Aston Villa,Wimbledon,Loss,Away,1998-02-21,0,3,3,3,4,4,5,5,5,-1,-2,-2,-1,0,5.0,8.0,-3.0,7
1145,1145,1997-98,1997,1998,Aston Villa,Liverpool,Win,Home,1998-02-28,3,0,3,3,3,2,2,3,6,-2,1,0,-3,1,5.0,4.0,1.0,7
1146,1146,1997-98,1997,1998,Aston Villa,Chelsea,Win,Away,1998-03-08,3,3,3,6,6,0,0,3,3,3,3,3,3,0,5.0,6.0,-1.0,8
1147,1147,1997-98,1997,1998,Aston Villa,Barnsley,Loss,Home,1998-03-11,0,6,6,6,9,3,4,4,7,3,2,2,2,1,5.0,21.0,-16.0,8
1148,1148,1997-98,1997,1998,Aston Villa,Crystal Palace,Win,Home,1998-03-14,3,3,6,6,6,0,0,0,0,3,6,6,6,1,5.0,21.0,-16.0,8
1149,1149,1997-98,1997,1998,Aston Villa,Everton,Win,Away,1998-03-28,3,3,6,9,9,3,4,5,5,0,2,4,4,0,5.0,15.0,-10.0,8
1150,1150,1997-98,1997,1998,Aston Villa,West Ham,Win,Home,1998-04-04,3,6,6,9,12,6,7,8,9,0,-1,1,3,1,5.0,14.0,-9.0,9
1151,1151,1997-98,1997,1998,Aston Villa,Coventry,Win,Away,1998-04-11,3,6,9,9,12,4,5,8,11,2,4,1,1,0,5.0,17.0,-12.0,9
1152,1152,1997-98,1997,1998,Aston Villa,Southampton,Win,Away,1998-04-18,3,6,9,12,12,1,1,4,4,5,8,8,8,0,5.0,16.0,-11.0,9
1153,1153,1997-98,1997,1998,Aston Villa,Bolton,Loss,Home,1998-04-25,0,6,9,12,15,0,3,4,4,6,6,8,11,1,5.0,21.0,-16.0,9
1154,1154,1997-98,1997,1998,Aston Villa,Sheffield Weds,Win,Away,1998-05-02,3,3,6,9,12,3,4,4,7,0,2,5,5,0,5.0,7.0,-2.0,10
1155,1155,1997-98,1997,1998,Aston Villa,Arsenal,Win,Home,1998-05-10,3,3,6,9,12,3,6,9,12,0,0,0,0,1,5.0,3.0,2.0,10
1156,1156,1998-99,1998,1999,Aston Villa,Everton,Draw,Away,1998-08-15,1,6,6,9,12,1,1,2,3,5,5,7,9,0,7.0,17.0,-10.0,1
1157,1157,1998-99,1998,1999,Aston Villa,Middlesbrough,Win,Home,1998-08-23,3,4,7,7,10,2,3,4,7,2,4,3,3,1,7.0,21.0,-14.0,1
1158,1158,1998-99,1998,1999,Aston Villa,Sheffield Weds,Win,Away,1998-08-29,3,4,7,10,10,3,3,3,6,1,4,7,4,0,7.0,16.0,-9.0,1
1159,1159,1998-99,1998,1999,Aston Villa,Newcastle,Win,Home,1998-09-09,3,6,7,10,13,1,2,2,5,5,5,8,8,1,7.0,13.0,-6.0,2
1160,1160,1998-99,1998,1999,Aston Villa,Wimbledon,Win,Home,1998-09-12,3,6,9,10,13,4,5,8,9,2,4,2,4,1,7.0,15.0,-8.0,2
1161,1161,1998-99,1998,1999,Aston Villa,Leeds,Draw,Away,1998-09-19,1,6,9,12,13,4,5,8,9,2,4,4,4,0,7.0,5.0,2.0,2
1162,1162,1998-99,1998,1999,Aston Villa,Derby,Win,Home,1998-09-26,3,4,7,10,13,6,9,10,11,-2,-2,0,2,1,7.0,9.0,-2.0,2
1163,1163,1998-99,1998,1999,Aston Villa,Coventry,Win,Away,1998-10-03,3,4,7,10,13,1,1,1,2,3,6,9,11,0,7.0,11.0,-4.0,3
1164,1164,1998-99,1998,1999,Aston Villa,West Ham,Draw,Away,1998-10-17,1,6,7,10,13,3,4,7,7,3,3,3,6,0,7.0,8.0,-1.0,3
1165,1165,1998-99,1998,1999,Aston Villa,Leicester,Draw,Home,1998-10-24,1,4,7,8,11,6,7,7,8,-2,0,1,3,1,7.0,10.0,-3.0,3
1166,1166,1998-99,1998,1999,Aston Villa,Tottenham,Win,Home,1998-11-07,3,2,5,8,9,4,4,7,8,-2,1,1,1,1,7.0,14.0,-7.0,4
1167,1167,1998-99,1998,1999,Aston Villa,Southampton,Win,Away,1998-11-14,3,4,5,8,11,2,5,6,6,2,0,2,5,0,7.0,12.0,-5.0,4
1168,1168,1998-99,1998,1999,Aston Villa,Liverpool,Loss,Home,1998-11-21,0,6,7,8,11,0,0,3,4,6,7,5,7,1,7.0,3.0,4.0,4
1169,1169,1998-99,1998,1999,Aston Villa,Nott'm Forest,Draw,Away,1998-11-28,1,3,6,7,8,1,1,2,2,2,5,5,6,0,7.0,21.0,-14.0,4
1170,1170,1998-99,1998,1999,Aston Villa,Man United,Draw,Home,1998-12-05,1,1,4,7,8,3,6,7,10,-2,-2,0,-2,1,7.0,2.0,5.0,5
1171,1171,1998-99,1998,1999,Aston Villa,Chelsea,Loss,Away,1998-12-09,0,2,2,5,8,2,5,8,9,0,-3,-3,-1,0,7.0,4.0,3.0,5
1172,1172,1998-99,1998,1999,Aston Villa,Arsenal,Win,Home,1998-12-13,3,1,2,2,5,2,2,3,6,-1,0,-1,-1,1,7.0,1.0,6.0,5
1173,1173,1998-99,1998,1999,Aston Villa,Charlton,Win,Away,1998-12-21,3,3,4,5,5,0,0,0,1,3,4,5,4,0,7.0,21.0,-14.0,5
1174,1174,1998-99,1998,1999,Aston Villa,Blackburn,Loss,Away,1998-12-26,0,6,6,7,8,2,5,5,5,4,1,2,3,0,7.0,6.0,1.0,5
1175,1175,1998-99,1998,1999,Aston Villa,Sheffield Weds,Win,Home,1998-12-28,3,3,6,6,7,0,3,6,7,3,3,0,0,1,7.0,16.0,-9.0,5
1176,1176,1998-99,1998,1999,Aston Villa,Middlesbrough,Draw,Away,1999-01-09,1,3,6,9,9,0,3,6,7,3,3,3,2,0,7.0,21.0,-14.0,6
1177,1177,1998-99,1998,1999,Aston Villa,Everton,Win,Home,1999-01-18,3,4,4,7,10,1,2,2,5,3,2,5,5,1,7.0,17.0,-10.0,6
1178,1178,1998-99,1998,1999,Aston Villa,Newcastle,Loss,Away,1999-01-30,0,4,7,7,10,1,1,1,4,3,6,6,6,0,7.0,13.0,-6.0,6
1179,1179,1998-99,1998,1999,Aston Villa,Blackburn,Loss,Home,1999-02-06,0,3,4,7,7,1,4,5,8,2,0,2,-1,1,7.0,6.0,1.0,7
1180,1180,1998-99,1998,1999,Aston Villa,Leeds,Loss,Home,1999-02-17,0,0,3,4,7,0,3,3,4,0,0,1,3,1,7.0,5.0,2.0,7
1181,1181,1998-99,1998,1999,Aston Villa,Wimbledon,Draw,Away,1999-02-21,1,0,0,3,4,1,2,5,6,-1,-2,-2,-2,0,7.0,15.0,-8.0,7
1182,1182,1998-99,1998,1999,Aston Villa,Coventry,Loss,Home,1999-02-27,0,1,1,1,4,0,1,4,4,1,0,-3,0,1,7.0,11.0,-4.0,7
1183,1183,1998-99,1998,1999,Aston Villa,Derby,Loss,Away,1999-03-10,0,1,1,1,1,1,4,4,7,0,-3,-3,-6,0,7.0,9.0,-2.0,8
1184,1184,1998-99,1998,1999,Aston Villa,Tottenham,Loss,Away,1999-03-13,0,0,1,1,1,3,4,5,6,-3,-3,-4,-5,0,7.0,14.0,-7.0,8
1185,1185,1998-99,1998,1999,Aston Villa,Chelsea,Loss,Home,1999-03-21,0,0,0,1,1,3,6,7,10,-3,-6,-6,-9,1,7.0,4.0,3.0,8
1186,1186,1998-99,1998,1999,Aston Villa,West Ham,Draw,Home,1999-04-02,1,0,0,0,1,6,6,9,10,-6,-6,-9,-9,1,7.0,8.0,-1.0,9
1187,1187,1998-99,1998,1999,Aston Villa,Leicester,Draw,Away,1999-04-06,1,1,1,1,1,4,7,7,7,-3,-6,-6,-6,0,7.0,10.0,-3.0,9
1188,1188,1998-99,1998,1999,Aston Villa,Southampton,Win,Home,1999-04-10,3,2,2,2,2,1,4,4,7,1,-2,-2,-5,1,7.0,12.0,-5.0,9
1189,1189,1998-99,1998,1999,Aston Villa,Liverpool,Win,Away,1999-04-17,3,4,5,5,5,2,5,5,5,2,0,0,0,0,7.0,3.0,4.0,9
1190,1190,1998-99,1998,1999,Aston Villa,Nott'm Forest,Win,Home,1999-04-24,3,6,7,8,8,0,1,1,1,6,6,7,7,1,7.0,21.0,-14.0,9
1191,1191,1998-99,1998,1999,Aston Villa,Man United,Loss,Away,1999-05-01,0,6,9,10,11,4,5,8,11,2,4,2,0,0,7.0,2.0,5.0,10
1192,1192,1998-99,1998,1999,Aston Villa,Charlton,Loss,Home,1999-05-08,0,3,6,9,10,1,1,2,2,2,5,7,8,1,7.0,21.0,-14.0,10
1193,1193,1998-99,1998,1999,Aston Villa,Arsenal,Loss,Away,1999-05-16,0,0,3,6,9,3,6,9,12,-3,-3,-3,-3,0,7.0,1.0,6.0,10
1194,1194,1999-00,1999,2000,Aston Villa,Newcastle,Win,Away,1999-08-07,3,0,0,3,6,1,2,3,4,-1,-2,0,2,0,6.0,13.0,-7.0,1
1195,1195,1999-00,1999,2000,Aston Villa,Everton,Win,Home,1999-08-11,3,3,3,3,6,1,4,4,7,2,-1,-1,-1,1,6.0,14.0,-8.0,1
1196,1196,1999-00,1999,2000,Aston Villa,West Ham,Draw,Home,1999-08-16,1,6,6,6,6,6,6,6,9,0,0,0,-3,1,6.0,5.0,1.0,1
1197,1197,1999-00,1999,2000,Aston Villa,Chelsea,Loss,Away,1999-08-21,0,4,7,7,7,4,7,8,11,0,0,-1,-4,0,6.0,3.0,3.0,1
1198,1198,1999-00,1999,2000,Aston Villa,Watford,Win,Away,1999-08-24,3,1,4,7,7,6,6,6,6,-5,-2,1,1,0,6.0,21.0,-15.0,1
1199,1199,1999-00,1999,2000,Aston Villa,Middlesbrough,Win,Home,1999-08-28,3,3,4,7,10,3,6,9,9,0,-2,-2,1,1,6.0,9.0,-3.0,1
1200,1200,1999-00,1999,2000,Aston Villa,Arsenal,Loss,Away,1999-09-11,0,6,6,7,10,3,3,4,7,3,3,3,3,0,6.0,2.0,4.0,2
1201,1201,1999-00,1999,2000,Aston Villa,Bradford,Win,Home,1999-09-18,3,3,6,6,7,1,1,1,2,2,5,5,5,1,6.0,21.0,-15.0,2
1202,1202,1999-00,1999,2000,Aston Villa,Leicester,Loss,Away,1999-09-25,0,3,6,9,9,1,4,7,7,2,2,2,2,0,6.0,10.0,-4.0,2
1203,1203,1999-00,1999,2000,Aston Villa,Liverpool,Draw,Home,1999-10-02,1,3,3,6,9,1,1,4,7,2,2,2,2,1,6.0,7.0,-1.0,3
1204,1204,1999-00,1999,2000,Aston Villa,Sunderland,Loss,Away,1999-10-18,0,1,4,4,7,6,9,12,13,-5,-5,-8,-6,0,6.0,21.0,-15.0,3
1205,1205,1999-00,1999,2000,Aston Villa,Wimbledon,Draw,Home,1999-10-23,1,1,1,4,4,3,4,5,6,-2,-3,-1,-2,1,6.0,16.0,-10.0,3
1206,1206,1999-00,1999,2000,Aston Villa,Man United,Loss,Away,1999-10-30,0,1,2,2,5,3,3,4,5,-2,-1,-2,0,0,6.0,1.0,5.0,3
1207,1207,1999-00,1999,2000,Aston Villa,Southampton,Loss,Home,1999-11-06,0,1,1,2,2,2,2,3,4,-1,-1,-1,-2,1,6.0,17.0,-11.0,4
1208,1208,1999-00,1999,2000,Aston Villa,Coventry,Loss,Away,1999-11-22,0,0,1,1,2,4,5,8,9,-4,-4,-7,-7,0,6.0,15.0,-9.0,4
1209,1209,1999-00,1999,2000,Aston Villa,Everton,Draw,Away,1999-11-27,1,0,0,1,1,2,2,3,3,-2,-2,-2,-2,0,6.0,14.0,-8.0,4
1210,1210,1999-00,1999,2000,Aston Villa,Newcastle,Loss,Home,1999-12-04,0,1,1,1,2,4,5,6,9,-3,-4,-5,-7,1,6.0,13.0,-7.0,5
1211,1211,1999-00,1999,2000,Aston Villa,Sheffield Weds,Win,Home,1999-12-18,3,1,1,1,1,0,1,1,2,1,0,0,-1,1,6.0,12.0,-6.0,5
1212,1212,1999-00,1999,2000,Aston Villa,Derby,Win,Away,1999-12-26,3,3,4,4,4,3,3,3,3,0,1,1,1,0,6.0,8.0,-2.0,5
1213,1213,1999-00,1999,2000,Aston Villa,Tottenham,Draw,Home,1999-12-29,1,6,6,7,7,3,4,4,7,3,2,3,0,1,6.0,11.0,-5.0,5
1214,1214,1999-00,1999,2000,Aston Villa,Leeds,Win,Away,2000-01-03,3,4,7,7,8,3,6,9,12,1,1,-2,-4,0,6.0,4.0,2.0,6
1215,1215,1999-00,1999,2000,Aston Villa,West Ham,Draw,Away,2000-01-15,1,4,7,10,10,2,3,3,4,2,4,7,6,0,6.0,5.0,1.0,6
1216,1216,1999-00,1999,2000,Aston Villa,Chelsea,Draw,Home,2000-01-22,1,4,5,8,11,4,5,6,9,0,0,2,2,1,6.0,3.0,3.0,6
1217,1217,1999-00,1999,2000,Aston Villa,Watford,Win,Home,2000-02-05,3,2,5,6,9,0,0,3,3,2,5,3,6,1,6.0,21.0,-15.0,7
1218,1218,1999-00,1999,2000,Aston Villa,Middlesbrough,Win,Away,2000-02-14,3,4,5,8,9,0,1,1,1,4,4,7,8,0,6.0,9.0,-3.0,7
1219,1219,1999-00,1999,2000,Aston Villa,Bradford,Draw,Away,2000-02-26,1,6,7,8,11,3,6,6,7,3,1,2,4,0,6.0,21.0,-15.0,7
1220,1220,1999-00,1999,2000,Aston Villa,Arsenal,Draw,Home,2000-03-05,1,4,7,8,9,3,3,4,7,1,4,4,2,1,6.0,2.0,4.0,8
1221,1221,1999-00,1999,2000,Aston Villa,Coventry,Win,Home,2000-03-11,3,2,5,8,9,0,0,3,3,2,5,5,6,1,6.0,15.0,-9.0,8
1222,1222,1999-00,1999,2000,Aston Villa,Liverpool,Draw,Away,2000-03-15,1,4,5,8,11,2,5,8,9,2,0,0,2,0,6.0,7.0,-1.0,8
1223,1223,1999-00,1999,2000,Aston Villa,Southampton,Loss,Away,2000-03-18,0,4,5,6,9,0,1,1,4,4,4,5,5,0,6.0,17.0,-11.0,8
1224,1224,1999-00,1999,2000,Aston Villa,Derby,Win,Home,2000-03-25,3,1,4,5,6,0,3,4,4,1,1,1,2,1,6.0,8.0,-2.0,8
1225,1225,1999-00,1999,2000,Aston Villa,Sheffield Weds,Win,Away,2000-04-05,3,3,4,7,8,0,3,4,4,3,1,3,4,0,6.0,12.0,-6.0,9
1226,1226,1999-00,1999,2000,Aston Villa,Leeds,Win,Home,2000-04-09,3,6,6,7,10,0,3,6,9,6,3,1,1,1,6.0,4.0,2.0,9
1227,1227,1999-00,1999,2000,Aston Villa,Tottenham,Win,Away,2000-04-15,3,6,9,9,10,0,1,1,4,6,8,8,6,0,6.0,11.0,-5.0,9
1228,1228,1999-00,1999,2000,Aston Villa,Leicester,Draw,Home,2000-04-22,1,6,9,12,12,3,4,4,7,3,5,8,5,1,6.0,10.0,-4.0,9
1229,1229,1999-00,1999,2000,Aston Villa,Sunderland,Draw,Home,2000-04-29,1,4,7,10,13,3,3,6,9,1,4,4,4,1,6.0,21.0,-15.0,9
1230,1230,1999-00,1999,2000,Aston Villa,Wimbledon,Draw,Away,2000-05-06,1,2,5,8,11,0,0,0,0,2,5,8,11,0,6.0,16.0,-10.0,10
1231,1231,1999-00,1999,2000,Aston Villa,Man United,Loss,Home,2000-05-14,0,2,3,6,9,6,9,12,15,-4,-6,-6,-6,1,6.0,1.0,5.0,10
1232,1232,2000-01,2000,2001,Aston Villa,Leicester,Draw,Away,2000-08-19,1,1,2,3,6,3,6,9,10,-2,-4,-6,-4,0,6.0,8.0,-2.0,1
1233,1233,2000-01,2000,2001,Aston Villa,Chelsea,Draw,Home,2000-08-27,1,1,2,3,4,3,6,6,9,-2,-4,-3,-5,1,6.0,5.0,1.0,1
1234,1234,2000-01,2000,2001,Aston Villa,Liverpool,Loss,Away,2000-09-06,0,2,2,3,4,1,4,4,5,1,-2,-1,-1,0,6.0,4.0,2.0,2
1235,1235,2000-01,2000,2001,Aston Villa,Ipswich,Win,Away,2000-09-09,3,1,2,2,3,3,4,4,4,-2,-2,-2,-1,0,6.0,21.0,-15.0,2
1236,1236,2000-01,2000,2001,Aston Villa,Bradford,Win,Home,2000-09-16,3,3,4,5,5,1,2,5,5,2,2,0,0,1,6.0,17.0,-11.0,2
1237,1237,2000-01,2000,2001,Aston Villa,Middlesbrough,Draw,Away,2000-09-23,1,6,6,7,8,1,2,2,3,5,4,5,5,0,6.0,12.0,-6.0,2
1238,1238,2000-01,2000,2001,Aston Villa,Derby,Win,Home,2000-09-30,3,4,7,7,8,1,2,3,4,3,5,4,4,1,6.0,16.0,-10.0,2
1239,1239,2000-01,2000,2001,Aston Villa,Arsenal,Loss,Away,2000-10-14,0,4,7,10,10,4,7,8,9,0,0,2,1,0,6.0,2.0,4.0,3
1240,1240,2000-01,2000,2001,Aston Villa,Sunderland,Draw,Home,2000-10-22,1,3,4,7,10,4,5,8,8,-1,-1,-1,2,1,6.0,7.0,-1.0,3
1241,1241,2000-01,2000,2001,Aston Villa,Charlton,Win,Home,2000-10-28,3,1,4,5,8,3,4,7,10,-2,0,-2,-2,1,6.0,21.0,-15.0,3
1242,1242,2000-01,2000,2001,Aston Villa,Everton,Win,Away,2000-11-05,3,4,4,7,8,3,4,4,5,1,0,3,3,0,6.0,13.0,-7.0,4
1243,1243,2000-01,2000,2001,Aston Villa,Tottenham,Win,Home,2000-11-11,3,6,7,7,10,3,6,6,6,3,1,1,4,1,6.0,10.0,-4.0,4
1244,1244,2000-01,2000,2001,Aston Villa,Southampton,Loss,Away,2000-11-18,0,6,9,10,10,4,4,4,5,2,5,6,5,0,6.0,15.0,-9.0,4
1245,1245,2000-01,2000,2001,Aston Villa,Coventry,Draw,Away,2000-11-25,1,3,6,9,10,0,0,0,0,3,6,9,10,0,6.0,14.0,-8.0,4
1246,1246,2000-01,2000,2001,Aston Villa,Newcastle,Draw,Home,2000-12-02,1,1,4,7,10,3,4,7,7,-2,0,0,3,1,6.0,11.0,-5.0,5
1247,1247,2000-01,2000,2001,Aston Villa,West Ham,Draw,Away,2000-12-09,1,2,2,5,8,6,9,12,13,-4,-7,-7,-5,0,6.0,9.0,-3.0,5
1248,1248,2000-01,2000,2001,Aston Villa,Man City,Draw,Home,2000-12-16,1,2,3,3,6,3,3,3,3,-1,0,0,3,1,6.0,21.0,-15.0,5
1249,1249,2000-01,2000,2001,Aston Villa,Leeds,Win,Away,2000-12-23,3,2,3,4,4,3,3,6,6,-1,0,-2,-2,0,6.0,3.0,3.0,5
1250,1250,2000-01,2000,2001,Aston Villa,Man United,Loss,Home,2000-12-26,0,4,5,6,7,3,4,7,10,1,1,-1,-3,1,6.0,1.0,5.0,5
1251,1251,2000-01,2000,2001,Aston Villa,Chelsea,Loss,Away,2001-01-01,0,3,4,5,6,4,4,7,10,-1,0,-2,-4,0,6.0,5.0,1.0,6
1252,1252,2000-01,2000,2001,Aston Villa,Liverpool,Loss,Home,2001-01-13,0,0,3,4,5,3,6,9,9,-3,-3,-5,-4,1,6.0,4.0,2.0,6
1253,1253,2000-01,2000,2001,Aston Villa,Man United,Loss,Away,2001-01-20,0,0,0,3,4,6,7,10,13,-6,-7,-7,-9,0,6.0,1.0,5.0,6
1254,1254,2000-01,2000,2001,Aston Villa,Leeds,Loss,Home,2001-01-24,0,0,0,0,3,3,4,4,4,-3,-4,-4,-1,1,6.0,3.0,3.0,6
1255,1255,2000-01,2000,2001,Aston Villa,Bradford,Win,Away,2001-02-03,3,0,0,0,0,1,1,4,4,-1,-1,-4,-4,0,6.0,17.0,-11.0,7
1256,1256,2000-01,2000,2001,Aston Villa,Middlesbrough,Draw,Home,2001-02-10,1,3,3,3,3,2,3,6,7,1,0,-3,-4,1,6.0,12.0,-6.0,7
1257,1257,2000-01,2000,2001,Aston Villa,Derby,Loss,Away,2001-02-24,0,4,4,4,4,4,4,5,5,0,0,-1,-1,0,6.0,16.0,-10.0,7
1258,1258,2000-01,2000,2001,Aston Villa,Sunderland,Draw,Away,2001-03-05,1,1,4,4,4,1,1,1,2,0,3,3,2,0,6.0,7.0,-1.0,8
1259,1259,2000-01,2000,2001,Aston Villa,Ipswich,Win,Home,2001-03-10,3,1,2,5,5,6,6,6,6,-5,-4,-1,-1,1,6.0,21.0,-15.0,8
1260,1260,2000-01,2000,2001,Aston Villa,Arsenal,Draw,Home,2001-03-18,1,4,4,5,8,3,6,9,12,1,-2,-4,-4,1,6.0,2.0,4.0,8
1261,1261,2000-01,2000,2001,Aston Villa,Man City,Win,Away,2001-03-31,3,4,5,5,6,1,4,4,5,3,1,1,1,0,6.0,21.0,-15.0,8
1262,1262,2000-01,2000,2001,Aston Villa,Leicester,Win,Home,2001-04-04,3,4,7,8,8,0,3,6,6,4,4,2,2,1,6.0,8.0,-2.0,9
1263,1263,2000-01,2000,2001,Aston Villa,West Ham,Draw,Home,2001-04-07,1,6,7,10,11,0,0,0,3,6,7,10,8,1,6.0,9.0,-3.0,9
1264,1264,2000-01,2000,2001,Aston Villa,Everton,Win,Home,2001-04-14,3,4,7,8,11,6,6,7,7,-2,1,1,4,1,6.0,13.0,-7.0,9
1265,1265,2000-01,2000,2001,Aston Villa,Charlton,Draw,Away,2001-04-17,1,4,7,10,11,0,3,3,4,4,4,7,7,0,6.0,21.0,-15.0,9
1266,1266,2000-01,2000,2001,Aston Villa,Southampton,Draw,Home,2001-04-21,1,4,5,8,11,0,0,3,6,4,5,5,5,1,6.0,15.0,-9.0,9
1267,1267,2000-01,2000,2001,Aston Villa,Tottenham,Draw,Away,2001-04-28,1,2,5,6,9,0,3,6,6,2,2,0,3,0,6.0,10.0,-4.0,9
1268,1268,2000-01,2000,2001,Aston Villa,Coventry,Win,Home,2001-05-05,3,2,3,6,7,0,3,3,6,2,0,3,1,1,6.0,14.0,-8.0,10
1269,1269,2000-01,2000,2001,Aston Villa,Newcastle,Loss,Away,2001-05-19,0,4,5,6,9,1,2,5,6,3,3,1,3,0,6.0,11.0,-5.0,10
1270,1270,2001-02,2001,2002,Aston Villa,Tottenham,Draw,Away,2001-08-18,1,3,4,5,6,3,4,4,4,0,0,1,2,0,8.0,12.0,-4.0,1
1271,1271,2001-02,2001,2002,Aston Villa,Man United,Draw,Home,2001-08-26,1,1,4,5,6,4,4,4,4,-3,0,1,2,1,8.0,1.0,7.0,1
1272,1272,2001-02,2001,2002,Aston Villa,Liverpool,Win,Away,2001-09-08,3,2,2,5,6,3,6,7,10,-1,-4,-2,-4,0,8.0,3.0,5.0,2
1273,1273,2001-02,2001,2002,Aston Villa,Sunderland,Draw,Home,2001-09-16,1,4,5,5,8,4,4,7,8,0,1,-2,0,1,8.0,7.0,1.0,2
1274,1274,2001-02,2001,2002,Aston Villa,Southampton,Win,Away,2001-09-24,3,4,5,6,6,3,3,3,6,1,2,3,0,0,8.0,10.0,-2.0,2
1275,1275,2001-02,2001,2002,Aston Villa,Blackburn,Win,Home,2001-09-30,3,4,7,8,9,4,5,5,8,0,2,3,1,1,8.0,21.0,-13.0,2
1276,1276,2001-02,2001,2002,Aston Villa,Fulham,Win,Home,2001-10-14,3,6,7,10,11,2,2,3,4,4,5,7,7,1,8.0,21.0,-13.0,3
1277,1277,2001-02,2001,2002,Aston Villa,Everton,Loss,Away,2001-10-20,0,6,9,10,13,4,4,4,4,2,5,6,9,0,8.0,16.0,-8.0,3
1278,1278,2001-02,2001,2002,Aston Villa,Charlton,Win,Home,2001-10-24,3,3,6,9,10,2,5,6,6,1,1,3,4,1,8.0,9.0,-1.0,3
1279,1279,2001-02,2001,2002,Aston Villa,Bolton,Win,Home,2001-10-27,3,3,6,9,12,3,3,4,5,0,3,5,7,1,8.0,21.0,-13.0,3
1280,1280,2001-02,2001,2002,Aston Villa,Newcastle,Loss,Away,2001-11-03,0,6,6,9,12,3,6,6,9,3,0,3,3,0,8.0,11.0,-3.0,4
1281,1281,2001-02,2001,2002,Aston Villa,Middlesbrough,Draw,Home,2001-11-17,1,3,6,6,9,3,6,7,7,0,0,-1,2,1,8.0,14.0,-6.0,4
1282,1282,2001-02,2001,2002,Aston Villa,Leeds,Draw,Away,2001-11-25,1,1,4,7,7,3,4,5,6,-2,0,2,1,0,8.0,4.0,4.0,4
1283,1283,2001-02,2001,2002,Aston Villa,Leicester,Loss,Home,2001-12-01,0,2,2,5,8,1,4,5,5,1,-2,0,3,1,8.0,13.0,-5.0,5
1284,1284,2001-02,2001,2002,Aston Villa,West Ham,Draw,Away,2001-12-05,1,1,2,2,5,0,1,1,4,1,1,1,1,0,8.0,15.0,-7.0,5
1285,1285,2001-02,2001,2002,Aston Villa,Arsenal,Loss,Away,2001-12-09,0,1,2,3,3,6,7,7,8,-5,-5,-4,-5,0,8.0,2.0,6.0,5
1286,1286,2001-02,2001,2002,Aston Villa,Ipswich,Win,Home,2001-12-17,3,1,1,2,3,0,1,1,1,1,0,1,2,1,8.0,5.0,3.0,5
1287,1287,2001-02,2001,2002,Aston Villa,Derby,Loss,Away,2001-12-22,0,3,4,4,5,0,3,3,3,3,1,1,2,0,8.0,17.0,-9.0,5
1288,1288,2001-02,2001,2002,Aston Villa,Liverpool,Loss,Home,2001-12-26,0,3,3,4,4,0,1,4,7,3,2,0,-3,1,8.0,3.0,5.0,5
1289,1289,2001-02,2001,2002,Aston Villa,Tottenham,Draw,Home,2001-12-29,1,0,3,3,4,0,3,3,6,0,0,0,-2,1,8.0,12.0,-4.0,5
1290,1290,2001-02,2001,2002,Aston Villa,Sunderland,Draw,Away,2002-01-01,1,1,1,4,4,3,6,6,7,-2,-5,-2,-3,0,8.0,7.0,1.0,6
1291,1291,2001-02,2001,2002,Aston Villa,Derby,Win,Home,2002-01-12,3,2,2,2,5,3,3,6,6,-1,-1,-4,-1,1,8.0,17.0,-9.0,6
1292,1292,2001-02,2001,2002,Aston Villa,Charlton,Win,Away,2002-01-21,3,4,5,5,5,3,6,7,7,1,-1,-2,-2,0,8.0,9.0,-1.0,6
1293,1293,2001-02,2001,2002,Aston Villa,Everton,Draw,Home,2002-01-30,1,6,7,8,8,4,4,4,4,2,3,4,4,1,8.0,16.0,-8.0,6
1294,1294,2001-02,2001,2002,Aston Villa,Fulham,Draw,Away,2002-02-02,1,4,7,8,9,1,4,7,7,3,3,1,2,0,8.0,21.0,-13.0,7
1295,1295,2001-02,2001,2002,Aston Villa,Chelsea,Draw,Home,2002-02-09,1,2,5,8,9,6,9,10,10,-4,-4,-2,-1,1,8.0,6.0,2.0,7
1296,1296,2001-02,2001,2002,Aston Villa,Man United,Loss,Away,2002-02-23,0,2,3,6,9,6,9,9,12,-4,-6,-3,-3,0,8.0,1.0,7.0,7
1297,1297,2001-02,2001,2002,Aston Villa,West Ham,Win,Home,2002-03-02,3,1,2,3,6,3,6,6,6,-2,-4,-3,0,1,8.0,15.0,-7.0,8
1298,1298,2001-02,2001,2002,Aston Villa,Blackburn,Loss,Away,2002-03-05,0,3,4,5,6,1,1,1,1,2,3,4,5,0,8.0,21.0,-13.0,8
1299,1299,2001-02,2001,2002,Aston Villa,Arsenal,Loss,Home,2002-03-17,0,3,3,4,5,6,9,12,13,-3,-6,-8,-8,1,8.0,2.0,6.0,8
1300,1300,2001-02,2001,2002,Aston Villa,Ipswich,Draw,Away,2002-03-23,1,0,3,3,4,1,1,1,1,-1,2,2,3,0,8.0,5.0,3.0,8
1301,1301,2001-02,2001,2002,Aston Villa,Bolton,Loss,Away,2002-03-30,0,1,1,4,4,3,3,4,5,-2,-2,0,-1,0,8.0,21.0,-13.0,8
1302,1302,2001-02,2001,2002,Aston Villa,Newcastle,Draw,Home,2002-04-02,1,1,1,1,4,4,4,4,7,-3,-3,-3,-3,1,8.0,11.0,-3.0,9
1303,1303,2001-02,2001,2002,Aston Villa,Middlesbrough,Loss,Away,2002-04-06,0,1,2,2,2,4,7,7,8,-3,-5,-5,-6,0,8.0,14.0,-6.0,9
1304,1304,2001-02,2001,2002,Aston Villa,Leeds,Loss,Home,2002-04-13,0,1,1,2,2,3,3,6,9,-2,-2,-4,-7,1,8.0,4.0,4.0,9
1305,1305,2001-02,2001,2002,Aston Villa,Leicester,Draw,Away,2002-04-20,1,0,1,1,2,1,1,4,4,-1,0,-3,-2,0,8.0,13.0,-5.0,9
1306,1306,2001-02,2001,2002,Aston Villa,Southampton,Win,Home,2002-04-27,3,1,1,2,2,1,4,4,5,0,-3,-2,-3,1,8.0,10.0,-2.0,9
1307,1307,2001-02,2001,2002,Aston Villa,Chelsea,Win,Away,2002-05-11,3,4,4,4,5,3,4,7,8,1,0,-3,-3,0,8.0,6.0,2.0,10
1308,1308,2002-03,2002,2003,Aston Villa,Liverpool,Loss,Home,2002-08-18,0,6,7,7,7,6,6,9,12,0,1,-2,-5,1,8.0,2.0,6.0,1
1309,1309,2002-03,2002,2003,Aston Villa,Tottenham,Loss,Away,2002-08-24,0,3,6,7,7,1,4,5,6,2,2,2,1,0,8.0,9.0,-1.0,1
1310,1310,2002-03,2002,2003,Aston Villa,Man City,Win,Home,2002-08-28,3,0,3,6,7,3,3,3,6,-3,0,3,1,1,8.0,21.0,-13.0,1
1311,1311,2002-03,2002,2003,Aston Villa,Bolton,Loss,Away,2002-09-01,0,3,3,6,9,0,0,0,0,3,3,6,9,0,8.0,16.0,-8.0,2
1312,1312,2002-03,2002,2003,Aston Villa,Charlton,Win,Home,2002-09-11,3,3,3,3,6,3,6,6,7,0,-3,-3,-1,1,8.0,14.0,-6.0,2
1313,1313,2002-03,2002,2003,Aston Villa,Birmingham,Loss,Away,2002-09-16,0,3,6,6,6,4,5,5,5,-1,1,1,1,0,8.0,21.0,-13.0,2
1314,1314,2002-03,2002,2003,Aston Villa,Everton,Win,Home,2002-09-22,3,3,3,6,6,3,3,4,7,0,0,2,-1,1,8.0,15.0,-7.0,2
1315,1315,2002-03,2002,2003,Aston Villa,Sunderland,Loss,Away,2002-09-28,0,3,6,6,9,0,0,1,4,3,6,5,5,0,8.0,17.0,-9.0,2
1316,1316,2002-03,2002,2003,Aston Villa,Leeds,Draw,Home,2002-10-06,1,3,3,6,6,0,3,6,6,3,0,0,0,1,8.0,5.0,3.0,3
1317,1317,2002-03,2002,2003,Aston Villa,Southampton,Loss,Home,2002-10-21,0,1,4,4,7,4,5,5,8,-3,-1,-1,-1,1,8.0,11.0,-3.0,3
1318,1318,2002-03,2002,2003,Aston Villa,Man United,Draw,Away,2002-10-26,1,1,1,4,4,4,7,10,10,-3,-6,-6,-6,0,8.0,3.0,5.0,3
1319,1319,2002-03,2002,2003,Aston Villa,Blackburn,Draw,Away,2002-11-03,1,1,2,2,5,6,6,9,12,-5,-4,-7,-7,0,8.0,10.0,-2.0,4
1320,1320,2002-03,2002,2003,Aston Villa,Fulham,Win,Home,2002-11-09,3,2,2,3,3,0,0,1,4,2,2,2,-1,1,8.0,13.0,-5.0,4
1321,1321,2002-03,2002,2003,Aston Villa,West Brom,Draw,Away,2002-11-16,1,4,5,5,6,1,1,2,2,3,4,3,4,0,8.0,21.0,-13.0,4
1322,1322,2002-03,2002,2003,Aston Villa,West Ham,Win,Home,2002-11-23,3,4,5,6,6,1,1,1,4,3,4,5,2,1,8.0,7.0,1.0,4
1323,1323,2002-03,2002,2003,Aston Villa,Arsenal,Loss,Away,2002-11-30,0,4,7,8,9,3,6,9,9,1,1,-1,0,0,8.0,1.0,7.0,4
1324,1324,2002-03,2002,2003,Aston Villa,Newcastle,Loss,Home,2002-12-07,0,3,4,7,8,3,6,6,9,0,-2,1,-1,1,8.0,4.0,4.0,5
1325,1325,2002-03,2002,2003,Aston Villa,West Brom,Win,Home,2002-12-14,3,0,3,4,7,3,3,4,5,-3,0,0,2,1,8.0,21.0,-13.0,5
1326,1326,2002-03,2002,2003,Aston Villa,Chelsea,Loss,Away,2002-12-21,0,3,3,6,7,4,7,8,11,-1,-4,-2,-4,0,8.0,6.0,2.0,5
1327,1327,2002-03,2002,2003,Aston Villa,Man City,Loss,Away,2002-12-26,0,3,3,3,6,1,4,7,7,2,-1,-4,-1,0,8.0,21.0,-13.0,5
1328,1328,2002-03,2002,2003,Aston Villa,Middlesbrough,Win,Home,2002-12-28,3,0,3,3,3,3,4,5,5,-3,-1,-2,-2,1,8.0,12.0,-4.0,5
1329,1329,2002-03,2002,2003,Aston Villa,Bolton,Win,Home,2003-01-01,3,3,3,6,6,4,5,5,6,-1,-2,1,0,1,8.0,16.0,-8.0,6
1330,1330,2002-03,2002,2003,Aston Villa,Liverpool,Draw,Away,2003-01-11,1,6,6,6,9,1,2,3,3,5,4,3,6,0,8.0,2.0,6.0,6
1331,1331,2002-03,2002,2003,Aston Villa,Tottenham,Loss,Home,2003-01-18,0,4,7,7,7,3,3,4,7,1,4,3,0,1,8.0,9.0,-1.0,6
1332,1332,2002-03,2002,2003,Aston Villa,Middlesbrough,Win,Away,2003-01-28,3,1,4,7,7,1,1,1,4,0,3,6,3,0,8.0,12.0,-4.0,6
1333,1333,2002-03,2002,2003,Aston Villa,Blackburn,Win,Home,2003-02-02,3,3,4,7,10,1,2,5,6,2,2,2,4,1,8.0,10.0,-2.0,7
1334,1334,2002-03,2002,2003,Aston Villa,Fulham,Loss,Away,2003-02-08,0,6,6,7,10,0,3,4,4,6,3,3,6,0,8.0,13.0,-5.0,7
1335,1335,2002-03,2002,2003,Aston Villa,Charlton,Loss,Away,2003-02-22,0,3,6,6,7,6,9,12,13,-3,-3,-6,-6,0,8.0,14.0,-6.0,7
1336,1336,2002-03,2002,2003,Aston Villa,Birmingham,Loss,Home,2003-03-03,0,0,3,6,6,3,3,3,4,-3,0,3,2,1,8.0,21.0,-13.0,8
1337,1337,2002-03,2002,2003,Aston Villa,Man United,Loss,Home,2003-03-15,0,0,0,3,6,4,5,8,11,-4,-5,-5,-5,1,8.0,3.0,5.0,8
1338,1338,2002-03,2002,2003,Aston Villa,Southampton,Draw,Away,2003-03-22,1,0,0,0,3,4,4,4,4,-4,-4,-4,-1,0,8.0,11.0,-3.0,8
1339,1339,2002-03,2002,2003,Aston Villa,Arsenal,Draw,Home,2003-04-05,1,1,1,1,1,3,6,9,10,-2,-5,-8,-9,1,8.0,1.0,7.0,9
1340,1340,2002-03,2002,2003,Aston Villa,West Ham,Draw,Away,2003-04-12,1,2,2,2,2,4,5,8,11,-2,-3,-6,-9,0,8.0,7.0,1.0,9
1341,1341,2002-03,2002,2003,Aston Villa,Chelsea,Win,Home,2003-04-19,3,2,3,3,3,6,9,12,12,-4,-6,-9,-9,1,8.0,6.0,2.0,9
1342,1342,2002-03,2002,2003,Aston Villa,Newcastle,Draw,Away,2003-04-21,1,4,5,6,6,0,0,3,6,4,5,3,0,0,8.0,4.0,4.0,9
1343,1343,2002-03,2002,2003,Aston Villa,Everton,Loss,Away,2003-04-26,0,4,5,6,7,0,3,6,6,4,2,0,1,0,8.0,15.0,-7.0,9
1344,1344,2002-03,2002,2003,Aston Villa,Sunderland,Win,Home,2003-05-03,3,1,4,5,6,0,0,0,0,1,4,5,6,1,8.0,17.0,-9.0,10
1345,1345,2002-03,2002,2003,Aston Villa,Leeds,Loss,Away,2003-05-11,0,3,4,7,8,3,6,6,7,0,-2,1,1,0,8.0,5.0,3.0,10
1346,1346,2003-04,2003,2004,Aston Villa,Portsmouth,Loss,Away,2003-08-16,0,3,3,4,7,0,0,0,0,3,3,4,7,0,16.0,21.0,-5.0,1
1347,1347,2003-04,2003,2004,Aston Villa,Liverpool,Draw,Home,2003-08-24,1,0,3,3,4,0,0,3,6,0,3,0,-2,1,16.0,5.0,11.0,1
1348,1348,2003-04,2003,2004,Aston Villa,Arsenal,Loss,Away,2003-08-27,0,1,1,4,4,6,9,12,12,-5,-8,-8,-8,0,16.0,2.0,14.0,1
1349,1349,2003-04,2003,2004,Aston Villa,Leicester,Win,Home,2003-08-30,3,1,1,1,4,1,2,5,6,0,-1,-4,-2,1,16.0,21.0,-5.0,1
1350,1350,2003-04,2003,2004,Aston Villa,Man City,Loss,Away,2003-09-14,0,3,4,4,4,3,4,7,7,0,0,-3,-3,0,16.0,9.0,7.0,2
1351,1351,2003-04,2003,2004,Aston Villa,Charlton,Win,Home,2003-09-20,3,3,3,4,4,1,2,5,5,2,1,-1,-1,1,16.0,12.0,4.0,2
1352,1352,2003-04,2003,2004,Aston Villa,Chelsea,Loss,Away,2003-09-27,0,3,6,6,7,6,7,10,13,-3,-1,-4,-6,0,16.0,4.0,12.0,2
1353,1353,2003-04,2003,2004,Aston Villa,Bolton,Draw,Home,2003-10-05,1,3,3,6,6,2,5,6,6,1,-2,0,0,1,16.0,17.0,-1.0,3
1354,1354,2003-04,2003,2004,Aston Villa,Birmingham,Draw,Away,2003-10-19,1,1,4,4,7,1,4,7,8,0,0,-3,-1,0,16.0,13.0,3.0,3
1355,1355,2003-04,2003,2004,Aston Villa,Everton,Draw,Home,2003-10-25,1,2,2,5,5,1,4,4,5,1,-2,1,0,1,16.0,7.0,9.0,3
1356,1356,2003-04,2003,2004,Aston Villa,Newcastle,Draw,Away,2003-11-01,1,2,3,3,6,6,9,12,12,-4,-6,-9,-6,0,16.0,3.0,13.0,4
1357,1357,2003-04,2003,2004,Aston Villa,Middlesbrough,Loss,Home,2003-11-08,0,2,3,4,4,4,4,4,7,-2,-1,0,-3,1,16.0,11.0,5.0,4
1358,1358,2003-04,2003,2004,Aston Villa,Tottenham,Loss,Away,2003-11-23,0,1,2,3,4,0,1,4,7,1,1,-1,-3,0,16.0,10.0,6.0,4
1359,1359,2003-04,2003,2004,Aston Villa,Southampton,Win,Home,2003-11-29,3,0,1,2,3,1,1,4,5,-1,0,-2,-2,1,16.0,8.0,8.0,4
1360,1360,2003-04,2003,2004,Aston Villa,Man United,Loss,Away,2003-12-06,0,3,3,4,5,3,6,9,9,0,-3,-5,-4,0,16.0,1.0,15.0,5
1361,1361,2003-04,2003,2004,Aston Villa,Wolves,Win,Home,2003-12-14,3,3,3,3,4,1,1,2,2,2,2,1,2,1,16.0,21.0,-5.0,5
1362,1362,2003-04,2003,2004,Aston Villa,Blackburn,Win,Away,2003-12-20,3,3,6,6,6,3,6,6,9,0,0,0,-3,0,16.0,6.0,10.0,5
1363,1363,2003-04,2003,2004,Aston Villa,Leeds,Draw,Away,2003-12-26,1,6,6,9,9,4,5,8,8,2,1,1,1,0,16.0,15.0,1.0,5
1364,1364,2003-04,2003,2004,Aston Villa,Fulham,Win,Home,2003-12-28,3,4,7,7,10,3,3,6,7,1,4,1,3,1,16.0,14.0,2.0,5
1365,1365,2003-04,2003,2004,Aston Villa,Portsmouth,Win,Home,2004-01-06,3,4,7,10,10,3,3,3,4,1,4,7,6,1,16.0,21.0,-5.0,6
1366,1366,2003-04,2003,2004,Aston Villa,Liverpool,Loss,Away,2004-01-10,0,6,7,10,13,4,7,7,8,2,0,3,5,0,16.0,5.0,11.0,6
1367,1367,2003-04,2003,2004,Aston Villa,Arsenal,Loss,Home,2004-01-18,0,3,6,7,10,4,7,10,11,-1,-1,-3,-1,1,16.0,2.0,14.0,6
1368,1368,2003-04,2003,2004,Aston Villa,Leicester,Win,Away,2004-01-31,3,0,3,6,7,1,2,3,4,-1,1,3,3,0,16.0,21.0,-5.0,6
1369,1369,2003-04,2003,2004,Aston Villa,Leeds,Win,Home,2004-02-07,3,3,3,6,9,0,0,0,0,3,3,6,9,1,16.0,15.0,1.0,7
1370,1370,2003-04,2003,2004,Aston Villa,Fulham,Win,Away,2004-02-11,3,6,6,6,9,4,4,7,7,2,2,-1,2,0,16.0,14.0,2.0,7
1371,1371,2003-04,2003,2004,Aston Villa,Birmingham,Draw,Home,2004-02-22,1,6,9,9,9,4,5,6,9,2,4,3,0,1,16.0,13.0,3.0,7
1372,1372,2003-04,2003,2004,Aston Villa,Everton,Loss,Away,2004-02-28,0,4,7,10,10,1,1,2,2,3,6,8,8,0,16.0,7.0,9.0,7
1373,1373,2003-04,2003,2004,Aston Villa,Wolves,Win,Away,2004-03-14,3,1,4,7,10,4,4,4,5,-3,0,3,5,0,16.0,21.0,-5.0,8
1374,1374,2003-04,2003,2004,Aston Villa,Blackburn,Loss,Home,2004-03-20,0,3,4,7,10,1,1,2,5,2,3,5,5,1,16.0,6.0,10.0,8
1375,1375,2003-04,2003,2004,Aston Villa,Charlton,Win,Away,2004-03-27,3,3,3,4,7,3,3,6,6,0,0,-2,1,0,16.0,12.0,4.0,8
1376,1376,2003-04,2003,2004,Aston Villa,Man City,Draw,Home,2004-04-04,1,3,6,6,7,1,4,4,7,2,2,2,0,1,16.0,9.0,7.0,9
1377,1377,2003-04,2003,2004,Aston Villa,Bolton,Draw,Away,2004-04-10,1,4,4,7,7,3,3,3,3,1,1,4,4,0,16.0,17.0,-1.0,9
1378,1378,2003-04,2003,2004,Aston Villa,Chelsea,Win,Home,2004-04-12,3,2,5,5,8,4,7,10,13,-2,-2,-5,-5,1,16.0,4.0,12.0,9
1379,1379,2003-04,2003,2004,Aston Villa,Newcastle,Draw,Home,2004-04-18,1,4,5,8,8,4,4,7,7,0,1,1,1,1,16.0,3.0,13.0,9
1380,1380,2003-04,2003,2004,Aston Villa,Middlesbrough,Win,Away,2004-04-24,3,4,5,6,9,3,4,7,8,1,1,-1,1,0,16.0,11.0,5.0,9
1381,1381,2003-04,2003,2004,Aston Villa,Tottenham,Win,Home,2004-05-02,3,4,7,8,9,1,2,2,2,3,5,6,7,1,16.0,10.0,6.0,10
1382,1382,2003-04,2003,2004,Aston Villa,Southampton,Draw,Away,2004-05-08,1,6,7,10,11,0,3,3,6,6,4,7,5,0,16.0,8.0,8.0,10
1383,1383,2003-04,2003,2004,Aston Villa,Man United,Loss,Home,2004-05-15,0,4,7,8,11,1,1,4,4,3,6,4,7,1,16.0,1.0,15.0,10
1384,1384,2004-05,2004,2005,Aston Villa,Southampton,Win,Home,2004-08-14,3,1,4,7,8,1,2,2,2,0,2,5,6,1,6.0,12.0,-6.0,1
1385,1385,2004-05,2004,2005,Aston Villa,West Brom,Draw,Away,2004-08-22,1,3,4,7,10,2,3,3,3,1,1,4,7,0,6.0,21.0,-15.0,1
1386,1386,2004-05,2004,2005,Aston Villa,Charlton,Loss,Away,2004-08-25,0,4,4,5,8,3,6,7,8,1,-2,-2,0,0,6.0,7.0,-1.0,1
1387,1387,2004-05,2004,2005,Aston Villa,Newcastle,Win,Home,2004-08-28,3,1,4,4,5,1,2,3,4,0,2,1,1,1,6.0,5.0,1.0,1
1388,1388,2004-05,2004,2005,Aston Villa,Chelsea,Draw,Home,2004-09-11,1,3,4,7,7,6,9,12,15,-3,-5,-5,-8,1,6.0,2.0,4.0,2
1389,1389,2004-05,2004,2005,Aston Villa,Norwich,Draw,Away,2004-09-18,1,4,4,5,8,1,2,2,3,3,2,3,5,0,6.0,21.0,-15.0,2
1390,1390,2004-05,2004,2005,Aston Villa,Crystal Palace,Draw,Home,2004-09-25,1,2,5,5,6,0,0,0,0,2,5,5,6,1,6.0,21.0,-15.0,2
1391,1391,2004-05,2004,2005,Aston Villa,Blackburn,Draw,Away,2004-10-02,1,2,3,6,6,3,3,4,4,-1,0,2,2,0,6.0,15.0,-9.0,3
1392,1392,2004-05,2004,2005,Aston Villa,Arsenal,Loss,Away,2004-10-16,0,2,3,4,7,6,7,10,13,-4,-4,-6,-6,0,6.0,1.0,5.0,3
1393,1393,2004-05,2004,2005,Aston Villa,Fulham,Win,Home,2004-10-23,3,1,2,3,4,0,3,4,4,1,-1,-1,0,1,6.0,9.0,-3.0,3
1394,1394,2004-05,2004,2005,Aston Villa,Everton,Draw,Away,2004-10-30,1,3,4,5,6,6,6,9,12,-3,-2,-4,-6,0,6.0,17.0,-11.0,3
1395,1395,2004-05,2004,2005,Aston Villa,Portsmouth,Win,Home,2004-11-06,3,4,4,5,6,4,7,8,8,0,-3,-3,-2,1,6.0,13.0,-7.0,4
1396,1396,2004-05,2004,2005,Aston Villa,Bolton,Win,Away,2004-11-13,3,4,7,7,8,4,7,10,10,0,0,-3,-2,0,6.0,8.0,-2.0,4
1397,1397,2004-05,2004,2005,Aston Villa,Tottenham,Win,Home,2004-11-22,3,6,7,10,10,0,0,0,0,6,7,10,10,1,6.0,14.0,-8.0,4
1398,1398,2004-05,2004,2005,Aston Villa,Man City,Loss,Away,2004-11-27,0,6,9,10,13,4,5,6,6,2,4,4,7,0,6.0,16.0,-10.0,4
1399,1399,2004-05,2004,2005,Aston Villa,Liverpool,Draw,Home,2004-12-04,1,3,6,9,10,3,6,6,7,0,0,3,3,1,6.0,4.0,2.0,5
1400,1400,2004-05,2004,2005,Aston Villa,Birmingham,Loss,Home,2004-12-12,0,1,4,7,10,1,2,2,5,0,2,5,5,1,6.0,10.0,-4.0,5
1401,1401,2004-05,2004,2005,Aston Villa,Middlesbrough,Loss,Away,2004-12-18,0,1,1,4,7,4,4,7,10,-3,-3,-3,-3,0,6.0,11.0,-5.0,5
1402,1402,2004-05,2004,2005,Aston Villa,Chelsea,Loss,Away,2004-12-26,0,0,1,1,4,4,7,10,11,-4,-6,-9,-7,0,6.0,2.0,4.0,5
1403,1403,2004-05,2004,2005,Aston Villa,Man United,Loss,Home,2004-12-28,0,0,0,1,1,6,7,10,13,-6,-7,-9,-12,1,6.0,3.0,3.0,5
1404,1404,2004-05,2004,2005,Aston Villa,Blackburn,Win,Home,2005-01-01,3,0,0,0,1,4,5,6,6,-4,-5,-6,-5,1,6.0,15.0,-9.0,6
1405,1405,2004-05,2004,2005,Aston Villa,Crystal Palace,Loss,Away,2005-01-03,0,3,3,3,3,1,1,1,2,2,2,2,1,0,6.0,21.0,-15.0,6
1406,1406,2004-05,2004,2005,Aston Villa,Norwich,Win,Home,2005-01-15,3,3,3,3,3,1,1,1,1,2,2,2,2,1,6.0,21.0,-15.0,6
1407,1407,2004-05,2004,2005,Aston Villa,Man United,Loss,Away,2005-01-22,0,3,6,6,6,4,7,10,13,-1,-1,-4,-7,0,6.0,3.0,3.0,6
1408,1408,2004-05,2004,2005,Aston Villa,Fulham,Draw,Away,2005-02-02,1,3,3,6,6,6,7,10,10,-3,-4,-4,-4,0,6.0,9.0,-3.0,7
1409,1409,2004-05,2004,2005,Aston Villa,Arsenal,Loss,Home,2005-02-05,0,1,4,4,7,3,3,4,7,-2,1,0,0,1,6.0,1.0,5.0,7
1410,1410,2004-05,2004,2005,Aston Villa,Portsmouth,Win,Away,2005-02-12,3,1,1,4,4,3,3,3,3,-2,-2,1,1,0,6.0,13.0,-7.0,7
1411,1411,2004-05,2004,2005,Aston Villa,Everton,Loss,Home,2005-02-26,0,3,4,4,7,1,4,4,5,2,0,0,2,1,6.0,17.0,-11.0,7
1412,1412,2004-05,2004,2005,Aston Villa,Middlesbrough,Win,Home,2005-03-05,3,3,3,4,4,2,5,5,6,1,-2,-1,-2,1,6.0,11.0,-5.0,8
1413,1413,2004-05,2004,2005,Aston Villa,Birmingham,Loss,Away,2005-03-20,0,3,6,6,7,0,3,3,6,3,3,3,1,0,6.0,10.0,-4.0,8
1414,1414,2004-05,2004,2005,Aston Villa,Newcastle,Win,Away,2005-04-02,3,3,3,6,6,4,7,8,9,-1,-4,-2,-3,0,6.0,5.0,1.0,9
1415,1415,2004-05,2004,2005,Aston Villa,West Brom,Draw,Home,2005-04-10,1,3,6,6,9,6,6,9,10,-3,0,-3,-1,1,6.0,21.0,-15.0,9
1416,1416,2004-05,2004,2005,Aston Villa,Southampton,Win,Away,2005-04-16,3,4,4,7,7,0,3,6,7,4,1,1,0,0,6.0,12.0,-6.0,9
1417,1417,2004-05,2004,2005,Aston Villa,Charlton,Draw,Home,2005-04-20,1,4,7,7,10,0,1,1,4,4,6,6,6,1,6.0,7.0,-1.0,9
1418,1418,2004-05,2004,2005,Aston Villa,Bolton,Draw,Home,2005-04-23,1,4,5,8,8,4,7,7,10,0,-2,1,-2,1,6.0,8.0,-2.0,9
1419,1419,2004-05,2004,2005,Aston Villa,Tottenham,Loss,Away,2005-05-01,0,2,5,6,9,1,2,5,6,1,3,1,3,0,6.0,14.0,-8.0,10
1420,1420,2004-05,2004,2005,Aston Villa,Man City,Loss,Home,2005-05-07,0,1,2,5,6,4,7,8,11,-3,-5,-3,-5,1,6.0,16.0,-10.0,10
1421,1421,2004-05,2004,2005,Aston Villa,Liverpool,Loss,Away,2005-05-15,0,0,1,2,5,1,1,4,5,-1,0,-2,0,0,6.0,4.0,2.0,10
1422,1422,2005-06,2005,2006,Aston Villa,Bolton,Draw,Home,2005-08-13,1,0,0,1,2,4,4,5,6,-4,-4,-4,-4,1,10.0,6.0,4.0,1
1423,1423,2005-06,2005,2006,Aston Villa,Man United,Loss,Away,2005-08-20,0,1,1,1,2,6,6,7,10,-5,-5,-6,-8,0,10.0,3.0,7.0,1
1424,1424,2005-06,2005,2006,Aston Villa,Portsmouth,Draw,Away,2005-08-23,1,1,1,1,1,0,0,1,1,1,1,0,0,0,10.0,16.0,-6.0,1
1425,1425,2005-06,2005,2006,Aston Villa,Blackburn,Win,Home,2005-08-27,3,1,2,2,2,4,4,5,5,-3,-2,-3,-3,1,10.0,15.0,-5.0,1
1426,1426,2005-06,2005,2006,Aston Villa,West Ham,Loss,Away,2005-09-12,0,4,4,5,5,1,4,5,8,3,0,0,-3,0,10.0,21.0,-11.0,2
1427,1427,2005-06,2005,2006,Aston Villa,Tottenham,Draw,Home,2005-09-17,1,3,4,4,5,1,2,5,8,2,2,-1,-3,1,10.0,9.0,1.0,2
1428,1428,2005-06,2005,2006,Aston Villa,Chelsea,Loss,Away,2005-09-24,0,1,4,5,5,6,9,12,15,-5,-5,-7,-10,0,10.0,1.0,9.0,2
1429,1429,2005-06,2005,2006,Aston Villa,Middlesbrough,Loss,Home,2005-10-02,0,1,1,4,5,1,4,4,7,0,-3,0,-2,1,10.0,7.0,3.0,3
1430,1430,2005-06,2005,2006,Aston Villa,Birmingham,Win,Away,2005-10-16,3,0,1,1,4,1,2,2,5,-1,-1,-1,-1,0,10.0,12.0,-2.0,3
1431,1431,2005-06,2005,2006,Aston Villa,Wigan,Loss,Home,2005-10-22,0,3,3,4,4,6,9,10,13,-3,-6,-6,-9,1,10.0,21.0,-11.0,3
1432,1432,2005-06,2005,2006,Aston Villa,Man City,Loss,Away,2005-10-31,0,3,3,3,4,3,6,6,6,0,-3,-3,-2,0,10.0,8.0,2.0,3
1433,1433,2005-06,2005,2006,Aston Villa,Liverpool,Loss,Home,2005-11-05,0,0,3,3,3,3,6,6,7,-3,-3,-3,-4,1,10.0,5.0,5.0,4
1434,1434,2005-06,2005,2006,Aston Villa,Sunderland,Win,Away,2005-11-19,3,0,0,3,3,0,0,0,1,0,0,3,2,0,10.0,21.0,-11.0,4
1435,1435,2005-06,2005,2006,Aston Villa,Charlton,Win,Home,2005-11-26,3,3,3,3,6,0,0,3,4,3,3,0,2,1,10.0,11.0,-1.0,4
1436,1436,2005-06,2005,2006,Aston Villa,Newcastle,Draw,Away,2005-12-03,1,6,6,6,6,0,3,6,9,6,3,0,-3,0,10.0,14.0,-4.0,5
1437,1437,2005-06,2005,2006,Aston Villa,Bolton,Draw,Away,2005-12-10,1,4,7,7,7,3,6,9,12,1,1,-2,-5,0,10.0,6.0,4.0,5
1438,1438,2005-06,2005,2006,Aston Villa,Man United,Loss,Home,2005-12-17,0,2,5,8,8,4,7,10,13,-2,-2,-2,-5,1,10.0,3.0,7.0,5
1439,1439,2005-06,2005,2006,Aston Villa,Everton,Win,Home,2005-12-26,3,1,2,5,8,0,1,4,7,1,1,1,1,1,10.0,4.0,6.0,5
1440,1440,2005-06,2005,2006,Aston Villa,Fulham,Draw,Away,2005-12-28,1,3,4,5,8,3,3,4,7,0,1,1,1,0,10.0,13.0,-3.0,5
1441,1441,2005-06,2005,2006,Aston Villa,Arsenal,Draw,Home,2005-12-31,1,4,4,5,6,6,6,6,6,-2,-2,-1,0,1,10.0,2.0,8.0,5
1442,1442,2005-06,2005,2006,Aston Villa,West Brom,Win,Away,2006-01-02,3,2,5,5,6,3,3,3,6,-1,2,2,0,0,10.0,17.0,-7.0,6
1443,1443,2005-06,2005,2006,Aston Villa,West Ham,Loss,Home,2006-01-14,0,4,5,8,8,0,0,1,1,4,5,7,7,1,10.0,21.0,-11.0,6
1444,1444,2005-06,2005,2006,Aston Villa,Tottenham,Draw,Away,2006-01-21,1,3,4,5,8,3,6,6,9,0,-2,-1,-1,0,10.0,9.0,1.0,6
1445,1445,2005-06,2005,2006,Aston Villa,Chelsea,Draw,Home,2006-02-01,1,1,4,5,6,4,7,10,13,-3,-3,-5,-7,1,10.0,1.0,9.0,7
1446,1446,2005-06,2005,2006,Aston Villa,Middlesbrough,Win,Away,2006-02-04,3,2,2,5,6,3,3,4,5,-1,-1,1,1,0,10.0,7.0,3.0,7
1447,1447,2005-06,2005,2006,Aston Villa,Newcastle,Loss,Home,2006-02-11,0,4,5,5,8,3,3,3,4,1,2,2,4,1,10.0,14.0,-4.0,7
1448,1448,2005-06,2005,2006,Aston Villa,Charlton,Draw,Away,2006-02-25,1,3,4,5,5,1,4,4,5,2,0,1,0,0,10.0,11.0,-1.0,7
1449,1449,2005-06,2005,2006,Aston Villa,Portsmouth,Win,Home,2006-03-04,3,1,4,5,6,0,0,1,1,1,4,4,5,1,10.0,16.0,-6.0,8
1450,1450,2005-06,2005,2006,Aston Villa,Blackburn,Loss,Away,2006-03-11,0,4,4,7,8,3,6,6,6,1,-2,1,2,0,10.0,15.0,-5.0,8
1451,1451,2005-06,2005,2006,Aston Villa,Everton,Loss,Away,2006-03-18,0,3,4,4,7,4,4,7,10,-1,0,-3,-3,0,10.0,4.0,6.0,8
1452,1452,2005-06,2005,2006,Aston Villa,Fulham,Draw,Home,2006-03-25,1,0,3,4,4,3,3,3,3,-3,0,1,1,1,10.0,13.0,-3.0,8
1453,1453,2005-06,2005,2006,Aston Villa,Arsenal,Loss,Away,2006-04-01,0,1,1,4,5,6,9,9,9,-5,-8,-5,-4,0,10.0,2.0,8.0,9
1454,1454,2005-06,2005,2006,Aston Villa,West Brom,Draw,Home,2006-04-09,1,1,1,1,4,0,0,1,1,1,1,0,3,1,10.0,17.0,-7.0,9
1455,1455,2005-06,2005,2006,Aston Villa,Birmingham,Win,Home,2006-04-16,3,1,2,2,2,4,5,5,5,-3,-3,-3,-3,1,10.0,12.0,-2.0,9
1456,1456,2005-06,2005,2006,Aston Villa,Wigan,Loss,Away,2006-04-18,0,4,4,5,5,1,2,2,5,3,2,3,0,0,10.0,21.0,-11.0,9
1457,1457,2005-06,2005,2006,Aston Villa,Man City,Loss,Home,2006-04-25,0,3,4,4,5,0,0,0,0,3,4,4,5,1,10.0,8.0,2.0,9
1458,1458,2005-06,2005,2006,Aston Villa,Liverpool,Loss,Away,2006-04-29,0,0,3,4,4,6,9,12,15,-6,-6,-8,-11,0,10.0,5.0,5.0,9
1459,1459,2005-06,2005,2006,Aston Villa,Sunderland,Win,Home,2006-05-07,3,0,0,3,4,3,3,3,4,-3,-3,0,0,1,10.0,21.0,-11.0,10
1460,1460,2006-07,2006,2007,Aston Villa,Arsenal,Draw,Away,2006-08-19,1,3,3,3,6,6,9,10,13,-3,-6,-7,-7,0,16.0,4.0,12.0,1
1461,1461,2006-07,2006,2007,Aston Villa,Reading,Win,Home,2006-08-23,3,4,4,4,4,3,3,3,3,1,1,1,1,1,16.0,21.0,-5.0,1
1462,1462,2006-07,2006,2007,Aston Villa,Newcastle,Win,Home,2006-08-27,3,4,7,7,7,6,7,10,13,-2,0,-3,-6,1,16.0,7.0,9.0,1
1463,1463,2006-07,2006,2007,Aston Villa,West Ham,Draw,Away,2006-09-10,1,6,7,10,10,1,4,7,10,5,3,3,0,0,16.0,9.0,7.0,2
1464,1464,2006-07,2006,2007,Aston Villa,Watford,Draw,Away,2006-09-16,1,4,7,8,11,0,1,1,4,4,6,7,7,0,16.0,21.0,-5.0,2
1465,1465,2006-07,2006,2007,Aston Villa,Charlton,Win,Home,2006-09-23,3,2,5,8,9,0,3,3,3,2,2,5,6,1,16.0,13.0,3.0,2
1466,1466,2006-07,2006,2007,Aston Villa,Chelsea,Draw,Away,2006-09-30,1,4,5,8,11,6,9,12,12,-2,-4,-4,-1,0,16.0,1.0,15.0,2
1467,1467,2006-07,2006,2007,Aston Villa,Tottenham,Draw,Home,2006-10-14,1,4,5,6,9,3,4,4,4,1,1,2,5,1,16.0,5.0,11.0,3
1468,1468,2006-07,2006,2007,Aston Villa,Fulham,Draw,Home,2006-10-21,1,2,5,6,7,4,4,5,8,-2,1,1,-1,1,16.0,12.0,4.0,3
1469,1469,2006-07,2006,2007,Aston Villa,Liverpool,Loss,Away,2006-10-28,0,2,3,6,7,1,1,4,7,1,2,2,0,0,16.0,3.0,13.0,3
1470,1470,2006-07,2006,2007,Aston Villa,Blackburn,Win,Home,2006-11-05,3,1,2,3,6,0,1,4,7,1,1,-1,-1,1,16.0,6.0,10.0,4
1471,1471,2006-07,2006,2007,Aston Villa,Everton,Win,Away,2006-11-11,3,3,4,5,6,1,4,4,5,2,0,1,1,0,16.0,11.0,5.0,4
1472,1472,2006-07,2006,2007,Aston Villa,Wigan,Draw,Away,2006-11-19,1,6,6,7,8,6,9,12,12,0,-3,-5,-4,0,16.0,10.0,6.0,4
1473,1473,2006-07,2006,2007,Aston Villa,Middlesbrough,Draw,Home,2006-11-25,1,4,7,7,8,4,4,4,7,0,3,3,1,1,16.0,14.0,2.0,4
1474,1474,2006-07,2006,2007,Aston Villa,Man City,Loss,Home,2006-11-29,0,2,5,8,8,3,4,4,7,-1,1,4,1,1,16.0,15.0,1.0,4
1475,1475,2006-07,2006,2007,Aston Villa,Portsmouth,Draw,Away,2006-12-02,1,1,2,5,8,1,4,5,5,0,-2,0,3,0,16.0,17.0,-1.0,5
1476,1476,2006-07,2006,2007,Aston Villa,Sheffield United,Draw,Away,2006-12-11,1,1,2,3,6,6,6,6,7,-5,-4,-3,-1,0,16.0,21.0,-5.0,5
1477,1477,2006-07,2006,2007,Aston Villa,Bolton,Loss,Home,2006-12-16,0,2,2,3,4,3,3,6,6,-1,-1,-3,-2,1,16.0,8.0,8.0,5
1478,1478,2006-07,2006,2007,Aston Villa,Man United,Loss,Home,2006-12-23,0,1,2,2,3,3,6,9,10,-2,-4,-7,-7,1,16.0,2.0,14.0,5
1479,1479,2006-07,2006,2007,Aston Villa,Tottenham,Loss,Away,2006-12-26,0,0,1,2,2,3,6,9,9,-3,-5,-7,-7,0,16.0,5.0,11.0,5
1480,1480,2006-07,2006,2007,Aston Villa,Charlton,Loss,Away,2006-12-30,0,0,0,1,2,1,1,1,4,-1,-1,0,-2,0,16.0,13.0,3.0,5
1481,1481,2006-07,2006,2007,Aston Villa,Chelsea,Draw,Home,2007-01-02,1,0,0,0,1,2,5,8,11,-2,-5,-8,-10,1,16.0,1.0,15.0,6
1482,1482,2006-07,2006,2007,Aston Villa,Man United,Loss,Away,2007-01-13,0,1,1,1,1,4,7,10,10,-3,-6,-9,-9,0,16.0,2.0,14.0,6
1483,1483,2006-07,2006,2007,Aston Villa,Watford,Win,Home,2007-01-20,3,1,1,1,1,1,1,1,1,0,0,0,0,1,16.0,21.0,-5.0,6
1484,1484,2006-07,2006,2007,Aston Villa,Newcastle,Loss,Away,2007-01-31,0,3,4,4,4,4,5,5,5,-1,-1,-1,-1,0,16.0,7.0,9.0,6
1485,1485,2006-07,2006,2007,Aston Villa,West Ham,Win,Home,2007-02-03,3,3,3,4,4,1,2,2,2,2,1,2,2,1,16.0,9.0,7.0,7
1486,1486,2006-07,2006,2007,Aston Villa,Reading,Loss,Away,2007-02-10,0,3,6,6,7,6,9,10,13,-3,-3,-4,-6,0,16.0,21.0,-5.0,7
1487,1487,2006-07,2006,2007,Aston Villa,Fulham,Draw,Away,2007-03-03,1,3,3,6,6,0,3,3,4,3,0,3,2,0,16.0,12.0,4.0,8
1488,1488,2006-07,2006,2007,Aston Villa,Arsenal,Loss,Home,2007-03-14,0,1,4,4,7,6,7,10,13,-5,-3,-6,-6,1,16.0,4.0,12.0,8
1489,1489,2006-07,2006,2007,Aston Villa,Liverpool,Draw,Home,2007-03-18,1,1,1,4,4,3,3,4,7,-2,-2,0,-3,1,16.0,3.0,13.0,8
1490,1490,2006-07,2006,2007,Aston Villa,Everton,Draw,Home,2007-04-02,1,1,2,2,5,4,7,7,10,-3,-5,-5,-5,1,16.0,11.0,5.0,9
1491,1491,2006-07,2006,2007,Aston Villa,Blackburn,Win,Away,2007-04-07,3,2,2,3,3,0,3,6,6,2,-1,-3,-3,0,16.0,6.0,10.0,9
1492,1492,2006-07,2006,2007,Aston Villa,Wigan,Draw,Home,2007-04-09,1,4,5,5,6,0,1,4,7,4,4,1,-1,1,16.0,10.0,6.0,9
1493,1493,2006-07,2006,2007,Aston Villa,Middlesbrough,Win,Away,2007-04-14,3,4,5,6,6,3,3,4,7,1,2,2,-1,0,16.0,14.0,2.0,9
1494,1494,2006-07,2006,2007,Aston Villa,Portsmouth,Draw,Home,2007-04-22,1,4,7,8,9,3,6,7,8,1,1,1,1,1,16.0,17.0,-1.0,9
1495,1495,2006-07,2006,2007,Aston Villa,Man City,Win,Away,2007-04-28,3,4,5,8,9,1,2,5,6,3,3,3,3,0,16.0,15.0,1.0,9
1496,1496,2006-07,2006,2007,Aston Villa,Sheffield United,Win,Home,2007-05-05,3,4,7,8,11,4,4,7,7,0,3,1,4,1,16.0,21.0,-5.0,10
1497,1497,2006-07,2006,2007,Aston Villa,Bolton,Draw,Away,2007-05-13,1,6,7,10,11,1,1,1,2,5,6,9,9,0,16.0,8.0,8.0,10
1498,1498,2007-08,2007,2008,Aston Villa,Liverpool,Loss,Home,2007-08-11,0,4,7,8,11,1,1,4,7,3,6,4,4,1,11.0,3.0,8.0,1
1499,1499,2007-08,2007,2008,Aston Villa,Newcastle,Draw,Away,2007-08-18,1,1,4,7,8,4,4,4,5,-3,0,3,3,0,11.0,13.0,-2.0,1
1500,1500,2007-08,2007,2008,Aston Villa,Fulham,Win,Home,2007-08-25,3,1,2,5,8,3,3,3,6,-2,-1,2,2,1,11.0,16.0,-5.0,1
1501,1501,2007-08,2007,2008,Aston Villa,Chelsea,Win,Home,2007-09-02,3,4,4,5,8,4,7,10,11,0,-3,-5,-3,1,11.0,2.0,9.0,2
1502,1502,2007-08,2007,2008,Aston Villa,Man City,Loss,Away,2007-09-16,0,6,7,7,8,0,3,6,9,6,4,1,-1,0,11.0,14.0,-3.0,2
1503,1503,2007-08,2007,2008,Aston Villa,Everton,Win,Home,2007-09-23,3,3,6,7,7,3,4,4,7,0,2,3,0,1,11.0,6.0,5.0,2
1504,1504,2007-08,2007,2008,Aston Villa,Tottenham,Draw,Away,2007-10-01,1,3,6,9,10,1,2,2,5,2,4,7,5,0,11.0,5.0,6.0,3
1505,1505,2007-08,2007,2008,Aston Villa,West Ham,Win,Home,2007-10-06,3,4,4,7,10,0,3,6,7,4,1,1,3,1,11.0,15.0,-4.0,3
1506,1506,2007-08,2007,2008,Aston Villa,Man United,Loss,Home,2007-10-20,0,4,7,7,10,6,9,12,15,-2,-2,-5,-5,1,11.0,1.0,10.0,3
1507,1507,2007-08,2007,2008,Aston Villa,Bolton,Draw,Away,2007-10-28,1,3,4,7,7,0,1,2,2,3,3,5,5,0,11.0,7.0,4.0,3
1508,1508,2007-08,2007,2008,Aston Villa,Derby,Win,Home,2007-11-03,3,1,4,5,8,1,1,2,2,0,3,3,6,1,11.0,21.0,-10.0,4
1509,1509,2007-08,2007,2008,Aston Villa,Birmingham,Win,Away,2007-11-11,3,4,4,7,8,3,3,3,3,1,1,4,5,0,11.0,21.0,-10.0,4
1510,1510,2007-08,2007,2008,Aston Villa,Middlesbrough,Win,Away,2007-11-24,3,6,7,7,10,2,2,2,2,4,5,5,8,0,11.0,12.0,-1.0,4
1511,1511,2007-08,2007,2008,Aston Villa,Blackburn,Win,Away,2007-11-28,3,6,9,10,10,1,2,5,8,5,7,5,2,0,11.0,10.0,1.0,4
1512,1512,2007-08,2007,2008,Aston Villa,Arsenal,Loss,Home,2007-12-01,0,6,9,12,13,6,7,8,11,0,2,4,2,1,11.0,4.0,7.0,5
1513,1513,2007-08,2007,2008,Aston Villa,Portsmouth,Loss,Home,2007-12-08,0,3,6,9,12,4,5,8,9,-1,1,1,3,1,11.0,9.0,2.0,5
1514,1514,2007-08,2007,2008,Aston Villa,Sunderland,Draw,Away,2007-12-15,1,0,3,6,9,3,3,4,4,-3,0,2,5,0,11.0,21.0,-10.0,5
1515,1515,2007-08,2007,2008,Aston Villa,Man City,Draw,Home,2007-12-22,1,1,1,4,7,3,4,7,8,-2,-3,-3,-1,1,11.0,14.0,-3.0,5
1516,1516,2007-08,2007,2008,Aston Villa,Chelsea,Draw,Away,2007-12-26,1,2,2,2,5,3,6,9,12,-1,-4,-7,-7,0,11.0,2.0,9.0,5
1517,1517,2007-08,2007,2008,Aston Villa,Wigan,Win,Away,2007-12-29,3,2,3,3,3,4,7,7,8,-2,-4,-4,-5,0,11.0,17.0,-6.0,5
1518,1518,2007-08,2007,2008,Aston Villa,Tottenham,Win,Home,2008-01-01,3,4,5,6,6,6,6,9,12,-2,-1,-3,-6,1,11.0,5.0,6.0,6
1519,1519,2007-08,2007,2008,Aston Villa,Reading,Win,Home,2008-01-12,3,6,7,8,9,0,1,4,5,6,6,4,4,1,11.0,8.0,3.0,6
1520,1520,2007-08,2007,2008,Aston Villa,Liverpool,Draw,Away,2008-01-21,1,6,9,10,11,2,3,6,9,4,6,4,2,0,11.0,3.0,8.0,6
1521,1521,2007-08,2007,2008,Aston Villa,Blackburn,Draw,Home,2008-01-26,1,4,7,10,11,4,7,10,11,0,0,0,0,1,11.0,10.0,1.0,6
1522,1522,2007-08,2007,2008,Aston Villa,Fulham,Loss,Away,2008-02-03,0,2,5,8,11,1,1,1,2,1,4,7,9,0,11.0,16.0,-5.0,7
1523,1523,2007-08,2007,2008,Aston Villa,Newcastle,Win,Home,2008-02-09,3,1,2,5,8,1,2,2,2,0,0,3,6,1,11.0,13.0,-2.0,7
1524,1524,2007-08,2007,2008,Aston Villa,Reading,Win,Away,2008-02-24,3,3,4,5,8,0,0,0,0,3,4,5,8,0,11.0,8.0,3.0,7
1525,1525,2007-08,2007,2008,Aston Villa,Arsenal,Draw,Away,2008-03-01,1,6,6,7,8,4,7,10,13,2,-1,-3,-5,0,11.0,4.0,7.0,8
1526,1526,2007-08,2007,2008,Aston Villa,Middlesbrough,Draw,Home,2008-03-12,1,4,7,7,8,0,3,4,7,4,4,3,1,1,11.0,12.0,-1.0,8
1527,1527,2007-08,2007,2008,Aston Villa,Portsmouth,Loss,Away,2008-03-15,0,2,5,8,8,3,6,9,10,-1,-1,-1,-2,0,11.0,9.0,2.0,8
1528,1528,2007-08,2007,2008,Aston Villa,Sunderland,Loss,Home,2008-03-22,0,1,2,5,8,0,1,1,4,1,1,4,4,1,11.0,21.0,-10.0,8
1529,1529,2007-08,2007,2008,Aston Villa,Man United,Loss,Away,2008-03-29,0,0,1,2,5,6,9,12,15,-6,-8,-10,-10,0,11.0,1.0,10.0,8
1530,1530,2007-08,2007,2008,Aston Villa,Bolton,Win,Home,2008-04-05,3,0,0,1,2,1,1,1,1,-1,-1,0,1,1,11.0,7.0,4.0,9
1531,1531,2007-08,2007,2008,Aston Villa,Derby,Win,Away,2008-04-12,3,3,3,3,4,1,1,1,1,2,2,2,3,0,11.0,21.0,-10.0,9
1532,1532,2007-08,2007,2008,Aston Villa,Birmingham,Win,Home,2008-04-20,3,6,6,6,6,1,4,4,5,5,2,2,1,1,11.0,21.0,-10.0,9
1533,1533,2007-08,2007,2008,Aston Villa,Everton,Draw,Away,2008-04-27,1,6,9,9,9,1,4,4,5,5,5,5,4,0,11.0,6.0,5.0,9
1534,1534,2007-08,2007,2008,Aston Villa,Wigan,Loss,Home,2008-05-03,0,4,7,10,10,2,3,6,6,2,4,4,4,1,11.0,17.0,-6.0,10
1535,1535,2007-08,2007,2008,Aston Villa,West Ham,Draw,Away,2008-05-11,1,1,4,7,10,1,4,4,4,0,0,3,6,0,11.0,15.0,-4.0,10
1536,1536,2008-09,2008,2009,Aston Villa,Man City,Win,Home,2008-08-17,3,1,2,5,8,0,0,3,6,1,2,2,2,1,6.0,9.0,-3.0,1
1537,1537,2008-09,2008,2009,Aston Villa,Stoke,Loss,Away,2008-08-23,0,4,4,5,8,0,0,0,0,4,4,5,8,0,6.0,21.0,-15.0,1
1538,1538,2008-09,2008,2009,Aston Villa,Liverpool,Draw,Home,2008-08-31,1,3,4,4,5,6,9,12,13,-3,-5,-8,-8,1,6.0,4.0,2.0,1
1539,1539,2008-09,2008,2009,Aston Villa,Tottenham,Win,Away,2008-09-15,3,1,4,5,5,1,1,1,4,0,3,4,1,0,6.0,11.0,-5.0,2
1540,1540,2008-09,2008,2009,Aston Villa,West Brom,Win,Away,2008-09-21,3,4,4,7,8,4,4,4,5,0,0,3,3,0,6.0,21.0,-15.0,2
1541,1541,2008-09,2008,2009,Aston Villa,Sunderland,Win,Home,2008-09-27,3,6,7,7,10,4,4,7,7,2,3,0,3,1,6.0,15.0,-9.0,2
1542,1542,2008-09,2008,2009,Aston Villa,Chelsea,Loss,Away,2008-10-05,0,6,9,10,10,4,7,8,11,2,2,2,-1,0,6.0,2.0,4.0,3
1543,1543,2008-09,2008,2009,Aston Villa,Portsmouth,Draw,Home,2008-10-18,1,3,6,9,10,6,6,9,12,-3,0,0,-2,1,6.0,8.0,-2.0,3
1544,1544,2008-09,2008,2009,Aston Villa,Wigan,Win,Away,2008-10-26,3,1,4,7,10,0,3,4,5,1,1,3,5,0,6.0,14.0,-8.0,3
1545,1545,2008-09,2008,2009,Aston Villa,Blackburn,Win,Home,2008-10-29,3,4,4,7,10,2,2,5,8,2,2,2,2,1,6.0,7.0,-1.0,3
1546,1546,2008-09,2008,2009,Aston Villa,Newcastle,Loss,Away,2008-11-03,0,6,7,7,10,3,4,5,5,3,3,2,5,0,6.0,12.0,-6.0,4
1547,1547,2008-09,2008,2009,Aston Villa,Middlesbrough,Loss,Home,2008-11-09,0,3,6,7,7,4,5,5,8,-1,1,2,-1,1,6.0,13.0,-7.0,4
1548,1548,2008-09,2008,2009,Aston Villa,Arsenal,Win,Away,2008-11-15,3,0,3,6,7,3,4,7,10,-3,-1,-1,-3,0,6.0,3.0,3.0,4
1549,1549,2008-09,2008,2009,Aston Villa,Man United,Draw,Home,2008-11-22,1,3,3,6,9,3,6,9,10,0,-3,-3,-1,1,6.0,1.0,5.0,4
1550,1550,2008-09,2008,2009,Aston Villa,Fulham,Draw,Home,2008-11-29,1,4,4,4,7,4,7,7,10,0,-3,-3,-3,1,6.0,17.0,-11.0,4
1551,1551,2008-09,2008,2009,Aston Villa,Everton,Win,Away,2008-12-07,3,2,5,5,5,3,4,7,10,-1,1,-2,-5,0,6.0,5.0,1.0,5
1552,1552,2008-09,2008,2009,Aston Villa,Bolton,Win,Home,2008-12-13,3,4,5,8,8,3,6,6,9,1,-1,2,-1,1,6.0,16.0,-10.0,5
1553,1553,2008-09,2008,2009,Aston Villa,West Ham,Win,Away,2008-12-20,3,6,7,8,11,1,2,5,6,5,5,3,5,0,6.0,10.0,-4.0,5
1554,1554,2008-09,2008,2009,Aston Villa,Arsenal,Draw,Home,2008-12-26,1,6,9,10,11,2,5,8,8,4,4,2,3,1,6.0,3.0,3.0,5
1555,1555,2008-09,2008,2009,Aston Villa,Hull,Win,Away,2008-12-30,3,4,7,10,11,0,1,4,5,4,6,6,6,0,6.0,21.0,-15.0,5
1556,1556,2008-09,2008,2009,Aston Villa,West Brom,Win,Home,2009-01-10,3,4,7,10,13,3,6,6,7,1,1,4,6,1,6.0,21.0,-15.0,6
1557,1557,2008-09,2008,2009,Aston Villa,Sunderland,Win,Away,2009-01-17,3,6,7,10,13,1,2,5,8,5,5,5,5,0,6.0,15.0,-9.0,6
1558,1558,2008-09,2008,2009,Aston Villa,Portsmouth,Win,Away,2009-01-27,3,6,9,10,13,1,1,1,1,5,8,9,12,0,6.0,8.0,-2.0,6
1559,1559,2008-09,2008,2009,Aston Villa,Wigan,Draw,Home,2009-01-31,1,6,9,12,13,1,1,4,7,5,8,8,6,1,6.0,14.0,-8.0,6
1560,1560,2008-09,2008,2009,Aston Villa,Blackburn,Win,Away,2009-02-07,3,4,7,10,13,2,5,6,7,2,2,4,6,0,6.0,7.0,-1.0,7
1561,1561,2008-09,2008,2009,Aston Villa,Chelsea,Loss,Home,2009-02-21,0,4,7,10,13,1,4,7,7,3,3,3,6,1,6.0,2.0,4.0,7
1562,1562,2008-09,2008,2009,Aston Villa,Stoke,Draw,Home,2009-03-01,1,3,4,7,10,1,4,4,4,2,0,3,6,1,6.0,21.0,-15.0,8
1563,1563,2008-09,2008,2009,Aston Villa,Man City,Loss,Away,2009-03-04,0,1,4,5,8,1,1,4,4,0,3,1,4,0,6.0,9.0,-3.0,8
1564,1564,2008-09,2008,2009,Aston Villa,Tottenham,Loss,Home,2009-03-15,0,1,1,4,5,4,7,8,8,-3,-6,-4,-3,1,6.0,11.0,-5.0,8
1565,1565,2008-09,2008,2009,Aston Villa,Liverpool,Loss,Away,2009-03-22,0,0,1,1,4,6,6,7,10,-6,-5,-6,-6,0,6.0,4.0,2.0,8
1566,1566,2008-09,2008,2009,Aston Villa,Man United,Loss,Away,2009-04-05,0,0,0,1,1,0,3,6,9,0,-3,-5,-8,0,6.0,1.0,5.0,9
1567,1567,2008-09,2008,2009,Aston Villa,Everton,Draw,Home,2009-04-12,1,0,0,0,1,3,6,7,10,-3,-6,-7,-9,1,6.0,5.0,1.0,9
1568,1568,2008-09,2008,2009,Aston Villa,West Ham,Draw,Home,2009-04-18,1,1,1,1,1,3,4,5,8,-2,-3,-4,-7,1,6.0,10.0,-4.0,9
1569,1569,2008-09,2008,2009,Aston Villa,Bolton,Draw,Away,2009-04-25,1,2,2,2,2,0,3,4,4,2,-1,-2,-2,0,6.0,16.0,-10.0,9
1570,1570,2008-09,2008,2009,Aston Villa,Hull,Win,Home,2009-05-04,3,2,3,3,3,0,0,1,1,2,3,2,2,1,6.0,21.0,-15.0,10
1571,1571,2008-09,2008,2009,Aston Villa,Fulham,Loss,Away,2009-05-09,0,4,5,6,6,3,4,7,7,1,1,-1,-1,0,6.0,17.0,-11.0,10
1572,1572,2008-09,2008,2009,Aston Villa,Middlesbrough,Draw,Away,2009-05-16,1,3,4,5,6,0,0,1,4,3,4,4,2,0,6.0,13.0,-7.0,10
1573,1573,2008-09,2008,2009,Aston Villa,Newcastle,Win,Home,2009-05-24,3,1,4,5,6,3,3,4,4,-2,1,1,2,1,6.0,12.0,-6.0,10
1574,1574,2009-10,2009,2010,Aston Villa,Wigan,Loss,Home,2009-08-15,0,4,4,7,8,3,3,3,4,1,1,4,4,1,6.0,11.0,-5.0,1
1575,1575,2009-10,2009,2010,Aston Villa,Liverpool,Win,Away,2009-08-24,3,3,4,4,7,3,6,9,12,0,-2,-5,-5,0,6.0,2.0,4.0,1
1576,1576,2009-10,2009,2010,Aston Villa,Fulham,Win,Home,2009-08-30,3,3,6,7,7,3,3,6,9,0,3,1,-2,1,6.0,7.0,-1.0,1
1577,1577,2009-10,2009,2010,Aston Villa,Birmingham,Win,Away,2009-09-13,3,6,6,9,10,1,4,4,7,5,2,5,3,0,6.0,21.0,-15.0,2
1578,1578,2009-10,2009,2010,Aston Villa,Portsmouth,Win,Home,2009-09-19,3,6,9,9,12,0,0,0,0,6,9,9,12,1,6.0,14.0,-8.0,2
1579,1579,2009-10,2009,2010,Aston Villa,Blackburn,Loss,Away,2009-09-26,0,6,9,12,12,3,4,4,4,3,5,8,8,0,6.0,15.0,-9.0,2
1580,1580,2009-10,2009,2010,Aston Villa,Man City,Draw,Home,2009-10-05,1,3,6,9,12,3,6,9,12,0,0,0,0,1,6.0,10.0,-4.0,3
1581,1581,2009-10,2009,2010,Aston Villa,Chelsea,Win,Home,2009-10-17,3,1,4,7,10,3,6,9,12,-2,-2,-2,-2,1,6.0,3.0,3.0,3
1582,1582,2009-10,2009,2010,Aston Villa,Wolves,Draw,Away,2009-10-24,1,4,4,7,10,1,1,4,4,3,3,3,6,0,6.0,21.0,-15.0,3
1583,1583,2009-10,2009,2010,Aston Villa,Everton,Draw,Away,2009-10-31,1,4,5,5,8,1,2,5,8,3,3,0,0,0,6.0,5.0,1.0,3
1584,1584,2009-10,2009,2010,Aston Villa,West Ham,Loss,Away,2009-11-04,0,2,5,6,6,2,2,3,3,0,3,3,3,0,6.0,9.0,-3.0,4
1585,1585,2009-10,2009,2010,Aston Villa,Bolton,Win,Home,2009-11-07,3,1,2,5,6,3,3,4,7,-2,-1,1,-1,1,6.0,13.0,-7.0,4
1586,1586,2009-10,2009,2010,Aston Villa,Burnley,Draw,Away,2009-11-21,1,3,4,5,8,4,4,4,7,-1,0,1,1,0,6.0,21.0,-15.0,4
1587,1587,2009-10,2009,2010,Aston Villa,Tottenham,Draw,Home,2009-11-28,1,4,4,5,6,6,6,6,9,-2,-2,-1,-3,1,6.0,8.0,-2.0,4
1588,1588,2009-10,2009,2010,Aston Villa,Hull,Win,Home,2009-12-05,3,2,5,5,6,4,5,8,8,-2,0,-3,-2,1,6.0,17.0,-11.0,5
1589,1589,2009-10,2009,2010,Aston Villa,Man United,Win,Away,2009-12-12,3,4,5,8,8,6,9,9,12,-2,-4,-1,-4,0,6.0,1.0,5.0,5
1590,1590,2009-10,2009,2010,Aston Villa,Sunderland,Win,Away,2009-12-15,3,6,7,8,11,1,1,4,4,5,6,4,7,0,6.0,16.0,-10.0,5
1591,1591,2009-10,2009,2010,Aston Villa,Stoke,Win,Home,2009-12-19,3,6,9,10,11,1,2,5,5,5,7,5,6,1,6.0,12.0,-6.0,5
1592,1592,2009-10,2009,2010,Aston Villa,Arsenal,Loss,Away,2009-12-27,0,6,9,12,13,4,7,10,10,2,2,2,3,0,6.0,4.0,2.0,5
1593,1593,2009-10,2009,2010,Aston Villa,Liverpool,Loss,Home,2009-12-29,0,3,6,9,12,3,6,6,7,0,0,3,5,1,6.0,2.0,4.0,5
1594,1594,2009-10,2009,2010,Aston Villa,West Ham,Draw,Home,2010-01-17,1,0,3,6,9,3,4,4,4,-3,-1,2,5,1,6.0,9.0,-3.0,6
1595,1595,2009-10,2009,2010,Aston Villa,Arsenal,Draw,Home,2010-01-27,1,1,1,4,7,6,7,10,13,-5,-6,-6,-6,1,6.0,4.0,2.0,6
1596,1596,2009-10,2009,2010,Aston Villa,Fulham,Win,Away,2010-01-30,3,2,2,2,5,0,0,0,1,2,2,2,4,0,6.0,7.0,-1.0,6
1597,1597,2009-10,2009,2010,Aston Villa,Tottenham,Draw,Away,2010-02-06,1,4,5,5,5,4,4,5,8,0,1,0,-3,0,6.0,8.0,-2.0,7
1598,1598,2009-10,2009,2010,Aston Villa,Man United,Draw,Home,2010-02-10,1,4,5,6,6,6,9,12,13,-2,-4,-6,-7,1,6.0,1.0,5.0,7
1599,1599,2009-10,2009,2010,Aston Villa,Burnley,Win,Home,2010-02-21,3,2,5,6,7,3,3,3,3,-1,2,3,4,1,6.0,21.0,-15.0,7
1600,1600,2009-10,2009,2010,Aston Villa,Stoke,Draw,Away,2010-03-13,1,4,5,8,9,1,4,5,6,3,1,3,3,0,6.0,12.0,-6.0,8
1601,1601,2009-10,2009,2010,Aston Villa,Wigan,Win,Away,2010-03-16,3,4,5,6,9,3,3,3,4,1,2,3,5,0,6.0,11.0,-5.0,8
1602,1602,2009-10,2009,2010,Aston Villa,Wolves,Draw,Home,2010-03-20,1,4,7,8,9,3,3,3,6,1,4,5,3,1,6.0,21.0,-15.0,8
1603,1603,2009-10,2009,2010,Aston Villa,Sunderland,Draw,Home,2010-03-24,1,4,5,8,9,4,7,8,8,0,-2,0,1,1,6.0,16.0,-10.0,8
1604,1604,2009-10,2009,2010,Aston Villa,Chelsea,Loss,Away,2010-03-27,0,2,5,6,9,4,7,7,10,-2,-2,-1,-1,0,6.0,3.0,3.0,8
1605,1605,2009-10,2009,2010,Aston Villa,Bolton,Win,Away,2010-04-03,3,1,2,5,6,0,3,3,6,1,-1,2,0,0,6.0,13.0,-7.0,9
1606,1606,2009-10,2009,2010,Aston Villa,Everton,Draw,Home,2010-04-14,1,3,4,5,8,2,5,8,9,1,-1,-3,-1,1,6.0,5.0,1.0,9
1607,1607,2009-10,2009,2010,Aston Villa,Portsmouth,Win,Away,2010-04-18,3,4,4,5,6,2,2,2,5,2,2,3,1,0,6.0,14.0,-8.0,9
1608,1608,2009-10,2009,2010,Aston Villa,Hull,Win,Away,2010-04-21,3,4,7,7,8,1,1,4,4,3,6,3,4,0,6.0,17.0,-11.0,9
1609,1609,2009-10,2009,2010,Aston Villa,Birmingham,Win,Home,2010-04-25,3,6,7,10,10,1,2,3,3,5,5,7,7,1,6.0,21.0,-15.0,9
1610,1610,2009-10,2009,2010,Aston Villa,Man City,Loss,Away,2010-05-01,0,6,9,10,13,1,4,7,10,5,5,3,3,0,6.0,10.0,-4.0,10
1611,1611,2009-10,2009,2010,Aston Villa,Blackburn,Loss,Home,2010-05-09,0,3,6,9,10,4,4,5,6,-1,2,4,4,1,6.0,15.0,-9.0,10
1612,1612,2010-11,2010,2011,Aston Villa,West Ham,Win,Home,2010-08-14,3,0,3,6,9,1,4,4,7,-1,-1,2,2,1,6.0,17.0,-11.0,1
1613,1613,2010-11,2010,2011,Aston Villa,Newcastle,Loss,Away,2010-08-22,0,3,3,6,9,0,0,3,3,3,3,3,6,0,6.0,21.0,-15.0,1
1614,1614,2010-11,2010,2011,Aston Villa,Everton,Win,Home,2010-08-29,3,3,3,3,6,1,4,5,8,2,-1,-2,-2,1,6.0,8.0,-2.0,1
1615,1615,2010-11,2010,2011,Aston Villa,Stoke,Loss,Away,2010-09-13,0,3,6,6,6,0,0,0,3,3,6,6,3,0,6.0,11.0,-5.0,2
1616,1616,2010-11,2010,2011,Aston Villa,Bolton,Draw,Home,2010-09-18,1,3,3,6,6,1,4,5,8,2,-1,1,-2,1,6.0,14.0,-8.0,2
1617,1617,2010-11,2010,2011,Aston Villa,Wolves,Win,Away,2010-09-26,3,1,4,4,7,0,1,2,5,1,3,2,2,0,6.0,15.0,-9.0,2
1618,1618,2010-11,2010,2011,Aston Villa,Tottenham,Loss,Away,2010-10-02,0,4,4,7,7,3,4,4,7,1,0,3,0,0,6.0,4.0,2.0,3
1619,1619,2010-11,2010,2011,Aston Villa,Chelsea,Draw,Home,2010-10-16,1,3,4,4,7,3,6,9,12,0,-2,-5,-5,1,6.0,1.0,5.0,3
1620,1620,2010-11,2010,2011,Aston Villa,Sunderland,Loss,Away,2010-10-23,0,1,4,5,5,2,3,4,5,-1,1,1,0,0,6.0,13.0,-7.0,3
1621,1621,2010-11,2010,2011,Aston Villa,Birmingham,Draw,Home,2010-10-31,1,1,1,4,5,3,3,4,4,-2,-2,0,1,1,6.0,9.0,-3.0,3
1622,1622,2010-11,2010,2011,Aston Villa,Fulham,Draw,Away,2010-11-06,1,1,2,2,5,3,3,4,5,-2,-1,-2,0,0,6.0,12.0,-6.0,4
1623,1623,2010-11,2010,2011,Aston Villa,Blackpool,Win,Home,2010-11-10,3,2,2,3,3,4,4,4,7,-2,-2,-1,-4,1,6.0,21.0,-15.0,4
1624,1624,2010-11,2010,2011,Aston Villa,Man United,Draw,Home,2010-11-13,1,4,5,5,6,4,7,10,11,0,-2,-5,-5,1,6.0,2.0,4.0,4
1625,1625,2010-11,2010,2011,Aston Villa,Blackburn,Loss,Away,2010-11-21,0,4,5,6,6,3,6,6,6,1,-1,0,0,0,6.0,10.0,-4.0,4
1626,1626,2010-11,2010,2011,Aston Villa,Arsenal,Loss,Home,2010-11-27,0,1,4,5,6,3,6,6,9,-2,-2,-1,-3,1,6.0,3.0,3.0,4
1627,1627,2010-11,2010,2011,Aston Villa,Liverpool,Loss,Away,2010-12-06,0,0,1,4,5,3,3,4,7,-3,-2,0,-2,0,6.0,7.0,-1.0,5
1628,1628,2010-11,2010,2011,Aston Villa,West Brom,Win,Home,2010-12-11,3,0,0,1,4,6,6,6,7,-6,-6,-5,-3,1,6.0,21.0,-15.0,5
1629,1629,2010-11,2010,2011,Aston Villa,Tottenham,Loss,Home,2010-12-26,0,3,3,3,4,2,5,8,11,1,-2,-5,-7,1,6.0,4.0,2.0,5
1630,1630,2010-11,2010,2011,Aston Villa,Man City,Loss,Away,2010-12-28,0,3,3,3,3,3,6,9,10,0,-3,-6,-7,0,6.0,5.0,1.0,5
1631,1631,2010-11,2010,2011,Aston Villa,Chelsea,Draw,Away,2011-01-02,1,0,3,3,3,3,4,5,6,-3,-1,-2,-3,0,6.0,1.0,5.0,6
1632,1632,2010-11,2010,2011,Aston Villa,Sunderland,Loss,Home,2011-01-05,0,1,1,4,4,3,3,6,7,-2,-2,-2,-3,1,6.0,13.0,-7.0,6
1633,1633,2010-11,2010,2011,Aston Villa,Birmingham,Draw,Away,2011-01-16,1,1,1,1,4,3,4,4,5,-2,-3,-3,-1,0,6.0,9.0,-3.0,6
1634,1634,2010-11,2010,2011,Aston Villa,Man City,Win,Home,2011-01-22,3,1,2,2,2,4,7,10,13,-3,-5,-8,-11,1,6.0,5.0,1.0,6
1635,1635,2010-11,2010,2011,Aston Villa,Wigan,Win,Away,2011-01-25,3,4,4,5,5,1,2,2,3,3,2,3,2,0,6.0,16.0,-10.0,6
1636,1636,2010-11,2010,2011,Aston Villa,Man United,Loss,Away,2011-02-01,0,6,7,7,8,6,7,10,13,0,0,-3,-5,0,6.0,2.0,4.0,7
1637,1637,2010-11,2010,2011,Aston Villa,Fulham,Draw,Home,2011-02-05,1,3,6,7,7,3,6,7,10,0,0,0,-3,1,6.0,12.0,-6.0,7
1638,1638,2010-11,2010,2011,Aston Villa,Blackpool,Draw,Away,2011-02-12,1,1,4,7,8,0,0,0,0,1,4,7,8,0,6.0,21.0,-15.0,7
1639,1639,2010-11,2010,2011,Aston Villa,Blackburn,Win,Home,2011-02-26,3,2,2,5,8,1,1,4,4,1,1,1,4,1,6.0,10.0,-4.0,7
1640,1640,2010-11,2010,2011,Aston Villa,Bolton,Loss,Away,2011-03-05,0,4,5,5,8,4,4,7,7,0,1,-2,1,0,6.0,14.0,-8.0,8
1641,1641,2010-11,2010,2011,Aston Villa,Wolves,Loss,Home,2011-03-19,0,3,4,5,5,4,5,5,8,-1,-1,0,-3,1,6.0,15.0,-9.0,8
1642,1642,2010-11,2010,2011,Aston Villa,Everton,Draw,Away,2011-04-02,1,0,3,4,5,4,7,10,10,-4,-4,-6,-5,0,6.0,8.0,-2.0,9
1643,1643,2010-11,2010,2011,Aston Villa,Newcastle,Win,Home,2011-04-10,3,1,1,4,5,3,3,4,7,-2,-2,0,-2,1,6.0,21.0,-15.0,9
1644,1644,2010-11,2010,2011,Aston Villa,West Ham,Win,Away,2011-04-16,3,4,4,4,7,0,1,4,7,4,3,0,0,0,6.0,17.0,-11.0,9
1645,1645,2010-11,2010,2011,Aston Villa,Stoke,Draw,Home,2011-04-23,1,6,7,7,7,1,4,4,5,5,3,3,2,1,6.0,11.0,-5.0,9
1646,1646,2010-11,2010,2011,Aston Villa,West Brom,Loss,Away,2011-04-30,0,4,7,8,8,1,4,7,8,3,3,1,0,0,6.0,21.0,-15.0,9
1647,1647,2010-11,2010,2011,Aston Villa,Wigan,Draw,Home,2011-05-07,1,1,4,7,8,1,4,4,5,0,0,3,3,1,6.0,16.0,-10.0,10
1648,1648,2010-11,2010,2011,Aston Villa,Arsenal,Win,Away,2011-05-15,3,1,2,5,8,3,3,4,5,-2,-1,1,3,0,6.0,3.0,3.0,10
1649,1649,2010-11,2010,2011,Aston Villa,Liverpool,Win,Home,2011-05-22,3,4,4,5,8,3,6,9,10,1,-2,-4,-2,1,6.0,7.0,-1.0,10
1650,1650,2011-12,2011,2012,Aston Villa,Fulham,Draw,Away,2011-08-13,1,6,7,7,8,4,4,7,10,2,3,0,-2,0,9.0,8.0,1.0,1
1651,1651,2011-12,2011,2012,Aston Villa,Blackburn,Win,Home,2011-08-20,3,4,7,8,8,3,4,5,8,1,3,3,0,1,9.0,15.0,-6.0,1
1652,1652,2011-12,2011,2012,Aston Villa,Wolves,Draw,Home,2011-08-27,1,4,7,10,11,6,6,9,12,-2,1,1,-1,1,9.0,17.0,-8.0,1
1653,1653,2011-12,2011,2012,Aston Villa,Everton,Draw,Away,2011-09-10,1,4,5,8,11,3,6,6,9,1,-1,2,2,0,9.0,7.0,2.0,2
1654,1654,2011-12,2011,2012,Aston Villa,Newcastle,Draw,Home,2011-09-17,1,2,5,6,9,4,7,8,9,-2,-2,-2,0,1,9.0,12.0,-3.0,2
1655,1655,2011-12,2011,2012,Aston Villa,QPR,Draw,Away,2011-09-25,1,2,3,6,7,4,4,7,7,-2,-1,-1,0,0,9.0,21.0,-12.0,2
1656,1656,2011-12,2011,2012,Aston Villa,Wigan,Win,Home,2011-10-01,3,2,3,4,7,0,0,3,4,2,3,1,3,1,9.0,16.0,-7.0,3
1657,1657,2011-12,2011,2012,Aston Villa,Man City,Loss,Away,2011-10-15,0,4,5,6,7,6,7,10,13,-2,-2,-4,-6,0,9.0,3.0,6.0,3
1658,1658,2011-12,2011,2012,Aston Villa,West Brom,Loss,Home,2011-10-22,0,3,4,5,6,4,5,5,8,-1,-1,0,-2,1,9.0,11.0,-2.0,3
1659,1659,2011-12,2011,2012,Aston Villa,Sunderland,Draw,Away,2011-10-29,1,0,3,4,5,3,4,4,7,-3,-1,0,-2,0,9.0,10.0,-1.0,3
1660,1660,2011-12,2011,2012,Aston Villa,Norwich,Win,Home,2011-11-05,3,1,1,4,5,2,5,5,8,-1,-4,-1,-3,1,9.0,21.0,-12.0,4
1661,1661,2011-12,2011,2012,Aston Villa,Tottenham,Loss,Away,2011-11-21,0,4,4,4,7,6,9,10,13,-2,-5,-6,-6,0,9.0,5.0,4.0,4
1662,1662,2011-12,2011,2012,Aston Villa,Swansea,Draw,Away,2011-11-27,1,3,4,4,4,1,4,5,5,2,0,-1,-1,0,9.0,21.0,-12.0,4
1663,1663,2011-12,2011,2012,Aston Villa,Man United,Loss,Home,2011-12-03,0,1,4,5,5,4,7,10,10,-3,-3,-5,-5,1,9.0,1.0,8.0,5
1664,1664,2011-12,2011,2012,Aston Villa,Bolton,Win,Away,2011-12-10,3,1,1,4,5,0,0,3,3,1,1,1,2,0,9.0,14.0,-5.0,5
1665,1665,2011-12,2011,2012,Aston Villa,Liverpool,Loss,Home,2011-12-18,0,3,4,4,7,3,4,7,8,0,0,-3,-1,1,9.0,6.0,3.0,5
1666,1666,2011-12,2011,2012,Aston Villa,Arsenal,Loss,Home,2011-12-21,0,3,3,4,4,3,6,7,10,0,-3,-3,-6,1,9.0,4.0,5.0,5
1667,1667,2011-12,2011,2012,Aston Villa,Stoke,Draw,Away,2011-12-26,1,0,3,3,4,3,6,9,12,-3,-3,-6,-8,0,9.0,13.0,-4.0,5
1668,1668,2011-12,2011,2012,Aston Villa,Chelsea,Win,Away,2011-12-31,3,1,1,4,4,2,3,6,9,-1,-2,-2,-5,0,9.0,2.0,7.0,5
1669,1669,2011-12,2011,2012,Aston Villa,Swansea,Loss,Home,2012-01-02,0,4,4,4,7,2,2,3,6,2,2,1,1,1,9.0,21.0,-12.0,6
1670,1670,2011-12,2011,2012,Aston Villa,Everton,Draw,Home,2012-01-14,1,3,4,4,4,0,3,4,7,3,1,0,-3,1,9.0,7.0,2.0,6
1671,1671,2011-12,2011,2012,Aston Villa,Wolves,Win,Away,2012-01-21,3,1,4,5,5,1,2,3,4,0,2,2,1,0,9.0,17.0,-8.0,6
1672,1672,2011-12,2011,2012,Aston Villa,QPR,Draw,Home,2012-02-01,1,4,4,7,8,3,3,3,4,1,1,4,4,1,9.0,21.0,-12.0,7
1673,1673,2011-12,2011,2012,Aston Villa,Newcastle,Loss,Away,2012-02-05,0,4,5,5,8,3,6,9,9,1,-1,-4,-1,0,9.0,12.0,-3.0,7
1674,1674,2011-12,2011,2012,Aston Villa,Man City,Loss,Home,2012-02-12,0,1,4,5,5,3,6,9,12,-2,-2,-4,-7,1,9.0,3.0,6.0,7
1675,1675,2011-12,2011,2012,Aston Villa,Wigan,Draw,Away,2012-02-25,1,0,1,4,5,4,4,4,4,-4,-3,0,1,0,9.0,16.0,-7.0,7
1676,1676,2011-12,2011,2012,Aston Villa,Blackburn,Draw,Away,2012-03-03,1,1,1,2,5,3,3,3,4,-2,-2,-1,1,0,9.0,15.0,-6.0,8
1677,1677,2011-12,2011,2012,Aston Villa,Fulham,Win,Home,2012-03-10,3,2,2,2,3,6,9,9,10,-4,-7,-7,-7,1,9.0,8.0,1.0,8
1678,1678,2011-12,2011,2012,Aston Villa,Arsenal,Loss,Away,2012-03-24,0,4,5,5,5,6,9,12,15,-2,-4,-7,-10,0,9.0,4.0,5.0,8
1679,1679,2011-12,2011,2012,Aston Villa,Chelsea,Loss,Home,2012-03-31,0,3,4,5,5,1,4,4,7,2,0,1,-2,1,9.0,2.0,7.0,8
1680,1680,2011-12,2011,2012,Aston Villa,Liverpool,Draw,Away,2012-04-07,1,0,3,4,5,0,0,3,3,0,3,1,2,0,9.0,6.0,3.0,9
1681,1681,2011-12,2011,2012,Aston Villa,Stoke,Draw,Home,2012-04-09,1,1,1,4,5,3,4,5,5,-2,-3,-1,0,1,9.0,13.0,-4.0,9
1682,1682,2011-12,2011,2012,Aston Villa,Man United,Loss,Away,2012-04-15,0,2,2,2,5,3,6,9,12,-1,-4,-7,-7,0,9.0,1.0,8.0,9
1683,1683,2011-12,2011,2012,Aston Villa,Sunderland,Draw,Home,2012-04-21,1,1,2,2,2,1,2,3,6,0,0,-1,-4,1,9.0,10.0,-1.0,9
1684,1684,2011-12,2011,2012,Aston Villa,Bolton,Loss,Home,2012-04-24,0,1,2,3,3,1,1,4,7,0,1,-1,-4,1,9.0,14.0,-5.0,9
1685,1685,2011-12,2011,2012,Aston Villa,West Brom,Draw,Away,2012-04-28,1,1,1,2,3,6,6,9,9,-5,-5,-7,-6,0,9.0,11.0,-2.0,9
1686,1686,2011-12,2011,2012,Aston Villa,Tottenham,Draw,Home,2012-05-06,1,1,2,2,3,6,6,6,7,-5,-4,-4,-4,1,9.0,5.0,4.0,10
1687,1687,2011-12,2011,2012,Aston Villa,Norwich,Loss,Away,2012-05-13,0,2,2,3,3,1,1,1,4,1,1,2,-1,0,9.0,21.0,-12.0,10
1688,1688,2012-13,2012,2013,Aston Villa,West Ham,Loss,Away,2012-08-18,0,1,2,2,3,0,1,1,1,1,1,1,2,0,16.0,21.0,-5.0,1
1689,1689,2012-13,2012,2013,Aston Villa,Everton,Loss,Home,2012-08-25,0,0,1,2,2,6,7,8,11,-6,-6,-6,-9,1,16.0,7.0,9.0,1
1690,1690,2012-13,2012,2013,Aston Villa,Newcastle,Draw,Away,2012-09-02,1,0,0,1,2,3,3,3,6,-3,-3,-2,-4,0,16.0,5.0,11.0,2
1691,1691,2012-13,2012,2013,Aston Villa,Swansea,Win,Home,2012-09-15,3,1,1,1,2,4,7,10,10,-3,-6,-9,-8,1,16.0,11.0,5.0,2
1692,1692,2012-13,2012,2013,Aston Villa,Southampton,Loss,Away,2012-09-22,0,4,4,4,4,0,0,0,0,4,4,4,4,0,16.0,21.0,-5.0,2
1693,1693,2012-13,2012,2013,Aston Villa,West Brom,Draw,Home,2012-09-30,1,3,4,4,4,3,6,7,10,0,-2,-3,-6,1,16.0,10.0,6.0,2
1694,1694,2012-13,2012,2013,Aston Villa,Tottenham,Loss,Away,2012-10-07,0,1,4,5,5,6,9,10,11,-5,-5,-5,-6,0,16.0,4.0,12.0,3
1695,1695,2012-13,2012,2013,Aston Villa,Fulham,Loss,Away,2012-10-20,0,1,1,4,5,1,4,7,7,0,-3,-3,-2,0,16.0,9.0,7.0,3
1696,1696,2012-13,2012,2013,Aston Villa,Norwich,Draw,Home,2012-10-27,1,0,1,1,4,3,3,3,4,-3,-2,-2,0,1,16.0,12.0,4.0,3
1697,1697,2012-13,2012,2013,Aston Villa,Sunderland,Win,Away,2012-11-03,3,1,1,2,2,2,2,5,6,-1,-1,-3,-4,0,16.0,13.0,3.0,4
1698,1698,2012-13,2012,2013,Aston Villa,Man United,Loss,Home,2012-11-10,0,4,4,4,5,6,9,12,12,-2,-5,-8,-7,1,16.0,2.0,14.0,4
1699,1699,2012-13,2012,2013,Aston Villa,Man City,Loss,Away,2012-11-17,0,3,4,4,4,4,7,10,13,-1,-3,-6,-9,0,16.0,1.0,15.0,4
1700,1700,2012-13,2012,2013,Aston Villa,Arsenal,Draw,Home,2012-11-24,1,0,3,4,4,4,4,7,7,-4,-1,-3,-3,1,16.0,3.0,13.0,4
1701,1701,2012-13,2012,2013,Aston Villa,Reading,Win,Home,2012-11-27,3,1,1,4,5,3,4,5,6,-2,-3,-1,-1,1,16.0,21.0,-5.0,4
1702,1702,2012-13,2012,2013,Aston Villa,QPR,Draw,Away,2012-12-01,1,4,4,4,7,1,1,1,2,3,3,3,5,0,16.0,17.0,-1.0,5
1703,1703,2012-13,2012,2013,Aston Villa,Stoke,Draw,Home,2012-12-08,1,4,5,5,5,6,9,10,13,-2,-4,-5,-8,1,16.0,14.0,2.0,5
1704,1704,2012-13,2012,2013,Aston Villa,Liverpool,Win,Away,2012-12-15,3,2,5,6,6,6,6,7,10,-4,-1,-1,-4,0,16.0,8.0,8.0,5
1705,1705,2012-13,2012,2013,Aston Villa,Chelsea,Loss,Away,2012-12-23,0,4,5,8,9,3,4,5,5,1,1,3,4,0,16.0,6.0,10.0,5
1706,1706,2012-13,2012,2013,Aston Villa,Tottenham,Loss,Home,2012-12-26,0,3,4,5,8,4,4,7,10,-1,0,-2,-2,1,16.0,4.0,12.0,5
1707,1707,2012-13,2012,2013,Aston Villa,Wigan,Loss,Home,2012-12-29,0,0,3,4,5,0,0,1,1,0,3,3,4,1,16.0,15.0,1.0,5
1708,1708,2012-13,2012,2013,Aston Villa,Swansea,Draw,Away,2013-01-01,1,0,0,3,4,4,5,5,5,-4,-5,-2,-1,0,16.0,11.0,5.0,6
1709,1709,2012-13,2012,2013,Aston Villa,Southampton,Loss,Home,2013-01-12,0,1,1,1,4,2,3,3,6,-1,-2,-2,-2,1,16.0,21.0,-5.0,6
1710,1710,2012-13,2012,2013,Aston Villa,West Brom,Draw,Away,2013-01-19,1,1,1,1,1,0,0,3,6,1,1,-2,-5,0,16.0,10.0,6.0,6
1711,1711,2012-13,2012,2013,Aston Villa,Newcastle,Loss,Home,2013-01-29,0,1,2,2,2,1,1,1,1,0,1,1,1,1,16.0,5.0,11.0,6
1712,1712,2012-13,2012,2013,Aston Villa,Everton,Draw,Away,2013-02-02,1,1,1,2,2,4,5,8,8,-3,-4,-6,-6,0,16.0,7.0,9.0,7
1713,1713,2012-13,2012,2013,Aston Villa,West Ham,Win,Home,2013-02-10,3,1,2,2,3,3,3,4,4,-2,-1,-2,-1,1,16.0,21.0,-5.0,7
1714,1714,2012-13,2012,2013,Aston Villa,Arsenal,Loss,Away,2013-02-23,0,4,4,5,5,6,7,10,10,-2,-3,-5,-5,0,16.0,3.0,13.0,7
1715,1715,2012-13,2012,2013,Aston Villa,Man City,Loss,Home,2013-03-04,0,3,4,4,5,3,4,5,8,0,0,-1,-3,1,16.0,1.0,15.0,8
1716,1716,2012-13,2012,2013,Aston Villa,Reading,Win,Away,2013-03-09,3,0,3,4,4,0,0,3,4,0,3,1,0,0,16.0,21.0,-5.0,8
1717,1717,2012-13,2012,2013,Aston Villa,QPR,Win,Home,2013-03-16,3,3,3,6,7,6,6,6,7,-3,-3,0,0,1,16.0,17.0,-1.0,8
1718,1718,2012-13,2012,2013,Aston Villa,Liverpool,Loss,Home,2013-03-31,0,6,6,6,9,3,6,9,9,3,0,-3,0,1,16.0,8.0,8.0,8
1719,1719,2012-13,2012,2013,Aston Villa,Stoke,Win,Away,2013-04-06,3,3,6,6,6,1,1,1,1,2,5,5,5,0,16.0,14.0,2.0,9
1720,1720,2012-13,2012,2013,Aston Villa,Fulham,Draw,Home,2013-04-13,1,3,6,9,9,3,6,7,10,0,0,2,-1,1,16.0,9.0,7.0,9
1721,1721,2012-13,2012,2013,Aston Villa,Man United,Loss,Away,2013-04-22,0,4,4,7,10,4,4,7,10,0,0,0,0,0,16.0,2.0,14.0,9
1722,1722,2012-13,2012,2013,Aston Villa,Sunderland,Win,Home,2013-04-29,3,1,4,4,7,6,6,6,7,-5,-2,-2,0,1,16.0,13.0,3.0,9
1723,1723,2012-13,2012,2013,Aston Villa,Norwich,Win,Away,2013-05-04,3,3,4,7,7,3,3,4,4,0,1,3,3,0,16.0,12.0,4.0,10
1724,1724,2012-13,2012,2013,Aston Villa,Chelsea,Loss,Home,2013-05-11,0,6,6,7,10,4,7,8,11,2,-1,-1,-1,1,16.0,6.0,10.0,10
1725,1725,2012-13,2012,2013,Aston Villa,Wigan,Draw,Away,2013-05-19,1,3,6,6,7,0,3,4,4,3,3,2,3,0,16.0,15.0,1.0,10
1726,1726,2013-14,2013,2014,Aston Villa,Arsenal,Win,Away,2013-08-17,3,1,4,7,7,6,9,10,13,-5,-5,-3,-6,0,15.0,4.0,11.0,1
1727,1727,2013-14,2013,2014,Aston Villa,Chelsea,Loss,Away,2013-08-21,0,4,4,7,10,6,9,10,13,-2,-5,-3,-3,0,15.0,3.0,12.0,1
1728,1728,2013-14,2013,2014,Aston Villa,Liverpool,Loss,Home,2013-08-24,0,3,4,4,7,6,9,10,13,-3,-5,-6,-6,1,15.0,7.0,8.0,1
1729,1729,2013-14,2013,2014,Aston Villa,Newcastle,Loss,Home,2013-09-14,0,0,3,4,4,4,4,4,7,-4,-1,0,-3,1,15.0,16.0,-1.0,2
1730,1730,2013-14,2013,2014,Aston Villa,Norwich,Win,Away,2013-09-21,3,0,0,3,4,3,3,4,7,-3,-3,-1,-3,0,15.0,11.0,4.0,2
1731,1731,2013-14,2013,2014,Aston Villa,Man City,Win,Home,2013-09-28,3,3,3,3,6,4,7,7,10,-1,-4,-4,-4,1,15.0,2.0,13.0,2
1732,1732,2013-14,2013,2014,Aston Villa,Hull,Draw,Away,2013-10-05,1,6,6,6,6,6,7,7,10,0,-1,-1,-4,0,15.0,21.0,-6.0,3
1733,1733,2013-14,2013,2014,Aston Villa,Tottenham,Loss,Home,2013-10-20,0,4,7,7,7,1,4,7,7,3,3,0,0,1,15.0,5.0,10.0,3
1734,1734,2013-14,2013,2014,Aston Villa,Everton,Loss,Home,2013-10-26,0,1,4,7,7,3,6,9,12,-2,-2,-2,-5,1,15.0,6.0,9.0,3
1735,1735,2013-14,2013,2014,Aston Villa,West Ham,Draw,Away,2013-11-02,1,0,1,4,7,1,4,4,4,-1,-3,0,3,0,15.0,10.0,5.0,4
1736,1736,2013-14,2013,2014,Aston Villa,Cardiff,Win,Home,2013-11-09,3,1,1,2,5,4,4,4,7,-3,-3,-2,-2,1,15.0,21.0,-6.0,4
1737,1737,2013-14,2013,2014,Aston Villa,West Brom,Draw,Away,2013-11-25,1,4,4,4,5,4,4,5,6,0,0,-1,-1,0,15.0,8.0,7.0,4
1738,1738,2013-14,2013,2014,Aston Villa,Sunderland,Draw,Home,2013-11-30,1,4,5,5,5,3,3,6,6,1,2,-1,-1,1,15.0,17.0,-2.0,4
1739,1739,2013-14,2013,2014,Aston Villa,Southampton,Win,Away,2013-12-04,3,2,5,6,6,0,3,4,7,2,2,2,-1,0,15.0,14.0,1.0,5
1740,1740,2013-14,2013,2014,Aston Villa,Fulham,Loss,Away,2013-12-08,0,4,5,8,9,0,0,0,0,4,5,8,9,0,15.0,12.0,3.0,5
1741,1741,2013-14,2013,2014,Aston Villa,Man United,Loss,Home,2013-12-15,0,3,4,5,8,0,1,2,5,3,3,3,3,1,15.0,1.0,14.0,5
1742,1742,2013-14,2013,2014,Aston Villa,Stoke,Loss,Away,2013-12-21,0,0,3,4,5,4,5,5,8,-4,-2,-1,-3,0,15.0,13.0,2.0,5
1743,1743,2013-14,2013,2014,Aston Villa,Crystal Palace,Loss,Home,2013-12-26,0,0,0,3,4,0,3,6,6,0,-3,-3,-2,1,15.0,21.0,-6.0,5
1744,1744,2013-14,2013,2014,Aston Villa,Swansea,Draw,Home,2013-12-28,1,0,0,0,3,0,1,2,5,0,-1,-2,-2,1,15.0,9.0,6.0,5
1745,1745,2013-14,2013,2014,Aston Villa,Sunderland,Win,Away,2014-01-01,3,1,1,1,1,4,5,6,6,-3,-4,-5,-5,0,15.0,17.0,-2.0,6
1746,1746,2013-14,2013,2014,Aston Villa,Arsenal,Loss,Home,2014-01-13,0,4,4,4,4,6,9,10,10,-2,-5,-6,-6,1,15.0,4.0,11.0,6
1747,1747,2013-14,2013,2014,Aston Villa,Liverpool,Draw,Away,2014-01-18,1,3,4,4,4,6,6,6,9,-3,-2,-2,-5,0,15.0,7.0,8.0,6
1748,1748,2013-14,2013,2014,Aston Villa,West Brom,Win,Home,2014-01-29,3,1,4,5,5,1,4,5,6,0,0,0,-1,1,15.0,8.0,7.0,6
1749,1749,2013-14,2013,2014,Aston Villa,Everton,Loss,Away,2014-02-01,0,4,4,7,8,1,4,5,8,3,0,2,0,0,15.0,6.0,9.0,7
1750,1750,2013-14,2013,2014,Aston Villa,West Ham,Loss,Home,2014-02-08,0,3,4,4,7,4,4,7,7,-1,0,-3,0,1,15.0,10.0,5.0,7
1751,1751,2013-14,2013,2014,Aston Villa,Cardiff,Draw,Away,2014-02-11,1,0,3,4,4,3,3,3,3,-3,0,1,1,0,15.0,21.0,-6.0,7
1752,1752,2013-14,2013,2014,Aston Villa,Newcastle,Loss,Away,2014-02-23,0,1,1,4,5,0,0,1,4,1,1,3,1,0,15.0,16.0,-1.0,7
1753,1753,2013-14,2013,2014,Aston Villa,Norwich,Win,Home,2014-03-02,3,1,1,1,4,3,4,4,5,-2,-3,-3,-1,1,15.0,11.0,4.0,8
1754,1754,2013-14,2013,2014,Aston Villa,Chelsea,Win,Home,2014-03-15,3,3,4,4,4,6,9,10,13,-3,-5,-6,-9,1,15.0,3.0,12.0,8
1755,1755,2013-14,2013,2014,Aston Villa,Stoke,Loss,Home,2014-03-23,0,6,6,7,7,4,7,7,8,2,-1,0,-1,1,15.0,13.0,2.0,8
1756,1756,2013-14,2013,2014,Aston Villa,Man United,Loss,Away,2014-03-29,0,3,6,6,7,3,3,6,9,0,3,0,-2,0,15.0,1.0,14.0,8
1757,1757,2013-14,2013,2014,Aston Villa,Fulham,Loss,Home,2014-04-05,0,0,3,6,6,0,3,3,3,0,0,3,3,1,15.0,12.0,3.0,9
1758,1758,2013-14,2013,2014,Aston Villa,Crystal Palace,Loss,Away,2014-04-12,0,0,0,3,6,6,6,7,7,-6,-6,-4,-1,0,15.0,21.0,-6.0,9
1759,1759,2013-14,2013,2014,Aston Villa,Southampton,Draw,Home,2014-04-19,1,0,0,0,3,0,3,3,6,0,-3,-3,-3,1,15.0,14.0,1.0,9
1760,1760,2013-14,2013,2014,Aston Villa,Swansea,Loss,Away,2014-04-26,0,1,1,1,1,3,3,6,7,-2,-2,-5,-6,0,15.0,9.0,6.0,9
1761,1761,2013-14,2013,2014,Aston Villa,Hull,Win,Home,2014-05-03,3,1,1,1,1,1,4,4,4,0,-3,-3,-3,1,15.0,21.0,-6.0,10
1762,1762,2013-14,2013,2014,Aston Villa,Man City,Loss,Away,2014-05-07,0,3,4,4,4,6,9,10,10,-3,-5,-6,-6,0,15.0,2.0,13.0,10
1763,1763,2013-14,2013,2014,Aston Villa,Tottenham,Loss,Away,2014-05-11,0,3,3,4,4,3,6,7,10,0,-3,-3,-6,0,15.0,5.0,10.0,10
1764,1764,2014-15,2014,2015,Aston Villa,Stoke,Win,Away,2014-08-16,3,0,3,3,4,6,6,7,10,-6,-3,-4,-6,0,15.0,9.0,6.0,1
1765,1765,2014-15,2014,2015,Aston Villa,Newcastle,Draw,Home,2014-08-23,1,3,3,6,6,0,3,3,3,3,0,3,3,1,15.0,10.0,5.0,1
1766,1766,2014-15,2014,2015,Aston Villa,Hull,Win,Home,2014-08-31,3,4,4,4,7,4,4,4,4,0,0,0,3,1,15.0,16.0,-1.0,1
1767,1767,2014-15,2014,2015,Aston Villa,Liverpool,Win,Away,2014-09-13,3,4,7,7,7,3,6,9,10,1,1,-2,-3,0,15.0,2.0,13.0,2
1768,1768,2014-15,2014,2015,Aston Villa,Arsenal,Loss,Home,2014-09-20,0,6,7,10,10,2,3,6,9,4,4,4,1,1,15.0,4.0,11.0,2
1769,1769,2014-15,2014,2015,Aston Villa,Chelsea,Loss,Away,2014-09-27,0,3,6,7,10,4,7,10,13,-1,-1,-3,-3,0,15.0,3.0,12.0,2
1770,1770,2014-15,2014,2015,Aston Villa,Man City,Loss,Home,2014-10-04,0,0,3,6,7,4,5,5,8,-4,-2,1,-1,1,15.0,1.0,14.0,3
1771,1771,2014-15,2014,2015,Aston Villa,Everton,Loss,Away,2014-10-18,0,0,0,3,6,1,1,4,4,-1,-1,-1,2,0,15.0,5.0,10.0,3
1772,1772,2014-15,2014,2015,Aston Villa,QPR,Loss,Away,2014-10-27,0,0,0,0,3,0,0,1,1,0,0,-1,2,0,15.0,21.0,-6.0,3
1773,1773,2014-15,2014,2015,Aston Villa,Tottenham,Loss,Home,2014-11-02,0,0,0,0,0,0,3,4,4,0,-3,-4,-4,1,15.0,6.0,9.0,4
1774,1774,2014-15,2014,2015,Aston Villa,West Ham,Draw,Away,2014-11-08,1,0,0,0,0,4,7,10,10,-4,-7,-10,-10,0,15.0,13.0,2.0,4
1775,1775,2014-15,2014,2015,Aston Villa,Southampton,Draw,Home,2014-11-24,1,1,1,1,1,6,9,12,12,-5,-8,-11,-11,1,15.0,8.0,7.0,4
1776,1776,2014-15,2014,2015,Aston Villa,Burnley,Draw,Away,2014-11-29,1,2,2,2,2,6,6,6,6,-4,-4,-4,-4,0,15.0,21.0,-6.0,4
1777,1777,2014-15,2014,2015,Aston Villa,Crystal Palace,Win,Away,2014-12-02,3,2,3,3,3,4,4,4,5,-2,-1,-1,-2,0,15.0,11.0,4.0,5
1778,1778,2014-15,2014,2015,Aston Villa,Leicester,Win,Home,2014-12-07,3,4,5,6,6,0,1,1,1,4,4,5,5,1,15.0,21.0,-6.0,5
1779,1779,2014-15,2014,2015,Aston Villa,West Brom,Loss,Away,2014-12-13,0,6,7,8,9,1,1,1,1,5,6,7,8,0,15.0,17.0,-2.0,5
1780,1780,2014-15,2014,2015,Aston Villa,Man United,Draw,Home,2014-12-20,1,3,6,7,8,6,9,12,15,-3,-3,-5,-7,1,15.0,7.0,8.0,5
1781,1781,2014-15,2014,2015,Aston Villa,Swansea,Loss,Away,2014-12-26,0,1,4,7,8,3,3,6,7,-2,1,1,1,0,15.0,12.0,3.0,5
1782,1782,2014-15,2014,2015,Aston Villa,Sunderland,Draw,Home,2014-12-28,1,1,1,4,7,3,4,5,5,-2,-3,-1,2,1,15.0,14.0,1.0,5
1783,1783,2014-15,2014,2015,Aston Villa,Crystal Palace,Draw,Home,2015-01-01,1,1,2,2,5,1,1,2,3,0,1,0,2,1,15.0,11.0,4.0,6
1784,1784,2014-15,2014,2015,Aston Villa,Leicester,Loss,Away,2015-01-10,0,2,2,3,3,4,4,4,4,-2,-2,-1,-1,0,15.0,21.0,-6.0,6
1785,1785,2014-15,2014,2015,Aston Villa,Liverpool,Loss,Home,2015-01-17,0,1,2,2,3,4,7,10,11,-3,-5,-8,-8,1,15.0,2.0,13.0,6
1786,1786,2014-15,2014,2015,Aston Villa,Arsenal,Loss,Away,2015-02-01,0,0,1,2,2,6,6,9,12,-6,-5,-7,-10,0,15.0,4.0,11.0,7
1787,1787,2014-15,2014,2015,Aston Villa,Chelsea,Loss,Home,2015-02-07,0,0,0,1,2,4,7,7,8,-4,-7,-6,-6,1,15.0,3.0,12.0,7
1788,1788,2014-15,2014,2015,Aston Villa,Hull,Loss,Away,2015-02-10,0,0,0,0,1,1,1,1,4,-1,-1,-1,-3,0,15.0,16.0,-1.0,7
1789,1789,2014-15,2014,2015,Aston Villa,Stoke,Loss,Home,2015-02-21,0,0,0,0,0,1,4,7,7,-1,-4,-7,-7,1,15.0,9.0,6.0,7
1790,1790,2014-15,2014,2015,Aston Villa,Newcastle,Loss,Away,2015-02-28,0,0,0,0,0,1,2,5,5,-1,-2,-5,-5,0,15.0,10.0,5.0,7
1791,1791,2014-15,2014,2015,Aston Villa,West Brom,Win,Home,2015-03-03,3,0,0,0,0,4,7,8,8,-4,-7,-8,-8,1,15.0,17.0,-2.0,8
1792,1792,2014-15,2014,2015,Aston Villa,Sunderland,Win,Away,2015-03-14,3,3,3,3,3,1,2,2,3,2,1,1,0,0,15.0,14.0,1.0,8
1793,1793,2014-15,2014,2015,Aston Villa,Swansea,Loss,Home,2015-03-21,0,6,6,6,6,0,3,6,6,6,3,0,0,1,15.0,12.0,3.0,8
1794,1794,2014-15,2014,2015,Aston Villa,Man United,Loss,Away,2015-04-04,0,3,6,6,6,6,9,12,12,-3,-3,-6,-6,0,15.0,7.0,8.0,9
1795,1795,2014-15,2014,2015,Aston Villa,QPR,Draw,Home,2015-04-07,1,0,3,6,6,3,3,3,3,-3,0,3,3,1,15.0,21.0,-6.0,9
1796,1796,2014-15,2014,2015,Aston Villa,Tottenham,Win,Away,2015-04-11,3,1,1,4,7,4,4,7,10,-3,-3,-3,-3,0,15.0,6.0,9.0,9
1797,1797,2014-15,2014,2015,Aston Villa,Man City,Loss,Away,2015-04-25,0,4,4,4,7,3,3,6,6,1,1,-2,1,0,15.0,1.0,14.0,9
1798,1798,2014-15,2014,2015,Aston Villa,Everton,Win,Home,2015-05-02,3,3,4,4,4,6,7,10,13,-3,-3,-6,-9,1,15.0,5.0,10.0,10
1799,1799,2014-15,2014,2015,Aston Villa,West Ham,Win,Home,2015-05-09,3,3,6,7,7,4,4,5,5,-1,2,2,2,1,15.0,13.0,2.0,10
1800,1800,2014-15,2014,2015,Aston Villa,Southampton,Loss,Away,2015-05-16,0,6,6,9,10,0,1,1,4,6,5,8,6,0,15.0,8.0,7.0,10
1801,1801,2014-15,2014,2015,Aston Villa,Burnley,Loss,Home,2015-05-24,0,3,6,6,9,4,4,4,4,-1,2,2,5,1,15.0,21.0,-6.0,10
1802,1802,2015-16,2015,2016,Aston Villa,Bournemouth,Win,Away,2015-08-08,3,0,3,6,6,0,0,0,0,0,3,6,6,0,17.0,21.0,-4.0,1
1803,1803,2015-16,2015,2016,Aston Villa,Man United,Loss,Home,2015-08-14,0,3,3,6,9,4,5,8,8,-1,-2,-2,1,1,17.0,4.0,13.0,1
1804,1804,2015-16,2015,2016,Aston Villa,Crystal Palace,Loss,Away,2015-08-22,0,3,3,3,6,3,6,9,9,0,-3,-6,-3,0,17.0,10.0,7.0,1
1805,1805,2015-16,2015,2016,Aston Villa,Sunderland,Draw,Home,2015-08-29,1,0,3,3,3,1,1,1,2,-1,2,2,1,1,17.0,16.0,1.0,1
1806,1806,2015-16,2015,2016,Aston Villa,Leicester,Loss,Away,2015-09-13,0,1,1,4,4,2,5,8,11,-1,-4,-4,-7,0,17.0,14.0,3.0,2
1807,1807,2015-16,2015,2016,Aston Villa,West Brom,Loss,Home,2015-09-19,0,1,1,1,4,4,4,5,5,-3,-3,-4,-1,1,17.0,13.0,4.0,2
1808,1808,2015-16,2015,2016,Aston Villa,Liverpool,Loss,Away,2015-09-26,0,0,1,1,1,1,1,2,5,-1,0,-1,-4,0,17.0,6.0,11.0,2
1809,1809,2015-16,2015,2016,Aston Villa,Stoke,Loss,Home,2015-10-03,0,0,0,1,1,4,4,4,5,-4,-4,-3,-4,1,17.0,9.0,8.0,3
1810,1810,2015-16,2015,2016,Aston Villa,Chelsea,Loss,Away,2015-10-17,0,0,0,0,1,1,4,4,4,-1,-4,-4,-3,0,17.0,1.0,16.0,3
1811,1811,2015-16,2015,2016,Aston Villa,Swansea,Loss,Home,2015-10-24,0,0,0,0,0,1,1,2,2,-1,-1,-2,-2,1,17.0,8.0,9.0,3
1812,1812,2015-16,2015,2016,Aston Villa,Tottenham,Loss,Away,2015-11-02,0,0,0,0,0,4,5,8,11,-4,-5,-8,-11,0,17.0,5.0,12.0,4
1813,1813,2015-16,2015,2016,Aston Villa,Man City,Draw,Home,2015-11-08,1,0,0,0,0,4,7,10,10,-4,-7,-10,-10,1,17.0,2.0,15.0,4
1814,1814,2015-16,2015,2016,Aston Villa,Everton,Loss,Away,2015-11-21,0,1,1,1,1,4,4,4,5,-3,-3,-3,-4,0,17.0,11.0,6.0,4
1815,1815,2015-16,2015,2016,Aston Villa,Watford,Loss,Home,2015-11-28,0,1,1,1,1,0,3,6,6,1,-2,-5,-5,1,17.0,21.0,-4.0,4
1816,1816,2015-16,2015,2016,Aston Villa,Southampton,Draw,Away,2015-12-05,1,0,1,1,1,0,3,6,7,0,-2,-5,-6,0,17.0,7.0,10.0,5
1817,1817,2015-16,2015,2016,Aston Villa,Arsenal,Loss,Home,2015-12-13,0,1,1,2,2,4,4,5,8,-3,-3,-3,-6,1,17.0,3.0,14.0,5
1818,1818,2015-16,2015,2016,Aston Villa,Newcastle,Draw,Away,2015-12-19,1,1,1,1,2,6,6,6,9,-5,-5,-5,-7,0,17.0,15.0,2.0,5
1819,1819,2015-16,2015,2016,Aston Villa,West Ham,Draw,Home,2015-12-26,1,1,2,2,2,2,3,4,4,-1,-1,-2,-2,1,17.0,12.0,5.0,5
1820,1820,2015-16,2015,2016,Aston Villa,Norwich,Loss,Away,2015-12-28,0,2,2,3,3,3,4,4,5,-1,-2,-1,-2,0,17.0,21.0,-4.0,5
1821,1821,2015-16,2015,2016,Aston Villa,Sunderland,Loss,Away,2016-01-02,0,1,2,2,3,0,0,0,0,1,2,2,3,0,17.0,16.0,1.0,6
1822,1822,2015-16,2015,2016,Aston Villa,Crystal Palace,Win,Home,2016-01-12,3,0,1,2,2,1,2,5,8,-1,-1,-3,-6,1,17.0,10.0,7.0,6
1823,1823,2015-16,2015,2016,Aston Villa,Leicester,Draw,Home,2016-01-16,1,3,3,4,5,4,5,5,8,-1,-2,-1,-3,1,17.0,14.0,3.0,6
1824,1824,2015-16,2015,2016,Aston Villa,West Brom,Draw,Away,2016-01-23,1,4,4,4,5,1,4,7,7,3,0,-3,-2,0,17.0,13.0,4.0,6
1825,1825,2015-16,2015,2016,Aston Villa,West Ham,Loss,Away,2016-02-02,0,2,5,5,5,1,4,7,10,1,1,-2,-5,0,17.0,12.0,5.0,7
1826,1826,2015-16,2015,2016,Aston Villa,Norwich,Win,Home,2016-02-06,3,1,2,5,5,0,0,0,3,1,2,5,2,1,17.0,21.0,-4.0,7
1827,1827,2015-16,2015,2016,Aston Villa,Liverpool,Loss,Home,2016-02-14,0,3,4,5,8,1,4,4,5,2,0,1,3,1,17.0,6.0,11.0,7
1828,1828,2015-16,2015,2016,Aston Villa,Stoke,Loss,Away,2016-02-27,0,3,3,4,5,3,3,3,4,0,0,1,1,0,17.0,9.0,8.0,7
1829,1829,2015-16,2015,2016,Aston Villa,Everton,Loss,Home,2016-03-01,0,0,3,3,4,3,6,6,7,-3,-3,-3,-3,1,17.0,11.0,6.0,8
1830,1830,2015-16,2015,2016,Aston Villa,Man City,Loss,Away,2016-03-05,0,0,0,3,3,0,0,3,4,0,0,0,-1,0,17.0,2.0,15.0,8
1831,1831,2015-16,2015,2016,Aston Villa,Tottenham,Loss,Home,2016-03-13,0,0,0,0,3,1,4,7,10,-1,-4,-7,-7,1,17.0,5.0,12.0,8
1832,1832,2015-16,2015,2016,Aston Villa,Swansea,Loss,Away,2016-03-19,0,0,0,0,0,3,6,6,6,-3,-6,-6,-6,0,17.0,8.0,9.0,8
1833,1833,2015-16,2015,2016,Aston Villa,Chelsea,Loss,Home,2016-04-02,0,0,0,0,0,2,5,8,11,-2,-5,-8,-11,1,17.0,1.0,16.0,9
1834,1834,2015-16,2015,2016,Aston Villa,Bournemouth,Loss,Home,2016-04-09,0,0,0,0,0,0,3,6,9,0,-3,-6,-9,1,17.0,21.0,-4.0,9
1835,1835,2015-16,2015,2016,Aston Villa,Man United,Loss,Away,2016-04-16,0,0,0,0,0,3,6,6,9,-3,-6,-6,-9,0,17.0,4.0,13.0,9
1836,1836,2015-16,2015,2016,Aston Villa,Southampton,Loss,Home,2016-04-23,0,0,0,0,0,4,4,7,10,-4,-4,-7,-10,1,17.0,7.0,10.0,9
1837,1837,2015-16,2015,2016,Aston Villa,Watford,Loss,Away,2016-04-30,0,0,0,0,0,3,4,4,4,-3,-4,-4,-4,0,17.0,21.0,-4.0,9
1838,1838,2015-16,2015,2016,Aston Villa,Newcastle,Draw,Home,2016-05-07,1,0,0,0,0,4,5,8,8,-4,-5,-8,-8,1,17.0,15.0,2.0,10
1839,1839,2015-16,2015,2016,Aston Villa,Arsenal,Loss,Away,2016-05-15,0,1,1,1,1,4,5,8,9,-3,-4,-7,-8,0,17.0,3.0,14.0,10
1840,1840,1997-98,1997,1998,Barnsley,West Ham,Loss,Home,1997-08-09,0,0,0,0,0,1,4,7,8,-1,-4,-7,-8,1,21.0,14.0,7.0,1
1841,1841,1997-98,1997,1998,Barnsley,Crystal Palace,Win,Away,1997-08-12,3,0,0,0,0,3,3,6,6,-3,-3,-6,-6,0,21.0,21.0,0.0,1
1842,1842,1997-98,1997,1998,Barnsley,Chelsea,Loss,Home,1997-08-24,0,3,3,3,3,3,4,7,10,0,-1,-4,-7,1,21.0,6.0,15.0,1
1843,1843,1997-98,1997,1998,Barnsley,Bolton,Win,Home,1997-08-27,3,3,3,3,3,4,4,4,4,-1,-1,-1,-1,1,21.0,21.0,0.0,1
1844,1844,1997-98,1997,1998,Barnsley,Derby,Loss,Away,1997-08-30,0,3,6,6,6,0,0,3,4,3,6,3,2,0,21.0,12.0,9.0,1
1845,1845,1997-98,1997,1998,Barnsley,Aston Villa,Loss,Home,1997-09-13,0,3,3,6,6,3,3,3,3,0,0,3,3,1,21.0,5.0,16.0,2
1846,1846,1997-98,1997,1998,Barnsley,Everton,Loss,Away,1997-09-20,0,0,3,3,6,1,1,4,4,-1,2,-1,2,0,21.0,15.0,6.0,2
1847,1847,1997-98,1997,1998,Barnsley,Wimbledon,Loss,Away,1997-09-23,0,0,0,3,3,3,3,3,4,-3,-3,0,-1,0,21.0,8.0,13.0,2
1848,1848,1997-98,1997,1998,Barnsley,Leicester,Loss,Home,1997-09-27,0,0,0,0,3,4,7,7,8,-4,-7,-7,-5,1,21.0,9.0,12.0,2
1849,1849,1997-98,1997,1998,Barnsley,Arsenal,Loss,Away,1997-10-04,0,0,0,0,0,4,7,10,11,-4,-7,-10,-11,0,21.0,3.0,18.0,3
1850,1850,1997-98,1997,1998,Barnsley,Coventry,Win,Home,1997-10-20,3,0,0,0,0,2,3,4,7,-2,-3,-4,-7,1,21.0,17.0,4.0,3
1851,1851,1997-98,1997,1998,Barnsley,Man United,Loss,Away,1997-10-25,0,3,3,3,3,4,4,5,6,-1,-1,-2,-3,0,21.0,1.0,20.0,3
1852,1852,1997-98,1997,1998,Barnsley,Blackburn,Draw,Home,1997-11-01,1,3,3,3,3,4,7,8,9,-1,-4,-5,-6,1,21.0,13.0,8.0,4
1853,1853,1997-98,1997,1998,Barnsley,Southampton,Loss,Away,1997-11-08,0,1,4,4,4,6,6,9,9,-5,-2,-5,-5,0,21.0,16.0,5.0,4
1854,1854,1997-98,1997,1998,Barnsley,Liverpool,Win,Away,1997-11-22,3,1,1,4,4,4,7,7,10,-3,-6,-3,-6,0,21.0,4.0,17.0,4
1855,1855,1997-98,1997,1998,Barnsley,Leeds,Loss,Home,1997-11-29,0,3,4,4,7,6,9,9,12,-3,-5,-5,-5,1,21.0,11.0,10.0,4
1856,1856,1997-98,1997,1998,Barnsley,Sheffield Weds,Loss,Away,1997-12-08,0,3,3,4,4,6,9,9,9,-3,-6,-5,-5,0,21.0,7.0,14.0,5
1857,1857,1997-98,1997,1998,Barnsley,Newcastle,Draw,Home,1997-12-13,1,0,3,3,4,0,3,6,7,0,0,-3,-3,1,21.0,2.0,19.0,5
1858,1858,1997-98,1997,1998,Barnsley,Tottenham,Loss,Away,1997-12-20,0,1,1,4,4,0,3,3,3,1,-2,1,1,0,21.0,10.0,11.0,5
1859,1859,1997-98,1997,1998,Barnsley,Bolton,Draw,Away,1997-12-26,1,1,1,1,4,1,1,4,7,0,0,-3,-3,0,21.0,21.0,0.0,5
1860,1860,1997-98,1997,1998,Barnsley,Derby,Win,Home,1997-12-28,3,1,2,2,2,4,5,6,9,-3,-3,-4,-7,1,21.0,12.0,9.0,5
1861,1861,1997-98,1997,1998,Barnsley,West Ham,Loss,Away,1998-01-10,0,4,4,5,5,6,6,9,9,-2,-2,-4,-4,0,21.0,14.0,7.0,6
1862,1862,1997-98,1997,1998,Barnsley,Crystal Palace,Win,Home,1998-01-17,3,3,4,4,5,1,2,3,3,2,2,1,2,1,21.0,21.0,0.0,6
1863,1863,1997-98,1997,1998,Barnsley,Chelsea,Loss,Away,1998-01-31,0,3,6,7,7,3,3,4,7,0,3,3,0,0,21.0,6.0,15.0,6
1864,1864,1997-98,1997,1998,Barnsley,Everton,Draw,Home,1998-02-07,1,3,3,6,7,4,7,10,10,-1,-4,-4,-3,1,21.0,15.0,6.0,7
1865,1865,1997-98,1997,1998,Barnsley,Coventry,Loss,Away,1998-02-21,0,1,4,4,7,6,9,10,10,-5,-5,-6,-3,0,21.0,17.0,4.0,7
1866,1866,1997-98,1997,1998,Barnsley,Wimbledon,Win,Home,1998-02-28,3,1,1,4,4,6,7,8,8,-5,-6,-4,-4,1,21.0,8.0,13.0,7
1867,1867,1997-98,1997,1998,Barnsley,Aston Villa,Win,Away,1998-03-11,3,3,4,4,7,6,6,6,9,-3,-2,-2,-2,0,21.0,5.0,16.0,8
1868,1868,1997-98,1997,1998,Barnsley,Southampton,Win,Home,1998-03-14,3,6,6,7,7,6,9,9,12,0,-3,-2,-5,1,21.0,16.0,5.0,8
1869,1869,1997-98,1997,1998,Barnsley,Liverpool,Loss,Home,1998-03-28,0,6,9,9,10,4,4,5,6,2,5,4,4,1,21.0,4.0,17.0,8
1870,1870,1997-98,1997,1998,Barnsley,Blackburn,Loss,Away,1998-03-31,0,3,6,9,9,0,3,3,3,3,3,6,6,0,21.0,13.0,8.0,8
1871,1871,1997-98,1997,1998,Barnsley,Leeds,Loss,Away,1998-04-04,0,0,3,6,9,3,6,9,9,-3,-3,-3,0,0,21.0,11.0,10.0,9
1872,1872,1997-98,1997,1998,Barnsley,Sheffield Weds,Win,Home,1998-04-11,3,0,0,3,6,3,3,6,6,-3,-3,-3,0,1,21.0,7.0,14.0,9
1873,1873,1997-98,1997,1998,Barnsley,Newcastle,Loss,Away,1998-04-13,0,3,3,3,6,1,1,1,2,2,2,2,4,0,21.0,2.0,19.0,9
1874,1874,1997-98,1997,1998,Barnsley,Tottenham,Draw,Home,1998-04-18,1,3,3,3,3,1,2,5,6,2,1,-2,-3,1,21.0,10.0,11.0,9
1875,1875,1997-98,1997,1998,Barnsley,Arsenal,Loss,Home,1998-04-25,0,1,4,4,4,6,9,12,15,-5,-5,-8,-11,1,21.0,3.0,18.0,9
1876,1876,1997-98,1997,1998,Barnsley,Leicester,Loss,Away,1998-05-02,0,1,1,4,4,4,5,6,9,-3,-4,-2,-5,0,21.0,9.0,12.0,10
1877,1877,1997-98,1997,1998,Barnsley,Man United,Loss,Home,1998-05-10,0,0,1,1,4,6,7,8,11,-6,-6,-7,-7,1,21.0,1.0,20.0,10
1878,1878,2002-03,2002,2003,Birmingham,Arsenal,Loss,Away,2002-08-18,0,0,0,0,0,6,9,12,15,-6,-9,-12,-15,0,21.0,1.0,20.0,1
1879,1879,2002-03,2002,2003,Birmingham,Blackburn,Loss,Home,2002-08-24,0,0,0,0,0,4,4,7,8,-4,-4,-7,-8,1,21.0,10.0,11.0,1
1880,1880,2002-03,2002,2003,Birmingham,Everton,Draw,Away,2002-08-28,1,0,0,0,0,4,4,4,7,-4,-4,-4,-7,0,21.0,15.0,6.0,1
1881,1881,2002-03,2002,2003,Birmingham,Leeds,Win,Home,2002-08-31,3,1,1,1,1,3,6,9,12,-2,-5,-8,-11,1,21.0,5.0,16.0,1
1882,1882,2002-03,2002,2003,Birmingham,Liverpool,Draw,Away,2002-09-11,1,4,4,4,4,2,5,8,11,2,-1,-4,-7,0,21.0,2.0,19.0,2
1883,1883,2002-03,2002,2003,Birmingham,Aston Villa,Win,Home,2002-09-16,3,4,5,5,5,3,6,6,6,1,-1,-1,-1,1,21.0,8.0,13.0,2
1884,1884,2002-03,2002,2003,Birmingham,Middlesbrough,Loss,Away,2002-09-21,0,4,7,8,8,3,3,6,7,1,4,2,1,0,21.0,12.0,9.0,2
1885,1885,2002-03,2002,2003,Birmingham,Newcastle,Loss,Home,2002-09-28,0,3,4,7,8,3,3,4,4,0,1,3,4,1,21.0,4.0,17.0,2
1886,1886,2002-03,2002,2003,Birmingham,West Ham,Win,Away,2002-10-05,3,0,3,4,7,4,4,4,4,-4,-1,0,3,0,21.0,7.0,14.0,3
1887,1887,2002-03,2002,2003,Birmingham,West Brom,Draw,Away,2002-10-19,1,3,3,6,7,0,0,3,6,3,3,3,1,0,21.0,21.0,0.0,3
1888,1888,2002-03,2002,2003,Birmingham,Man City,Loss,Home,2002-10-26,0,4,4,4,7,0,0,1,2,4,4,3,5,1,21.0,21.0,0.0,3
1889,1889,2002-03,2002,2003,Birmingham,Bolton,Win,Home,2002-11-02,3,1,4,4,4,1,1,2,2,0,3,2,2,1,21.0,16.0,5.0,4
1890,1890,2002-03,2002,2003,Birmingham,Chelsea,Loss,Away,2002-11-09,0,3,4,7,7,4,7,7,7,-1,-3,0,0,0,21.0,6.0,15.0,4
1891,1891,2002-03,2002,2003,Birmingham,Fulham,Draw,Home,2002-11-17,1,3,3,4,7,0,0,0,1,3,3,4,6,1,21.0,13.0,8.0,4
1892,1892,2002-03,2002,2003,Birmingham,Sunderland,Win,Away,2002-11-23,3,1,4,4,5,4,5,6,6,-3,-1,-2,-1,0,21.0,17.0,4.0,4
1893,1893,2002-03,2002,2003,Birmingham,Tottenham,Draw,Home,2002-11-30,1,4,4,7,7,3,3,4,4,1,1,3,3,1,21.0,9.0,12.0,4
1894,1894,2002-03,2002,2003,Birmingham,Southampton,Loss,Away,2002-12-07,0,4,5,5,8,6,6,7,7,-2,-1,-2,1,0,21.0,11.0,10.0,5
1895,1895,2002-03,2002,2003,Birmingham,Fulham,Win,Away,2002-12-15,3,1,4,5,5,3,6,7,7,-2,-2,-2,-2,0,21.0,13.0,8.0,5
1896,1896,2002-03,2002,2003,Birmingham,Charlton,Draw,Home,2002-12-21,1,3,4,7,8,4,7,10,13,-1,-3,-3,-5,1,21.0,14.0,7.0,5
1897,1897,2002-03,2002,2003,Birmingham,Everton,Draw,Home,2002-12-26,1,4,4,5,8,4,4,4,7,0,0,1,1,1,21.0,15.0,6.0,5
1898,1898,2002-03,2002,2003,Birmingham,Man United,Loss,Away,2002-12-28,0,2,5,5,6,0,3,6,9,2,2,-1,-3,0,21.0,3.0,18.0,5
1899,1899,2002-03,2002,2003,Birmingham,Leeds,Loss,Away,2003-01-01,0,1,2,5,5,6,7,10,10,-5,-5,-5,-5,0,21.0,5.0,16.0,6
1900,1900,2002-03,2002,2003,Birmingham,Arsenal,Loss,Home,2003-01-12,0,0,1,2,5,4,7,10,11,-4,-6,-8,-6,1,21.0,1.0,20.0,6
1901,1901,2002-03,2002,2003,Birmingham,Blackburn,Draw,Away,2003-01-18,1,0,0,1,2,4,5,6,9,-4,-5,-5,-7,0,21.0,10.0,11.0,6
1902,1902,2002-03,2002,2003,Birmingham,Bolton,Loss,Away,2003-02-01,0,1,1,1,2,0,1,2,2,1,0,-1,0,0,21.0,16.0,5.0,7
1903,1903,2002-03,2002,2003,Birmingham,Man United,Loss,Home,2003-02-04,0,1,1,1,1,6,9,12,15,-5,-8,-11,-14,1,21.0,3.0,18.0,7
1904,1904,2002-03,2002,2003,Birmingham,Chelsea,Loss,Home,2003-02-08,0,0,1,1,1,4,4,7,7,-4,-3,-6,-6,1,21.0,6.0,15.0,7
1905,1905,2002-03,2002,2003,Birmingham,Liverpool,Win,Home,2003-02-23,3,0,0,1,1,4,5,8,9,-4,-5,-7,-8,1,21.0,2.0,19.0,7
1906,1906,2002-03,2002,2003,Birmingham,Aston Villa,Win,Away,2003-03-03,3,3,3,3,4,0,3,6,6,3,0,-3,-2,0,21.0,8.0,13.0,8
1907,1907,2002-03,2002,2003,Birmingham,Man City,Loss,Away,2003-03-16,0,6,6,6,6,0,1,1,4,6,5,5,2,0,21.0,21.0,0.0,8
1908,1908,2002-03,2002,2003,Birmingham,West Brom,Win,Home,2003-03-22,3,3,6,6,6,0,0,0,1,3,6,6,5,1,21.0,21.0,0.0,8
1909,1909,2002-03,2002,2003,Birmingham,Tottenham,Loss,Away,2003-04-05,0,3,6,9,9,0,0,1,4,3,6,8,5,0,21.0,9.0,12.0,9
1910,1910,2002-03,2002,2003,Birmingham,Sunderland,Win,Home,2003-04-12,3,3,3,6,9,0,0,0,0,3,3,6,9,1,21.0,17.0,4.0,9
1911,1911,2002-03,2002,2003,Birmingham,Charlton,Win,Away,2003-04-19,3,3,6,6,9,0,1,1,1,3,5,5,8,0,21.0,14.0,7.0,9
1912,1912,2002-03,2002,2003,Birmingham,Southampton,Win,Home,2003-04-21,3,6,6,9,9,4,5,6,9,2,1,3,0,1,21.0,11.0,10.0,9
1913,1913,2002-03,2002,2003,Birmingham,Middlesbrough,Win,Home,2003-04-26,3,6,9,9,12,0,1,4,5,6,8,5,7,1,21.0,12.0,9.0,9
1914,1914,2002-03,2002,2003,Birmingham,Newcastle,Loss,Away,2003-05-03,0,6,9,12,12,4,4,4,4,2,5,8,8,0,21.0,4.0,17.0,10
1915,1915,2002-03,2002,2003,Birmingham,West Ham,Draw,Home,2003-05-11,1,3,6,9,12,6,9,9,10,-3,-3,0,2,1,21.0,7.0,14.0,10
1916,1916,2003-04,2003,2004,Birmingham,Tottenham,Win,Home,2003-08-16,3,1,4,7,10,0,0,3,3,1,4,4,7,1,13.0,10.0,3.0,1
1917,1917,2003-04,2003,2004,Birmingham,Southampton,Draw,Away,2003-08-23,1,4,4,7,10,4,4,5,5,0,0,2,5,0,13.0,8.0,5.0,1
1918,1918,2003-04,2003,2004,Birmingham,Newcastle,Win,Away,2003-08-30,3,4,5,5,8,1,2,5,8,3,3,0,0,0,13.0,3.0,10.0,1
1919,1919,2003-04,2003,2004,Birmingham,Fulham,Draw,Home,2003-09-14,1,4,7,8,8,3,6,9,12,1,1,-1,-4,1,13.0,14.0,-1.0,2
1920,1920,2003-04,2003,2004,Birmingham,Leeds,Win,Away,2003-09-20,3,4,5,8,9,3,4,4,5,1,1,4,4,0,13.0,15.0,-2.0,2
1921,1921,2003-04,2003,2004,Birmingham,Portsmouth,Win,Home,2003-09-27,3,4,7,8,11,1,2,5,6,3,5,3,5,1,13.0,21.0,-8.0,2
1922,1922,2003-04,2003,2004,Birmingham,Man United,Loss,Away,2003-10-04,0,6,7,10,11,4,7,7,10,2,0,3,1,0,13.0,1.0,12.0,3
1923,1923,2003-04,2003,2004,Birmingham,Chelsea,Draw,Home,2003-10-14,1,3,6,7,10,6,9,12,13,-3,-3,-5,-3,1,13.0,4.0,9.0,3
1924,1924,2003-04,2003,2004,Birmingham,Aston Villa,Draw,Home,2003-10-19,1,1,4,7,8,1,4,4,7,0,0,3,1,1,13.0,16.0,-3.0,3
1925,1925,2003-04,2003,2004,Birmingham,Bolton,Win,Away,2003-10-25,3,2,2,5,8,1,2,3,6,1,0,2,2,0,13.0,17.0,-4.0,3
1926,1926,2003-04,2003,2004,Birmingham,Charlton,Loss,Home,2003-11-03,0,4,5,5,8,4,7,10,10,0,-2,-5,-2,1,13.0,12.0,1.0,4
1927,1927,2003-04,2003,2004,Birmingham,Wolves,Draw,Away,2003-11-08,1,3,4,5,5,3,4,7,8,0,0,-2,-3,0,13.0,21.0,-8.0,4
1928,1928,2003-04,2003,2004,Birmingham,Arsenal,Loss,Home,2003-11-22,0,1,4,5,6,6,7,10,13,-5,-3,-5,-7,1,13.0,2.0,11.0,4
1929,1929,2003-04,2003,2004,Birmingham,Liverpool,Loss,Away,2003-11-30,0,1,1,4,5,1,4,7,7,0,-3,-3,-2,0,13.0,5.0,8.0,4
1930,1930,2003-04,2003,2004,Birmingham,Blackburn,Loss,Home,2003-12-06,0,0,1,1,4,3,6,6,6,-3,-5,-5,-2,1,13.0,6.0,7.0,5
1931,1931,2003-04,2003,2004,Birmingham,Leicester,Win,Away,2003-12-13,3,0,0,1,1,4,5,8,11,-4,-5,-7,-10,0,13.0,21.0,-8.0,5
1932,1932,2003-04,2003,2004,Birmingham,Man City,Win,Home,2003-12-26,3,3,3,3,4,1,2,2,2,2,1,1,2,1,13.0,9.0,4.0,5
1933,1933,2003-04,2003,2004,Birmingham,Everton,Loss,Away,2003-12-28,0,6,6,6,6,3,6,7,7,3,0,-1,-1,0,13.0,7.0,6.0,5
1934,1934,2003-04,2003,2004,Birmingham,Tottenham,Loss,Away,2004-01-07,0,3,6,6,6,0,0,0,3,3,6,6,3,0,13.0,10.0,3.0,6
1935,1935,2003-04,2003,2004,Birmingham,Southampton,Win,Home,2004-01-10,3,0,3,6,6,1,1,4,7,-1,2,2,-1,1,13.0,8.0,5.0,6
1936,1936,2003-04,2003,2004,Birmingham,Chelsea,Draw,Away,2004-01-18,1,3,3,6,9,3,6,6,9,0,-3,0,0,0,13.0,4.0,9.0,6
1937,1937,2003-04,2003,2004,Birmingham,Newcastle,Draw,Home,2004-01-31,1,4,4,4,7,4,7,7,8,0,-3,-3,-1,1,13.0,3.0,10.0,6
1938,1938,2003-04,2003,2004,Birmingham,Man City,Draw,Away,2004-02-08,1,2,5,5,5,1,1,2,3,1,4,3,2,0,13.0,9.0,4.0,7
1939,1939,2003-04,2003,2004,Birmingham,Everton,Win,Home,2004-02-11,3,2,3,6,6,1,1,1,2,1,2,5,4,1,13.0,7.0,6.0,7
1940,1940,2003-04,2003,2004,Birmingham,Aston Villa,Draw,Away,2004-02-22,1,4,5,6,9,6,9,9,9,-2,-4,-3,0,0,13.0,16.0,-3.0,7
1941,1941,2003-04,2003,2004,Birmingham,Middlesbrough,Win,Home,2004-03-03,3,4,5,6,7,3,3,6,7,1,2,0,0,1,13.0,11.0,2.0,8
1942,1942,2003-04,2003,2004,Birmingham,Bolton,Win,Home,2004-03-06,3,4,7,8,9,1,2,5,8,3,5,3,1,1,13.0,17.0,-4.0,8
1943,1943,2003-04,2003,2004,Birmingham,Leicester,Loss,Home,2004-03-13,0,6,7,10,11,2,3,3,3,4,4,7,8,1,13.0,21.0,-8.0,8
1944,1944,2003-04,2003,2004,Birmingham,Middlesbrough,Loss,Away,2004-03-20,0,3,6,7,10,3,3,3,6,0,3,4,4,0,13.0,11.0,2.0,8
1945,1945,2003-04,2003,2004,Birmingham,Leeds,Win,Home,2004-03-27,3,0,3,6,7,3,4,5,8,-3,-1,1,-1,1,13.0,15.0,-2.0,8
1946,1946,2003-04,2003,2004,Birmingham,Fulham,Draw,Away,2004-04-03,1,3,3,6,9,1,4,5,5,2,-1,1,4,0,13.0,14.0,-1.0,9
1947,1947,2003-04,2003,2004,Birmingham,Man United,Loss,Home,2004-04-10,0,4,4,4,7,4,4,5,6,0,0,-1,1,1,13.0,1.0,12.0,9
1948,1948,2003-04,2003,2004,Birmingham,Portsmouth,Loss,Away,2004-04-12,0,1,4,4,4,4,7,7,7,-3,-3,-3,-3,0,13.0,21.0,-8.0,9
1949,1949,2003-04,2003,2004,Birmingham,Charlton,Draw,Away,2004-04-17,1,0,1,4,4,4,4,4,7,-4,-3,0,-3,0,13.0,12.0,1.0,9
1950,1950,2003-04,2003,2004,Birmingham,Wolves,Draw,Home,2004-04-25,1,1,1,2,5,3,4,4,4,-2,-3,-2,1,1,13.0,21.0,-8.0,9
1951,1951,2003-04,2003,2004,Birmingham,Arsenal,Draw,Away,2004-05-01,1,2,2,2,3,4,5,8,9,-2,-3,-6,-6,0,13.0,2.0,11.0,10
1952,1952,2003-04,2003,2004,Birmingham,Liverpool,Loss,Home,2004-05-08,0,2,3,3,3,6,7,7,7,-4,-4,-4,-4,1,13.0,5.0,8.0,10
1953,1953,2003-04,2003,2004,Birmingham,Blackburn,Draw,Away,2004-05-15,1,1,2,3,3,3,6,9,12,-2,-4,-6,-9,0,13.0,6.0,7.0,10
1954,1954,2004-05,2004,2005,Birmingham,Portsmouth,Draw,Away,2004-08-14,1,1,2,3,4,3,4,5,8,-2,-2,-2,-4,0,10.0,13.0,-3.0,1
1955,1955,2004-05,2004,2005,Birmingham,Chelsea,Loss,Home,2004-08-21,0,2,2,3,4,6,7,10,10,-4,-5,-7,-6,1,10.0,2.0,8.0,1
1956,1956,2004-05,2004,2005,Birmingham,Man City,Win,Home,2004-08-24,3,1,2,2,3,1,4,4,7,0,-2,-2,-4,1,10.0,16.0,-6.0,1
1957,1957,2004-05,2004,2005,Birmingham,Tottenham,Loss,Away,2004-08-28,0,3,4,5,5,4,5,8,11,-1,-1,-3,-6,0,10.0,14.0,-4.0,1
1958,1958,2004-05,2004,2005,Birmingham,Middlesbrough,Loss,Away,2004-09-11,0,3,3,4,5,6,6,7,7,-3,-3,-3,-2,0,10.0,11.0,-1.0,2
1959,1959,2004-05,2004,2005,Birmingham,Charlton,Draw,Home,2004-09-18,1,0,3,3,4,1,4,7,7,-1,-1,-4,-3,1,10.0,7.0,3.0,2
1960,1960,2004-05,2004,2005,Birmingham,Bolton,Draw,Away,2004-09-25,1,1,1,4,4,2,5,8,8,-1,-4,-4,-4,0,10.0,8.0,2.0,2
1961,1961,2004-05,2004,2005,Birmingham,Newcastle,Draw,Home,2004-10-03,1,2,2,2,5,6,9,9,10,-4,-7,-7,-5,1,10.0,5.0,5.0,3
1962,1962,2004-05,2004,2005,Birmingham,Man United,Draw,Home,2004-10-16,1,2,3,3,3,4,7,8,9,-2,-4,-5,-6,1,10.0,3.0,7.0,3
1963,1963,2004-05,2004,2005,Birmingham,Southampton,Draw,Away,2004-10-24,1,2,3,4,4,1,1,1,2,1,2,3,2,0,10.0,12.0,-2.0,3
1964,1964,2004-05,2004,2005,Birmingham,Crystal Palace,Loss,Home,2004-10-30,0,2,3,4,5,3,6,7,7,-1,-3,-3,-2,1,10.0,21.0,-11.0,3
1965,1965,2004-05,2004,2005,Birmingham,Liverpool,Win,Away,2004-11-06,3,1,2,3,4,4,7,7,10,-3,-5,-4,-6,0,10.0,4.0,6.0,4
1966,1966,2004-05,2004,2005,Birmingham,Everton,Loss,Home,2004-11-13,0,3,4,5,6,1,4,7,7,2,0,-2,-1,1,10.0,17.0,-7.0,4
1967,1967,2004-05,2004,2005,Birmingham,Blackburn,Draw,Away,2004-11-21,1,3,3,4,5,2,3,3,3,1,0,1,2,0,10.0,15.0,-5.0,4
1968,1968,2004-05,2004,2005,Birmingham,Norwich,Draw,Home,2004-11-27,1,1,4,4,5,3,4,5,5,-2,0,-1,0,1,10.0,21.0,-11.0,4
1969,1969,2004-05,2004,2005,Birmingham,Arsenal,Loss,Away,2004-12-04,0,2,2,5,5,1,4,5,6,1,-2,0,-1,0,10.0,1.0,9.0,5
1970,1970,2004-05,2004,2005,Birmingham,Aston Villa,Win,Away,2004-12-12,3,1,2,2,5,1,4,7,10,0,-2,-5,-5,0,10.0,6.0,4.0,5
1971,1971,2004-05,2004,2005,Birmingham,West Brom,Win,Home,2004-12-18,3,3,4,5,5,0,0,1,1,3,4,4,4,1,10.0,21.0,-11.0,5
1972,1972,2004-05,2004,2005,Birmingham,Middlesbrough,Win,Home,2004-12-26,3,6,6,7,8,4,7,7,10,2,-1,0,-2,1,10.0,11.0,-1.0,5
1973,1973,2004-05,2004,2005,Birmingham,Fulham,Win,Away,2004-12-28,3,6,9,9,10,0,1,4,4,6,8,5,6,0,10.0,9.0,1.0,5
1974,1974,2004-05,2004,2005,Birmingham,Newcastle,Loss,Away,2005-01-01,0,6,9,12,12,1,1,2,2,5,8,10,10,0,10.0,5.0,5.0,6
1975,1975,2004-05,2004,2005,Birmingham,Bolton,Loss,Home,2005-01-04,0,3,6,9,12,1,1,1,1,2,5,8,11,1,10.0,8.0,2.0,6
1976,1976,2004-05,2004,2005,Birmingham,Charlton,Loss,Away,2005-01-15,0,0,3,6,9,0,3,4,7,0,0,2,2,0,10.0,7.0,3.0,6
1977,1977,2004-05,2004,2005,Birmingham,Fulham,Loss,Home,2005-01-22,0,0,0,3,6,4,7,7,7,-4,-7,-4,-1,1,10.0,9.0,1.0,6
1978,1978,2004-05,2004,2005,Birmingham,Southampton,Win,Home,2005-02-02,3,0,0,0,3,3,4,4,4,-3,-4,-4,-1,1,10.0,12.0,-2.0,7
1979,1979,2004-05,2004,2005,Birmingham,Man United,Loss,Away,2005-02-05,0,3,3,3,3,6,9,10,13,-3,-6,-7,-10,0,10.0,3.0,7.0,7
1980,1980,2004-05,2004,2005,Birmingham,Liverpool,Win,Home,2005-02-12,3,3,3,3,3,6,6,6,9,-3,-3,-3,-6,1,10.0,4.0,6.0,7
1981,1981,2004-05,2004,2005,Birmingham,Crystal Palace,Loss,Away,2005-02-26,0,3,6,6,6,0,1,4,4,3,5,2,2,0,10.0,21.0,-11.0,7
1982,1982,2004-05,2004,2005,Birmingham,West Brom,Loss,Away,2005-03-06,0,3,3,6,6,1,2,5,5,2,1,1,1,0,10.0,21.0,-11.0,8
1983,1983,2004-05,2004,2005,Birmingham,Aston Villa,Win,Home,2005-03-20,3,0,3,3,6,3,6,6,7,-3,-3,-3,-1,1,10.0,6.0,4.0,8
1984,1984,2004-05,2004,2005,Birmingham,Tottenham,Draw,Home,2005-04-02,1,3,3,6,6,3,3,6,9,0,0,0,-3,1,10.0,14.0,-4.0,9
1985,1985,2004-05,2004,2005,Birmingham,Chelsea,Draw,Away,2005-04-09,1,4,4,4,7,6,9,12,15,-2,-5,-8,-8,0,10.0,2.0,8.0,9
1986,1986,2004-05,2004,2005,Birmingham,Portsmouth,Draw,Home,2005-04-16,1,2,5,5,5,3,4,4,4,-1,1,1,1,1,10.0,13.0,-3.0,9
1987,1987,2004-05,2004,2005,Birmingham,Man City,Loss,Away,2005-04-20,0,2,3,6,6,4,5,5,5,-2,-2,1,1,0,10.0,16.0,-6.0,9
1988,1988,2004-05,2004,2005,Birmingham,Everton,Draw,Away,2005-04-23,1,1,2,3,6,6,6,6,6,-5,-4,-3,0,0,10.0,17.0,-7.0,9
1989,1989,2004-05,2004,2005,Birmingham,Blackburn,Win,Home,2005-04-30,3,1,2,3,4,2,5,8,9,-1,-3,-5,-5,1,10.0,15.0,-5.0,9
1990,1990,2004-05,2004,2005,Birmingham,Norwich,Loss,Away,2005-05-07,0,4,4,5,6,3,6,7,10,1,-2,-2,-4,0,10.0,21.0,-11.0,10
1991,1991,2004-05,2004,2005,Birmingham,Arsenal,Win,Home,2005-05-15,3,3,4,4,5,6,9,12,13,-3,-5,-8,-8,1,10.0,1.0,9.0,10
1992,1992,2005-06,2005,2006,Birmingham,Fulham,Draw,Away,2005-08-13,1,3,6,7,7,6,6,9,9,-3,0,-2,-2,0,12.0,13.0,-1.0,1
1993,1993,2005-06,2005,2006,Birmingham,Man City,Loss,Home,2005-08-20,0,4,4,7,8,2,5,8,9,2,-1,-1,-1,1,12.0,8.0,4.0,1
1994,1994,2005-06,2005,2006,Birmingham,Middlesbrough,Loss,Home,2005-08-23,0,1,4,4,7,1,2,5,6,0,2,-1,1,1,12.0,7.0,5.0,1
1995,1995,2005-06,2005,2006,Birmingham,West Brom,Win,Away,2005-08-27,3,0,1,4,4,3,4,7,8,-3,-3,-3,-4,0,12.0,17.0,-5.0,1
1996,1996,2005-06,2005,2006,Birmingham,Charlton,Loss,Home,2005-09-10,0,3,3,4,7,6,9,10,10,-3,-6,-6,-3,1,12.0,11.0,1.0,2
1997,1997,2005-06,2005,2006,Birmingham,Portsmouth,Draw,Away,2005-09-17,1,3,3,3,4,3,4,4,4,0,-1,-1,0,0,12.0,16.0,-4.0,2
1998,1998,2005-06,2005,2006,Birmingham,Liverpool,Draw,Home,2005-09-24,1,1,4,4,4,2,5,6,9,-1,-1,-2,-5,1,12.0,5.0,7.0,2
1999,1999,2005-06,2005,2006,Birmingham,Arsenal,Loss,Away,2005-10-02,0,2,2,5,5,4,4,7,7,-2,-2,-2,-2,0,12.0,2.0,10.0,3
2000,2000,2005-06,2005,2006,Birmingham,Aston Villa,Loss,Home,2005-10-16,0,1,2,2,5,0,1,1,4,1,1,1,1,1,12.0,10.0,2.0,3
2001,2001,2005-06,2005,2006,Birmingham,Blackburn,Loss,Away,2005-10-22,0,0,1,2,2,3,6,6,7,-3,-5,-4,-5,0,12.0,15.0,-3.0,3
2002,2002,2005-06,2005,2006,Birmingham,Everton,Loss,Home,2005-10-29,0,0,0,1,2,1,1,1,1,-1,-1,0,1,1,12.0,4.0,8.0,3
2003,2003,2005-06,2005,2006,Birmingham,Newcastle,Loss,Away,2005-11-05,0,0,0,0,1,6,6,7,10,-6,-6,-7,-9,0,12.0,14.0,-2.0,4
2004,2004,2005-06,2005,2006,Birmingham,Sunderland,Win,Away,2005-11-26,3,0,0,0,0,0,0,0,0,0,0,0,0,0,12.0,21.0,-9.0,4
2005,2005,2005-06,2005,2006,Birmingham,West Ham,Loss,Home,2005-12-05,0,3,3,3,3,1,4,4,7,2,-1,-1,-4,1,12.0,21.0,-9.0,5
2006,2006,2005-06,2005,2006,Birmingham,Fulham,Win,Home,2005-12-10,3,3,3,3,3,4,4,7,7,-1,-1,-4,-4,1,12.0,13.0,-1.0,5
2007,2007,2005-06,2005,2006,Birmingham,Man City,Loss,Away,2005-12-17,0,3,6,6,6,3,3,4,4,0,3,2,2,0,12.0,8.0,4.0,5
2008,2008,2005-06,2005,2006,Birmingham,Tottenham,Loss,Away,2005-12-26,0,3,3,6,6,4,7,10,11,-1,-4,-4,-5,0,12.0,9.0,3.0,5
2009,2009,2005-06,2005,2006,Birmingham,Man United,Draw,Home,2005-12-28,1,0,3,3,6,6,9,10,13,-6,-6,-7,-7,1,12.0,3.0,9.0,5
2010,2010,2005-06,2005,2006,Birmingham,Chelsea,Loss,Away,2005-12-31,0,1,1,4,4,6,9,12,15,-5,-8,-8,-11,0,12.0,1.0,11.0,5
2011,2011,2005-06,2005,2006,Birmingham,Wigan,Win,Home,2006-01-02,3,1,1,1,4,3,6,9,9,-2,-5,-8,-5,1,12.0,21.0,-9.0,6
2012,2012,2005-06,2005,2006,Birmingham,Charlton,Loss,Away,2006-01-14,0,3,4,4,4,3,3,3,6,0,1,1,-2,0,12.0,11.0,1.0,6
2013,2013,2005-06,2005,2006,Birmingham,Portsmouth,Win,Home,2006-01-21,3,3,3,4,4,0,3,3,4,3,0,1,0,1,12.0,16.0,-4.0,6
2014,2014,2005-06,2005,2006,Birmingham,Liverpool,Draw,Away,2006-02-01,1,3,6,6,7,3,4,7,10,0,2,-1,-3,0,12.0,5.0,7.0,7
2015,2015,2005-06,2005,2006,Birmingham,Arsenal,Loss,Home,2006-02-04,0,4,4,7,7,0,3,4,5,4,1,3,2,1,12.0,2.0,10.0,7
2016,2016,2005-06,2005,2006,Birmingham,West Ham,Loss,Away,2006-02-13,0,1,4,4,7,6,9,12,12,-5,-5,-8,-5,0,12.0,21.0,-9.0,7
2017,2017,2005-06,2005,2006,Birmingham,Sunderland,Win,Home,2006-02-25,3,0,1,4,4,1,1,1,4,-1,0,3,0,1,12.0,21.0,-9.0,7
2018,2018,2005-06,2005,2006,Birmingham,Middlesbrough,Loss,Away,2006-03-04,0,3,3,4,7,6,6,9,9,-3,-3,-5,-2,0,12.0,7.0,5.0,8
2019,2019,2005-06,2005,2006,Birmingham,West Brom,Draw,Home,2006-03-11,1,3,3,3,4,0,0,3,4,3,3,0,0,1,12.0,17.0,-5.0,8
2020,2020,2005-06,2005,2006,Birmingham,Tottenham,Loss,Home,2006-03-18,0,1,4,4,4,3,4,5,8,-2,0,-1,-4,1,12.0,9.0,3.0,8
2021,2021,2005-06,2005,2006,Birmingham,Man United,Loss,Away,2006-03-26,0,1,1,4,4,6,9,12,15,-5,-8,-8,-11,0,12.0,3.0,9.0,8
2022,2022,2005-06,2005,2006,Birmingham,Chelsea,Draw,Home,2006-04-01,1,0,1,1,4,3,6,9,12,-3,-5,-8,-8,1,12.0,1.0,11.0,9
2023,2023,2005-06,2005,2006,Birmingham,Bolton,Win,Home,2006-04-04,3,1,1,2,2,0,3,6,6,1,-2,-4,-4,1,12.0,6.0,6.0,9
2024,2024,2005-06,2005,2006,Birmingham,Wigan,Draw,Away,2006-04-08,1,4,4,4,5,1,4,7,7,3,0,-3,-2,0,12.0,21.0,-9.0,9
2025,2025,2005-06,2005,2006,Birmingham,Aston Villa,Loss,Away,2006-04-16,0,4,5,5,5,1,2,2,2,3,3,3,3,0,12.0,10.0,2.0,9
2026,2026,2005-06,2005,2006,Birmingham,Blackburn,Win,Home,2006-04-19,3,1,4,5,5,1,2,5,8,0,2,0,-3,1,12.0,15.0,-3.0,9
2027,2027,2005-06,2005,2006,Birmingham,Everton,Draw,Away,2006-04-22,1,3,4,7,8,0,1,2,2,3,3,5,6,0,12.0,4.0,8.0,9
2028,2028,2005-06,2005,2006,Birmingham,Newcastle,Draw,Home,2006-04-29,1,4,4,5,8,6,9,12,15,-2,-5,-7,-7,1,12.0,14.0,-2.0,9
2029,2029,2005-06,2005,2006,Birmingham,Bolton,Loss,Away,2006-05-07,0,2,5,5,6,1,4,5,5,1,1,0,1,0,12.0,6.0,6.0,10
2030,2030,2007-08,2007,2008,Birmingham,Chelsea,Loss,Away,2007-08-12,0,1,2,5,5,2,3,4,5,-1,-1,1,0,0,21.0,2.0,19.0,1
2031,2031,2007-08,2007,2008,Birmingham,Sunderland,Draw,Home,2007-08-15,1,0,1,2,5,3,6,6,6,-3,-5,-4,-1,1,21.0,21.0,0.0,1
2032,2032,2007-08,2007,2008,Birmingham,West Ham,Loss,Home,2007-08-18,0,1,1,2,3,3,6,9,12,-2,-5,-7,-9,1,21.0,15.0,6.0,1
2033,2033,2007-08,2007,2008,Birmingham,Derby,Win,Away,2007-08-25,3,1,1,1,2,0,1,2,2,1,0,-1,0,0,21.0,21.0,0.0,1
2034,2034,2007-08,2007,2008,Birmingham,Middlesbrough,Loss,Away,2007-09-01,0,3,4,4,4,4,4,4,7,-1,0,0,-3,0,21.0,12.0,9.0,2
2035,2035,2007-08,2007,2008,Birmingham,Bolton,Win,Home,2007-09-15,3,3,3,4,4,3,3,3,3,0,0,1,1,1,21.0,7.0,14.0,2
2036,2036,2007-08,2007,2008,Birmingham,Liverpool,Draw,Away,2007-09-22,1,3,6,6,7,4,7,8,11,-1,-1,-2,-4,0,21.0,3.0,18.0,2
2037,2037,2007-08,2007,2008,Birmingham,Man United,Loss,Home,2007-09-29,0,4,4,7,7,6,9,12,12,-2,-5,-5,-5,1,21.0,1.0,20.0,2
2038,2038,2007-08,2007,2008,Birmingham,Blackburn,Loss,Away,2007-10-07,0,1,4,4,7,3,4,7,8,-2,0,-3,-1,0,21.0,10.0,11.0,3
2039,2039,2007-08,2007,2008,Birmingham,Man City,Loss,Away,2007-10-20,0,0,1,4,4,6,7,10,10,-6,-6,-6,-6,0,21.0,14.0,7.0,3
2040,2040,2007-08,2007,2008,Birmingham,Wigan,Win,Home,2007-10-27,3,0,0,1,4,0,0,0,1,0,0,1,3,1,21.0,17.0,4.0,3
2041,2041,2007-08,2007,2008,Birmingham,Everton,Loss,Away,2007-11-03,0,3,3,3,4,3,3,6,6,0,0,-3,-2,0,21.0,6.0,15.0,4
2042,2042,2007-08,2007,2008,Birmingham,Aston Villa,Loss,Home,2007-11-11,0,3,3,3,3,4,4,7,8,-1,-1,-4,-5,1,21.0,11.0,10.0,4
2043,2043,2007-08,2007,2008,Birmingham,Portsmouth,Loss,Home,2007-11-24,0,0,3,3,3,4,5,8,11,-4,-2,-5,-8,1,21.0,9.0,12.0,4
2044,2044,2007-08,2007,2008,Birmingham,Tottenham,Win,Away,2007-12-02,3,0,0,3,3,4,5,5,5,-4,-5,-2,-2,0,21.0,5.0,16.0,5
2045,2045,2007-08,2007,2008,Birmingham,Newcastle,Loss,Away,2007-12-08,0,3,3,3,6,1,1,2,2,2,2,1,4,0,21.0,13.0,8.0,5
2046,2046,2007-08,2007,2008,Birmingham,Reading,Draw,Home,2007-12-15,1,3,3,3,3,4,4,4,4,-1,-1,-1,-1,1,21.0,8.0,13.0,5
2047,2047,2007-08,2007,2008,Birmingham,Bolton,Loss,Away,2007-12-22,0,1,4,4,4,3,3,6,7,-2,1,-2,-3,0,21.0,7.0,14.0,5
2048,2048,2007-08,2007,2008,Birmingham,Middlesbrough,Win,Home,2007-12-26,3,1,1,4,4,3,6,7,7,-2,-5,-3,-3,1,21.0,12.0,9.0,5
2049,2049,2007-08,2007,2008,Birmingham,Fulham,Draw,Home,2007-12-29,1,3,4,4,7,1,1,1,1,2,3,3,6,1,21.0,16.0,5.0,5
2050,2050,2007-08,2007,2008,Birmingham,Man United,Loss,Away,2008-01-01,0,4,4,5,5,3,6,9,12,1,-2,-4,-7,0,21.0,1.0,20.0,6
2051,2051,2007-08,2007,2008,Birmingham,Arsenal,Draw,Away,2008-01-12,1,1,4,4,5,6,7,10,13,-5,-3,-6,-8,0,21.0,4.0,17.0,6
2052,2052,2007-08,2007,2008,Birmingham,Chelsea,Loss,Home,2008-01-19,0,1,2,5,5,6,9,10,13,-5,-7,-5,-8,1,21.0,2.0,19.0,6
2053,2053,2007-08,2007,2008,Birmingham,Sunderland,Loss,Away,2008-01-29,0,1,1,2,5,3,3,6,6,-2,-2,-4,-1,0,21.0,21.0,0.0,6
2054,2054,2007-08,2007,2008,Birmingham,Derby,Draw,Home,2008-02-02,1,0,1,1,2,1,1,1,1,-1,0,0,1,1,21.0,21.0,0.0,7
2055,2055,2007-08,2007,2008,Birmingham,West Ham,Draw,Away,2008-02-09,1,1,1,2,2,3,4,7,7,-2,-3,-5,-5,0,21.0,15.0,6.0,7
2056,2056,2007-08,2007,2008,Birmingham,Arsenal,Draw,Home,2008-02-23,1,2,2,2,3,6,9,12,13,-4,-7,-10,-10,1,21.0,4.0,17.0,7
2057,2057,2007-08,2007,2008,Birmingham,Tottenham,Win,Home,2008-03-01,3,2,3,3,3,4,5,8,8,-2,-2,-5,-5,1,21.0,5.0,16.0,8
2058,2058,2007-08,2007,2008,Birmingham,Portsmouth,Loss,Away,2008-03-12,0,4,5,6,6,3,6,7,7,1,-1,-1,-1,0,21.0,9.0,12.0,8
2059,2059,2007-08,2007,2008,Birmingham,Newcastle,Draw,Home,2008-03-17,1,3,4,5,6,0,0,0,1,3,4,5,5,1,21.0,13.0,8.0,8
2060,2060,2007-08,2007,2008,Birmingham,Reading,Loss,Away,2008-03-22,0,1,4,5,6,3,6,6,6,-2,-2,-1,0,0,21.0,8.0,13.0,8
2061,2061,2007-08,2007,2008,Birmingham,Man City,Win,Home,2008-03-29,3,1,1,4,5,4,4,5,5,-3,-3,-1,0,1,21.0,14.0,7.0,8
2062,2062,2007-08,2007,2008,Birmingham,Wigan,Loss,Away,2008-04-05,0,3,4,4,7,0,3,4,5,3,1,0,2,0,21.0,17.0,4.0,9
2063,2063,2007-08,2007,2008,Birmingham,Everton,Draw,Home,2008-04-12,1,3,3,4,4,3,4,4,7,0,-1,0,-3,1,21.0,6.0,15.0,9
2064,2064,2007-08,2007,2008,Birmingham,Aston Villa,Loss,Away,2008-04-20,0,1,4,4,5,6,6,6,6,-5,-2,-2,-1,0,21.0,11.0,10.0,9
2065,2065,2007-08,2007,2008,Birmingham,Liverpool,Draw,Home,2008-04-26,1,1,1,4,4,6,7,10,10,-5,-6,-6,-6,1,21.0,3.0,18.0,9
2066,2066,2007-08,2007,2008,Birmingham,Fulham,Loss,Away,2008-05-03,0,1,2,2,5,3,6,6,7,-2,-4,-4,-2,0,21.0,16.0,5.0,10
2067,2067,2007-08,2007,2008,Birmingham,Blackburn,Win,Home,2008-05-11,3,1,1,2,2,6,7,7,8,-5,-6,-5,-6,1,21.0,10.0,11.0,10
2068,2068,2009-10,2009,2010,Birmingham,Man United,Loss,Away,2009-08-16,0,3,4,4,5,4,7,10,13,-1,-3,-6,-8,0,21.0,1.0,20.0,1
2069,2069,2009-10,2009,2010,Birmingham,Portsmouth,Win,Home,2009-08-19,3,3,3,4,4,0,3,3,3,3,0,1,1,1,21.0,14.0,7.0,1
2070,2070,2009-10,2009,2010,Birmingham,Stoke,Draw,Home,2009-08-22,1,3,6,6,7,3,3,6,9,0,3,0,-2,1,21.0,12.0,9.0,1
2071,2071,2009-10,2009,2010,Birmingham,Tottenham,Loss,Away,2009-08-29,0,4,4,7,7,6,9,9,12,-2,-5,-2,-5,0,21.0,8.0,13.0,1
2072,2072,2009-10,2009,2010,Birmingham,Aston Villa,Loss,Home,2009-09-13,0,1,4,4,7,6,6,9,10,-5,-2,-5,-3,1,21.0,6.0,15.0,2
2073,2073,2009-10,2009,2010,Birmingham,Hull,Win,Away,2009-09-19,3,0,1,4,4,1,4,4,4,-1,-3,0,0,0,21.0,17.0,4.0,2
2074,2074,2009-10,2009,2010,Birmingham,Bolton,Loss,Home,2009-09-26,0,3,3,4,7,4,4,4,4,-1,-1,0,3,1,21.0,13.0,8.0,2
2075,2075,2009-10,2009,2010,Birmingham,Burnley,Loss,Away,2009-10-03,0,3,3,3,4,3,3,3,6,0,0,0,-2,0,21.0,21.0,0.0,3
2076,2076,2009-10,2009,2010,Birmingham,Arsenal,Loss,Away,2009-10-17,0,0,3,3,3,6,9,9,9,-6,-6,-6,-6,0,21.0,4.0,17.0,3
2077,2077,2009-10,2009,2010,Birmingham,Sunderland,Win,Home,2009-10-24,3,0,0,3,3,4,7,7,10,-4,-7,-4,-7,1,21.0,16.0,5.0,3
2078,2078,2009-10,2009,2010,Birmingham,Man City,Draw,Home,2009-11-01,1,3,3,3,6,2,3,6,6,1,0,-3,0,1,21.0,10.0,11.0,4
2079,2079,2009-10,2009,2010,Birmingham,Liverpool,Draw,Away,2009-11-09,1,4,4,4,4,3,3,3,6,1,1,1,-2,0,21.0,2.0,19.0,4
2080,2080,2009-10,2009,2010,Birmingham,Fulham,Win,Home,2009-11-21,3,2,5,5,5,4,5,8,9,-2,0,-3,-4,1,21.0,7.0,14.0,4
2081,2081,2009-10,2009,2010,Birmingham,Wolves,Win,Away,2009-11-29,3,4,5,8,8,0,1,2,3,4,4,6,5,0,21.0,21.0,0.0,4
2082,2082,2009-10,2009,2010,Birmingham,Wigan,Win,Away,2009-12-05,3,6,7,8,11,3,4,4,7,3,3,4,4,0,21.0,11.0,10.0,5
2083,2083,2009-10,2009,2010,Birmingham,West Ham,Win,Home,2009-12-12,3,6,9,10,11,3,4,4,7,3,5,6,4,1,21.0,9.0,12.0,5
2084,2084,2009-10,2009,2010,Birmingham,Blackburn,Win,Home,2009-12-15,3,6,9,12,13,2,3,3,6,4,6,9,7,1,21.0,15.0,6.0,5
2085,2085,2009-10,2009,2010,Birmingham,Everton,Draw,Away,2009-12-20,1,6,9,12,15,2,2,2,2,4,7,10,13,0,21.0,5.0,16.0,5
2086,2086,2009-10,2009,2010,Birmingham,Chelsea,Draw,Home,2009-12-26,1,4,7,10,13,4,5,5,8,0,2,5,5,1,21.0,3.0,18.0,5
2087,2087,2009-10,2009,2010,Birmingham,Stoke,Win,Away,2009-12-28,3,2,5,8,11,0,1,1,2,2,4,7,9,0,21.0,12.0,9.0,5
2088,2088,2009-10,2009,2010,Birmingham,Man United,Draw,Home,2010-01-09,1,4,5,8,11,6,6,9,9,-2,-1,-1,2,1,21.0,1.0,20.0,6
2089,2089,2009-10,2009,2010,Birmingham,Chelsea,Loss,Away,2010-01-27,0,4,5,6,9,6,7,8,11,-2,-2,-2,-2,0,21.0,3.0,18.0,6
2090,2090,2009-10,2009,2010,Birmingham,Tottenham,Draw,Home,2010-01-30,1,1,4,5,6,3,4,7,8,-2,0,-2,-2,1,21.0,8.0,13.0,6
2091,2091,2009-10,2009,2010,Birmingham,Wolves,Win,Home,2010-02-07,3,1,2,5,6,2,2,2,2,-1,0,3,4,1,21.0,21.0,0.0,7
2092,2092,2009-10,2009,2010,Birmingham,West Ham,Loss,Away,2010-02-10,0,4,4,5,8,1,2,3,3,3,2,2,5,0,21.0,9.0,12.0,7
2093,2093,2009-10,2009,2010,Birmingham,Fulham,Loss,Away,2010-02-21,0,3,4,4,5,4,7,7,7,-1,-3,-3,-2,0,21.0,7.0,14.0,7
2094,2094,2009-10,2009,2010,Birmingham,Wigan,Win,Home,2010-02-27,3,0,3,4,4,1,2,3,3,-1,1,1,1,1,21.0,11.0,10.0,7
2095,2095,2009-10,2009,2010,Birmingham,Portsmouth,Win,Away,2010-03-09,3,3,3,6,7,3,4,4,4,0,-1,2,3,0,21.0,14.0,7.0,8
2096,2096,2009-10,2009,2010,Birmingham,Everton,Draw,Home,2010-03-13,1,6,6,6,9,3,6,9,9,3,0,-3,0,1,21.0,5.0,16.0,8
2097,2097,2009-10,2009,2010,Birmingham,Sunderland,Loss,Away,2010-03-20,0,4,7,7,7,4,5,5,6,0,2,2,1,0,21.0,16.0,5.0,8
2098,2098,2009-10,2009,2010,Birmingham,Blackburn,Loss,Away,2010-03-24,0,1,4,7,7,1,1,4,7,0,3,3,0,0,21.0,15.0,6.0,8
2099,2099,2009-10,2009,2010,Birmingham,Arsenal,Draw,Home,2010-03-27,1,0,1,4,7,6,9,12,15,-6,-8,-8,-8,1,21.0,4.0,17.0,8
2100,2100,2009-10,2009,2010,Birmingham,Liverpool,Draw,Home,2010-04-04,1,1,1,2,5,3,6,6,9,-2,-5,-4,-4,1,21.0,2.0,19.0,9
2101,2101,2009-10,2009,2010,Birmingham,Man City,Loss,Away,2010-04-11,0,2,2,2,3,6,6,9,10,-4,-4,-7,-7,0,21.0,10.0,11.0,9
2102,2102,2009-10,2009,2010,Birmingham,Hull,Draw,Home,2010-04-17,1,1,2,2,2,0,3,3,3,1,-1,-1,-1,1,21.0,17.0,4.0,9
2103,2103,2009-10,2009,2010,Birmingham,Aston Villa,Loss,Away,2010-04-25,0,1,2,3,3,6,7,10,10,-5,-5,-7,-7,0,21.0,6.0,15.0,9
2104,2104,2009-10,2009,2010,Birmingham,Burnley,Win,Home,2010-05-01,3,1,1,2,3,0,3,3,3,1,-2,-1,0,1,21.0,21.0,0.0,10
2105,2105,2009-10,2009,2010,Birmingham,Bolton,Loss,Away,2010-05-09,0,3,4,4,5,1,4,4,4,2,0,0,1,0,21.0,13.0,8.0,10
2106,2106,2010-11,2010,2011,Birmingham,Sunderland,Draw,Away,2010-08-14,1,3,3,4,4,0,3,6,6,3,0,-2,-2,0,9.0,13.0,-4.0,1
2107,2107,2010-11,2010,2011,Birmingham,Blackburn,Win,Home,2010-08-21,3,1,4,4,5,6,9,10,10,-5,-5,-6,-5,1,9.0,10.0,-1.0,1
2108,2108,2010-11,2010,2011,Birmingham,Bolton,Draw,Away,2010-08-29,1,4,4,7,7,4,7,7,8,0,-3,0,-1,0,9.0,14.0,-5.0,1
2109,2109,2010-11,2010,2011,Birmingham,Liverpool,Draw,Home,2010-09-12,1,4,5,5,8,3,4,5,5,1,1,0,3,1,9.0,7.0,2.0,2
2110,2110,2010-11,2010,2011,Birmingham,West Brom,Loss,Away,2010-09-18,0,2,5,6,6,1,4,4,5,1,1,2,1,0,9.0,21.0,-12.0,2
2111,2111,2010-11,2010,2011,Birmingham,Wigan,Draw,Home,2010-09-25,1,1,2,5,6,1,4,4,4,0,-2,1,2,1,9.0,16.0,-7.0,2
2112,2112,2010-11,2010,2011,Birmingham,Everton,Loss,Home,2010-10-02,0,1,2,3,6,1,2,2,3,0,0,1,3,1,9.0,8.0,1.0,3
2113,2113,2010-11,2010,2011,Birmingham,Arsenal,Loss,Away,2010-10-16,0,1,1,2,3,0,1,4,7,1,0,-2,-4,0,9.0,3.0,6.0,3
2114,2114,2010-11,2010,2011,Birmingham,Blackpool,Win,Home,2010-10-23,3,0,1,1,2,3,3,3,6,-3,-2,-2,-4,1,9.0,21.0,-12.0,3
2115,2115,2010-11,2010,2011,Birmingham,Aston Villa,Draw,Away,2010-10-31,1,3,3,4,4,1,1,4,5,2,2,0,-1,0,9.0,6.0,3.0,3
2116,2116,2010-11,2010,2011,Birmingham,West Ham,Draw,Home,2010-11-06,1,4,4,4,5,0,1,2,5,4,3,2,0,1,9.0,17.0,-8.0,4
2117,2117,2010-11,2010,2011,Birmingham,Stoke,Loss,Away,2010-11-09,0,2,5,5,5,0,0,0,3,2,5,5,2,0,9.0,11.0,-2.0,4
2118,2118,2010-11,2010,2011,Birmingham,Man City,Draw,Away,2010-11-13,1,1,2,5,5,4,4,4,7,-3,-2,1,-2,0,9.0,5.0,4.0,4
2119,2119,2010-11,2010,2011,Birmingham,Chelsea,Win,Home,2010-11-20,3,1,2,3,6,3,3,6,9,-2,-1,-3,-3,1,9.0,1.0,8.0,4
2120,2120,2010-11,2010,2011,Birmingham,Fulham,Draw,Away,2010-11-27,1,4,4,5,6,1,1,2,5,3,3,3,1,0,9.0,12.0,-3.0,4
2121,2121,2010-11,2010,2011,Birmingham,Tottenham,Draw,Home,2010-12-04,1,4,5,5,6,6,9,10,10,-2,-4,-5,-4,1,9.0,4.0,5.0,5
2122,2122,2010-11,2010,2011,Birmingham,Wolves,Loss,Away,2010-12-12,0,2,5,6,6,3,3,3,3,-1,2,3,3,0,9.0,15.0,-6.0,5
2123,2123,2010-11,2010,2011,Birmingham,Man United,Draw,Home,2010-12-28,1,1,2,5,6,6,9,12,13,-5,-7,-7,-7,1,9.0,2.0,7.0,5
2124,2124,2010-11,2010,2011,Birmingham,Arsenal,Loss,Home,2011-01-01,0,1,2,3,6,4,4,7,10,-3,-2,-4,-4,1,9.0,3.0,6.0,6
2125,2125,2010-11,2010,2011,Birmingham,Blackpool,Win,Away,2011-01-04,3,1,1,2,3,3,6,7,10,-2,-5,-5,-7,0,9.0,21.0,-12.0,6
2126,2126,2010-11,2010,2011,Birmingham,Aston Villa,Draw,Home,2011-01-16,1,3,4,4,5,1,1,1,4,2,3,3,1,1,9.0,6.0,3.0,6
2127,2127,2010-11,2010,2011,Birmingham,Man United,Loss,Away,2011-01-22,0,4,4,5,5,4,7,8,11,0,-3,-3,-6,0,9.0,2.0,7.0,6
2128,2128,2010-11,2010,2011,Birmingham,Man City,Draw,Home,2011-02-02,1,1,4,4,5,3,4,7,10,-2,0,-3,-5,1,9.0,5.0,4.0,7
2129,2129,2010-11,2010,2011,Birmingham,West Ham,Win,Away,2011-02-06,3,1,2,5,5,4,4,4,7,-3,-2,1,-2,0,9.0,17.0,-8.0,7
2130,2130,2010-11,2010,2011,Birmingham,Stoke,Win,Home,2011-02-12,3,4,4,5,8,3,3,6,6,1,1,-1,2,1,9.0,11.0,-2.0,7
2131,2131,2010-11,2010,2011,Birmingham,Newcastle,Loss,Home,2011-02-15,0,6,7,7,8,2,2,3,4,4,5,4,4,1,9.0,21.0,-12.0,7
2132,2132,2010-11,2010,2011,Birmingham,West Brom,Loss,Home,2011-03-05,0,3,6,7,7,2,3,3,4,1,3,4,3,1,9.0,21.0,-12.0,8
2133,2133,2010-11,2010,2011,Birmingham,Everton,Draw,Away,2011-03-09,1,0,3,6,7,6,6,9,9,-6,-3,-3,-2,0,9.0,8.0,1.0,8
2134,2134,2010-11,2010,2011,Birmingham,Wigan,Loss,Away,2011-03-19,0,1,1,4,7,0,1,4,5,1,0,0,2,0,9.0,16.0,-7.0,8
2135,2135,2010-11,2010,2011,Birmingham,Bolton,Win,Home,2011-04-02,3,1,1,1,4,3,4,7,7,-2,-3,-6,-3,1,9.0,14.0,-5.0,9
2136,2136,2010-11,2010,2011,Birmingham,Blackburn,Draw,Away,2011-04-09,1,3,4,4,4,2,2,2,3,1,2,2,1,0,9.0,10.0,-1.0,9
2137,2137,2010-11,2010,2011,Birmingham,Sunderland,Win,Home,2011-04-16,3,4,4,5,5,0,0,1,1,4,4,4,4,1,9.0,13.0,-4.0,9
2138,2138,2010-11,2010,2011,Birmingham,Chelsea,Loss,Away,2011-04-20,0,4,7,7,8,6,7,10,13,-2,0,-3,-5,0,9.0,1.0,8.0,9
2139,2139,2010-11,2010,2011,Birmingham,Liverpool,Loss,Away,2011-04-23,0,3,4,7,7,4,4,7,10,-1,0,0,-3,0,9.0,7.0,2.0,9
2140,2140,2010-11,2010,2011,Birmingham,Wolves,Draw,Home,2011-05-01,1,0,3,4,7,1,1,1,4,-1,2,3,3,1,9.0,15.0,-6.0,10
2141,2141,2010-11,2010,2011,Birmingham,Newcastle,Loss,Away,2011-05-07,0,1,1,4,5,1,2,2,5,0,-1,2,0,0,9.0,21.0,-12.0,10
2142,2142,2010-11,2010,2011,Birmingham,Fulham,Loss,Home,2011-05-15,0,1,1,1,4,3,6,7,7,-2,-5,-6,-3,1,9.0,12.0,-3.0,10
2143,2143,2010-11,2010,2011,Birmingham,Tottenham,Loss,Away,2011-05-22,0,0,1,1,1,3,4,4,5,-3,-3,-3,-4,0,9.0,4.0,5.0,10
2144,2144,1993-94,1993,1994,Blackburn,Chelsea,Win,Away,1993-08-14,3,0,0,0,0,0,0,0,0,0,0,0,0,0,4.0,11.0,-7.0,1
2145,2145,1993-94,1993,1994,Blackburn,Norwich,Loss,Home,1993-08-18,0,3,3,3,3,0,0,0,0,3,3,3,3,1,4.0,3.0,1.0,1
2146,2146,1993-94,1993,1994,Blackburn,Oldham,Win,Home,1993-08-21,3,3,3,3,3,3,3,3,3,0,0,0,0,1,4.0,19.0,-15.0,1
2147,2147,1993-94,1993,1994,Blackburn,Man City,Win,Away,1993-08-24,3,3,6,6,6,0,1,1,1,3,5,5,5,0,4.0,9.0,-5.0,1
2148,2148,1993-94,1993,1994,Blackburn,Newcastle,Draw,Away,1993-08-29,1,6,6,9,9,4,4,4,4,2,2,5,5,0,4.0,21.0,-17.0,1
2149,2149,1993-94,1993,1994,Blackburn,Arsenal,Draw,Home,1993-09-01,1,4,7,7,10,6,9,12,12,-2,-2,-5,-2,1,4.0,10.0,-6.0,2
2150,2150,1993-94,1993,1994,Blackburn,Liverpool,Win,Away,1993-09-12,3,2,5,8,8,3,3,6,9,-1,2,2,-1,0,4.0,6.0,-2.0,2
2151,2151,1993-94,1993,1994,Blackburn,West Ham,Loss,Home,1993-09-18,0,4,5,8,11,1,1,4,5,3,4,4,6,1,4.0,21.0,-17.0,2
2152,2152,1993-94,1993,1994,Blackburn,Sheffield Weds,Draw,Home,1993-09-25,1,3,4,5,8,3,4,5,5,0,0,0,3,1,4.0,7.0,-3.0,2
2153,2153,1993-94,1993,1994,Blackburn,Swindon,Win,Away,1993-10-02,3,1,4,5,6,1,2,2,3,0,2,3,3,0,4.0,21.0,-17.0,3
2154,2154,1993-94,1993,1994,Blackburn,Sheffield United,Draw,Home,1993-10-18,1,4,4,7,8,1,1,2,2,3,3,5,6,1,4.0,14.0,-10.0,3
2155,2155,1993-94,1993,1994,Blackburn,Leeds,Draw,Away,1993-10-23,1,4,5,5,8,4,7,10,13,0,-2,-5,-5,0,4.0,17.0,-13.0,3
2156,2156,1993-94,1993,1994,Blackburn,Tottenham,Win,Home,1993-10-30,3,2,5,6,6,1,4,5,8,1,1,1,-2,1,4.0,8.0,-4.0,3
2157,2157,1993-94,1993,1994,Blackburn,QPR,Loss,Away,1993-11-06,0,4,5,8,9,3,6,9,10,1,-1,-1,-1,0,4.0,5.0,-1.0,4
2158,2158,1993-94,1993,1994,Blackburn,Southampton,Win,Home,1993-11-20,3,3,4,5,8,3,6,7,8,0,-2,-2,0,1,4.0,18.0,-14.0,4
2159,2159,1993-94,1993,1994,Blackburn,Coventry,Win,Home,1993-11-23,3,3,6,7,8,4,5,5,6,-1,1,2,2,1,4.0,15.0,-11.0,4
2160,2160,1993-94,1993,1994,Blackburn,Ipswich,Loss,Away,1993-11-27,0,6,6,9,10,2,2,2,5,4,4,7,5,0,4.0,16.0,-12.0,4
2161,2161,1993-94,1993,1994,Blackburn,Chelsea,Win,Home,1993-12-05,3,3,6,6,9,1,1,1,1,2,5,5,8,1,4.0,11.0,-7.0,5
2162,2162,1993-94,1993,1994,Blackburn,Oldham,Win,Away,1993-12-11,3,3,6,9,9,4,7,7,7,-1,-1,2,2,0,4.0,19.0,-15.0,5
2163,2163,1993-94,1993,1994,Blackburn,Man City,Win,Home,1993-12-18,3,6,6,9,12,3,3,3,4,3,3,6,8,1,4.0,9.0,-5.0,5
2164,2164,1993-94,1993,1994,Blackburn,Man United,Draw,Away,1993-12-26,1,6,9,9,12,4,7,8,11,2,2,1,1,0,4.0,1.0,3.0,5
2165,2165,1993-94,1993,1994,Blackburn,Everton,Win,Home,1993-12-29,3,4,7,10,10,0,1,1,4,4,6,9,6,1,4.0,13.0,-9.0,5
2166,2166,1993-94,1993,1994,Blackburn,Aston Villa,Win,Away,1994-01-01,3,4,7,10,13,3,3,4,5,1,4,6,8,0,4.0,2.0,2.0,6
2167,2167,1993-94,1993,1994,Blackburn,Sheffield United,Win,Away,1994-01-15,3,6,7,10,13,4,4,5,5,2,3,5,8,0,4.0,14.0,-10.0,6
2168,2168,1993-94,1993,1994,Blackburn,Leeds,Win,Home,1994-01-23,3,6,9,10,13,2,3,4,7,4,6,6,6,1,4.0,17.0,-13.0,6
2169,2169,1993-94,1993,1994,Blackburn,Wimbledon,Win,Home,1994-02-05,3,6,9,12,13,4,4,5,5,2,5,7,8,1,4.0,12.0,-8.0,7
2170,2170,1993-94,1993,1994,Blackburn,Tottenham,Win,Away,1994-02-12,3,6,9,12,15,0,0,0,0,6,9,12,15,0,4.0,8.0,-4.0,7
2171,2171,1993-94,1993,1994,Blackburn,Newcastle,Win,Home,1994-02-19,3,6,9,12,15,0,3,6,9,6,6,6,6,1,4.0,21.0,-17.0,7
2172,2172,1993-94,1993,1994,Blackburn,Norwich,Draw,Away,1994-02-22,1,6,9,12,15,2,3,4,5,4,6,8,10,0,4.0,3.0,1.0,7
2173,2173,1993-94,1993,1994,Blackburn,Arsenal,Loss,Away,1994-02-26,0,4,7,10,13,2,3,4,5,2,4,6,8,0,4.0,10.0,-6.0,7
2174,2174,1993-94,1993,1994,Blackburn,Liverpool,Win,Home,1994-03-05,3,1,4,7,10,3,3,4,7,-2,1,3,3,1,4.0,6.0,-2.0,8
2175,2175,1993-94,1993,1994,Blackburn,Sheffield Weds,Win,Away,1994-03-20,3,3,4,7,10,1,1,2,5,2,3,5,5,0,4.0,7.0,-3.0,8
2176,2176,1993-94,1993,1994,Blackburn,Swindon,Win,Home,1994-03-26,3,6,6,7,10,1,2,2,3,5,4,5,7,1,4.0,21.0,-17.0,8
2177,2177,1993-94,1993,1994,Blackburn,Wimbledon,Loss,Away,1994-03-29,0,6,9,9,10,3,3,6,9,3,6,3,1,0,4.0,12.0,-8.0,8
2178,2178,1993-94,1993,1994,Blackburn,Man United,Win,Home,1994-04-02,3,3,6,9,9,4,5,8,8,-1,1,1,1,1,4.0,1.0,3.0,9
2179,2179,1993-94,1993,1994,Blackburn,Everton,Win,Away,1994-04-04,3,3,6,9,12,1,1,1,1,2,5,8,11,0,4.0,13.0,-9.0,9
2180,2180,1993-94,1993,1994,Blackburn,Aston Villa,Win,Home,1994-04-11,3,6,6,9,12,1,2,2,2,5,4,7,10,1,4.0,2.0,2.0,9
2181,2181,1993-94,1993,1994,Blackburn,Southampton,Loss,Away,1994-04-16,0,6,9,9,12,3,3,3,4,3,6,6,8,0,4.0,18.0,-14.0,9
2182,2182,1993-94,1993,1994,Blackburn,QPR,Draw,Home,1994-04-24,1,3,6,9,9,4,4,4,4,-1,2,5,5,1,4.0,5.0,-1.0,9
2183,2183,1993-94,1993,1994,Blackburn,West Ham,Win,Away,1994-04-27,3,1,4,7,10,3,3,6,9,-2,1,1,1,0,4.0,21.0,-17.0,9
2184,2184,1993-94,1993,1994,Blackburn,Coventry,Loss,Away,1994-05-02,0,4,4,7,10,2,5,8,8,2,-1,-1,2,0,4.0,15.0,-11.0,10
2185,2185,1993-94,1993,1994,Blackburn,Ipswich,Draw,Home,1994-05-07,1,3,4,4,7,0,1,1,1,3,3,3,6,1,4.0,16.0,-12.0,10
2186,2186,1994-95,1994,1995,Blackburn,Southampton,Draw,Away,1994-08-20,1,1,4,5,5,1,4,4,7,0,0,1,-2,0,2.0,18.0,-16.0,1
2187,2187,1994-95,1994,1995,Blackburn,Leicester,Win,Home,1994-08-23,3,2,2,5,6,0,0,0,0,2,2,5,6,1,2.0,21.0,-19.0,1
2188,2188,1994-95,1994,1995,Blackburn,Coventry,Win,Home,1994-08-27,3,4,5,5,8,1,2,5,8,3,3,0,0,1,2.0,11.0,-9.0,1
2189,2189,1994-95,1994,1995,Blackburn,Arsenal,Draw,Away,1994-08-31,1,6,7,8,8,0,3,3,3,6,4,5,5,0,2.0,4.0,-2.0,1
2190,2190,1994-95,1994,1995,Blackburn,Everton,Win,Home,1994-09-10,3,4,7,8,9,0,0,1,4,4,7,7,5,1,2.0,17.0,-15.0,2
2191,2191,1994-95,1994,1995,Blackburn,Chelsea,Win,Away,1994-09-18,3,4,7,10,11,3,6,9,12,1,1,1,-1,0,2.0,14.0,-12.0,2
2192,2192,1994-95,1994,1995,Blackburn,Aston Villa,Win,Home,1994-09-24,3,6,7,10,13,3,6,7,8,3,1,3,5,1,2.0,10.0,-8.0,2
2193,2193,1994-95,1994,1995,Blackburn,Norwich,Loss,Away,1994-10-01,0,6,9,10,13,3,4,5,8,3,5,5,5,0,2.0,12.0,-10.0,3
2194,2194,1994-95,1994,1995,Blackburn,Newcastle,Draw,Away,1994-10-09,1,3,6,9,10,4,7,10,13,-1,-1,-1,-3,0,2.0,3.0,-1.0,3
2195,2195,1994-95,1994,1995,Blackburn,Liverpool,Win,Home,1994-10-15,3,1,4,7,10,6,7,7,8,-5,-3,0,2,1,2.0,8.0,-6.0,3
2196,2196,1994-95,1994,1995,Blackburn,Man United,Loss,Home,1994-10-23,0,4,4,7,10,3,6,6,9,1,-2,1,1,1,2.0,1.0,1.0,3
2197,2197,1994-95,1994,1995,Blackburn,Nott'm Forest,Win,Away,1994-10-29,3,3,4,4,7,6,7,10,13,-3,-3,-6,-6,0,2.0,21.0,-19.0,3
2198,2198,1994-95,1994,1995,Blackburn,Sheffield Weds,Win,Away,1994-11-02,3,3,6,7,7,1,4,7,7,2,2,0,0,0,2.0,7.0,-5.0,4
2199,2199,1994-95,1994,1995,Blackburn,Tottenham,Win,Home,1994-11-05,3,6,6,9,10,3,4,5,8,3,2,4,2,1,2.0,15.0,-13.0,4
2200,2200,1994-95,1994,1995,Blackburn,Ipswich,Win,Away,1994-11-19,3,6,9,9,12,3,3,3,3,3,6,6,9,0,2.0,19.0,-17.0,4
2201,2201,1994-95,1994,1995,Blackburn,QPR,Win,Home,1994-11-26,3,6,9,12,12,3,6,9,9,3,3,3,3,1,2.0,9.0,-7.0,4
2202,2202,1994-95,1994,1995,Blackburn,Wimbledon,Win,Away,1994-12-03,3,6,9,12,15,3,6,6,9,3,3,6,6,0,2.0,6.0,-4.0,5
2203,2203,1994-95,1994,1995,Blackburn,Southampton,Win,Home,1994-12-10,3,6,9,12,15,1,4,5,6,5,5,7,9,1,2.0,18.0,-16.0,5
2204,2204,1994-95,1994,1995,Blackburn,Leicester,Draw,Away,1994-12-17,1,6,9,12,15,1,1,4,4,5,8,8,11,0,2.0,21.0,-19.0,5
2205,2205,1994-95,1994,1995,Blackburn,Man City,Win,Away,1994-12-26,3,4,7,10,13,0,3,6,9,4,4,4,4,0,2.0,16.0,-14.0,5
2206,2206,1994-95,1994,1995,Blackburn,Crystal Palace,Win,Away,1994-12-31,3,4,7,10,13,2,2,3,3,2,5,7,10,0,2.0,21.0,-19.0,5
2207,2207,1994-95,1994,1995,Blackburn,West Ham,Win,Home,1995-01-02,3,6,7,10,13,3,4,7,8,3,3,3,5,1,2.0,13.0,-11.0,6
2208,2208,1994-95,1994,1995,Blackburn,Nott'm Forest,Win,Home,1995-01-14,3,6,9,10,13,3,6,7,10,3,3,3,3,1,2.0,21.0,-19.0,6
2209,2209,1994-95,1994,1995,Blackburn,Man United,Loss,Away,1995-01-22,0,6,9,12,13,4,5,6,9,2,4,6,4,0,2.0,1.0,1.0,6
2210,2210,1994-95,1994,1995,Blackburn,Ipswich,Win,Home,1995-01-28,3,3,6,9,12,4,7,7,7,-1,-1,2,5,1,2.0,19.0,-17.0,6
2211,2211,1994-95,1994,1995,Blackburn,Leeds,Draw,Home,1995-02-01,1,3,6,9,12,4,5,5,6,-1,1,4,6,1,2.0,5.0,-3.0,7
2212,2212,1994-95,1994,1995,Blackburn,Tottenham,Loss,Away,1995-02-05,0,4,4,7,10,3,6,9,10,1,-2,-2,0,0,2.0,15.0,-13.0,7
2213,2213,1994-95,1994,1995,Blackburn,Sheffield Weds,Win,Home,1995-02-12,3,1,4,4,7,6,7,8,9,-5,-3,-4,-2,1,2.0,7.0,-5.0,7
2214,2214,1994-95,1994,1995,Blackburn,Wimbledon,Win,Home,1995-02-22,3,3,4,7,7,1,1,4,7,2,3,3,0,1,2.0,6.0,-4.0,7
2215,2215,1994-95,1994,1995,Blackburn,Norwich,Draw,Home,1995-02-25,1,6,6,7,10,1,1,2,2,5,5,5,8,1,2.0,12.0,-10.0,7
2216,2216,1994-95,1994,1995,Blackburn,Aston Villa,Win,Away,1995-03-04,3,4,7,7,8,1,4,7,7,3,3,0,1,0,2.0,10.0,-8.0,8
2217,2217,1994-95,1994,1995,Blackburn,Arsenal,Win,Home,1995-03-08,3,4,7,10,10,3,6,7,7,1,1,3,3,1,2.0,4.0,-2.0,8
2218,2218,1994-95,1994,1995,Blackburn,Coventry,Draw,Away,1995-03-11,1,6,7,10,13,2,5,8,11,4,2,2,2,0,2.0,11.0,-9.0,8
2219,2219,1994-95,1994,1995,Blackburn,Chelsea,Win,Home,1995-03-18,3,4,7,8,11,3,4,7,8,1,3,1,3,1,2.0,14.0,-12.0,8
2220,2220,1994-95,1994,1995,Blackburn,Everton,Win,Away,1995-04-01,3,4,7,10,11,4,4,5,8,0,3,5,3,0,2.0,17.0,-15.0,9
2221,2221,1994-95,1994,1995,Blackburn,QPR,Win,Away,1995-04-04,3,6,7,10,13,6,6,9,12,0,1,1,1,0,2.0,9.0,-7.0,9
2222,2222,1994-95,1994,1995,Blackburn,Leeds,Draw,Away,1995-04-15,1,6,9,10,13,6,7,7,10,0,2,3,3,0,2.0,5.0,-3.0,9
2223,2223,1994-95,1994,1995,Blackburn,Man City,Loss,Home,1995-04-17,0,4,7,10,11,3,3,3,6,1,4,7,5,1,2.0,16.0,-14.0,9
2224,2224,1994-95,1994,1995,Blackburn,Crystal Palace,Win,Home,1995-04-19,3,1,4,7,10,4,5,8,8,-3,-1,-1,2,1,2.0,21.0,-19.0,9
2225,2225,1994-95,1994,1995,Blackburn,West Ham,Loss,Away,1995-04-30,0,3,4,7,10,4,5,8,9,-1,-1,-1,1,0,2.0,13.0,-11.0,9
2226,2226,1994-95,1994,1995,Blackburn,Newcastle,Win,Home,1995-05-08,3,3,3,4,7,2,2,2,5,1,1,2,2,1,2.0,3.0,-1.0,10
2227,2227,1994-95,1994,1995,Blackburn,Liverpool,Loss,Away,1995-05-14,0,3,6,6,7,0,1,4,7,3,5,2,0,0,2.0,8.0,-6.0,10
2228,2228,1995-96,1995,1996,Blackburn,QPR,Win,Home,1995-08-19,3,3,3,6,6,6,7,7,7,-3,-4,-1,-1,1,1.0,8.0,-7.0,1
2229,2229,1995-96,1995,1996,Blackburn,Sheffield Weds,Loss,Away,1995-08-23,0,3,6,6,9,3,3,4,5,0,3,2,4,0,1.0,13.0,-12.0,1
2230,2230,1995-96,1995,1996,Blackburn,Bolton,Loss,Away,1995-08-26,0,3,3,6,6,0,0,0,0,3,3,6,6,0,1.0,21.0,-20.0,1
2231,2231,1995-96,1995,1996,Blackburn,Man United,Loss,Home,1995-08-28,0,0,3,3,6,6,6,7,10,-6,-3,-4,-4,1,1.0,2.0,-1.0,1
2232,2232,1995-96,1995,1996,Blackburn,Aston Villa,Draw,Home,1995-09-09,1,0,0,3,3,3,6,9,10,-3,-6,-6,-7,1,1.0,18.0,-17.0,2
2233,2233,1995-96,1995,1996,Blackburn,Liverpool,Loss,Away,1995-09-16,0,1,1,1,4,3,6,6,9,-2,-5,-5,-5,0,1.0,4.0,-3.0,2
2234,2234,1995-96,1995,1996,Blackburn,Coventry,Win,Home,1995-09-23,3,1,1,1,1,1,2,3,6,0,-1,-2,-5,1,1.0,16.0,-15.0,2
2235,2235,1995-96,1995,1996,Blackburn,Middlesbrough,Loss,Away,1995-09-30,0,3,4,4,4,6,7,8,8,-3,-3,-4,-4,0,1.0,21.0,-20.0,2
2236,2236,1995-96,1995,1996,Blackburn,Southampton,Win,Home,1995-10-14,3,3,3,4,4,1,1,2,5,2,2,2,-1,1,1.0,10.0,-9.0,3
2237,2237,1995-96,1995,1996,Blackburn,West Ham,Draw,Away,1995-10-21,1,3,6,6,7,4,7,7,7,-1,-1,-1,0,0,1.0,14.0,-13.0,3
2238,2238,1995-96,1995,1996,Blackburn,Chelsea,Win,Home,1995-10-28,3,4,4,7,7,3,6,6,9,1,-2,1,-2,1,1.0,11.0,-10.0,3
2239,2239,1995-96,1995,1996,Blackburn,Everton,Loss,Away,1995-11-05,0,4,7,7,10,1,2,2,2,3,5,5,8,0,1.0,15.0,-14.0,4
2240,2240,1995-96,1995,1996,Blackburn,Newcastle,Loss,Away,1995-11-08,0,3,4,7,7,4,7,10,13,-1,-3,-3,-6,0,1.0,6.0,-5.0,4
2241,2241,1995-96,1995,1996,Blackburn,Nott'm Forest,Win,Home,1995-11-18,3,0,3,4,7,4,7,10,13,-4,-4,-6,-6,1,1.0,3.0,-2.0,4
2242,2242,1995-96,1995,1996,Blackburn,Arsenal,Draw,Away,1995-11-26,1,3,3,6,7,3,6,6,9,0,-3,0,-2,0,1.0,12.0,-11.0,4
2243,2243,1995-96,1995,1996,Blackburn,West Ham,Win,Home,1995-12-02,3,4,4,4,7,4,7,7,10,0,-3,-3,-3,1,1.0,14.0,-13.0,5
2244,2244,1995-96,1995,1996,Blackburn,Coventry,Loss,Away,1995-12-09,0,4,7,7,7,1,1,2,2,3,6,5,5,0,1.0,16.0,-15.0,5
2245,2245,1995-96,1995,1996,Blackburn,Middlesbrough,Win,Home,1995-12-16,3,3,4,7,7,4,7,7,8,-1,-3,0,-1,1,1.0,21.0,-20.0,5
2246,2246,1995-96,1995,1996,Blackburn,Wimbledon,Draw,Away,1995-12-23,1,3,6,7,10,1,2,3,3,2,4,4,7,0,1.0,9.0,-8.0,5
2247,2247,1995-96,1995,1996,Blackburn,Man City,Win,Home,1995-12-26,3,4,4,7,8,1,1,4,7,3,3,3,1,1,1.0,17.0,-16.0,5
2248,2248,1995-96,1995,1996,Blackburn,Tottenham,Win,Home,1995-12-30,3,4,7,7,10,2,5,8,9,2,2,-1,1,1,1.0,7.0,-6.0,5
2249,2249,1995-96,1995,1996,Blackburn,Leeds,Draw,Away,1996-01-01,1,6,7,10,10,3,6,6,7,3,1,4,3,0,1.0,5.0,-4.0,6
2250,2250,1995-96,1995,1996,Blackburn,QPR,Win,Away,1996-01-13,3,4,7,8,11,0,0,3,6,4,7,5,5,0,1.0,8.0,-7.0,6
2251,2251,1995-96,1995,1996,Blackburn,Sheffield Weds,Win,Home,1996-01-20,3,4,7,10,11,4,4,5,8,0,3,5,3,1,1.0,13.0,-12.0,6
2252,2252,1995-96,1995,1996,Blackburn,Bolton,Win,Home,1996-02-03,3,6,7,10,13,3,3,3,3,3,4,7,10,1,1.0,21.0,-20.0,7
2253,2253,1995-96,1995,1996,Blackburn,Man United,Loss,Away,1996-02-10,0,6,9,10,13,6,7,7,10,0,2,3,3,0,1.0,2.0,-1.0,7
2254,2254,1995-96,1995,1996,Blackburn,Liverpool,Loss,Home,1996-02-24,0,3,6,9,10,4,7,10,11,-1,-1,-1,-1,1,1.0,4.0,-3.0,7
2255,2255,1995-96,1995,1996,Blackburn,Aston Villa,Loss,Away,1996-02-28,0,0,3,6,9,4,7,7,10,-4,-4,-1,-1,0,1.0,18.0,-17.0,7
2256,2256,1995-96,1995,1996,Blackburn,Man City,Draw,Away,1996-03-02,1,0,0,3,6,1,4,5,6,-1,-4,-2,0,0,1.0,17.0,-16.0,8
2257,2257,1995-96,1995,1996,Blackburn,Leeds,Win,Home,1996-03-13,3,1,1,1,4,3,3,3,3,-2,-2,-2,1,1,1.0,5.0,-4.0,8
2258,2258,1995-96,1995,1996,Blackburn,Tottenham,Win,Away,1996-03-16,3,4,4,4,4,6,6,7,7,-2,-2,-3,-3,0,1.0,7.0,-6.0,8
2259,2259,1995-96,1995,1996,Blackburn,Everton,Loss,Home,1996-03-30,0,6,7,7,7,1,2,5,8,5,5,2,-1,1,1.0,15.0,-14.0,8
2260,2260,1995-96,1995,1996,Blackburn,Southampton,Loss,Away,1996-04-06,0,3,6,7,7,0,3,3,3,3,3,4,4,0,1.0,10.0,-9.0,9
2261,2261,1995-96,1995,1996,Blackburn,Newcastle,Win,Home,1996-04-08,3,0,3,6,7,3,3,6,6,-3,0,0,1,1,1.0,6.0,-5.0,9
2262,2262,1995-96,1995,1996,Blackburn,Nott'm Forest,Win,Away,1996-04-13,3,3,3,6,9,6,6,9,10,-3,-3,-3,-1,0,1.0,3.0,-2.0,9
2263,2263,1995-96,1995,1996,Blackburn,Wimbledon,Win,Home,1996-04-17,3,6,6,6,9,6,7,10,13,0,-1,-4,-4,1,1.0,9.0,-8.0,9
2264,2264,1995-96,1995,1996,Blackburn,Arsenal,Draw,Home,1996-04-27,1,6,9,9,9,1,4,7,7,5,5,2,2,1,1.0,12.0,-11.0,9
2265,2265,1995-96,1995,1996,Blackburn,Chelsea,Win,Away,1996-05-04,3,4,7,10,10,2,5,5,5,2,2,5,5,0,1.0,11.0,-10.0,10
2266,2266,1996-97,1996,1997,Blackburn,Tottenham,Loss,Home,1996-08-17,0,4,7,10,13,4,5,6,7,0,2,4,6,1,7.0,8.0,-1.0,1
2267,2267,1996-97,1996,1997,Blackburn,Aston Villa,Loss,Away,1996-08-21,0,3,4,7,10,0,0,1,1,3,4,6,9,0,7.0,4.0,3.0,1
2268,2268,1996-97,1996,1997,Blackburn,Man United,Draw,Away,1996-08-25,1,0,3,4,7,4,7,10,13,-4,-4,-6,-6,0,7.0,1.0,6.0,1
2269,2269,1996-97,1996,1997,Blackburn,Leeds,Loss,Home,1996-09-04,0,1,1,4,5,3,4,5,5,-2,-3,-1,0,1,7.0,13.0,-6.0,2
2270,2270,1996-97,1996,1997,Blackburn,Derby,Loss,Home,1996-09-09,0,1,1,1,4,1,2,3,3,0,-1,-2,1,1,7.0,21.0,-14.0,2
2271,2271,1996-97,1996,1997,Blackburn,Newcastle,Loss,Away,1996-09-14,0,0,1,1,1,6,6,9,9,-6,-5,-8,-8,0,7.0,2.0,5.0,2
2272,2272,1996-97,1996,1997,Blackburn,Everton,Draw,Home,1996-09-21,1,0,0,1,1,0,0,1,2,0,0,0,-1,1,7.0,6.0,1.0,2
2273,2273,1996-97,1996,1997,Blackburn,Coventry,Draw,Away,1996-09-28,1,1,1,1,2,3,3,3,3,-2,-2,-2,-1,0,7.0,16.0,-9.0,2
2274,2274,1996-97,1996,1997,Blackburn,Arsenal,Loss,Home,1996-10-12,0,2,2,2,2,6,9,10,11,-4,-7,-8,-9,1,7.0,5.0,2.0,3
2275,2275,1996-97,1996,1997,Blackburn,Sheffield Weds,Draw,Away,1996-10-19,1,1,2,2,2,0,1,1,1,1,1,1,1,0,7.0,15.0,-8.0,3
2276,2276,1996-97,1996,1997,Blackburn,West Ham,Loss,Away,1996-10-26,0,1,2,3,3,3,3,6,6,-2,-1,-3,-3,0,7.0,10.0,-3.0,3
2277,2277,1996-97,1996,1997,Blackburn,Liverpool,Win,Home,1996-11-03,3,1,1,2,3,3,6,9,12,-2,-5,-7,-9,1,7.0,3.0,4.0,4
2278,2278,1996-97,1996,1997,Blackburn,Chelsea,Draw,Home,1996-11-16,1,3,4,4,5,6,6,9,10,-3,-2,-5,-5,1,7.0,11.0,-4.0,4
2279,2279,1996-97,1996,1997,Blackburn,Nott'm Forest,Draw,Away,1996-11-25,1,4,4,5,5,0,0,1,1,4,4,4,4,0,7.0,9.0,-2.0,4
2280,2280,1996-97,1996,1997,Blackburn,Southampton,Win,Home,1996-11-30,3,2,5,5,6,0,1,4,7,2,4,1,-1,1,7.0,17.0,-10.0,4
2281,2281,1996-97,1996,1997,Blackburn,Leicester,Draw,Away,1996-12-07,1,4,5,8,8,3,3,6,6,1,2,2,2,0,7.0,21.0,-14.0,5
2282,2282,1996-97,1996,1997,Blackburn,Wimbledon,Loss,Away,1996-12-14,0,4,5,6,9,6,7,8,9,-2,-2,-2,0,0,7.0,14.0,-7.0,5
2283,2283,1996-97,1996,1997,Blackburn,Newcastle,Win,Home,1996-12-26,3,1,4,5,6,1,2,2,3,0,2,3,3,1,7.0,2.0,5.0,5
2284,2284,1996-97,1996,1997,Blackburn,Derby,Draw,Away,1996-12-28,1,3,4,7,8,0,0,1,4,3,4,6,4,0,7.0,21.0,-14.0,5
2285,2285,1996-97,1996,1997,Blackburn,Everton,Win,Away,1997-01-01,3,4,4,5,8,0,1,4,5,4,3,1,3,0,7.0,6.0,1.0,6
2286,2286,1996-97,1996,1997,Blackburn,Coventry,Win,Home,1997-01-11,3,4,7,7,8,4,7,10,13,0,0,-3,-5,1,7.0,16.0,-9.0,6
2287,2287,1996-97,1996,1997,Blackburn,Sunderland,Draw,Away,1997-01-18,1,6,7,10,10,4,4,7,7,2,3,3,3,0,7.0,21.0,-14.0,6
2288,2288,1996-97,1996,1997,Blackburn,Tottenham,Loss,Away,1997-01-29,0,4,7,8,11,0,0,3,4,4,7,5,7,0,7.0,8.0,-1.0,6
2289,2289,1996-97,1996,1997,Blackburn,West Ham,Win,Home,1997-02-01,3,1,4,7,8,0,1,1,4,1,3,6,4,1,7.0,10.0,-3.0,7
2290,2290,1996-97,1996,1997,Blackburn,Liverpool,Draw,Away,1997-02-22,1,3,4,7,10,6,9,10,10,-3,-5,-3,0,0,7.0,3.0,4.0,7
2291,2291,1996-97,1996,1997,Blackburn,Sunderland,Win,Home,1997-03-01,3,4,4,5,8,0,1,2,5,4,3,3,3,1,7.0,21.0,-14.0,8
2292,2292,1996-97,1996,1997,Blackburn,Chelsea,Draw,Away,1997-03-05,1,4,7,7,8,1,4,7,7,3,3,0,1,0,7.0,11.0,-4.0,8
2293,2293,1996-97,1996,1997,Blackburn,Nott'm Forest,Draw,Home,1997-03-11,1,4,5,8,8,0,3,4,4,4,2,4,4,1,7.0,9.0,-2.0,8
2294,2294,1996-97,1996,1997,Blackburn,Wimbledon,Win,Home,1997-03-15,3,2,5,6,9,1,2,5,6,1,3,1,3,1,7.0,14.0,-7.0,8
2295,2295,1996-97,1996,1997,Blackburn,Middlesbrough,Loss,Away,1997-03-19,0,4,5,8,9,6,6,6,7,-2,-1,2,2,0,7.0,12.0,-5.0,8
2296,2296,1996-97,1996,1997,Blackburn,Aston Villa,Loss,Home,1997-03-22,0,3,4,5,8,1,4,5,8,2,0,0,0,1,7.0,4.0,3.0,8
2297,2297,1996-97,1996,1997,Blackburn,Leeds,Draw,Away,1997-04-07,1,0,3,4,5,1,2,5,8,-1,1,-1,-3,0,7.0,13.0,-6.0,9
2298,2298,1996-97,1996,1997,Blackburn,Man United,Loss,Home,1997-04-12,0,1,1,4,5,3,6,6,9,-2,-5,-2,-4,1,7.0,1.0,6.0,9
2299,2299,1996-97,1996,1997,Blackburn,Arsenal,Draw,Away,1997-04-19,1,1,1,1,4,6,6,9,12,-5,-5,-8,-8,0,7.0,5.0,2.0,9
2300,2300,1996-97,1996,1997,Blackburn,Sheffield Weds,Win,Home,1997-04-22,3,1,2,2,2,4,7,8,8,-3,-5,-6,-6,1,7.0,15.0,-8.0,9
2301,2301,1996-97,1996,1997,Blackburn,Southampton,Loss,Away,1997-05-03,0,4,4,5,5,4,7,8,11,0,-3,-3,-6,0,7.0,17.0,-10.0,10
2302,2302,1996-97,1996,1997,Blackburn,Middlesbrough,Draw,Home,1997-05-08,1,3,4,4,5,4,4,4,5,-1,0,0,0,1,7.0,12.0,-5.0,10
2303,2303,1996-97,1996,1997,Blackburn,Leicester,Loss,Home,1997-05-11,0,1,4,5,5,4,4,4,4,-3,0,1,1,1,7.0,21.0,-14.0,10
2304,2304,1997-98,1997,1998,Blackburn,Derby,Win,Home,1997-08-09,3,1,1,4,5,3,4,4,7,-2,-3,0,-2,1,13.0,12.0,1.0,1
2305,2305,1997-98,1997,1998,Blackburn,Aston Villa,Win,Away,1997-08-13,3,3,4,4,7,3,3,4,5,0,1,0,2,0,13.0,5.0,8.0,1
2306,2306,1997-98,1997,1998,Blackburn,Liverpool,Draw,Home,1997-08-23,1,6,6,7,7,1,2,2,5,5,4,5,2,1,13.0,4.0,9.0,1
2307,2307,1997-98,1997,1998,Blackburn,Sheffield Weds,Win,Home,1997-08-25,3,4,7,7,8,1,1,2,2,3,6,5,6,1,13.0,7.0,6.0,1
2308,2308,1997-98,1997,1998,Blackburn,Crystal Palace,Win,Away,1997-08-30,3,4,7,10,10,3,3,6,6,1,4,4,4,0,13.0,21.0,-8.0,1
2309,2309,1997-98,1997,1998,Blackburn,Leeds,Loss,Home,1997-09-14,0,6,7,10,13,0,0,3,4,6,7,7,9,1,13.0,11.0,2.0,2
2310,2310,1997-98,1997,1998,Blackburn,Tottenham,Draw,Away,1997-09-20,1,3,6,7,10,1,4,7,7,2,2,0,3,0,13.0,10.0,3.0,2
2311,2311,1997-98,1997,1998,Blackburn,Leicester,Draw,Away,1997-09-24,1,1,4,7,8,6,6,7,8,-5,-2,0,0,0,13.0,9.0,4.0,2
2312,2312,1997-98,1997,1998,Blackburn,Coventry,Draw,Home,1997-09-28,1,2,2,5,8,2,5,5,6,0,-3,0,2,1,13.0,17.0,-4.0,2
2313,2313,1997-98,1997,1998,Blackburn,Wimbledon,Win,Away,1997-10-04,3,2,3,3,6,4,4,7,7,-2,-1,-4,-1,0,13.0,8.0,5.0,3
2314,2314,1997-98,1997,1998,Blackburn,Southampton,Win,Home,1997-10-18,3,4,5,6,6,3,3,4,4,1,2,2,2,1,13.0,16.0,-3.0,3
2315,2315,1997-98,1997,1998,Blackburn,Newcastle,Draw,Away,1997-10-25,1,6,7,8,9,3,3,6,9,3,4,2,0,0,13.0,2.0,11.0,3
2316,2316,1997-98,1997,1998,Blackburn,Barnsley,Draw,Away,1997-11-01,1,4,7,8,9,3,3,3,3,1,4,5,6,0,13.0,21.0,-8.0,4
2317,2317,1997-98,1997,1998,Blackburn,Everton,Win,Home,1997-11-08,3,2,5,8,9,1,4,4,5,1,1,4,4,1,13.0,15.0,-2.0,4
2318,2318,1997-98,1997,1998,Blackburn,Chelsea,Win,Home,1997-11-22,3,4,5,8,11,6,6,9,9,-2,-1,-1,2,1,13.0,6.0,7.0,4
2319,2319,1997-98,1997,1998,Blackburn,Man United,Loss,Away,1997-11-30,0,6,7,8,11,3,6,9,10,3,1,-1,1,0,13.0,1.0,12.0,4
2320,2320,1997-98,1997,1998,Blackburn,Bolton,Win,Home,1997-12-06,3,3,6,7,8,6,7,7,8,-3,-1,0,0,1,13.0,21.0,-8.0,5
2321,2321,1997-98,1997,1998,Blackburn,Arsenal,Win,Away,1997-12-13,3,3,6,9,10,3,3,6,6,0,3,3,4,0,13.0,3.0,10.0,5
2322,2322,1997-98,1997,1998,Blackburn,West Ham,Win,Home,1997-12-20,3,6,6,9,12,3,6,9,9,3,0,0,3,1,13.0,14.0,-1.0,5
2323,2323,1997-98,1997,1998,Blackburn,Sheffield Weds,Draw,Away,1997-12-26,1,6,9,9,12,0,3,6,9,6,6,3,3,0,13.0,7.0,6.0,5
2324,2324,1997-98,1997,1998,Blackburn,Crystal Palace,Draw,Home,1997-12-28,1,4,7,10,10,2,2,3,3,2,5,7,7,1,13.0,21.0,-8.0,5
2325,2325,1997-98,1997,1998,Blackburn,Derby,Loss,Away,1998-01-11,0,2,5,8,11,3,4,5,6,-1,1,3,5,0,13.0,12.0,1.0,6
2326,2326,1997-98,1997,1998,Blackburn,Aston Villa,Win,Home,1998-01-17,3,1,2,5,8,2,5,6,6,-1,-3,-1,2,1,13.0,5.0,8.0,6
2327,2327,1997-98,1997,1998,Blackburn,Liverpool,Draw,Away,1998-01-31,1,3,4,5,8,4,7,10,13,-1,-3,-5,-5,0,13.0,4.0,9.0,6
2328,2328,1997-98,1997,1998,Blackburn,Tottenham,Loss,Home,1998-02-07,0,4,4,5,6,3,3,4,4,1,1,1,2,1,13.0,10.0,3.0,7
2329,2329,1997-98,1997,1998,Blackburn,Southampton,Loss,Away,1998-02-21,0,1,4,4,5,3,3,6,7,-2,1,-2,-2,0,13.0,16.0,-3.0,7
2330,2330,1997-98,1997,1998,Blackburn,Leicester,Win,Home,1998-02-28,3,0,1,4,4,4,7,10,11,-4,-6,-6,-7,1,13.0,9.0,4.0,7
2331,2331,1997-98,1997,1998,Blackburn,Leeds,Loss,Away,1998-03-11,0,3,3,4,7,3,4,4,7,0,-1,0,0,0,13.0,11.0,2.0,8
2332,2332,1997-98,1997,1998,Blackburn,Everton,Loss,Away,1998-03-14,0,3,3,3,4,1,2,2,3,2,1,1,1,0,13.0,15.0,-2.0,8
2333,2333,1997-98,1997,1998,Blackburn,Barnsley,Win,Home,1998-03-31,3,0,3,3,3,3,6,9,9,-3,-3,-6,-6,1,13.0,21.0,-8.0,8
2334,2334,1997-98,1997,1998,Blackburn,Man United,Loss,Home,1998-04-06,0,3,3,6,6,3,4,4,7,0,-1,2,-1,1,13.0,1.0,12.0,9
2335,2335,1997-98,1997,1998,Blackburn,Bolton,Loss,Away,1998-04-11,0,3,3,3,6,1,4,7,7,2,-1,-4,-1,0,13.0,21.0,-8.0,9
2336,2336,1997-98,1997,1998,Blackburn,Arsenal,Loss,Home,1998-04-13,0,0,3,3,3,6,9,12,15,-6,-6,-9,-12,1,13.0,3.0,10.0,9
2337,2337,1997-98,1997,1998,Blackburn,West Ham,Loss,Away,1998-04-18,0,0,0,3,3,2,2,5,8,-2,-2,-2,-5,0,13.0,14.0,-1.0,9
2338,2338,1997-98,1997,1998,Blackburn,Wimbledon,Draw,Home,1998-04-25,1,0,0,0,3,1,4,5,6,-1,-4,-5,-3,1,13.0,8.0,5.0,9
2339,2339,1997-98,1997,1998,Blackburn,Chelsea,Win,Away,1998-04-29,3,1,1,1,1,6,9,9,12,-5,-8,-8,-11,0,13.0,6.0,7.0,9
2340,2340,1997-98,1997,1998,Blackburn,Coventry,Loss,Away,1998-05-02,0,4,4,4,4,2,3,4,4,2,1,0,0,0,13.0,17.0,-4.0,10
2341,2341,1997-98,1997,1998,Blackburn,Newcastle,Win,Home,1998-05-10,3,3,4,4,4,4,4,5,8,-1,0,-1,-4,1,13.0,2.0,11.0,10
2342,2342,1998-99,1998,1999,Blackburn,Derby,Draw,Home,1998-08-15,1,3,6,7,7,6,6,6,6,-3,0,1,1,1,6.0,9.0,-3.0,1
2343,2343,1998-99,1998,1999,Blackburn,Leeds,Loss,Away,1998-08-24,0,4,4,7,8,2,2,3,6,2,2,4,2,0,6.0,5.0,1.0,1
2344,2344,1998-99,1998,1999,Blackburn,Leicester,Win,Home,1998-08-29,3,1,4,4,7,4,4,7,8,-3,0,-3,-1,1,6.0,10.0,-4.0,1
2345,2345,1998-99,1998,1999,Blackburn,Tottenham,Loss,Away,1998-09-09,0,3,4,7,7,3,3,4,7,0,1,3,0,0,6.0,14.0,-8.0,2
2346,2346,1998-99,1998,1999,Blackburn,Sheffield Weds,Loss,Away,1998-09-12,0,3,3,4,7,0,3,3,3,3,0,1,4,0,6.0,16.0,-10.0,2
2347,2347,1998-99,1998,1999,Blackburn,Chelsea,Loss,Home,1998-09-21,0,0,3,3,4,4,5,5,8,-4,-2,-2,-4,1,6.0,4.0,2.0,2
2348,2348,1998-99,1998,1999,Blackburn,Everton,Draw,Away,1998-09-26,1,0,0,3,3,2,5,5,5,-2,-5,-2,-2,0,6.0,17.0,-11.0,2
2349,2349,1998-99,1998,1999,Blackburn,West Ham,Win,Home,1998-10-03,3,1,1,1,4,4,7,7,8,-3,-6,-6,-4,1,6.0,8.0,-2.0,3
2350,2350,1998-99,1998,1999,Blackburn,Middlesbrough,Loss,Away,1998-10-17,0,4,4,4,4,3,4,7,10,1,0,-3,-6,0,6.0,21.0,-15.0,3
2351,2351,1998-99,1998,1999,Blackburn,Arsenal,Loss,Home,1998-10-25,0,3,4,4,4,4,4,7,8,-1,0,-3,-4,1,6.0,1.0,5.0,3
2352,2352,1998-99,1998,1999,Blackburn,Wimbledon,Draw,Away,1998-10-31,1,0,3,4,4,1,1,2,5,-1,2,2,-1,0,6.0,15.0,-9.0,3
2353,2353,1998-99,1998,1999,Blackburn,Coventry,Loss,Home,1998-11-07,0,1,1,4,5,0,3,3,4,1,-2,1,1,1,6.0,11.0,-5.0,4
2354,2354,1998-99,1998,1999,Blackburn,Man United,Loss,Away,1998-11-14,0,1,1,1,4,4,5,8,11,-3,-4,-7,-7,0,6.0,2.0,4.0,4
2355,2355,1998-99,1998,1999,Blackburn,Southampton,Loss,Home,1998-11-21,0,0,1,1,1,1,2,5,6,-1,-1,-4,-5,1,6.0,12.0,-6.0,4
2356,2356,1998-99,1998,1999,Blackburn,Liverpool,Loss,Away,1998-11-29,0,0,0,1,1,3,3,3,6,-3,-3,-2,-5,0,6.0,3.0,3.0,4
2357,2357,1998-99,1998,1999,Blackburn,Charlton,Win,Home,1998-12-05,3,0,0,0,1,0,1,2,3,0,-1,-2,-2,1,6.0,21.0,-15.0,5
2358,2358,1998-99,1998,1999,Blackburn,Newcastle,Draw,Home,1998-12-12,1,3,3,3,3,4,4,5,6,-1,-1,-2,-3,1,6.0,13.0,-7.0,5
2359,2359,1998-99,1998,1999,Blackburn,Nott'm Forest,Draw,Away,1998-12-19,1,4,4,4,4,0,1,1,2,4,3,3,2,0,6.0,21.0,-15.0,5
2360,2360,1998-99,1998,1999,Blackburn,Aston Villa,Win,Home,1998-12-26,3,2,5,5,5,6,6,7,8,-4,-1,-2,-3,1,6.0,7.0,-1.0,5
2361,2361,1998-99,1998,1999,Blackburn,Leicester,Draw,Away,1998-12-28,1,4,5,8,8,3,6,9,10,1,-1,-1,-2,0,6.0,10.0,-4.0,5
2362,2362,1998-99,1998,1999,Blackburn,Leeds,Win,Home,1999-01-09,3,4,5,6,9,4,4,7,10,0,1,-1,-1,1,6.0,5.0,1.0,6
2363,2363,1998-99,1998,1999,Blackburn,Derby,Loss,Away,1999-01-16,0,4,7,8,9,3,4,5,6,1,3,3,3,0,6.0,9.0,-3.0,6
2364,2364,1998-99,1998,1999,Blackburn,Tottenham,Draw,Home,1999-01-30,1,3,4,7,8,2,5,6,6,1,-1,1,2,1,6.0,14.0,-8.0,6
2365,2365,1998-99,1998,1999,Blackburn,Aston Villa,Win,Away,1999-02-06,3,1,4,5,8,3,4,7,7,-2,0,-2,1,0,6.0,7.0,-1.0,7
2366,2366,1998-99,1998,1999,Blackburn,Chelsea,Draw,Away,1999-02-17,1,4,4,7,8,3,6,9,10,1,-2,-2,-2,0,6.0,4.0,2.0,7
2367,2367,1998-99,1998,1999,Blackburn,Sheffield Weds,Loss,Home,1999-02-20,0,4,5,5,8,3,6,7,7,1,-1,-2,1,1,6.0,16.0,-10.0,7
2368,2368,1998-99,1998,1999,Blackburn,West Ham,Loss,Away,1999-02-27,0,1,4,5,5,4,4,5,5,-3,0,0,0,0,6.0,8.0,-2.0,7
2369,2369,1998-99,1998,1999,Blackburn,Everton,Loss,Home,1999-03-10,0,0,1,4,5,1,4,4,4,-1,-3,0,1,1,6.0,17.0,-11.0,8
2370,2370,1998-99,1998,1999,Blackburn,Coventry,Draw,Away,1999-03-13,1,0,0,1,4,6,6,6,7,-6,-6,-5,-3,0,6.0,11.0,-5.0,8
2371,2371,1998-99,1998,1999,Blackburn,Wimbledon,Win,Home,1999-03-20,3,1,1,1,2,0,3,4,5,1,-2,-3,-3,1,6.0,15.0,-9.0,8
2372,2372,1998-99,1998,1999,Blackburn,Middlesbrough,Draw,Home,1999-04-03,1,4,4,4,4,6,6,7,7,-2,-2,-3,-3,1,6.0,21.0,-15.0,9
2373,2373,1998-99,1998,1999,Blackburn,Arsenal,Loss,Away,1999-04-06,0,4,5,5,5,4,7,10,11,0,-2,-5,-6,0,6.0,1.0,5.0,9
2374,2374,1998-99,1998,1999,Blackburn,Southampton,Draw,Away,1999-04-17,1,1,4,5,5,0,1,4,4,1,3,1,1,0,6.0,12.0,-6.0,9
2375,2375,1998-99,1998,1999,Blackburn,Liverpool,Loss,Home,1999-04-24,0,1,2,5,6,0,1,2,5,1,1,3,1,1,6.0,3.0,3.0,9
2376,2376,1998-99,1998,1999,Blackburn,Charlton,Draw,Away,1999-05-01,1,1,1,2,5,0,1,1,4,1,0,1,1,0,6.0,21.0,-15.0,10
2377,2377,1998-99,1998,1999,Blackburn,Nott'm Forest,Loss,Home,1999-05-08,0,1,2,2,3,3,3,3,4,-2,-1,-1,-1,1,6.0,21.0,-15.0,10
2378,2378,1998-99,1998,1999,Blackburn,Man United,Draw,Home,1999-05-12,1,1,1,2,2,4,7,8,11,-3,-6,-6,-9,1,6.0,2.0,4.0,10
2379,2379,1998-99,1998,1999,Blackburn,Newcastle,Draw,Away,1999-05-16,1,1,2,2,3,1,2,3,3,0,0,-1,0,0,6.0,13.0,-7.0,10
2380,2380,2001-02,2001,2002,Blackburn,Derby,Loss,Away,2001-08-18,0,2,2,3,3,4,4,4,7,-2,-2,-1,-4,0,21.0,17.0,4.0,1
2381,2381,2001-02,2001,2002,Blackburn,Man United,Draw,Home,2001-08-22,1,1,2,2,3,3,3,3,6,-2,-1,-1,-3,1,21.0,1.0,20.0,1
2382,2382,2001-02,2001,2002,Blackburn,Tottenham,Win,Home,2001-08-25,3,1,2,3,3,2,5,5,6,-1,-3,-2,-3,1,21.0,12.0,9.0,1
2383,2383,2001-02,2001,2002,Blackburn,Sunderland,Loss,Away,2001-09-08,0,4,4,5,6,1,4,5,8,3,0,0,-2,0,21.0,7.0,14.0,2
2384,2384,2001-02,2001,2002,Blackburn,Ipswich,Draw,Away,2001-09-16,1,3,4,4,5,1,4,4,5,2,0,0,0,0,21.0,5.0,16.0,2
2385,2385,2001-02,2001,2002,Blackburn,Bolton,Draw,Home,2001-09-19,1,1,4,5,5,1,4,7,10,0,0,-2,-5,1,21.0,21.0,0.0,2
2386,2386,2001-02,2001,2002,Blackburn,Everton,Win,Home,2001-09-22,3,2,2,5,6,0,3,4,7,2,-1,1,-1,1,21.0,16.0,5.0,2
2387,2387,2001-02,2001,2002,Blackburn,Aston Villa,Loss,Away,2001-09-30,0,4,5,5,8,4,7,8,9,0,-2,-3,-1,0,21.0,8.0,13.0,2
2388,2388,2001-02,2001,2002,Blackburn,West Ham,Win,Home,2001-10-14,3,3,4,5,5,3,3,4,5,0,1,1,0,1,21.0,15.0,6.0,3
2389,2389,2001-02,2001,2002,Blackburn,Arsenal,Draw,Away,2001-10-20,1,3,6,7,8,6,7,10,11,-3,-1,-3,-3,0,21.0,2.0,19.0,3
2390,2390,2001-02,2001,2002,Blackburn,Leicester,Draw,Home,2001-10-29,1,4,4,7,8,0,0,0,1,4,4,7,7,1,21.0,13.0,8.0,3
2391,2391,2001-02,2001,2002,Blackburn,Southampton,Win,Away,2001-11-03,3,2,5,5,8,1,1,1,4,1,4,4,4,0,21.0,10.0,11.0,4
2392,2392,2001-02,2001,2002,Blackburn,Liverpool,Draw,Home,2001-11-17,1,4,5,8,8,6,9,10,13,-2,-4,-2,-5,1,21.0,3.0,18.0,4
2393,2393,2001-02,2001,2002,Blackburn,Chelsea,Draw,Away,2001-11-24,1,4,5,6,9,4,5,5,6,0,0,1,3,0,21.0,6.0,15.0,4
2394,2394,2001-02,2001,2002,Blackburn,Middlesbrough,Loss,Home,2001-12-01,0,2,5,6,7,2,5,5,8,0,0,1,-1,1,21.0,14.0,7.0,5
2395,2395,2001-02,2001,2002,Blackburn,Leeds,Loss,Home,2001-12-09,0,1,2,5,6,2,2,5,6,-1,0,0,0,1,21.0,4.0,17.0,5
2396,2396,2001-02,2001,2002,Blackburn,Newcastle,Loss,Away,2001-12-15,0,0,1,2,5,4,7,7,10,-4,-6,-5,-5,0,21.0,11.0,10.0,5
2397,2397,2001-02,2001,2002,Blackburn,Charlton,Win,Away,2001-12-22,3,0,0,1,2,4,7,8,8,-4,-7,-7,-6,0,21.0,9.0,12.0,5
2398,2398,2001-02,2001,2002,Blackburn,Sunderland,Loss,Home,2001-12-26,0,3,3,3,4,3,4,7,7,0,-1,-4,-3,1,21.0,7.0,14.0,5
2399,2399,2001-02,2001,2002,Blackburn,Derby,Loss,Home,2001-12-29,0,3,3,3,3,3,3,3,6,0,0,0,-3,1,21.0,17.0,4.0,5
2400,2400,2001-02,2001,2002,Blackburn,Tottenham,Loss,Away,2002-01-01,0,0,3,3,3,1,1,4,4,-1,2,-1,-1,0,21.0,12.0,9.0,6
2401,2401,2001-02,2001,2002,Blackburn,Charlton,Win,Home,2002-01-12,3,0,0,3,3,6,7,7,8,-6,-7,-4,-5,1,21.0,9.0,12.0,6
2402,2402,2001-02,2001,2002,Blackburn,Man United,Loss,Away,2002-01-19,0,3,3,3,6,6,9,12,15,-3,-6,-9,-9,0,21.0,1.0,20.0,6
2403,2403,2001-02,2001,2002,Blackburn,Arsenal,Loss,Home,2002-01-30,0,3,3,3,3,4,5,8,11,-1,-2,-5,-8,1,21.0,2.0,19.0,6
2404,2404,2001-02,2001,2002,Blackburn,West Ham,Loss,Away,2002-02-02,0,0,3,3,3,0,3,3,4,0,0,0,-1,0,21.0,15.0,6.0,7
2405,2405,2001-02,2001,2002,Blackburn,Fulham,Loss,Away,2002-02-09,0,0,0,3,3,1,2,5,8,-1,-2,-2,-5,0,21.0,21.0,0.0,7
2406,2406,2001-02,2001,2002,Blackburn,Bolton,Draw,Away,2002-03-02,1,0,0,0,3,4,4,4,5,-4,-4,-4,-2,0,21.0,21.0,0.0,8
2407,2407,2001-02,2001,2002,Blackburn,Aston Villa,Win,Home,2002-03-05,3,1,1,1,1,3,4,5,6,-2,-3,-4,-5,1,21.0,8.0,13.0,8
2408,2408,2001-02,2001,2002,Blackburn,Ipswich,Win,Home,2002-03-13,3,4,4,4,4,0,0,3,6,4,4,1,-2,1,21.0,5.0,16.0,8
2409,2409,2001-02,2001,2002,Blackburn,Leeds,Loss,Away,2002-03-17,0,6,7,7,7,4,5,6,6,2,2,1,1,0,21.0,4.0,17.0,8
2410,2410,2001-02,2001,2002,Blackburn,Leicester,Loss,Away,2002-03-30,0,3,6,7,7,1,2,2,2,2,4,5,5,0,21.0,13.0,8.0,8
2411,2411,2001-02,2001,2002,Blackburn,Southampton,Win,Home,2002-04-01,3,0,3,6,7,2,3,4,7,-2,0,2,0,1,21.0,10.0,11.0,9
2412,2412,2001-02,2001,2002,Blackburn,Chelsea,Draw,Home,2002-04-10,1,3,3,6,9,4,7,7,10,-1,-4,-1,-1,1,21.0,6.0,15.0,9
2413,2413,2001-02,2001,2002,Blackburn,Middlesbrough,Win,Away,2002-04-20,3,4,4,4,7,6,7,10,10,-2,-3,-6,-3,0,21.0,14.0,7.0,9
2414,2414,2001-02,2001,2002,Blackburn,Newcastle,Draw,Home,2002-04-23,1,4,7,7,7,6,7,8,11,-2,0,-1,-4,1,21.0,11.0,10.0,9
2415,2415,2001-02,2001,2002,Blackburn,Everton,Win,Away,2002-04-28,3,4,5,8,8,4,4,7,7,0,1,1,1,0,21.0,16.0,5.0,9
2416,2416,2001-02,2001,2002,Blackburn,Liverpool,Loss,Away,2002-05-08,0,4,7,8,11,3,6,9,12,1,1,-1,-1,0,21.0,3.0,18.0,10
2417,2417,2001-02,2001,2002,Blackburn,Fulham,Win,Home,2002-05-11,3,3,4,7,8,4,7,8,8,-1,-3,-1,0,1,21.0,21.0,0.0,10
2418,2418,2002-03,2002,2003,Blackburn,Sunderland,Draw,Home,2002-08-17,1,3,6,7,10,2,2,2,2,1,4,5,8,1,10.0,17.0,-7.0,1
2419,2419,2002-03,2002,2003,Blackburn,Birmingham,Win,Away,2002-08-24,3,4,4,7,8,0,0,0,0,4,4,7,8,0,10.0,21.0,-11.0,1
2420,2420,2002-03,2002,2003,Blackburn,Liverpool,Draw,Home,2002-08-28,1,4,7,7,10,6,9,12,12,-2,-2,-5,-2,1,10.0,2.0,8.0,1
2421,2421,2002-03,2002,2003,Blackburn,Middlesbrough,Loss,Away,2002-08-31,0,4,5,8,8,2,2,2,2,2,3,6,6,0,10.0,12.0,-2.0,1
2422,2422,2002-03,2002,2003,Blackburn,Chelsea,Loss,Home,2002-09-11,0,1,4,5,8,2,3,6,6,-1,1,-1,2,1,10.0,6.0,4.0,2
2423,2423,2002-03,2002,2003,Blackburn,Man City,Draw,Away,2002-09-15,1,0,1,4,5,3,3,6,6,-3,-2,-2,-1,0,10.0,21.0,-11.0,2
2424,2424,2002-03,2002,2003,Blackburn,Leeds,Win,Home,2002-09-22,3,1,1,2,5,6,6,6,9,-5,-5,-4,-4,1,10.0,5.0,5.0,2
2425,2425,2002-03,2002,2003,Blackburn,West Brom,Win,Away,2002-09-30,3,4,4,4,5,3,6,9,9,1,-2,-5,-4,0,10.0,21.0,-11.0,2
2426,2426,2002-03,2002,2003,Blackburn,Tottenham,Loss,Home,2002-10-06,0,6,7,7,7,0,3,3,6,6,4,4,1,1,10.0,9.0,1.0,3
2427,2427,2002-03,2002,2003,Blackburn,Newcastle,Win,Home,2002-10-19,3,3,6,7,7,6,9,9,9,-3,-3,-2,-2,1,10.0,4.0,6.0,3
2428,2428,2002-03,2002,2003,Blackburn,Arsenal,Win,Away,2002-10-26,3,3,6,9,10,3,6,9,12,0,0,0,-2,0,10.0,1.0,9.0,3
2429,2429,2002-03,2002,2003,Blackburn,Aston Villa,Draw,Home,2002-11-03,1,6,6,9,12,1,2,2,5,5,4,7,7,1,10.0,8.0,2.0,4
2430,2430,2002-03,2002,2003,Blackburn,Southampton,Draw,Away,2002-11-09,1,4,7,7,10,3,6,9,10,1,1,-2,0,0,10.0,11.0,-1.0,4
2431,2431,2002-03,2002,2003,Blackburn,Everton,Loss,Home,2002-11-17,0,2,5,8,8,6,9,12,12,-4,-4,-4,-4,1,10.0,15.0,-5.0,4
2432,2432,2002-03,2002,2003,Blackburn,Charlton,Loss,Away,2002-11-24,0,1,2,5,8,3,4,4,7,-2,-2,1,1,0,10.0,14.0,-4.0,4
2433,2433,2002-03,2002,2003,Blackburn,Fulham,Win,Home,2002-11-30,3,0,1,2,5,4,4,4,4,-4,-3,-2,1,1,10.0,13.0,-3.0,4
2434,2434,2002-03,2002,2003,Blackburn,Bolton,Draw,Away,2002-12-07,1,3,3,4,5,1,4,5,5,2,-1,-1,0,0,10.0,16.0,-6.0,5
2435,2435,2002-03,2002,2003,Blackburn,Everton,Loss,Away,2002-12-14,0,4,4,4,5,0,3,6,9,4,1,-2,-4,0,10.0,15.0,-5.0,5
2436,2436,2002-03,2002,2003,Blackburn,Man United,Win,Home,2002-12-22,3,1,4,4,4,6,9,12,13,-5,-5,-8,-9,1,10.0,3.0,7.0,5
2437,2437,2002-03,2002,2003,Blackburn,Liverpool,Draw,Away,2002-12-26,1,3,4,7,7,1,1,1,1,2,3,6,6,0,10.0,2.0,8.0,5
2438,2438,2002-03,2002,2003,Blackburn,West Ham,Draw,Home,2002-12-28,1,4,4,5,8,2,2,3,3,2,2,2,5,1,10.0,7.0,3.0,5
2439,2439,2002-03,2002,2003,Blackburn,Middlesbrough,Win,Home,2003-01-01,3,2,5,5,6,3,3,4,5,-1,2,1,1,1,10.0,12.0,-2.0,6
2440,2440,2002-03,2002,2003,Blackburn,Sunderland,Draw,Away,2003-01-11,1,4,5,8,8,0,0,1,4,4,5,7,4,0,10.0,17.0,-7.0,6
2441,2441,2002-03,2002,2003,Blackburn,Birmingham,Draw,Home,2003-01-18,1,4,5,6,9,0,0,1,2,4,5,5,7,1,10.0,21.0,-11.0,6
2442,2442,2002-03,2002,2003,Blackburn,West Ham,Loss,Away,2003-01-29,0,2,5,6,7,0,1,2,3,2,4,4,4,0,10.0,7.0,3.0,6
2443,2443,2002-03,2002,2003,Blackburn,Aston Villa,Loss,Away,2003-02-02,0,1,2,5,6,3,4,7,10,-2,-2,-2,-4,0,10.0,8.0,2.0,7
2444,2444,2002-03,2002,2003,Blackburn,Southampton,Win,Home,2003-02-08,3,0,1,2,5,3,3,4,7,-3,-2,-2,-2,1,10.0,11.0,-1.0,7
2445,2445,2002-03,2002,2003,Blackburn,Chelsea,Win,Away,2003-02-22,3,3,3,4,5,4,7,7,10,-1,-4,-3,-5,0,10.0,6.0,4.0,7
2446,2446,2002-03,2002,2003,Blackburn,Man City,Win,Home,2003-03-01,3,6,6,6,7,1,1,4,4,5,5,2,3,1,10.0,21.0,-11.0,8
2447,2447,2002-03,2002,2003,Blackburn,Arsenal,Win,Home,2003-03-15,3,6,9,9,9,6,7,10,11,0,2,-1,-2,1,10.0,1.0,9.0,8
2448,2448,2002-03,2002,2003,Blackburn,Newcastle,Loss,Away,2003-03-22,0,6,9,12,12,3,6,9,10,3,3,3,2,0,10.0,4.0,6.0,8
2449,2449,2002-03,2002,2003,Blackburn,Fulham,Win,Away,2003-04-07,3,3,6,9,12,1,4,5,8,2,2,4,4,0,10.0,13.0,-3.0,9
2450,2450,2002-03,2002,2003,Blackburn,Charlton,Win,Home,2003-04-12,3,3,6,9,12,1,1,1,4,2,5,8,8,1,10.0,14.0,-4.0,9
2451,2451,2002-03,2002,2003,Blackburn,Man United,Loss,Away,2003-04-19,0,6,6,9,12,4,7,10,13,2,-1,-1,-1,0,10.0,3.0,7.0,9
2452,2452,2002-03,2002,2003,Blackburn,Bolton,Draw,Home,2003-04-21,1,3,6,6,9,3,6,9,12,0,0,-3,-3,1,10.0,16.0,-6.0,9
2453,2453,2002-03,2002,2003,Blackburn,Leeds,Win,Away,2003-04-26,3,1,4,7,7,3,4,7,7,-2,0,0,0,0,10.0,5.0,5.0,9
2454,2454,2002-03,2002,2003,Blackburn,West Brom,Draw,Home,2003-05-03,1,4,4,7,10,0,3,3,3,4,1,4,7,1,10.0,21.0,-11.0,10
2455,2455,2002-03,2002,2003,Blackburn,Tottenham,Win,Away,2003-05-11,3,4,5,5,8,0,3,3,4,4,2,2,4,0,10.0,9.0,1.0,10
2456,2456,2003-04,2003,2004,Blackburn,Wolves,Win,Home,2003-08-16,3,4,7,8,8,0,0,0,0,4,7,8,8,1,6.0,21.0,-15.0,1
2457,2457,2003-04,2003,2004,Blackburn,Bolton,Draw,Away,2003-08-23,1,6,7,10,11,3,4,5,6,3,3,5,5,0,6.0,17.0,-11.0,1
2458,2458,2003-04,2003,2004,Blackburn,Man City,Loss,Home,2003-08-25,0,4,7,8,11,4,4,7,7,0,3,1,4,1,6.0,9.0,-3.0,1
2459,2459,2003-04,2003,2004,Blackburn,Chelsea,Draw,Away,2003-08-30,1,1,4,7,8,6,9,9,10,-5,-5,-2,-2,0,6.0,4.0,2.0,1
2460,2460,2003-04,2003,2004,Blackburn,Liverpool,Loss,Home,2003-09-13,0,1,2,5,8,4,5,5,5,-3,-3,0,3,1,6.0,5.0,1.0,2
2461,2461,2003-04,2003,2004,Blackburn,Portsmouth,Win,Away,2003-09-20,3,1,1,2,5,2,5,6,9,-1,-4,-4,-4,0,6.0,21.0,-15.0,2
2462,2462,2003-04,2003,2004,Blackburn,Fulham,Loss,Home,2003-09-28,0,3,4,4,5,2,5,5,8,1,-1,-1,-3,1,6.0,14.0,-8.0,2
2463,2463,2003-04,2003,2004,Blackburn,Leeds,Loss,Away,2003-10-04,0,3,3,4,4,0,0,3,4,3,3,1,0,0,6.0,15.0,-9.0,3
2464,2464,2003-04,2003,2004,Blackburn,Charlton,Loss,Home,2003-10-20,0,0,3,3,4,6,6,6,7,-6,-3,-3,-3,1,6.0,12.0,-6.0,3
2465,2465,2003-04,2003,2004,Blackburn,Southampton,Loss,Away,2003-10-25,0,0,0,3,3,1,1,4,7,-1,-1,-1,-4,0,6.0,8.0,-2.0,3
2466,2466,2003-04,2003,2004,Blackburn,Leicester,Loss,Away,2003-11-02,0,0,0,0,3,0,0,0,0,0,0,0,3,0,6.0,21.0,-15.0,4
2467,2467,2003-04,2003,2004,Blackburn,Everton,Win,Home,2003-11-10,3,0,0,0,0,1,2,2,5,-1,-2,-2,-5,1,6.0,7.0,-1.0,4
2468,2468,2003-04,2003,2004,Blackburn,Man United,Loss,Away,2003-11-22,0,3,3,3,3,6,6,9,12,-3,-3,-6,-9,0,6.0,1.0,5.0,4
2469,2469,2003-04,2003,2004,Blackburn,Tottenham,Win,Home,2003-11-29,3,3,3,3,3,3,3,4,7,0,0,-1,-4,1,6.0,10.0,-4.0,4
2470,2470,2003-04,2003,2004,Blackburn,Birmingham,Win,Away,2003-12-06,3,3,6,6,6,0,1,1,4,3,5,5,2,0,6.0,13.0,-7.0,5
2471,2471,2003-04,2003,2004,Blackburn,Arsenal,Loss,Away,2003-12-14,0,6,6,9,9,2,5,8,11,4,1,1,-2,0,6.0,2.0,4.0,5
2472,2472,2003-04,2003,2004,Blackburn,Aston Villa,Loss,Home,2003-12-20,0,3,6,6,9,3,6,6,6,0,0,0,3,1,6.0,16.0,-10.0,5
2473,2473,2003-04,2003,2004,Blackburn,Middlesbrough,Draw,Home,2003-12-26,1,0,3,6,6,2,5,6,9,-2,-2,0,-3,1,6.0,11.0,-5.0,5
2474,2474,2003-04,2003,2004,Blackburn,Newcastle,Win,Away,2003-12-28,3,1,1,4,7,2,5,6,7,-1,-4,-2,0,0,6.0,3.0,3.0,5
2475,2475,2003-04,2003,2004,Blackburn,Wolves,Draw,Away,2004-01-07,1,4,4,4,7,3,3,3,4,1,1,1,3,0,6.0,21.0,-15.0,6
2476,2476,2003-04,2003,2004,Blackburn,Bolton,Loss,Home,2004-01-10,0,4,5,5,5,1,1,2,5,3,4,3,0,1,6.0,17.0,-11.0,6
2477,2477,2003-04,2003,2004,Blackburn,Man City,Draw,Away,2004-01-17,1,1,4,5,5,1,2,2,3,0,2,3,2,0,6.0,9.0,-3.0,6
2478,2478,2003-04,2003,2004,Blackburn,Chelsea,Loss,Home,2004-02-01,0,1,2,5,6,4,4,7,7,-3,-2,-2,-1,1,6.0,4.0,2.0,7
2479,2479,2003-04,2003,2004,Blackburn,Middlesbrough,Win,Away,2004-02-07,3,1,1,2,5,4,4,7,7,-3,-3,-5,-2,0,6.0,11.0,-5.0,7
2480,2480,2003-04,2003,2004,Blackburn,Newcastle,Draw,Home,2004-02-11,1,3,4,4,5,4,7,8,11,-1,-3,-4,-6,1,6.0,3.0,3.0,7
2481,2481,2003-04,2003,2004,Blackburn,Charlton,Loss,Away,2004-02-21,0,4,4,5,5,0,0,3,6,4,4,2,-1,0,6.0,12.0,-6.0,7
2482,2482,2003-04,2003,2004,Blackburn,Southampton,Draw,Home,2004-02-28,1,1,4,4,5,1,2,2,5,0,2,2,0,1,6.0,8.0,-2.0,7
2483,2483,2003-04,2003,2004,Blackburn,Arsenal,Loss,Home,2004-03-13,0,1,2,5,5,6,9,12,15,-5,-7,-7,-10,1,6.0,2.0,4.0,8
2484,2484,2003-04,2003,2004,Blackburn,Aston Villa,Win,Away,2004-03-20,3,1,1,2,5,3,4,7,10,-2,-3,-5,-5,0,6.0,16.0,-10.0,8
2485,2485,2003-04,2003,2004,Blackburn,Portsmouth,Loss,Home,2004-03-27,0,3,4,4,5,3,3,4,4,0,1,0,1,1,6.0,21.0,-15.0,8
2486,2486,2003-04,2003,2004,Blackburn,Liverpool,Loss,Away,2004-04-04,0,3,3,4,4,4,7,7,8,-1,-4,-3,-4,0,6.0,5.0,1.0,9
2487,2487,2003-04,2003,2004,Blackburn,Leeds,Loss,Home,2004-04-10,0,0,3,3,4,3,6,6,7,-3,-3,-3,-3,1,6.0,15.0,-9.0,9
2488,2488,2003-04,2003,2004,Blackburn,Fulham,Win,Away,2004-04-12,3,0,0,3,3,4,5,5,8,-4,-5,-2,-5,0,6.0,14.0,-8.0,9
2489,2489,2003-04,2003,2004,Blackburn,Leicester,Win,Home,2004-04-17,3,3,3,3,6,0,0,1,2,3,3,2,4,1,6.0,21.0,-15.0,9
2490,2490,2003-04,2003,2004,Blackburn,Everton,Win,Away,2004-04-24,3,6,6,6,6,2,5,5,6,4,1,1,0,0,6.0,7.0,-1.0,9
2491,2491,2003-04,2003,2004,Blackburn,Man United,Win,Home,2004-05-01,3,6,9,9,9,3,3,6,9,3,6,3,0,1,6.0,1.0,5.0,10
2492,2492,2003-04,2003,2004,Blackburn,Tottenham,Loss,Away,2004-05-08,0,6,9,12,12,1,1,2,2,5,8,10,10,0,6.0,10.0,-4.0,10
2493,2493,2003-04,2003,2004,Blackburn,Birmingham,Draw,Home,2004-05-15,1,3,6,9,12,1,2,3,3,2,4,6,9,1,6.0,13.0,-7.0,10
2494,2494,2004-05,2004,2005,Blackburn,West Brom,Draw,Home,2004-08-14,1,1,4,7,10,2,2,2,5,-1,2,5,5,1,15.0,21.0,-6.0,1
2495,2495,2004-05,2004,2005,Blackburn,Southampton,Loss,Away,2004-08-21,0,2,2,5,8,0,1,2,2,2,1,3,6,0,15.0,12.0,3.0,1
2496,2496,2004-05,2004,2005,Blackburn,Arsenal,Loss,Away,2004-08-25,0,1,2,2,5,6,9,12,13,-5,-7,-10,-8,0,15.0,1.0,14.0,1
2497,2497,2004-05,2004,2005,Blackburn,Man United,Draw,Home,2004-08-28,1,0,1,2,2,3,6,7,7,-3,-5,-5,-5,1,15.0,3.0,12.0,1
2498,2498,2004-05,2004,2005,Blackburn,Newcastle,Loss,Away,2004-09-11,0,1,1,2,3,1,1,2,3,0,0,0,0,0,15.0,5.0,10.0,2
2499,2499,2004-05,2004,2005,Blackburn,Portsmouth,Win,Home,2004-09-18,3,1,1,1,2,6,6,7,10,-5,-5,-6,-8,1,15.0,13.0,2.0,2
2500,2500,2004-05,2004,2005,Blackburn,Charlton,Loss,Away,2004-09-27,0,3,4,4,4,2,2,5,8,1,2,-1,-4,0,15.0,7.0,8.0,2
2501,2501,2004-05,2004,2005,Blackburn,Aston Villa,Draw,Home,2004-10-02,1,3,3,4,4,2,3,6,6,1,0,-2,-2,1,15.0,6.0,9.0,3
2502,2502,2004-05,2004,2005,Blackburn,Middlesbrough,Loss,Home,2004-10-16,0,1,4,4,5,1,1,4,7,0,3,0,-2,1,15.0,11.0,4.0,3
2503,2503,2004-05,2004,2005,Blackburn,Chelsea,Loss,Away,2004-10-23,0,1,1,4,4,3,6,7,8,-2,-5,-3,-4,0,15.0,2.0,13.0,3
2504,2504,2004-05,2004,2005,Blackburn,Liverpool,Draw,Home,2004-10-30,1,0,1,1,4,6,6,9,9,-6,-5,-8,-5,1,15.0,4.0,11.0,3
2505,2505,2004-05,2004,2005,Blackburn,Norwich,Draw,Away,2004-11-06,1,1,1,2,2,1,2,3,3,0,-1,-1,-1,0,15.0,21.0,-6.0,4
2506,2506,2004-05,2004,2005,Blackburn,Man City,Draw,Away,2004-11-13,1,2,2,2,3,2,2,5,6,0,0,-3,-3,0,15.0,16.0,-1.0,4
2507,2507,2004-05,2004,2005,Blackburn,Birmingham,Draw,Home,2004-11-21,1,2,3,3,3,3,3,4,5,-1,0,-1,-2,1,15.0,10.0,5.0,4
2508,2508,2004-05,2004,2005,Blackburn,Fulham,Win,Away,2004-11-27,3,2,3,4,4,0,3,6,6,2,0,-2,-2,0,15.0,9.0,6.0,4
2509,2509,2004-05,2004,2005,Blackburn,Tottenham,Loss,Home,2004-12-04,0,4,5,6,7,3,3,3,3,1,2,3,4,1,15.0,14.0,1.0,5
2510,2510,2004-05,2004,2005,Blackburn,Crystal Palace,Draw,Away,2004-12-11,1,3,4,5,6,1,1,1,2,2,3,4,4,0,15.0,21.0,-6.0,5
2511,2511,2004-05,2004,2005,Blackburn,Everton,Draw,Home,2004-12-18,1,1,4,5,6,6,7,10,13,-5,-3,-5,-7,1,15.0,17.0,-2.0,5
2512,2512,2004-05,2004,2005,Blackburn,Newcastle,Draw,Home,2004-12-26,1,2,2,5,6,1,1,2,5,1,1,3,1,1,15.0,5.0,10.0,5
2513,2513,2004-05,2004,2005,Blackburn,Bolton,Win,Away,2004-12-28,3,2,3,3,6,0,0,0,0,2,3,3,6,0,15.0,8.0,7.0,5
2514,2514,2004-05,2004,2005,Blackburn,Aston Villa,Loss,Away,2005-01-01,0,4,5,6,6,0,0,0,1,4,5,6,5,0,15.0,6.0,9.0,6
2515,2515,2004-05,2004,2005,Blackburn,Charlton,Win,Home,2005-01-03,3,3,4,5,6,3,4,7,10,0,0,-2,-4,1,15.0,7.0,8.0,6
2516,2516,2004-05,2004,2005,Blackburn,Portsmouth,Win,Away,2005-01-15,3,3,6,7,8,1,1,4,4,2,5,3,4,0,15.0,13.0,2.0,6
2517,2517,2004-05,2004,2005,Blackburn,Bolton,Loss,Home,2005-01-24,0,6,6,9,10,6,7,7,7,0,-1,2,3,1,15.0,8.0,7.0,6
2518,2518,2004-05,2004,2005,Blackburn,Chelsea,Loss,Home,2005-02-02,0,3,6,6,9,6,9,12,15,-3,-3,-6,-6,1,15.0,2.0,13.0,7
2519,2519,2004-05,2004,2005,Blackburn,Middlesbrough,Loss,Away,2005-02-05,0,0,3,6,6,1,2,2,2,-1,1,4,4,0,15.0,11.0,4.0,7
2520,2520,2004-05,2004,2005,Blackburn,Norwich,Win,Home,2005-02-12,3,0,0,3,6,3,4,4,4,-3,-4,-1,2,1,15.0,21.0,-6.0,7
2521,2521,2004-05,2004,2005,Blackburn,Everton,Win,Away,2005-03-06,3,3,3,3,6,3,4,7,7,0,-1,-4,-1,0,15.0,17.0,-2.0,8
2522,2522,2004-05,2004,2005,Blackburn,Liverpool,Draw,Away,2005-03-16,1,6,6,6,6,0,3,6,6,6,3,0,0,0,15.0,4.0,11.0,8
2523,2523,2004-05,2004,2005,Blackburn,Arsenal,Loss,Home,2005-03-19,0,4,7,7,7,4,7,10,10,0,0,-3,-3,1,15.0,1.0,14.0,8
2524,2524,2004-05,2004,2005,Blackburn,Man United,Draw,Away,2005-04-02,1,1,4,7,7,4,7,10,13,-3,-3,-3,-6,0,15.0,3.0,12.0,9
2525,2525,2004-05,2004,2005,Blackburn,Southampton,Win,Home,2005-04-09,3,1,2,5,8,3,6,7,8,-2,-4,-2,0,1,15.0,12.0,3.0,9
2526,2526,2004-05,2004,2005,Blackburn,Crystal Palace,Win,Home,2005-04-20,3,4,4,5,8,1,1,1,2,3,3,4,6,1,15.0,21.0,-6.0,9
2527,2527,2004-05,2004,2005,Blackburn,Man City,Draw,Home,2005-04-23,1,6,7,7,8,4,7,8,8,2,0,-1,0,1,15.0,16.0,-1.0,9
2528,2528,2004-05,2004,2005,Blackburn,West Brom,Draw,Away,2005-04-26,1,4,7,8,8,1,2,5,8,3,5,3,0,0,15.0,21.0,-6.0,9
2529,2529,2004-05,2004,2005,Blackburn,Birmingham,Loss,Away,2005-04-30,0,2,5,8,9,1,2,3,4,1,3,5,5,0,15.0,10.0,5.0,9
2530,2530,2004-05,2004,2005,Blackburn,Fulham,Loss,Home,2005-05-07,0,1,2,5,8,3,3,4,5,-2,-1,1,3,1,15.0,9.0,6.0,10
2531,2531,2004-05,2004,2005,Blackburn,Tottenham,Draw,Away,2005-05-15,1,0,1,2,5,3,3,4,5,-3,-2,-2,0,0,15.0,14.0,1.0,10
2532,2532,2005-06,2005,2006,Blackburn,West Ham,Loss,Away,2005-08-13,0,1,1,2,3,4,7,10,10,-3,-6,-8,-7,0,15.0,21.0,-6.0,1
2533,2533,2005-06,2005,2006,Blackburn,Fulham,Win,Home,2005-08-20,3,1,1,1,2,4,7,7,10,-3,-6,-6,-8,1,15.0,13.0,2.0,1
2534,2534,2005-06,2005,2006,Blackburn,Tottenham,Draw,Home,2005-08-24,1,3,4,4,4,6,7,7,10,-3,-3,-3,-6,1,15.0,9.0,6.0,1
2535,2535,2005-06,2005,2006,Blackburn,Aston Villa,Loss,Away,2005-08-27,0,4,4,5,5,1,2,2,2,3,2,3,3,0,15.0,10.0,5.0,1
2536,2536,2005-06,2005,2006,Blackburn,Bolton,Draw,Away,2005-09-11,1,1,4,4,5,6,6,7,10,-5,-2,-3,-5,0,15.0,6.0,9.0,2
2537,2537,2005-06,2005,2006,Blackburn,Newcastle,Loss,Home,2005-09-18,0,1,2,5,5,1,1,2,2,0,1,3,3,1,15.0,14.0,1.0,2
2538,2538,2005-06,2005,2006,Blackburn,Man United,Win,Away,2005-09-24,3,1,1,2,5,2,5,8,11,-1,-4,-6,-6,0,15.0,3.0,12.0,2
2539,2539,2005-06,2005,2006,Blackburn,West Brom,Win,Home,2005-10-01,3,3,4,4,5,1,1,1,1,2,3,3,4,1,15.0,17.0,-2.0,3
2540,2540,2005-06,2005,2006,Blackburn,Liverpool,Loss,Away,2005-10-15,0,6,6,7,7,1,2,3,6,5,4,4,1,0,15.0,5.0,10.0,3
2541,2541,2005-06,2005,2006,Blackburn,Birmingham,Win,Home,2005-10-22,3,3,6,6,7,0,1,2,2,3,5,4,5,1,15.0,12.0,3.0,3
2542,2542,2005-06,2005,2006,Blackburn,Chelsea,Loss,Away,2005-10-29,0,3,6,9,9,4,7,10,13,-1,-1,-1,-4,0,15.0,1.0,14.0,3
2543,2543,2005-06,2005,2006,Blackburn,Charlton,Win,Home,2005-11-05,3,3,3,6,9,3,4,4,7,0,-1,2,2,1,15.0,11.0,4.0,4
2544,2544,2005-06,2005,2006,Blackburn,Man City,Draw,Away,2005-11-19,1,3,6,6,9,3,3,6,9,0,3,0,0,0,15.0,8.0,7.0,4
2545,2545,2005-06,2005,2006,Blackburn,Arsenal,Loss,Away,2005-11-26,0,4,4,7,7,6,7,10,10,-2,-3,-3,-3,0,15.0,2.0,13.0,4
2546,2546,2005-06,2005,2006,Blackburn,Everton,Loss,Home,2005-12-03,0,1,4,4,7,3,6,9,10,-2,-2,-5,-3,1,15.0,4.0,11.0,5
2547,2547,2005-06,2005,2006,Blackburn,West Ham,Win,Home,2005-12-10,3,0,1,4,4,3,4,7,7,-3,-3,-3,-3,1,15.0,21.0,-6.0,5
2548,2548,2005-06,2005,2006,Blackburn,Fulham,Loss,Away,2005-12-17,0,3,3,4,7,1,4,4,7,2,-1,0,0,0,15.0,13.0,2.0,5
2549,2549,2005-06,2005,2006,Blackburn,Middlesbrough,Win,Away,2005-12-26,3,3,3,3,4,1,1,2,5,2,2,1,-1,0,15.0,7.0,8.0,5
2550,2550,2005-06,2005,2006,Blackburn,Wigan,Win,Away,2005-12-31,3,3,6,6,6,6,9,9,9,-3,-3,-3,-3,0,15.0,21.0,-6.0,5
2551,2551,2005-06,2005,2006,Blackburn,Portsmouth,Win,Home,2006-01-02,3,6,6,9,9,3,4,7,7,3,2,2,2,1,15.0,16.0,-1.0,6
2552,2552,2005-06,2005,2006,Blackburn,Bolton,Draw,Home,2006-01-14,1,6,9,9,12,1,2,5,6,5,7,4,6,1,15.0,6.0,9.0,6
2553,2553,2005-06,2005,2006,Blackburn,Newcastle,Win,Away,2006-01-21,3,4,7,10,10,1,1,1,4,3,6,9,6,0,15.0,14.0,1.0,6
2554,2554,2005-06,2005,2006,Blackburn,Man United,Win,Home,2006-02-01,3,4,7,10,13,3,4,7,8,1,3,3,5,1,15.0,3.0,12.0,7
2555,2555,2005-06,2005,2006,Blackburn,West Brom,Loss,Away,2006-02-04,0,6,7,10,13,1,4,4,4,5,3,6,9,0,15.0,17.0,-2.0,7
2556,2556,2005-06,2005,2006,Blackburn,Everton,Loss,Away,2006-02-11,0,3,6,7,10,4,7,10,13,-1,-1,-3,-3,0,15.0,4.0,11.0,7
2557,2557,2005-06,2005,2006,Blackburn,Sunderland,Win,Home,2006-02-15,3,0,3,6,7,1,1,4,4,-1,2,2,3,1,15.0,21.0,-6.0,7
2558,2558,2005-06,2005,2006,Blackburn,Arsenal,Win,Home,2006-02-25,3,3,3,6,9,1,4,4,4,2,-1,2,5,1,15.0,2.0,13.0,7
2559,2559,2005-06,2005,2006,Blackburn,Tottenham,Loss,Away,2006-03-05,0,6,6,6,9,2,5,5,6,4,1,1,3,0,15.0,9.0,6.0,8
2560,2560,2005-06,2005,2006,Blackburn,Aston Villa,Win,Home,2006-03-11,3,3,6,6,6,4,4,7,8,-1,2,-1,-2,1,15.0,10.0,5.0,8
2561,2561,2005-06,2005,2006,Blackburn,Middlesbrough,Win,Home,2006-03-18,3,3,6,9,9,3,6,9,9,0,0,0,0,1,15.0,7.0,8.0,8
2562,2562,2005-06,2005,2006,Blackburn,Sunderland,Win,Away,2006-03-25,3,6,6,9,12,0,0,0,0,6,6,9,12,0,15.0,21.0,-6.0,8
2563,2563,2005-06,2005,2006,Blackburn,Wigan,Draw,Home,2006-04-03,1,6,9,9,12,3,6,6,7,3,3,3,5,1,15.0,21.0,-6.0,9
2564,2564,2005-06,2005,2006,Blackburn,Portsmouth,Draw,Away,2006-04-08,1,4,7,10,10,6,9,9,9,-2,-2,1,1,0,15.0,16.0,-1.0,9
2565,2565,2005-06,2005,2006,Blackburn,Liverpool,Loss,Home,2006-04-16,0,2,5,8,11,6,9,12,15,-4,-4,-4,-4,1,15.0,5.0,10.0,9
2566,2566,2005-06,2005,2006,Blackburn,Birmingham,Loss,Away,2006-04-19,0,1,2,5,8,1,4,5,5,0,-2,0,3,0,15.0,12.0,3.0,9
2567,2567,2005-06,2005,2006,Blackburn,Charlton,Win,Away,2006-04-29,3,0,1,2,5,3,3,4,5,-3,-2,-2,0,0,15.0,11.0,4.0,9
2568,2568,2005-06,2005,2006,Blackburn,Chelsea,Win,Home,2006-05-02,3,3,3,4,5,6,9,12,13,-3,-6,-8,-8,1,15.0,1.0,14.0,10
2569,2569,2005-06,2005,2006,Blackburn,Man City,Win,Home,2006-05-07,3,6,6,6,7,0,3,3,3,6,3,3,4,1,15.0,8.0,7.0,10
2570,2570,2006-07,2006,2007,Blackburn,Portsmouth,Loss,Away,2006-08-19,0,6,9,9,9,3,6,6,9,3,3,3,0,0,6.0,17.0,-11.0,1
2571,2571,2006-07,2006,2007,Blackburn,Everton,Draw,Home,2006-08-23,1,3,6,9,9,4,7,8,8,-1,-1,1,1,1,6.0,11.0,-5.0,1
2572,2572,2006-07,2006,2007,Blackburn,Chelsea,Loss,Home,2006-08-27,0,1,4,7,10,3,3,3,6,-2,1,4,4,1,6.0,1.0,5.0,1
2573,2573,2006-07,2006,2007,Blackburn,Sheffield United,Draw,Away,2006-09-09,1,1,1,4,7,0,1,1,2,1,0,3,5,0,6.0,21.0,-15.0,2
2574,2574,2006-07,2006,2007,Blackburn,Man City,Win,Home,2006-09-17,3,1,2,2,5,3,4,4,4,-2,-2,-2,1,1,6.0,15.0,-9.0,2
2575,2575,2006-07,2006,2007,Blackburn,Middlesbrough,Win,Away,2006-09-23,3,4,4,5,5,2,2,5,5,2,2,0,0,0,6.0,14.0,-8.0,2
2576,2576,2006-07,2006,2007,Blackburn,Wigan,Win,Home,2006-10-01,3,6,7,7,8,2,2,5,5,4,5,2,3,1,6.0,10.0,-4.0,3
2577,2577,2006-07,2006,2007,Blackburn,Liverpool,Draw,Away,2006-10-14,1,6,9,10,10,3,6,6,6,3,3,4,4,0,6.0,3.0,3.0,3
2578,2578,2006-07,2006,2007,Blackburn,Bolton,Loss,Home,2006-10-22,0,4,7,10,11,6,9,10,13,-2,-2,0,-2,1,6.0,8.0,-2.0,3
2579,2579,2006-07,2006,2007,Blackburn,West Ham,Loss,Away,2006-10-29,0,1,4,7,10,0,0,0,0,1,4,7,10,0,6.0,9.0,-3.0,3
2580,2580,2006-07,2006,2007,Blackburn,Aston Villa,Loss,Away,2006-11-05,0,0,1,4,7,1,2,3,6,-1,-1,1,1,0,6.0,16.0,-10.0,4
2581,2581,2006-07,2006,2007,Blackburn,Man United,Loss,Home,2006-11-11,0,0,0,1,4,6,9,12,15,-6,-9,-11,-11,1,6.0,2.0,4.0,4
2582,2582,2006-07,2006,2007,Blackburn,Tottenham,Draw,Home,2006-11-19,1,0,0,0,1,3,4,7,8,-3,-4,-7,-7,1,6.0,5.0,1.0,4
2583,2583,2006-07,2006,2007,Blackburn,Fulham,Win,Home,2006-12-02,3,1,1,1,1,3,3,4,7,-2,-2,-3,-6,1,6.0,12.0,-6.0,5
2584,2584,2006-07,2006,2007,Blackburn,Charlton,Loss,Away,2006-12-05,0,4,4,4,4,1,1,1,4,3,3,3,0,0,6.0,13.0,-7.0,5
2585,2585,2006-07,2006,2007,Blackburn,Newcastle,Loss,Home,2006-12-09,0,3,4,4,4,6,7,8,8,-3,-3,-4,-4,1,6.0,7.0,-1.0,5
2586,2586,2006-07,2006,2007,Blackburn,Reading,Win,Away,2006-12-16,3,0,3,4,4,1,4,7,10,-1,-1,-3,-6,0,6.0,21.0,-15.0,5
2587,2587,2006-07,2006,2007,Blackburn,Arsenal,Loss,Away,2006-12-23,0,3,3,6,7,4,5,8,8,-1,-2,-2,-1,0,6.0,4.0,2.0,5
2588,2588,2006-07,2006,2007,Blackburn,Liverpool,Win,Home,2006-12-26,3,3,3,3,6,6,9,12,13,-3,-6,-9,-7,1,6.0,3.0,3.0,5
2589,2589,2006-07,2006,2007,Blackburn,Middlesbrough,Win,Home,2006-12-30,3,3,6,6,6,4,4,5,5,-1,2,1,1,1,6.0,14.0,-8.0,5
2590,2590,2006-07,2006,2007,Blackburn,Wigan,Win,Away,2007-01-01,3,6,6,9,9,0,0,0,1,6,6,9,8,0,6.0,10.0,-4.0,6
2591,2591,2006-07,2006,2007,Blackburn,Arsenal,Loss,Home,2007-01-13,0,6,9,9,12,3,6,9,10,3,3,0,2,1,6.0,4.0,2.0,6
2592,2592,2006-07,2006,2007,Blackburn,Man City,Win,Away,2007-01-20,3,3,6,9,9,4,7,10,10,-1,-1,-1,-1,0,6.0,15.0,-9.0,6
2593,2593,2006-07,2006,2007,Blackburn,Watford,Loss,Away,2007-01-23,0,3,6,9,12,0,1,1,1,3,5,8,11,0,6.0,21.0,-15.0,6
2594,2594,2006-07,2006,2007,Blackburn,Chelsea,Loss,Away,2007-01-31,0,3,3,6,9,3,4,5,6,0,-1,1,3,0,6.0,1.0,5.0,6
2595,2595,2006-07,2006,2007,Blackburn,Sheffield United,Win,Home,2007-02-03,3,0,3,3,6,3,4,4,7,-3,-1,-1,-1,1,6.0,21.0,-15.0,7
2596,2596,2006-07,2006,2007,Blackburn,Everton,Loss,Away,2007-02-10,0,3,3,6,6,4,5,5,8,-1,-2,1,-2,0,6.0,11.0,-5.0,7
2597,2597,2006-07,2006,2007,Blackburn,Portsmouth,Win,Home,2007-02-25,3,3,3,3,6,3,4,4,5,0,-1,-1,1,1,6.0,17.0,-11.0,7
2598,2598,2006-07,2006,2007,Blackburn,Bolton,Win,Away,2007-03-04,3,3,6,6,6,3,6,7,7,0,0,-1,-1,0,6.0,8.0,-2.0,8
2599,2599,2006-07,2006,2007,Blackburn,West Ham,Loss,Home,2007-03-17,0,6,6,9,9,0,0,0,0,6,6,9,9,1,6.0,9.0,-3.0,8
2600,2600,2006-07,2006,2007,Blackburn,Man United,Loss,Away,2007-03-31,0,3,6,6,9,6,9,12,15,-3,-3,-6,-6,0,6.0,2.0,4.0,8
2601,2601,2006-07,2006,2007,Blackburn,Aston Villa,Loss,Home,2007-04-07,0,0,3,6,6,2,2,3,3,-2,1,3,3,1,6.0,16.0,-10.0,9
2602,2602,2006-07,2006,2007,Blackburn,Watford,Win,Home,2007-04-18,3,0,0,3,6,3,3,3,4,-3,-3,0,2,1,6.0,21.0,-15.0,9
2603,2603,2006-07,2006,2007,Blackburn,Fulham,Draw,Away,2007-04-21,1,3,3,3,6,0,0,1,2,3,3,2,4,0,6.0,12.0,-6.0,9
2604,2604,2006-07,2006,2007,Blackburn,Charlton,Win,Home,2007-04-28,3,4,4,4,4,1,2,3,6,3,2,1,-2,1,6.0,13.0,-7.0,9
2605,2605,2006-07,2006,2007,Blackburn,Newcastle,Win,Away,2007-05-05,3,4,7,7,7,1,1,2,5,3,6,5,2,0,6.0,7.0,-1.0,10
2606,2606,2006-07,2006,2007,Blackburn,Tottenham,Draw,Away,2007-05-10,1,6,7,10,10,6,7,8,8,0,0,2,2,0,6.0,5.0,1.0,10
2607,2607,2006-07,2006,2007,Blackburn,Reading,Draw,Home,2007-05-13,1,4,7,8,11,3,6,9,10,1,1,-1,1,1,6.0,21.0,-15.0,10
2608,2608,2007-08,2007,2008,Blackburn,Middlesbrough,Win,Away,2007-08-11,3,2,5,8,9,6,6,7,7,-4,-1,1,2,0,10.0,12.0,-2.0,1
2609,2609,2007-08,2007,2008,Blackburn,Arsenal,Draw,Home,2007-08-19,1,4,5,8,11,4,5,8,9,0,0,0,2,1,10.0,4.0,6.0,1
2610,2610,2007-08,2007,2008,Blackburn,Everton,Draw,Away,2007-08-25,1,4,5,6,9,3,6,7,10,1,-1,-1,-1,0,10.0,6.0,4.0,1
2611,2611,2007-08,2007,2008,Blackburn,Man City,Win,Home,2007-09-02,3,2,5,6,7,3,6,9,9,-1,-1,-3,-2,1,10.0,14.0,-4.0,2
2612,2612,2007-08,2007,2008,Blackburn,Chelsea,Draw,Away,2007-09-15,1,4,5,8,9,3,4,7,10,1,1,1,-1,0,10.0,2.0,8.0,2
2613,2613,2007-08,2007,2008,Blackburn,Portsmouth,Loss,Home,2007-09-23,0,4,5,6,9,1,1,4,5,3,4,2,4,1,10.0,9.0,1.0,2
2614,2614,2007-08,2007,2008,Blackburn,Sunderland,Win,Away,2007-09-29,3,1,4,5,6,4,4,4,4,-3,0,1,2,0,10.0,21.0,-11.0,2
2615,2615,2007-08,2007,2008,Blackburn,Birmingham,Win,Home,2007-10-07,3,3,4,7,8,1,4,4,7,2,0,3,1,1,10.0,21.0,-11.0,3
2616,2616,2007-08,2007,2008,Blackburn,Reading,Win,Home,2007-10-20,3,6,6,7,10,3,6,6,6,3,0,1,4,1,10.0,8.0,2.0,3
2617,2617,2007-08,2007,2008,Blackburn,Tottenham,Win,Away,2007-10-28,3,6,9,9,10,1,2,3,3,5,7,6,7,0,10.0,5.0,5.0,3
2618,2618,2007-08,2007,2008,Blackburn,Liverpool,Draw,Home,2007-11-03,1,6,9,12,12,4,5,8,9,2,4,4,3,1,10.0,3.0,7.0,4
2619,2619,2007-08,2007,2008,Blackburn,Man United,Loss,Away,2007-11-11,0,4,7,10,13,4,7,10,13,0,0,0,0,0,10.0,1.0,9.0,4
2620,2620,2007-08,2007,2008,Blackburn,Fulham,Draw,Away,2007-11-25,1,1,4,7,10,3,4,5,5,-2,0,2,5,0,10.0,16.0,-6.0,4
2621,2621,2007-08,2007,2008,Blackburn,Aston Villa,Loss,Home,2007-11-28,0,1,2,5,8,6,9,10,10,-5,-7,-5,-2,1,10.0,11.0,-1.0,4
2622,2622,2007-08,2007,2008,Blackburn,Newcastle,Win,Home,2007-12-01,3,1,1,2,5,1,1,1,4,0,0,1,1,1,10.0,13.0,-3.0,5
2623,2623,2007-08,2007,2008,Blackburn,West Ham,Loss,Home,2007-12-09,0,3,4,4,5,1,4,5,6,2,0,-1,-1,1,10.0,15.0,-5.0,5
2624,2624,2007-08,2007,2008,Blackburn,Wigan,Loss,Away,2007-12-15,0,3,3,4,4,1,1,1,1,2,2,3,3,0,10.0,17.0,-7.0,5
2625,2625,2007-08,2007,2008,Blackburn,Chelsea,Loss,Home,2007-12-23,0,0,3,3,4,3,6,9,10,-3,-3,-6,-6,1,10.0,2.0,8.0,5
2626,2626,2007-08,2007,2008,Blackburn,Man City,Draw,Away,2007-12-27,1,0,0,3,3,4,4,5,8,-4,-4,-2,-5,0,10.0,14.0,-4.0,5
2627,2627,2007-08,2007,2008,Blackburn,Derby,Win,Away,2007-12-30,3,1,1,1,4,1,1,1,1,0,0,0,3,0,10.0,21.0,-11.0,5
2628,2628,2007-08,2007,2008,Blackburn,Sunderland,Win,Home,2008-01-02,3,4,4,4,4,3,3,4,4,1,1,0,0,1,10.0,21.0,-11.0,6
2629,2629,2007-08,2007,2008,Blackburn,Bolton,Win,Away,2008-01-13,3,6,7,7,7,3,3,6,6,3,4,1,1,0,10.0,7.0,3.0,6
2630,2630,2007-08,2007,2008,Blackburn,Middlesbrough,Draw,Home,2008-01-19,1,6,9,10,10,1,4,4,4,5,5,6,6,1,10.0,12.0,-2.0,6
2631,2631,2007-08,2007,2008,Blackburn,Aston Villa,Draw,Away,2008-01-26,1,4,7,10,11,4,7,10,11,0,0,0,0,0,10.0,11.0,-1.0,6
2632,2632,2007-08,2007,2008,Blackburn,Everton,Draw,Home,2008-02-02,1,2,5,8,11,4,7,10,10,-2,-2,-2,1,1,10.0,6.0,4.0,7
2633,2633,2007-08,2007,2008,Blackburn,Arsenal,Loss,Away,2008-02-11,0,2,3,6,9,6,9,10,13,-4,-6,-4,-4,0,10.0,4.0,6.0,7
2634,2634,2007-08,2007,2008,Blackburn,Bolton,Win,Home,2008-02-24,3,1,2,3,6,3,4,5,5,-2,-2,-2,1,1,10.0,7.0,3.0,7
2635,2635,2007-08,2007,2008,Blackburn,Newcastle,Win,Away,2008-03-01,3,3,4,5,6,0,1,1,2,3,3,4,4,0,10.0,13.0,-3.0,8
2636,2636,2007-08,2007,2008,Blackburn,Fulham,Draw,Home,2008-03-08,1,6,6,7,8,0,0,3,4,6,6,4,4,1,10.0,16.0,-6.0,8
2637,2637,2007-08,2007,2008,Blackburn,West Ham,Loss,Away,2008-03-15,0,4,7,7,8,0,0,3,4,4,7,4,4,0,10.0,15.0,-5.0,8
2638,2638,2007-08,2007,2008,Blackburn,Wigan,Win,Home,2008-03-22,3,1,4,7,7,4,5,8,8,-3,-1,-1,-1,1,10.0,17.0,-7.0,8
2639,2639,2007-08,2007,2008,Blackburn,Reading,Draw,Away,2008-03-29,1,3,4,7,10,3,6,9,9,0,-2,-2,1,0,10.0,8.0,2.0,8
2640,2640,2007-08,2007,2008,Blackburn,Tottenham,Draw,Home,2008-04-05,1,4,4,5,8,3,4,4,7,1,0,1,1,1,10.0,5.0,5.0,9
2641,2641,2007-08,2007,2008,Blackburn,Liverpool,Loss,Away,2008-04-13,0,2,5,5,6,4,4,7,10,-2,1,-2,-4,0,10.0,3.0,7.0,9
2642,2642,2007-08,2007,2008,Blackburn,Man United,Draw,Home,2008-04-19,1,1,2,5,5,4,7,10,13,-3,-5,-5,-8,1,10.0,1.0,9.0,9
2643,2643,2007-08,2007,2008,Blackburn,Portsmouth,Win,Away,2008-04-27,3,1,2,3,6,1,4,7,7,0,-2,-4,-1,0,10.0,9.0,1.0,9
2644,2644,2007-08,2007,2008,Blackburn,Derby,Win,Home,2008-05-03,3,4,4,5,6,0,0,0,1,4,4,5,5,1,10.0,21.0,-11.0,10
2645,2645,2007-08,2007,2008,Blackburn,Birmingham,Loss,Away,2008-05-11,0,6,7,7,8,1,1,2,2,5,6,5,6,0,10.0,21.0,-11.0,10
2646,2646,2008-09,2008,2009,Blackburn,Everton,Win,Away,2008-08-16,3,3,6,7,7,3,4,4,5,0,2,3,2,0,7.0,5.0,2.0,1
2647,2647,2008-09,2008,2009,Blackburn,Hull,Draw,Home,2008-08-23,1,3,6,9,10,3,3,3,3,0,3,6,7,1,7.0,21.0,-14.0,1
2648,2648,2008-09,2008,2009,Blackburn,West Ham,Loss,Away,2008-08-30,0,4,4,7,10,3,4,4,5,1,0,3,5,0,7.0,10.0,-3.0,1
2649,2649,2008-09,2008,2009,Blackburn,Arsenal,Loss,Home,2008-09-13,0,1,4,4,7,3,6,9,12,-2,-2,-5,-5,1,7.0,3.0,4.0,2
2650,2650,2008-09,2008,2009,Blackburn,Fulham,Win,Home,2008-09-20,3,0,1,4,4,6,6,9,12,-6,-5,-5,-8,1,7.0,17.0,-10.0,2
2651,2651,2008-09,2008,2009,Blackburn,Newcastle,Win,Away,2008-09-27,3,3,3,4,7,0,0,3,4,3,3,1,3,0,7.0,12.0,-5.0,2
2652,2652,2008-09,2008,2009,Blackburn,Man United,Loss,Home,2008-10-04,0,6,6,6,7,4,4,7,8,2,2,-1,-1,1,7.0,1.0,6.0,3
2653,2653,2008-09,2008,2009,Blackburn,Bolton,Draw,Away,2008-10-18,1,3,6,6,6,3,3,3,4,0,3,3,2,0,7.0,16.0,-9.0,3
2654,2654,2008-09,2008,2009,Blackburn,Middlesbrough,Draw,Home,2008-10-25,1,1,4,7,7,3,3,3,3,-2,1,4,4,1,7.0,13.0,-6.0,3
2655,2655,2008-09,2008,2009,Blackburn,Aston Villa,Loss,Away,2008-10-29,0,2,2,5,8,4,4,7,10,-2,-2,-2,-2,0,7.0,6.0,1.0,3
2656,2656,2008-09,2008,2009,Blackburn,West Brom,Draw,Away,2008-11-01,1,1,2,2,5,0,0,3,6,1,2,-1,-1,0,7.0,21.0,-14.0,4
2657,2657,2008-09,2008,2009,Blackburn,Chelsea,Loss,Home,2008-11-09,0,1,2,3,3,6,6,9,12,-5,-4,-6,-9,1,7.0,2.0,5.0,4
2658,2658,2008-09,2008,2009,Blackburn,Sunderland,Loss,Home,2008-11-15,0,1,1,2,3,0,0,3,4,1,1,-1,-1,1,7.0,15.0,-8.0,4
2659,2659,2008-09,2008,2009,Blackburn,Tottenham,Loss,Away,2008-11-23,0,0,1,1,2,3,6,7,10,-3,-5,-6,-8,0,7.0,11.0,-4.0,4
2660,2660,2008-09,2008,2009,Blackburn,Portsmouth,Loss,Away,2008-11-30,0,0,0,1,1,2,5,5,5,-2,-5,-4,-4,0,7.0,8.0,-1.0,4
2661,2661,2008-09,2008,2009,Blackburn,Liverpool,Loss,Home,2008-12-06,0,0,0,0,1,2,5,8,8,-2,-5,-8,-7,1,7.0,4.0,3.0,5
2662,2662,2008-09,2008,2009,Blackburn,Wigan,Loss,Away,2008-12-13,0,0,0,0,0,3,6,7,8,-3,-6,-7,-8,0,7.0,14.0,-7.0,5
2663,2663,2008-09,2008,2009,Blackburn,Stoke,Win,Home,2008-12-20,3,0,0,0,0,2,3,6,6,-2,-3,-6,-6,1,7.0,21.0,-14.0,5
2664,2664,2008-09,2008,2009,Blackburn,Sunderland,Draw,Away,2008-12-26,1,3,3,3,3,6,6,6,6,-3,-3,-3,-3,0,7.0,15.0,-8.0,5
2665,2665,2008-09,2008,2009,Blackburn,Man City,Draw,Home,2008-12-28,1,4,4,4,4,3,3,4,4,1,1,0,0,1,7.0,9.0,-2.0,5
2666,2666,2008-09,2008,2009,Blackburn,Newcastle,Win,Home,2009-01-17,3,2,5,5,5,1,1,4,7,1,4,1,-2,1,7.0,12.0,-5.0,6
2667,2667,2008-09,2008,2009,Blackburn,Bolton,Draw,Home,2009-01-28,1,4,5,8,8,0,0,0,3,4,5,8,5,1,7.0,16.0,-9.0,6
2668,2668,2008-09,2008,2009,Blackburn,Middlesbrough,Draw,Away,2009-01-31,1,4,5,6,9,0,1,1,1,4,4,5,8,0,7.0,13.0,-6.0,6
2669,2669,2008-09,2008,2009,Blackburn,Aston Villa,Loss,Home,2009-02-07,0,2,5,6,7,4,7,10,13,-2,-2,-4,-6,1,7.0,6.0,1.0,7
2670,2670,2008-09,2008,2009,Blackburn,Man United,Loss,Away,2009-02-21,0,1,2,5,6,6,9,12,15,-5,-7,-7,-9,0,7.0,1.0,6.0,7
2671,2671,2008-09,2008,2009,Blackburn,Hull,Win,Away,2009-03-01,3,0,1,2,5,1,2,2,2,-1,-1,0,3,0,7.0,21.0,-14.0,8
2672,2672,2008-09,2008,2009,Blackburn,Everton,Draw,Home,2009-03-04,1,3,3,4,5,4,7,7,8,-1,-4,-3,-3,1,7.0,5.0,2.0,8
2673,2673,2008-09,2008,2009,Blackburn,Fulham,Win,Away,2009-03-11,3,4,4,4,5,1,4,4,5,3,0,0,0,0,7.0,17.0,-10.0,8
2674,2674,2008-09,2008,2009,Blackburn,Arsenal,Loss,Away,2009-03-14,0,4,7,7,7,4,5,6,7,0,2,1,0,0,7.0,3.0,4.0,8
2675,2675,2008-09,2008,2009,Blackburn,West Ham,Draw,Home,2009-03-21,1,3,4,7,7,4,7,7,7,-1,-3,0,0,1,7.0,10.0,-3.0,8
2676,2676,2008-09,2008,2009,Blackburn,Tottenham,Win,Home,2009-04-04,3,1,4,5,8,6,7,10,13,-5,-3,-5,-5,1,7.0,11.0,-4.0,9
2677,2677,2008-09,2008,2009,Blackburn,Liverpool,Loss,Away,2009-04-11,0,4,4,7,8,6,9,12,12,-2,-5,-5,-4,0,7.0,4.0,3.0,9
2678,2678,2008-09,2008,2009,Blackburn,Stoke,Loss,Away,2009-04-18,0,3,4,4,7,4,7,7,10,-1,-3,-3,-3,0,7.0,21.0,-14.0,9
2679,2679,2008-09,2008,2009,Blackburn,Wigan,Win,Home,2009-04-26,3,0,3,4,4,0,3,6,6,0,0,-2,-2,1,7.0,14.0,-7.0,9
2680,2680,2008-09,2008,2009,Blackburn,Man City,Loss,Away,2009-05-02,0,3,3,6,7,6,6,6,9,-3,-3,0,-2,0,7.0,9.0,-2.0,10
2681,2681,2008-09,2008,2009,Blackburn,Portsmouth,Win,Home,2009-05-09,3,3,3,3,6,1,1,4,5,2,2,-1,1,1,7.0,8.0,-1.0,10
2682,2682,2008-09,2008,2009,Blackburn,Chelsea,Loss,Away,2009-05-17,0,3,6,6,6,6,9,10,13,-3,-3,-4,-7,0,7.0,2.0,5.0,10
2683,2683,2008-09,2008,2009,Blackburn,West Brom,Draw,Home,2009-05-24,1,3,3,6,6,3,3,6,6,0,0,0,0,1,7.0,21.0,-14.0,10
2684,2684,2009-10,2009,2010,Blackburn,Man City,Loss,Home,2009-08-15,0,1,4,4,7,3,3,6,9,-2,1,-2,-2,1,15.0,10.0,5.0,1
2685,2685,2009-10,2009,2010,Blackburn,Sunderland,Loss,Away,2009-08-22,0,1,1,4,4,3,3,3,4,-2,-2,1,0,0,15.0,16.0,-1.0,1
2686,2686,2009-10,2009,2010,Blackburn,West Ham,Draw,Home,2009-08-29,1,0,1,1,4,3,6,6,6,-3,-5,-5,-2,1,15.0,9.0,6.0,1
2687,2687,2009-10,2009,2010,Blackburn,Wolves,Win,Home,2009-09-12,3,1,1,2,2,1,4,4,4,0,-3,-2,-2,1,15.0,21.0,-6.0,2
2688,2688,2009-10,2009,2010,Blackburn,Everton,Loss,Away,2009-09-20,0,4,4,4,5,3,3,3,6,1,1,1,-1,0,15.0,5.0,10.0,2
2689,2689,2009-10,2009,2010,Blackburn,Aston Villa,Win,Home,2009-09-26,3,3,4,4,4,6,9,12,12,-3,-5,-8,-8,1,15.0,6.0,9.0,2
2690,2690,2009-10,2009,2010,Blackburn,Arsenal,Loss,Away,2009-10-04,0,3,6,7,7,6,6,6,9,-3,0,1,-2,0,15.0,4.0,11.0,3
2691,2691,2009-10,2009,2010,Blackburn,Burnley,Win,Home,2009-10-18,3,3,3,6,7,3,6,6,6,0,-3,0,1,1,15.0,21.0,-6.0,3
2692,2692,2009-10,2009,2010,Blackburn,Chelsea,Loss,Away,2009-10-24,0,3,6,6,9,3,3,6,9,0,3,0,0,0,15.0,3.0,12.0,3
2693,2693,2009-10,2009,2010,Blackburn,Man United,Loss,Away,2009-10-31,0,3,3,6,6,3,4,7,10,0,-1,-1,-4,0,15.0,1.0,14.0,3
2694,2694,2009-10,2009,2010,Blackburn,Portsmouth,Win,Home,2009-11-07,3,0,3,3,6,4,4,7,7,-4,-1,-4,-1,1,15.0,14.0,1.0,4
2695,2695,2009-10,2009,2010,Blackburn,Bolton,Win,Away,2009-11-22,3,3,3,6,6,0,3,3,4,3,0,3,2,0,15.0,13.0,2.0,4
2696,2696,2009-10,2009,2010,Blackburn,Fulham,Loss,Away,2009-11-25,0,6,6,6,9,1,4,5,8,5,2,1,1,0,15.0,7.0,8.0,4
2697,2697,2009-10,2009,2010,Blackburn,Stoke,Draw,Home,2009-11-28,1,3,6,6,6,3,4,7,10,0,2,-1,-4,1,15.0,12.0,3.0,4
2698,2698,2009-10,2009,2010,Blackburn,Liverpool,Draw,Home,2009-12-05,1,1,4,7,7,4,5,5,8,-3,-1,2,-1,1,15.0,2.0,13.0,5
2699,2699,2009-10,2009,2010,Blackburn,Hull,Draw,Away,2009-12-12,1,2,2,5,8,1,4,5,8,1,-2,0,0,0,15.0,17.0,-2.0,5
2700,2700,2009-10,2009,2010,Blackburn,Birmingham,Loss,Away,2009-12-15,0,2,3,3,6,6,9,12,13,-4,-6,-9,-7,0,15.0,21.0,-6.0,5
2701,2701,2009-10,2009,2010,Blackburn,Tottenham,Loss,Home,2009-12-19,0,1,2,3,3,3,4,5,8,-2,-2,-2,-5,1,15.0,8.0,7.0,5
2702,2702,2009-10,2009,2010,Blackburn,Wigan,Draw,Away,2009-12-26,1,0,1,2,3,1,1,4,4,-1,0,-2,-1,0,15.0,11.0,4.0,5
2703,2703,2009-10,2009,2010,Blackburn,Sunderland,Draw,Home,2009-12-28,1,1,1,2,3,1,1,2,2,0,0,0,1,1,15.0,16.0,-1.0,5
2704,2704,2009-10,2009,2010,Blackburn,Man City,Loss,Away,2010-01-11,0,2,2,2,3,6,9,9,10,-4,-7,-7,-7,0,15.0,10.0,5.0,6
2705,2705,2009-10,2009,2010,Blackburn,Fulham,Win,Home,2010-01-17,3,1,2,2,2,0,1,4,5,1,1,-2,-3,1,15.0,7.0,8.0,6
2706,2706,2009-10,2009,2010,Blackburn,Wigan,Win,Home,2010-01-27,3,3,4,5,5,3,4,4,5,0,0,1,0,1,15.0,11.0,4.0,6
2707,2707,2009-10,2009,2010,Blackburn,West Ham,Draw,Away,2010-01-30,1,6,6,7,8,2,2,5,6,4,4,2,2,0,15.0,9.0,6.0,6
2708,2708,2009-10,2009,2010,Blackburn,Stoke,Loss,Away,2010-02-06,0,4,7,7,8,2,5,5,5,2,2,2,3,0,15.0,12.0,3.0,7
2709,2709,2009-10,2009,2010,Blackburn,Hull,Win,Home,2010-02-10,3,1,4,7,7,4,5,5,6,-3,-1,2,1,1,15.0,17.0,-2.0,7
2710,2710,2009-10,2009,2010,Blackburn,Bolton,Win,Home,2010-02-21,3,3,4,7,10,1,2,2,5,2,2,5,5,1,15.0,13.0,2.0,7
2711,2711,2009-10,2009,2010,Blackburn,Liverpool,Loss,Away,2010-02-28,0,6,6,7,10,1,4,7,8,5,2,0,2,0,15.0,2.0,13.0,7
2712,2712,2009-10,2009,2010,Blackburn,Tottenham,Loss,Away,2010-03-13,0,3,6,6,7,6,6,7,8,-3,0,-1,-1,0,15.0,8.0,7.0,8
2713,2713,2009-10,2009,2010,Blackburn,Chelsea,Draw,Home,2010-03-21,1,0,3,6,6,3,6,6,9,-3,-3,0,-3,1,15.0,3.0,12.0,8
2714,2714,2009-10,2009,2010,Blackburn,Birmingham,Win,Home,2010-03-24,3,1,1,4,7,1,4,7,7,0,-3,-3,0,1,15.0,21.0,-6.0,8
2715,2715,2009-10,2009,2010,Blackburn,Burnley,Win,Away,2010-03-28,3,4,4,4,7,0,1,1,1,4,3,3,6,0,15.0,21.0,-6.0,8
2716,2716,2009-10,2009,2010,Blackburn,Portsmouth,Draw,Away,2010-04-03,1,6,7,7,7,0,3,3,3,6,4,4,4,0,15.0,14.0,1.0,9
2717,2717,2009-10,2009,2010,Blackburn,Man United,Draw,Home,2010-04-11,1,4,7,8,8,3,6,9,12,1,1,-1,-4,1,15.0,1.0,14.0,9
2718,2718,2009-10,2009,2010,Blackburn,Everton,Loss,Home,2010-04-17,0,2,5,8,9,2,3,6,9,0,2,2,0,1,15.0,5.0,10.0,9
2719,2719,2009-10,2009,2010,Blackburn,Wolves,Draw,Away,2010-04-24,1,1,2,5,8,2,2,3,6,-1,0,2,2,0,15.0,21.0,-6.0,9
2720,2720,2009-10,2009,2010,Blackburn,Arsenal,Win,Home,2010-05-03,3,1,2,3,6,1,1,4,5,0,1,-1,1,1,15.0,4.0,11.0,10
2721,2721,2009-10,2009,2010,Blackburn,Aston Villa,Win,Away,2010-05-09,3,4,4,5,6,3,6,9,10,1,-2,-4,-4,0,15.0,6.0,9.0,10
2722,2722,2010-11,2010,2011,Blackburn,Everton,Win,Home,2010-08-14,3,6,7,7,8,4,7,10,11,2,0,-3,-3,1,10.0,8.0,2.0,1
2723,2723,2010-11,2010,2011,Blackburn,Birmingham,Loss,Away,2010-08-21,0,6,9,10,10,1,4,4,5,5,5,6,5,0,10.0,9.0,1.0,1
2724,2724,2010-11,2010,2011,Blackburn,Arsenal,Loss,Home,2010-08-28,0,3,6,9,10,4,7,7,8,-1,-1,2,2,1,10.0,3.0,7.0,1
2725,2725,2010-11,2010,2011,Blackburn,Man City,Draw,Away,2010-09-11,1,0,3,6,9,3,4,5,5,-3,-1,1,4,0,10.0,5.0,5.0,2
2726,2726,2010-11,2010,2011,Blackburn,Fulham,Draw,Home,2010-09-18,1,1,1,4,7,4,5,6,6,-3,-4,-2,1,1,10.0,12.0,-2.0,2
2727,2727,2010-11,2010,2011,Blackburn,Blackpool,Win,Away,2010-09-25,3,2,2,2,5,3,4,4,7,-1,-2,-2,-2,0,10.0,21.0,-11.0,2
2728,2728,2010-11,2010,2011,Blackburn,Stoke,Loss,Away,2010-10-02,0,4,5,5,5,4,7,7,7,0,-2,-2,-2,0,10.0,11.0,-1.0,3
2729,2729,2010-11,2010,2011,Blackburn,Sunderland,Draw,Home,2010-10-18,1,3,4,5,5,2,3,4,7,1,1,1,-2,1,10.0,13.0,-3.0,3
2730,2730,2010-11,2010,2011,Blackburn,Liverpool,Loss,Away,2010-10-24,0,1,4,5,6,0,1,1,2,1,3,4,4,0,10.0,7.0,3.0,3
2731,2731,2010-11,2010,2011,Blackburn,Chelsea,Loss,Home,2010-10-30,0,1,1,4,5,4,7,7,10,-3,-6,-3,-5,1,10.0,1.0,9.0,3
2732,2732,2010-11,2010,2011,Blackburn,Wigan,Win,Home,2010-11-06,3,0,1,1,4,1,2,5,6,-1,-1,-4,-2,1,10.0,16.0,-6.0,4
2733,2733,2010-11,2010,2011,Blackburn,Newcastle,Win,Away,2010-11-10,3,3,3,4,4,6,9,10,10,-3,-6,-6,-6,0,10.0,21.0,-11.0,4
2734,2734,2010-11,2010,2011,Blackburn,Tottenham,Loss,Away,2010-11-13,0,6,6,6,7,1,1,2,5,5,5,4,2,0,10.0,4.0,6.0,4
2735,2735,2010-11,2010,2011,Blackburn,Aston Villa,Win,Home,2010-11-21,3,3,6,6,6,4,5,6,6,-1,1,0,0,1,10.0,6.0,4.0,4
2736,2736,2010-11,2010,2011,Blackburn,Man United,Loss,Away,2010-11-27,0,3,6,9,9,4,5,8,11,-1,1,1,-2,0,10.0,2.0,8.0,4
2737,2737,2010-11,2010,2011,Blackburn,Wolves,Win,Home,2010-12-04,3,3,3,6,9,3,3,3,3,0,0,3,6,1,10.0,15.0,-5.0,5
2738,2738,2010-11,2010,2011,Blackburn,Bolton,Loss,Away,2010-12-12,0,3,6,6,9,1,4,7,8,2,2,-1,1,0,10.0,14.0,-4.0,5
2739,2739,2010-11,2010,2011,Blackburn,West Ham,Draw,Home,2010-12-18,1,3,3,6,6,0,3,3,4,3,0,3,2,1,10.0,17.0,-7.0,5
2740,2740,2010-11,2010,2011,Blackburn,Stoke,Loss,Home,2010-12-26,0,1,4,4,7,1,2,5,8,0,2,-1,-1,1,10.0,11.0,-1.0,5
2741,2741,2010-11,2010,2011,Blackburn,West Brom,Win,Away,2010-12-28,3,1,1,4,4,0,3,6,6,1,-2,-2,-2,0,10.0,21.0,-11.0,5
2742,2742,2010-11,2010,2011,Blackburn,Sunderland,Loss,Away,2011-01-01,0,3,4,4,7,0,3,4,7,3,1,0,0,0,10.0,13.0,-3.0,6
2743,2743,2010-11,2010,2011,Blackburn,Liverpool,Win,Home,2011-01-05,3,3,3,4,4,3,3,6,6,0,0,-2,-2,1,10.0,7.0,3.0,6
2744,2744,2010-11,2010,2011,Blackburn,Chelsea,Loss,Away,2011-01-15,0,3,6,6,7,1,4,4,5,2,2,2,2,0,10.0,1.0,9.0,6
2745,2745,2010-11,2010,2011,Blackburn,West Brom,Win,Home,2011-01-23,3,3,3,6,6,3,3,3,3,0,0,3,3,1,10.0,21.0,-11.0,6
2746,2746,2010-11,2010,2011,Blackburn,Tottenham,Loss,Home,2011-02-02,0,3,6,6,9,2,2,5,8,1,4,1,1,1,10.0,4.0,6.0,7
2747,2747,2010-11,2010,2011,Blackburn,Wigan,Loss,Away,2011-02-05,0,3,3,6,6,1,1,2,3,2,2,4,3,0,10.0,16.0,-6.0,7
2748,2748,2010-11,2010,2011,Blackburn,Newcastle,Draw,Home,2011-02-12,1,0,3,3,6,1,2,3,6,-1,1,0,0,1,10.0,21.0,-11.0,7
2749,2749,2010-11,2010,2011,Blackburn,Aston Villa,Loss,Away,2011-02-26,0,1,1,4,4,2,2,5,8,-1,-1,-1,-4,0,10.0,6.0,4.0,7
2750,2750,2010-11,2010,2011,Blackburn,Fulham,Loss,Away,2011-03-05,0,1,1,1,4,2,3,6,6,-1,-2,-5,-2,0,10.0,12.0,-2.0,8
2751,2751,2010-11,2010,2011,Blackburn,Blackpool,Draw,Home,2011-03-19,1,0,1,1,1,0,3,4,4,0,-2,-3,-3,1,10.0,21.0,-11.0,8
2752,2752,2010-11,2010,2011,Blackburn,Arsenal,Draw,Away,2011-04-02,1,1,1,2,2,2,5,8,9,-1,-4,-6,-7,0,10.0,3.0,7.0,9
2753,2753,2010-11,2010,2011,Blackburn,Birmingham,Draw,Home,2011-04-09,1,2,2,2,3,3,4,4,4,-1,-2,-2,-1,1,10.0,9.0,1.0,9
2754,2754,2010-11,2010,2011,Blackburn,Everton,Loss,Away,2011-04-16,0,2,3,3,3,4,7,8,11,-2,-4,-5,-8,0,10.0,8.0,2.0,9
2755,2755,2010-11,2010,2011,Blackburn,Man City,Loss,Home,2011-04-25,0,1,2,3,3,3,3,6,7,-2,-1,-3,-4,1,10.0,5.0,5.0,9
2756,2756,2010-11,2010,2011,Blackburn,Bolton,Win,Home,2011-04-30,3,0,1,2,3,3,6,6,6,-3,-5,-4,-3,1,10.0,14.0,-4.0,9
2757,2757,2010-11,2010,2011,Blackburn,West Ham,Draw,Away,2011-05-07,1,3,3,4,5,0,0,0,0,3,3,4,5,0,10.0,17.0,-7.0,10
2758,2758,2010-11,2010,2011,Blackburn,Man United,Draw,Home,2011-05-14,1,4,4,4,5,3,6,7,10,1,-2,-3,-5,1,10.0,2.0,8.0,10
2759,2759,2010-11,2010,2011,Blackburn,Wolves,Win,Away,2011-05-22,3,2,5,5,5,6,7,7,8,-4,-2,-2,-3,0,10.0,15.0,-5.0,10
2760,2760,2011-12,2011,2012,Blackburn,Wolves,Loss,Home,2011-08-13,0,4,5,8,8,3,6,7,7,1,-1,1,1,1,15.0,17.0,-2.0,1
2761,2761,2011-12,2011,2012,Blackburn,Aston Villa,Loss,Away,2011-08-20,0,3,4,5,8,4,7,8,8,-1,-3,-3,0,0,15.0,9.0,6.0,1
2762,2762,2011-12,2011,2012,Blackburn,Everton,Loss,Home,2011-08-27,0,0,3,4,5,3,3,6,7,-3,0,-2,-2,1,15.0,7.0,8.0,1
2763,2763,2011-12,2011,2012,Blackburn,Fulham,Draw,Away,2011-09-11,1,0,0,3,4,0,1,2,5,0,-1,1,-1,0,15.0,8.0,7.0,2
2764,2764,2011-12,2011,2012,Blackburn,Arsenal,Win,Home,2011-09-17,3,1,1,1,4,3,3,4,5,-2,-2,-3,-1,1,15.0,4.0,11.0,2
2765,2765,2011-12,2011,2012,Blackburn,Newcastle,Loss,Away,2011-09-24,0,4,4,4,4,2,5,8,9,2,-1,-4,-5,0,15.0,12.0,3.0,2
2766,2766,2011-12,2011,2012,Blackburn,Man City,Loss,Home,2011-10-01,0,3,4,4,4,4,7,10,13,-1,-3,-6,-9,1,15.0,3.0,12.0,3
2767,2767,2011-12,2011,2012,Blackburn,QPR,Draw,Away,2011-10-15,1,0,3,4,4,1,4,5,5,-1,-1,-1,-1,0,15.0,21.0,-6.0,3
2768,2768,2011-12,2011,2012,Blackburn,Tottenham,Loss,Home,2011-10-23,0,1,1,4,5,4,7,10,13,-3,-6,-6,-8,1,15.0,5.0,10.0,3
2769,2769,2011-12,2011,2012,Blackburn,Norwich,Draw,Away,2011-10-29,1,1,1,1,4,4,4,7,10,-3,-3,-6,-6,0,15.0,21.0,-6.0,3
2770,2770,2011-12,2011,2012,Blackburn,Chelsea,Loss,Home,2011-11-05,0,1,2,2,2,0,3,6,9,1,-1,-4,-7,1,15.0,2.0,13.0,4
2771,2771,2011-12,2011,2012,Blackburn,Wigan,Draw,Away,2011-11-19,1,1,1,2,2,0,0,0,0,1,1,2,2,0,15.0,16.0,-1.0,4
2772,2772,2011-12,2011,2012,Blackburn,Stoke,Loss,Away,2011-11-26,0,1,2,2,3,0,0,0,3,1,2,2,0,0,15.0,13.0,2.0,4
2773,2773,2011-12,2011,2012,Blackburn,Swansea,Win,Home,2011-12-03,3,1,1,2,2,1,2,5,6,0,-1,-3,-4,1,15.0,21.0,-6.0,5
2774,2774,2011-12,2011,2012,Blackburn,Sunderland,Loss,Away,2011-12-11,0,3,4,4,5,0,1,1,2,3,3,3,3,0,15.0,10.0,5.0,5
2775,2775,2011-12,2011,2012,Blackburn,West Brom,Loss,Home,2011-12-17,0,3,3,4,4,1,1,4,4,2,2,0,0,1,15.0,11.0,4.0,5
2776,2776,2011-12,2011,2012,Blackburn,Bolton,Loss,Home,2011-12-20,0,0,3,3,4,0,0,0,0,0,3,3,4,1,15.0,14.0,1.0,5
2777,2777,2011-12,2011,2012,Blackburn,Liverpool,Draw,Away,2011-12-26,1,0,0,3,3,4,7,7,8,-4,-7,-4,-5,0,15.0,6.0,9.0,5
2778,2778,2011-12,2011,2012,Blackburn,Man United,Win,Away,2011-12-31,3,1,1,1,4,6,9,12,15,-5,-8,-11,-11,0,15.0,1.0,14.0,5
2779,2779,2011-12,2011,2012,Blackburn,Stoke,Loss,Home,2012-01-02,0,4,4,4,4,2,2,5,8,2,2,-1,-4,1,15.0,13.0,2.0,6
2780,2780,2011-12,2011,2012,Blackburn,Fulham,Win,Home,2012-01-14,3,3,4,4,4,4,5,5,8,-1,-1,-1,-4,1,15.0,8.0,7.0,6
2781,2781,2011-12,2011,2012,Blackburn,Everton,Draw,Away,2012-01-21,1,3,6,7,7,1,1,4,5,2,5,3,2,0,15.0,7.0,8.0,6
2782,2782,2011-12,2011,2012,Blackburn,Newcastle,Loss,Home,2012-02-01,0,4,4,7,8,3,6,6,9,1,-2,1,-1,1,15.0,12.0,3.0,7
2783,2783,2011-12,2011,2012,Blackburn,Arsenal,Loss,Away,2012-02-04,0,1,4,4,7,1,1,1,4,0,3,3,3,0,15.0,4.0,11.0,7
2784,2784,2011-12,2011,2012,Blackburn,QPR,Win,Home,2012-02-11,3,0,1,4,4,1,4,4,4,-1,-3,0,0,1,15.0,21.0,-6.0,7
2785,2785,2011-12,2011,2012,Blackburn,Man City,Loss,Away,2012-02-25,0,3,3,4,7,6,6,9,12,-3,-3,-5,-5,0,15.0,3.0,12.0,7
2786,2786,2011-12,2011,2012,Blackburn,Aston Villa,Draw,Home,2012-03-03,1,3,3,3,4,1,1,2,5,2,2,1,-1,1,15.0,9.0,6.0,8
2787,2787,2011-12,2011,2012,Blackburn,Wolves,Win,Away,2012-03-10,3,1,4,4,4,1,1,4,4,0,3,0,0,0,15.0,17.0,-2.0,8
2788,2788,2011-12,2011,2012,Blackburn,Sunderland,Win,Home,2012-03-20,3,4,4,7,7,4,4,4,7,0,0,3,0,1,15.0,10.0,5.0,8
2789,2789,2011-12,2011,2012,Blackburn,Bolton,Loss,Away,2012-03-24,0,6,7,7,10,3,3,3,3,3,4,4,7,0,15.0,14.0,1.0,8
2790,2790,2011-12,2011,2012,Blackburn,Man United,Loss,Home,2012-04-02,0,3,6,7,7,6,9,12,15,-3,-3,-5,-8,1,15.0,1.0,14.0,9
2791,2791,2011-12,2011,2012,Blackburn,West Brom,Loss,Away,2012-04-07,0,0,3,6,7,0,1,1,4,0,2,5,3,0,15.0,11.0,4.0,9
2792,2792,2011-12,2011,2012,Blackburn,Liverpool,Loss,Home,2012-04-10,0,0,0,3,6,1,1,1,4,-1,-1,2,2,1,15.0,6.0,9.0,9
2793,2793,2011-12,2011,2012,Blackburn,Swansea,Loss,Away,2012-04-14,0,0,0,0,3,0,0,0,3,0,0,0,0,0,15.0,21.0,-6.0,9
2794,2794,2011-12,2011,2012,Blackburn,Norwich,Win,Home,2012-04-21,3,0,0,0,0,3,4,4,7,-3,-4,-4,-7,1,15.0,21.0,-6.0,9
2795,2795,2011-12,2011,2012,Blackburn,Tottenham,Loss,Away,2012-04-29,0,3,3,3,3,0,1,4,5,3,2,-1,-2,0,15.0,5.0,10.0,9
2796,2796,2011-12,2011,2012,Blackburn,Wigan,Loss,Home,2012-05-07,0,3,3,3,3,3,6,9,9,0,-3,-6,-6,1,15.0,16.0,-1.0,10
2797,2797,2011-12,2011,2012,Blackburn,Chelsea,Loss,Away,2012-05-13,0,0,3,3,3,0,3,4,5,0,0,-1,-2,0,15.0,2.0,13.0,10
2798,2798,2010-11,2010,2011,Blackpool,Wigan,Win,Away,2010-08-14,3,0,0,0,0,1,1,4,5,-1,-1,-4,-5,0,21.0,16.0,5.0,1
2799,2799,2010-11,2010,2011,Blackpool,Arsenal,Loss,Away,2010-08-21,0,3,3,3,3,4,4,5,5,-1,-1,-2,-2,0,21.0,3.0,18.0,1
2800,2800,2010-11,2010,2011,Blackpool,Fulham,Draw,Home,2010-08-28,1,3,3,3,3,2,2,2,5,1,1,1,-2,1,21.0,12.0,9.0,1
2801,2801,2010-11,2010,2011,Blackpool,Newcastle,Win,Away,2010-09-11,3,1,4,4,4,4,4,4,4,-3,0,0,0,0,21.0,21.0,0.0,2
2802,2802,2010-11,2010,2011,Blackpool,Chelsea,Loss,Away,2010-09-19,0,4,4,7,7,6,9,12,15,-2,-5,-5,-8,0,21.0,1.0,20.0,2
2803,2803,2010-11,2010,2011,Blackpool,Blackburn,Loss,Home,2010-09-25,0,3,4,4,7,2,2,2,5,1,2,2,2,1,21.0,10.0,11.0,2
2804,2804,2010-11,2010,2011,Blackpool,Liverpool,Win,Away,2010-10-03,3,0,3,4,4,1,2,5,5,-1,1,-1,-1,0,21.0,7.0,14.0,3
2805,2805,2010-11,2010,2011,Blackpool,Man City,Loss,Home,2010-10-17,0,3,3,6,7,6,9,10,10,-3,-6,-4,-3,1,21.0,5.0,16.0,3
2806,2806,2010-11,2010,2011,Blackpool,Birmingham,Loss,Away,2010-10-23,0,3,3,3,6,0,1,1,2,3,2,2,4,0,21.0,9.0,12.0,3
2807,2807,2010-11,2010,2011,Blackpool,West Brom,Win,Home,2010-11-01,3,0,3,3,3,4,5,8,11,-4,-2,-5,-8,1,21.0,21.0,0.0,4
2808,2808,2010-11,2010,2011,Blackpool,Everton,Draw,Home,2010-11-06,1,3,3,6,6,4,7,10,11,-1,-4,-4,-5,1,21.0,8.0,13.0,4
2809,2809,2010-11,2010,2011,Blackpool,Aston Villa,Loss,Away,2010-11-10,0,4,4,4,7,2,2,3,3,2,2,1,4,0,21.0,6.0,15.0,4
2810,2810,2010-11,2010,2011,Blackpool,West Ham,Draw,Away,2010-11-13,1,1,4,4,4,2,2,2,3,-1,2,2,1,0,21.0,17.0,4.0,4
2811,2811,2010-11,2010,2011,Blackpool,Wolves,Win,Home,2010-11-20,3,1,2,5,5,0,0,3,3,1,2,2,2,1,21.0,15.0,6.0,4
2812,2812,2010-11,2010,2011,Blackpool,Bolton,Draw,Away,2010-11-27,1,4,4,5,8,6,7,10,10,-2,-3,-5,-2,0,21.0,14.0,7.0,4
2813,2813,2010-11,2010,2011,Blackpool,Stoke,Win,Away,2010-12-11,3,4,5,5,6,2,5,8,11,2,0,-3,-5,0,21.0,11.0,10.0,5
2814,2814,2010-11,2010,2011,Blackpool,Sunderland,Win,Away,2010-12-28,3,4,7,8,8,3,4,7,7,1,3,1,1,0,21.0,13.0,8.0,5
2815,2815,2010-11,2010,2011,Blackpool,Man City,Loss,Away,2011-01-01,0,6,7,10,11,6,6,9,12,0,1,1,-1,0,21.0,5.0,16.0,6
2816,2816,2010-11,2010,2011,Blackpool,Birmingham,Loss,Home,2011-01-04,0,3,6,7,10,1,1,2,3,2,5,5,7,1,21.0,9.0,12.0,6
2817,2817,2010-11,2010,2011,Blackpool,Liverpool,Win,Home,2011-01-12,3,0,3,6,7,3,3,3,6,-3,0,3,1,1,21.0,7.0,14.0,6
2818,2818,2010-11,2010,2011,Blackpool,West Brom,Loss,Away,2011-01-15,0,3,3,6,9,0,0,0,0,3,3,6,9,0,21.0,21.0,0.0,6
2819,2819,2010-11,2010,2011,Blackpool,Sunderland,Loss,Home,2011-01-22,0,3,3,3,6,4,7,7,7,-1,-4,-4,-1,1,21.0,13.0,8.0,6
2820,2820,2010-11,2010,2011,Blackpool,Man United,Loss,Home,2011-01-25,0,0,3,3,3,4,7,10,11,-4,-4,-7,-8,1,21.0,2.0,19.0,6
2821,2821,2010-11,2010,2011,Blackpool,West Ham,Loss,Home,2011-02-02,0,0,0,3,3,1,1,4,5,-1,-1,-1,-2,1,21.0,17.0,4.0,7
2822,2822,2010-11,2010,2011,Blackpool,Everton,Loss,Away,2011-02-05,0,0,0,0,3,1,2,5,5,-1,-2,-5,-2,0,21.0,8.0,13.0,7
2823,2823,2010-11,2010,2011,Blackpool,Aston Villa,Draw,Home,2011-02-12,1,0,0,0,0,1,4,7,8,-1,-4,-7,-8,1,21.0,6.0,15.0,7
2824,2824,2010-11,2010,2011,Blackpool,Tottenham,Win,Home,2011-02-22,3,1,1,1,1,6,9,10,11,-5,-8,-9,-10,1,21.0,4.0,17.0,7
2825,2825,2010-11,2010,2011,Blackpool,Wolves,Loss,Away,2011-02-26,0,4,4,4,4,1,4,4,4,3,0,0,0,0,21.0,15.0,6.0,7
2826,2826,2010-11,2010,2011,Blackpool,Chelsea,Loss,Home,2011-03-07,0,3,4,4,4,4,4,7,10,-1,0,-3,-6,1,21.0,1.0,20.0,8
2827,2827,2010-11,2010,2011,Blackpool,Blackburn,Draw,Away,2011-03-19,1,0,3,4,4,0,1,1,1,0,2,3,3,0,21.0,10.0,11.0,8
2828,2828,2010-11,2010,2011,Blackpool,Fulham,Loss,Away,2011-04-03,0,1,1,4,5,3,4,5,6,-2,-3,-1,-1,0,21.0,12.0,9.0,9
2829,2829,2010-11,2010,2011,Blackpool,Arsenal,Loss,Home,2011-04-10,0,1,1,1,4,2,3,6,9,-1,-2,-5,-5,1,21.0,3.0,18.0,9
2830,2830,2010-11,2010,2011,Blackpool,Wigan,Loss,Home,2011-04-16,0,0,1,1,1,1,4,4,4,-1,-3,-3,-3,1,21.0,16.0,5.0,9
2831,2831,2010-11,2010,2011,Blackpool,Newcastle,Draw,Home,2011-04-23,1,0,0,1,1,1,4,4,4,-1,-4,-3,-3,1,21.0,21.0,0.0,9
2832,2832,2010-11,2010,2011,Blackpool,Stoke,Draw,Home,2011-04-30,1,1,1,1,2,4,4,5,8,-3,-3,-4,-6,1,21.0,11.0,10.0,9
2833,2833,2010-11,2010,2011,Blackpool,Tottenham,Draw,Away,2011-05-07,1,2,2,2,2,1,2,5,6,1,0,-3,-4,0,21.0,4.0,17.0,10
2834,2834,2010-11,2010,2011,Blackpool,Bolton,Win,Home,2011-05-14,3,2,3,3,3,0,0,3,6,2,3,0,-3,1,21.0,14.0,7.0,10
2835,2835,2010-11,2010,2011,Blackpool,Man United,Loss,Away,2011-05-22,0,4,5,6,6,4,4,7,8,0,1,-1,-2,0,21.0,2.0,19.0,10
2836,2836,1995-96,1995,1996,Bolton,Wimbledon,Loss,Away,1995-08-19,0,0,0,0,0,2,3,4,4,-2,-3,-4,-4,0,21.0,9.0,12.0,1
2837,2837,1995-96,1995,1996,Bolton,Newcastle,Loss,Home,1995-08-22,0,0,0,0,0,6,6,7,8,-6,-6,-7,-8,1,21.0,6.0,15.0,1
2838,2838,1995-96,1995,1996,Bolton,Blackburn,Win,Home,1995-08-26,3,0,0,0,0,3,3,6,6,-3,-3,-6,-6,1,21.0,1.0,20.0,1
2839,2839,1995-96,1995,1996,Bolton,Aston Villa,Loss,Away,1995-08-30,0,3,3,3,3,3,6,7,10,0,-3,-4,-7,0,21.0,18.0,3.0,1
2840,2840,1995-96,1995,1996,Bolton,Middlesbrough,Draw,Home,1995-09-09,1,3,3,3,3,3,4,4,4,0,-1,-1,-1,1,21.0,21.0,0.0,2
2841,2841,1995-96,1995,1996,Bolton,Man United,Loss,Away,1995-09-16,0,1,4,4,4,6,9,12,12,-5,-5,-8,-8,0,21.0,2.0,19.0,2
2842,2842,1995-96,1995,1996,Bolton,Liverpool,Loss,Away,1995-09-23,0,1,1,4,4,3,6,9,9,-2,-5,-5,-5,0,21.0,4.0,17.0,2
2843,2843,1995-96,1995,1996,Bolton,QPR,Loss,Home,1995-09-30,0,0,1,1,4,3,3,3,6,-3,-2,-2,-2,1,21.0,8.0,13.0,2
2844,2844,1995-96,1995,1996,Bolton,Everton,Draw,Home,1995-10-14,1,0,0,1,1,0,0,0,3,0,0,1,-2,1,21.0,15.0,6.0,3
2845,2845,1995-96,1995,1996,Bolton,Nott'm Forest,Loss,Away,1995-10-21,0,1,1,1,2,6,7,10,11,-5,-6,-9,-9,0,21.0,3.0,18.0,3
2846,2846,1995-96,1995,1996,Bolton,Arsenal,Win,Home,1995-10-30,3,1,1,1,1,6,6,9,12,-5,-5,-8,-11,1,21.0,12.0,9.0,3
2847,2847,1995-96,1995,1996,Bolton,Man City,Loss,Away,1995-11-04,0,3,4,4,4,1,1,1,1,2,3,3,3,0,21.0,17.0,4.0,4
2848,2848,1995-96,1995,1996,Bolton,West Ham,Loss,Home,1995-11-18,0,3,3,4,4,3,4,7,8,0,-1,-3,-4,1,21.0,14.0,7.0,4
2849,2849,1995-96,1995,1996,Bolton,Chelsea,Loss,Away,1995-11-22,0,0,3,3,4,1,1,1,4,-1,2,2,0,0,21.0,11.0,10.0,4
2850,2850,1995-96,1995,1996,Bolton,Southampton,Loss,Away,1995-11-25,0,0,0,3,3,0,3,6,6,0,-3,-3,-3,0,21.0,10.0,11.0,4
2851,2851,1995-96,1995,1996,Bolton,Nott'm Forest,Draw,Home,1995-12-02,1,0,0,0,3,1,4,5,8,-1,-4,-5,-5,1,21.0,3.0,18.0,5
2852,2852,1995-96,1995,1996,Bolton,Liverpool,Loss,Home,1995-12-09,0,1,1,1,1,1,2,2,2,0,-1,-1,-1,1,21.0,4.0,17.0,5
2853,2853,1995-96,1995,1996,Bolton,QPR,Loss,Away,1995-12-16,0,1,1,1,1,1,1,1,2,0,0,0,-1,0,21.0,8.0,13.0,5
2854,2854,1995-96,1995,1996,Bolton,Tottenham,Draw,Away,1995-12-23,1,0,1,1,1,6,7,8,11,-6,-6,-7,-10,0,21.0,7.0,14.0,5
2855,2855,1995-96,1995,1996,Bolton,Leeds,Loss,Home,1995-12-27,0,1,1,2,2,3,4,4,4,-2,-3,-2,-2,1,21.0,5.0,16.0,5
2856,2856,1995-96,1995,1996,Bolton,Coventry,Loss,Home,1995-12-30,0,1,1,1,2,3,6,6,7,-2,-5,-5,-5,1,21.0,16.0,5.0,5
2857,2857,1995-96,1995,1996,Bolton,Sheffield Weds,Loss,Away,1996-01-01,0,0,1,1,1,1,4,5,8,-1,-3,-4,-7,0,21.0,13.0,8.0,6
2858,2858,1995-96,1995,1996,Bolton,Wimbledon,Win,Home,1996-01-13,3,0,0,1,1,3,6,7,7,-3,-6,-6,-6,1,21.0,9.0,12.0,6
2859,2859,1995-96,1995,1996,Bolton,Newcastle,Loss,Away,1996-01-20,0,3,3,3,4,6,6,9,12,-3,-3,-6,-8,0,21.0,6.0,15.0,6
2860,2860,1995-96,1995,1996,Bolton,Blackburn,Loss,Away,1996-02-03,0,3,3,3,3,6,7,10,13,-3,-4,-7,-10,0,21.0,1.0,20.0,7
2861,2861,1995-96,1995,1996,Bolton,Aston Villa,Loss,Home,1996-02-10,0,0,3,3,3,3,6,7,10,-3,-3,-4,-7,1,21.0,18.0,3.0,7
2862,2862,1995-96,1995,1996,Bolton,Middlesbrough,Win,Away,1996-02-17,3,0,0,3,3,0,0,0,0,0,0,3,3,0,21.0,21.0,0.0,7
2863,2863,1995-96,1995,1996,Bolton,Man United,Loss,Home,1996-02-25,0,3,3,3,6,6,9,12,13,-3,-6,-9,-7,1,21.0,2.0,19.0,7
2864,2864,1995-96,1995,1996,Bolton,Leeds,Win,Away,1996-03-02,3,3,3,3,3,0,0,3,4,3,3,0,-1,0,21.0,5.0,16.0,8
2865,2865,1995-96,1995,1996,Bolton,Coventry,Win,Away,1996-03-16,3,3,6,6,6,2,3,6,7,1,3,0,-1,0,21.0,16.0,5.0,8
2866,2866,1995-96,1995,1996,Bolton,Tottenham,Loss,Home,1996-03-20,0,6,6,9,9,3,6,6,7,3,0,3,2,1,21.0,7.0,14.0,8
2867,2867,1995-96,1995,1996,Bolton,Sheffield Weds,Win,Home,1996-03-23,3,3,6,6,9,6,6,6,6,-3,0,0,3,1,21.0,13.0,8.0,8
2868,2868,1995-96,1995,1996,Bolton,Man City,Draw,Home,1996-03-30,1,3,6,9,9,3,4,4,5,0,2,5,4,1,21.0,17.0,4.0,8
2869,2869,1995-96,1995,1996,Bolton,Everton,Loss,Away,1996-04-06,0,4,4,7,10,3,4,5,8,1,0,2,2,0,21.0,15.0,6.0,9
2870,2870,1995-96,1995,1996,Bolton,Chelsea,Win,Home,1996-04-08,3,1,4,4,7,1,1,2,3,0,3,2,4,1,21.0,11.0,10.0,9
2871,2871,1995-96,1995,1996,Bolton,West Ham,Loss,Away,1996-04-13,0,3,4,7,7,1,4,4,7,2,0,3,0,0,21.0,14.0,7.0,9
2872,2872,1995-96,1995,1996,Bolton,Southampton,Loss,Home,1996-04-27,0,3,3,4,7,3,3,6,6,0,0,-2,1,1,21.0,10.0,11.0,9
2873,2873,1995-96,1995,1996,Bolton,Arsenal,Loss,Away,1996-05-04,0,0,3,3,4,2,3,3,6,-2,0,0,-2,0,21.0,12.0,9.0,10
2874,2874,1997-98,1997,1998,Bolton,Southampton,Win,Away,1997-08-09,3,0,0,3,3,3,6,7,10,-3,-6,-4,-7,0,21.0,16.0,5.0,1
2875,2875,1997-98,1997,1998,Bolton,Coventry,Draw,Away,1997-08-23,1,3,3,3,6,3,6,6,7,0,-3,-3,-1,0,21.0,17.0,4.0,1
2876,2876,1997-98,1997,1998,Bolton,Barnsley,Loss,Away,1997-08-27,0,4,4,4,4,3,3,3,3,1,1,1,1,0,21.0,21.0,0.0,1
2877,2877,1997-98,1997,1998,Bolton,Everton,Draw,Home,1997-09-01,1,1,4,4,4,3,3,3,3,-2,1,1,1,1,21.0,15.0,6.0,2
2878,2878,1997-98,1997,1998,Bolton,Arsenal,Loss,Away,1997-09-13,0,1,2,5,5,2,5,8,9,-1,-3,-3,-4,0,21.0,3.0,18.0,2
2879,2879,1997-98,1997,1998,Bolton,Man United,Draw,Home,1997-09-20,1,1,1,2,5,6,9,10,13,-5,-8,-8,-8,1,21.0,1.0,20.0,2
2880,2880,1997-98,1997,1998,Bolton,Tottenham,Draw,Home,1997-09-23,1,1,2,2,3,1,2,5,8,0,0,-3,-5,1,21.0,10.0,11.0,2
2881,2881,1997-98,1997,1998,Bolton,Crystal Palace,Draw,Away,1997-09-27,1,2,2,3,3,4,4,4,4,-2,-2,-1,-1,0,21.0,21.0,0.0,2
2882,2882,1997-98,1997,1998,Bolton,Aston Villa,Loss,Home,1997-10-04,0,2,3,3,4,1,4,7,10,1,-1,-4,-6,1,21.0,5.0,16.0,3
2883,2883,1997-98,1997,1998,Bolton,West Ham,Loss,Away,1997-10-18,0,1,2,3,3,3,3,3,3,-2,-1,0,0,0,21.0,14.0,7.0,3
2884,2884,1997-98,1997,1998,Bolton,Chelsea,Win,Home,1997-10-26,3,0,1,2,3,3,6,7,7,-3,-5,-5,-4,1,21.0,6.0,15.0,3
2885,2885,1997-98,1997,1998,Bolton,Liverpool,Draw,Home,1997-11-01,1,3,3,4,5,3,6,6,9,0,-3,-2,-4,1,21.0,4.0,17.0,4
2886,2886,1997-98,1997,1998,Bolton,Sheffield Weds,Loss,Away,1997-11-08,0,4,4,4,5,0,0,3,4,4,4,1,1,0,21.0,7.0,14.0,4
2887,2887,1997-98,1997,1998,Bolton,Leicester,Draw,Away,1997-11-22,1,1,4,4,4,1,4,4,4,0,0,0,0,0,21.0,9.0,12.0,4
2888,2888,1997-98,1997,1998,Bolton,Wimbledon,Win,Home,1997-11-29,3,1,2,5,5,3,3,6,7,-2,-1,-1,-2,1,21.0,8.0,13.0,4
2889,2889,1997-98,1997,1998,Bolton,Newcastle,Win,Home,1997-12-01,3,4,4,5,8,6,7,8,9,-2,-3,-3,-1,1,21.0,2.0,19.0,5
2890,2890,1997-98,1997,1998,Bolton,Blackburn,Loss,Away,1997-12-06,0,6,7,7,8,3,6,7,8,3,1,0,0,0,21.0,13.0,8.0,5
2891,2891,1997-98,1997,1998,Bolton,Derby,Draw,Home,1997-12-14,1,3,6,7,7,3,6,6,9,0,0,1,-2,1,21.0,12.0,9.0,5
2892,2892,1997-98,1997,1998,Bolton,Leeds,Loss,Away,1997-12-20,0,1,4,7,8,2,5,8,11,-1,-1,-1,-3,0,21.0,11.0,10.0,5
2893,2893,1997-98,1997,1998,Bolton,Barnsley,Draw,Home,1997-12-26,1,1,1,4,7,1,1,1,4,0,0,3,3,1,21.0,21.0,0.0,5
2894,2894,1997-98,1997,1998,Bolton,Everton,Loss,Away,1997-12-28,0,1,2,2,5,3,4,5,5,-2,-2,-3,0,0,21.0,15.0,6.0,5
2895,2895,1997-98,1997,1998,Bolton,Southampton,Draw,Home,1998-01-10,1,1,1,2,2,4,5,8,8,-3,-4,-6,-6,1,21.0,16.0,5.0,6
2896,2896,1997-98,1997,1998,Bolton,Newcastle,Loss,Away,1998-01-17,0,1,2,2,3,0,0,0,1,1,2,2,2,0,21.0,2.0,19.0,6
2897,2897,1997-98,1997,1998,Bolton,Coventry,Loss,Home,1998-01-31,0,1,1,2,2,1,4,4,4,0,-3,-2,-2,1,21.0,17.0,4.0,6
2898,2898,1997-98,1997,1998,Bolton,Man United,Draw,Away,1998-02-07,1,0,1,1,2,0,3,3,6,0,-2,-2,-4,0,21.0,1.0,20.0,7
2899,2899,1997-98,1997,1998,Bolton,West Ham,Draw,Home,1998-02-21,1,1,1,2,2,4,4,7,10,-3,-3,-5,-8,1,21.0,14.0,7.0,7
2900,2900,1997-98,1997,1998,Bolton,Tottenham,Loss,Away,1998-03-01,0,2,2,2,3,1,4,4,7,1,-2,-2,-4,0,21.0,10.0,11.0,8
2901,2901,1997-98,1997,1998,Bolton,Liverpool,Loss,Away,1998-03-07,0,1,2,2,2,1,2,2,3,0,0,0,-1,0,21.0,4.0,17.0,8
2902,2902,1997-98,1997,1998,Bolton,Sheffield Weds,Win,Home,1998-03-14,3,0,1,2,2,3,6,7,7,-3,-5,-5,-5,1,21.0,7.0,14.0,8
2903,2903,1997-98,1997,1998,Bolton,Leicester,Win,Home,1998-03-28,3,3,3,4,5,0,3,4,7,3,0,0,-2,1,21.0,9.0,12.0,8
2904,2904,1997-98,1997,1998,Bolton,Arsenal,Loss,Home,1998-03-31,0,6,6,6,7,6,9,10,13,0,-3,-4,-6,1,21.0,3.0,18.0,8
2905,2905,1997-98,1997,1998,Bolton,Wimbledon,Draw,Away,1998-04-04,1,3,6,6,6,1,4,4,4,2,2,2,2,0,21.0,8.0,13.0,9
2906,2906,1997-98,1997,1998,Bolton,Blackburn,Win,Home,1998-04-11,3,1,4,7,7,3,3,3,6,-2,1,4,1,1,21.0,13.0,8.0,9
2907,2907,1997-98,1997,1998,Bolton,Derby,Loss,Away,1998-04-13,0,4,4,7,10,1,1,1,4,3,3,6,6,0,21.0,12.0,9.0,9
2908,2908,1997-98,1997,1998,Bolton,Leeds,Loss,Home,1998-04-18,0,3,4,4,7,3,6,6,9,0,-2,-2,-2,1,21.0,11.0,10.0,9
2909,2909,1997-98,1997,1998,Bolton,Aston Villa,Win,Away,1998-04-25,3,0,3,4,4,6,9,12,15,-6,-6,-8,-11,0,21.0,5.0,16.0,9
2910,2910,1997-98,1997,1998,Bolton,Crystal Palace,Win,Home,1998-05-02,3,3,3,6,7,3,3,3,3,0,0,3,4,1,21.0,21.0,0.0,10
2911,2911,1997-98,1997,1998,Bolton,Chelsea,Loss,Away,1998-05-10,0,6,6,6,9,0,3,6,9,6,3,0,0,0,21.0,6.0,15.0,10
2912,2912,2001-02,2001,2002,Bolton,Leicester,Win,Away,2001-08-18,3,3,6,6,6,3,3,3,3,0,3,3,3,0,21.0,13.0,8.0,1
2913,2913,2001-02,2001,2002,Bolton,Middlesbrough,Win,Home,2001-08-21,3,3,6,9,9,3,4,4,7,0,2,5,2,1,21.0,14.0,7.0,1
2914,2914,2001-02,2001,2002,Bolton,Liverpool,Win,Home,2001-08-27,3,6,6,9,12,6,7,10,13,0,-1,-1,-1,1,21.0,3.0,18.0,1
2915,2915,2001-02,2001,2002,Bolton,Leeds,Draw,Away,2001-09-08,1,6,9,9,12,4,7,10,13,2,2,-1,-1,0,21.0,4.0,17.0,2
2916,2916,2001-02,2001,2002,Bolton,Southampton,Loss,Home,2001-09-15,0,4,7,10,10,0,0,3,6,4,7,7,4,1,21.0,10.0,11.0,2
2917,2917,2001-02,2001,2002,Bolton,Blackburn,Draw,Away,2001-09-19,1,1,4,7,10,1,4,5,5,0,0,2,5,0,21.0,21.0,0.0,2
2918,2918,2001-02,2001,2002,Bolton,Arsenal,Draw,Away,2001-09-22,1,1,2,5,8,4,7,7,10,-3,-5,-2,-2,0,21.0,2.0,19.0,2
2919,2919,2001-02,2001,2002,Bolton,Sunderland,Loss,Home,2001-09-29,0,2,2,3,6,1,2,5,6,1,0,-2,0,1,21.0,7.0,14.0,2
2920,2920,2001-02,2001,2002,Bolton,Newcastle,Loss,Home,2001-10-13,0,1,2,2,3,3,3,6,9,-2,-1,-4,-6,1,21.0,11.0,10.0,3
2921,2921,2001-02,2001,2002,Bolton,Man United,Win,Away,2001-10-20,3,0,1,2,2,6,9,9,12,-6,-8,-7,-10,0,21.0,1.0,20.0,3
2922,2922,2001-02,2001,2002,Bolton,Aston Villa,Loss,Away,2001-10-27,0,3,3,4,5,3,6,9,12,0,-3,-5,-7,0,21.0,8.0,13.0,3
2923,2923,2001-02,2001,2002,Bolton,Everton,Draw,Home,2001-11-03,1,3,3,3,4,3,4,7,7,0,-1,-4,-3,1,21.0,16.0,5.0,4
2924,2924,2001-02,2001,2002,Bolton,Ipswich,Win,Away,2001-11-18,3,1,4,4,4,0,1,2,3,1,3,2,1,0,21.0,5.0,16.0,4
2925,2925,2001-02,2001,2002,Bolton,Fulham,Draw,Home,2001-11-24,1,4,4,7,7,6,9,10,10,-2,-5,-3,-3,1,21.0,21.0,0.0,4
2926,2926,2001-02,2001,2002,Bolton,Tottenham,Loss,Away,2001-12-03,0,4,5,5,8,4,4,7,10,0,1,-2,-2,0,21.0,12.0,9.0,5
2927,2927,2001-02,2001,2002,Bolton,Derby,Loss,Away,2001-12-08,0,1,4,5,5,0,3,3,4,1,1,2,1,0,21.0,17.0,4.0,5
2928,2928,2001-02,2001,2002,Bolton,Charlton,Draw,Home,2001-12-15,1,0,1,4,5,6,7,7,8,-6,-6,-3,-3,1,21.0,9.0,12.0,5
2929,2929,2001-02,2001,2002,Bolton,Chelsea,Loss,Away,2001-12-23,0,1,1,2,5,4,4,7,8,-3,-3,-5,-3,0,21.0,6.0,15.0,5
2930,2930,2001-02,2001,2002,Bolton,Leeds,Loss,Home,2001-12-26,0,1,1,1,2,3,4,7,8,-2,-3,-6,-6,1,21.0,4.0,17.0,5
2931,2931,2001-02,2001,2002,Bolton,Leicester,Draw,Home,2001-12-29,1,0,1,1,1,1,2,2,5,-1,-1,-1,-4,1,21.0,13.0,8.0,5
2932,2932,2001-02,2001,2002,Bolton,Liverpool,Draw,Away,2002-01-01,1,1,1,2,2,4,4,4,5,-3,-3,-2,-3,0,21.0,3.0,18.0,6
2933,2933,2001-02,2001,2002,Bolton,Chelsea,Draw,Home,2002-01-12,1,2,2,2,3,3,3,6,9,-1,-1,-4,-6,1,21.0,6.0,15.0,6
2934,2934,2001-02,2001,2002,Bolton,Middlesbrough,Draw,Away,2002-01-19,1,2,3,3,3,3,3,3,3,-1,0,0,0,0,21.0,14.0,7.0,6
2935,2935,2001-02,2001,2002,Bolton,Man United,Loss,Home,2002-01-29,0,2,3,4,4,3,6,9,12,-1,-3,-5,-8,1,21.0,1.0,20.0,6
2936,2936,2001-02,2001,2002,Bolton,Newcastle,Loss,Away,2002-02-02,0,1,2,3,4,4,7,7,7,-3,-5,-4,-3,0,21.0,11.0,10.0,7
2937,2937,2001-02,2001,2002,Bolton,West Ham,Win,Home,2002-02-09,3,0,1,2,3,3,3,6,6,-3,-2,-4,-3,1,21.0,15.0,6.0,7
2938,2938,2001-02,2001,2002,Bolton,Southampton,Draw,Away,2002-02-23,1,3,3,4,5,1,4,5,5,2,-1,-1,0,0,21.0,10.0,11.0,7
2939,2939,2001-02,2001,2002,Bolton,Blackburn,Draw,Home,2002-03-02,1,4,4,4,5,0,0,0,3,4,4,4,2,1,21.0,21.0,0.0,8
2940,2940,2001-02,2001,2002,Bolton,Sunderland,Loss,Away,2002-03-05,0,2,5,5,5,0,3,3,3,2,2,2,2,0,21.0,7.0,14.0,8
2941,2941,2001-02,2001,2002,Bolton,Derby,Loss,Home,2002-03-16,0,1,2,5,5,1,4,4,7,0,-2,1,-2,1,21.0,17.0,4.0,8
2942,2942,2001-02,2001,2002,Bolton,Charlton,Win,Away,2002-03-23,3,0,1,2,5,4,7,8,8,-4,-6,-6,-3,0,21.0,9.0,12.0,8
2943,2943,2001-02,2001,2002,Bolton,Aston Villa,Win,Home,2002-03-30,3,3,3,4,5,1,1,4,4,2,2,0,1,1,21.0,8.0,13.0,8
2944,2944,2001-02,2001,2002,Bolton,Everton,Loss,Away,2002-04-01,0,6,6,6,7,3,6,6,7,3,0,0,0,0,21.0,16.0,5.0,9
2945,2945,2001-02,2001,2002,Bolton,Ipswich,Win,Home,2002-04-06,3,3,6,6,6,1,2,3,3,2,4,3,3,1,21.0,5.0,16.0,9
2946,2946,2001-02,2001,2002,Bolton,Tottenham,Draw,Home,2002-04-20,1,3,6,9,9,1,4,5,8,2,2,4,1,1,21.0,12.0,9.0,9
2947,2947,2001-02,2001,2002,Bolton,Fulham,Loss,Away,2002-04-23,0,4,4,7,10,4,4,5,5,0,0,2,5,0,21.0,21.0,0.0,9
2948,2948,2001-02,2001,2002,Bolton,Arsenal,Loss,Home,2002-04-29,0,1,4,4,7,6,9,12,15,-5,-5,-8,-8,1,21.0,2.0,19.0,9
2949,2949,2001-02,2001,2002,Bolton,West Ham,Loss,Away,2002-05-11,0,0,1,4,4,0,3,4,7,0,-2,0,-3,0,21.0,15.0,6.0,10
2950,2950,2002-03,2002,2003,Bolton,Fulham,Loss,Away,2002-08-17,0,0,0,1,4,1,4,7,8,-1,-4,-6,-4,0,16.0,13.0,3.0,1
2951,2951,2002-03,2002,2003,Bolton,Charlton,Loss,Home,2002-08-24,0,0,0,0,1,1,2,2,3,-1,-2,-2,-2,1,16.0,14.0,2.0,1
2952,2952,2002-03,2002,2003,Bolton,Aston Villa,Win,Home,2002-09-01,3,0,0,0,0,3,3,6,9,-3,-3,-6,-9,1,16.0,8.0,8.0,2
2953,2953,2002-03,2002,2003,Bolton,Man United,Win,Away,2002-09-11,3,3,3,3,3,4,5,8,9,-1,-2,-5,-6,0,16.0,3.0,13.0,2
2954,2954,2002-03,2002,2003,Bolton,Liverpool,Loss,Home,2002-09-14,0,6,6,6,6,2,3,6,9,4,3,0,-3,1,16.0,2.0,14.0,2
2955,2955,2002-03,2002,2003,Bolton,Arsenal,Loss,Away,2002-09-21,0,3,6,6,6,6,7,10,11,-3,-1,-4,-5,0,16.0,1.0,15.0,2
2956,2956,2002-03,2002,2003,Bolton,Southampton,Draw,Home,2002-09-28,1,0,3,6,6,1,4,4,5,-1,-1,2,1,1,16.0,11.0,5.0,2
2957,2957,2002-03,2002,2003,Bolton,Middlesbrough,Loss,Away,2002-10-05,0,1,1,4,7,6,6,9,9,-5,-5,-5,-2,0,16.0,12.0,4.0,3
2958,2958,2002-03,2002,2003,Bolton,Tottenham,Loss,Away,2002-10-20,0,1,1,1,4,3,3,6,6,-2,-2,-5,-2,0,16.0,9.0,7.0,3
2959,2959,2002-03,2002,2003,Bolton,Sunderland,Draw,Home,2002-10-28,1,0,1,1,1,0,3,3,3,0,-2,-2,-2,1,16.0,17.0,-1.0,3
2960,2960,2002-03,2002,2003,Bolton,Birmingham,Loss,Away,2002-11-02,0,1,1,2,2,1,4,4,4,0,-3,-2,-2,0,16.0,21.0,-5.0,4
2961,2961,2002-03,2002,2003,Bolton,West Brom,Draw,Home,2002-11-09,1,1,1,1,2,0,1,1,1,1,0,0,1,1,16.0,21.0,-5.0,4
2962,2962,2002-03,2002,2003,Bolton,Leeds,Win,Away,2002-11-17,3,1,2,2,2,3,4,4,5,-2,-2,-2,-3,0,16.0,5.0,11.0,4
2963,2963,2002-03,2002,2003,Bolton,Chelsea,Draw,Home,2002-11-23,1,4,4,5,5,6,7,10,13,-2,-3,-5,-8,1,16.0,6.0,10.0,4
2964,2964,2002-03,2002,2003,Bolton,Man City,Loss,Away,2002-11-30,0,4,5,5,6,0,3,6,9,4,2,-1,-3,0,16.0,21.0,-5.0,4
2965,2965,2002-03,2002,2003,Bolton,Blackburn,Draw,Home,2002-12-07,1,1,4,5,5,3,3,4,5,-2,1,1,0,1,16.0,10.0,6.0,5
2966,2966,2002-03,2002,2003,Bolton,Leeds,Loss,Home,2002-12-16,0,1,2,5,6,0,0,0,3,1,2,5,3,1,16.0,5.0,11.0,5
2967,2967,2002-03,2002,2003,Bolton,West Ham,Draw,Away,2002-12-21,1,1,1,2,5,1,1,1,2,0,0,1,3,0,16.0,7.0,9.0,5
2968,2968,2002-03,2002,2003,Bolton,Newcastle,Win,Home,2002-12-26,3,1,2,2,3,4,7,10,10,-3,-5,-8,-7,1,16.0,4.0,12.0,5
2969,2969,2002-03,2002,2003,Bolton,Everton,Draw,Away,2002-12-28,1,4,4,5,5,2,5,5,5,2,-1,0,0,0,16.0,15.0,1.0,5
2970,2970,2002-03,2002,2003,Bolton,Aston Villa,Loss,Away,2003-01-01,0,4,5,5,6,3,3,6,6,1,2,-1,0,0,16.0,8.0,8.0,6
2971,2971,2002-03,2002,2003,Bolton,Fulham,Draw,Home,2003-01-11,1,1,4,5,5,1,1,1,4,0,3,4,1,1,16.0,13.0,3.0,6
2972,2972,2002-03,2002,2003,Bolton,Charlton,Draw,Away,2003-01-18,1,1,2,5,6,3,4,5,6,-2,-2,0,0,0,16.0,14.0,2.0,6
2973,2973,2002-03,2002,2003,Bolton,Newcastle,Loss,Away,2003-01-22,0,2,2,3,6,4,7,10,10,-2,-5,-7,-4,0,16.0,4.0,12.0,6
2974,2974,2002-03,2002,2003,Bolton,Everton,Loss,Home,2003-01-28,0,1,2,2,3,3,4,5,6,-2,-2,-3,-3,1,16.0,15.0,1.0,6
2975,2975,2002-03,2002,2003,Bolton,Birmingham,Win,Home,2003-02-01,3,0,1,2,2,1,1,1,2,-1,0,1,0,1,16.0,21.0,-5.0,7
2976,2976,2002-03,2002,2003,Bolton,West Brom,Draw,Away,2003-02-08,1,3,3,4,5,3,4,4,4,0,-1,0,1,0,16.0,21.0,-5.0,7
2977,2977,2002-03,2002,2003,Bolton,Man United,Draw,Home,2003-02-22,1,4,4,4,5,4,7,10,13,0,-3,-6,-8,1,16.0,3.0,13.0,7
2978,2978,2002-03,2002,2003,Bolton,Liverpool,Loss,Away,2003-03-08,0,2,5,5,5,1,4,5,8,1,1,0,-3,0,16.0,2.0,14.0,8
2979,2979,2002-03,2002,2003,Bolton,Sunderland,Win,Away,2003-03-15,3,1,2,5,5,0,0,0,0,1,2,5,5,0,16.0,17.0,-1.0,8
2980,2980,2002-03,2002,2003,Bolton,Tottenham,Win,Home,2003-03-24,3,3,4,5,8,0,1,4,5,3,3,1,3,1,16.0,9.0,7.0,8
2981,2981,2002-03,2002,2003,Bolton,Man City,Win,Home,2003-04-05,3,6,6,7,8,3,3,3,4,3,3,4,4,1,16.0,21.0,-5.0,9
2982,2982,2002-03,2002,2003,Bolton,Chelsea,Loss,Away,2003-04-12,0,6,9,9,10,6,9,9,9,0,0,0,1,0,16.0,6.0,10.0,9
2983,2983,2002-03,2002,2003,Bolton,West Ham,Win,Home,2003-04-19,3,3,6,9,9,2,5,6,9,1,1,3,0,1,16.0,7.0,9.0,9
2984,2984,2002-03,2002,2003,Bolton,Blackburn,Draw,Away,2003-04-21,1,3,6,9,12,3,6,6,9,0,0,3,3,0,16.0,10.0,6.0,9
2985,2985,2002-03,2002,2003,Bolton,Arsenal,Draw,Home,2003-04-26,1,4,4,7,10,4,5,8,8,0,-1,-1,2,1,16.0,1.0,15.0,9
2986,2986,2002-03,2002,2003,Bolton,Southampton,Draw,Away,2003-05-03,1,2,5,5,8,0,3,4,5,2,2,1,3,0,16.0,11.0,5.0,10
2987,2987,2002-03,2002,2003,Bolton,Middlesbrough,Win,Home,2003-05-11,3,2,3,6,6,3,3,3,4,-1,0,3,2,1,16.0,12.0,4.0,10
2988,2988,2003-04,2003,2004,Bolton,Man United,Loss,Away,2003-08-16,0,4,5,6,9,6,9,12,13,-2,-4,-6,-4,0,17.0,1.0,16.0,1
2989,2989,2003-04,2003,2004,Bolton,Blackburn,Draw,Home,2003-08-23,1,3,4,5,6,6,7,10,11,-3,-3,-5,-5,1,17.0,6.0,11.0,1
2990,2990,2003-04,2003,2004,Bolton,Portsmouth,Loss,Away,2003-08-26,0,1,4,5,6,4,4,4,4,-3,0,1,2,0,17.0,21.0,-4.0,1
2991,2991,2003-04,2003,2004,Bolton,Charlton,Draw,Home,2003-08-30,1,1,1,4,5,4,4,4,4,-3,-3,0,1,1,17.0,12.0,5.0,1
2992,2992,2003-04,2003,2004,Bolton,Middlesbrough,Win,Home,2003-09-13,3,1,2,2,5,1,1,1,1,0,1,1,4,1,17.0,11.0,6.0,2
2993,2993,2003-04,2003,2004,Bolton,Newcastle,Draw,Away,2003-09-20,1,4,4,5,5,1,1,2,3,3,3,3,2,0,17.0,3.0,14.0,2
2994,2994,2003-04,2003,2004,Bolton,Wolves,Draw,Home,2003-09-27,1,4,5,5,6,0,1,1,1,4,4,4,5,1,17.0,21.0,-4.0,2
2995,2995,2003-04,2003,2004,Bolton,Aston Villa,Draw,Away,2003-10-05,1,2,5,6,6,3,3,6,6,-1,2,0,0,0,17.0,16.0,1.0,3
2996,2996,2003-04,2003,2004,Bolton,Man City,Loss,Away,2003-10-18,0,2,3,6,7,1,2,5,5,1,1,1,2,0,17.0,9.0,8.0,3
2997,2997,2003-04,2003,2004,Bolton,Birmingham,Loss,Home,2003-10-25,0,1,2,3,6,2,2,5,8,-1,0,-2,-2,1,17.0,13.0,4.0,3
2998,2998,2003-04,2003,2004,Bolton,Tottenham,Win,Away,2003-11-01,3,0,1,2,3,4,7,8,8,-4,-6,-6,-5,0,17.0,10.0,7.0,4
2999,2999,2003-04,2003,2004,Bolton,Southampton,Draw,Home,2003-11-08,1,3,3,4,5,3,4,4,4,0,-1,0,1,1,17.0,8.0,9.0,4
3000,3000,2003-04,2003,2004,Bolton,Leeds,Win,Away,2003-11-22,3,4,4,4,5,0,0,0,3,4,4,4,2,0,17.0,15.0,2.0,4
3001,3001,2003-04,2003,2004,Bolton,Everton,Win,Home,2003-11-29,3,4,7,7,7,3,3,4,5,1,4,3,2,1,17.0,7.0,10.0,4
3002,3002,2003-04,2003,2004,Bolton,Fulham,Loss,Away,2003-12-06,0,6,7,10,10,4,4,4,7,2,3,6,3,0,17.0,14.0,3.0,5
3003,3003,2003-04,2003,2004,Bolton,Chelsea,Win,Away,2003-12-13,3,3,6,7,10,4,7,10,13,-1,-1,-3,-3,0,17.0,4.0,13.0,5
3004,3004,2003-04,2003,2004,Bolton,Arsenal,Draw,Home,2003-12-20,1,3,6,9,10,4,5,8,11,-1,1,1,-1,1,17.0,2.0,15.0,5
3005,3005,2003-04,2003,2004,Bolton,Liverpool,Loss,Away,2003-12-26,0,4,4,7,10,1,4,5,5,3,0,2,5,0,17.0,5.0,12.0,5
3006,3006,2003-04,2003,2004,Bolton,Leicester,Draw,Home,2003-12-28,1,1,4,4,7,1,1,2,5,0,3,2,2,1,17.0,21.0,-4.0,5
3007,3007,2003-04,2003,2004,Bolton,Man United,Loss,Home,2004-01-07,0,1,2,5,5,6,9,12,15,-5,-7,-7,-10,1,17.0,1.0,16.0,6
3008,3008,2003-04,2003,2004,Bolton,Blackburn,Win,Away,2004-01-10,3,1,1,2,5,4,5,5,5,-3,-4,-3,0,0,17.0,6.0,11.0,6
3009,3009,2003-04,2003,2004,Bolton,Portsmouth,Win,Home,2004-01-17,3,3,4,4,5,3,3,6,6,0,1,-2,-1,1,17.0,21.0,-4.0,6
3010,3010,2003-04,2003,2004,Bolton,Charlton,Win,Away,2004-01-31,3,6,6,7,7,6,7,10,13,0,-1,-3,-6,0,17.0,12.0,5.0,6
3011,3011,2003-04,2003,2004,Bolton,Liverpool,Draw,Home,2004-02-07,1,6,9,9,10,2,2,5,8,4,7,4,2,1,17.0,5.0,12.0,7
3012,3012,2003-04,2003,2004,Bolton,Leicester,Draw,Away,2004-02-10,1,4,7,10,10,0,1,1,2,4,6,9,8,0,17.0,21.0,-4.0,7
3013,3013,2003-04,2003,2004,Bolton,Man City,Loss,Home,2004-02-21,0,2,5,8,11,1,1,2,2,1,4,6,9,1,17.0,9.0,8.0,7
3014,3014,2003-04,2003,2004,Bolton,Birmingham,Loss,Away,2004-03-06,0,1,2,5,8,4,7,8,9,-3,-5,-3,-1,0,17.0,13.0,4.0,8
3015,3015,2003-04,2003,2004,Bolton,Chelsea,Loss,Home,2004-03-13,0,0,1,2,5,3,6,9,12,-3,-5,-7,-7,1,17.0,4.0,13.0,8
3016,3016,2003-04,2003,2004,Bolton,Arsenal,Loss,Away,2004-03-20,0,0,0,1,2,6,9,12,15,-6,-9,-11,-13,0,17.0,2.0,15.0,8
3017,3017,2003-04,2003,2004,Bolton,Newcastle,Win,Home,2004-03-28,3,0,0,0,1,3,4,7,8,-3,-4,-7,-7,1,17.0,3.0,14.0,8
3018,3018,2003-04,2003,2004,Bolton,Middlesbrough,Loss,Away,2004-04-03,0,3,3,3,3,4,4,7,7,-1,-1,-4,-4,0,17.0,11.0,6.0,9
3019,3019,2003-04,2003,2004,Bolton,Aston Villa,Draw,Home,2004-04-10,1,3,3,3,3,4,4,7,7,-1,-1,-4,-4,1,17.0,16.0,1.0,9
3020,3020,2003-04,2003,2004,Bolton,Wolves,Win,Away,2004-04-12,3,1,4,4,4,1,1,1,1,0,3,3,3,0,17.0,21.0,-4.0,9
3021,3021,2003-04,2003,2004,Bolton,Tottenham,Win,Home,2004-04-17,3,4,4,7,7,1,1,1,1,3,3,6,6,1,17.0,10.0,7.0,9
3022,3022,2003-04,2003,2004,Bolton,Southampton,Win,Away,2004-04-24,3,6,7,7,10,3,6,9,9,3,1,-2,1,0,17.0,8.0,9.0,9
3023,3023,2003-04,2003,2004,Bolton,Leeds,Win,Home,2004-05-02,3,6,9,10,10,0,1,4,7,6,8,6,3,1,17.0,15.0,2.0,10
3024,3024,2003-04,2003,2004,Bolton,Everton,Win,Away,2004-05-08,3,6,9,12,13,0,1,2,5,6,8,10,8,0,17.0,7.0,10.0,10
3025,3025,2003-04,2003,2004,Bolton,Fulham,Loss,Home,2004-05-15,0,6,9,12,15,1,4,5,5,5,5,7,10,1,17.0,14.0,3.0,10
3026,3026,2004-05,2004,2005,Bolton,Charlton,Win,Home,2004-08-14,3,3,6,9,12,4,5,5,5,-1,1,4,7,1,8.0,7.0,1.0,1
3027,3027,2004-05,2004,2005,Bolton,Fulham,Loss,Away,2004-08-21,0,3,6,9,12,4,4,5,8,-1,2,4,4,0,8.0,9.0,-1.0,1
3028,3028,2004-05,2004,2005,Bolton,Southampton,Win,Away,2004-08-25,3,3,3,6,9,3,3,4,5,0,0,2,4,0,8.0,12.0,-4.0,1
3029,3029,2004-05,2004,2005,Bolton,Liverpool,Win,Home,2004-08-29,3,3,6,6,9,4,5,8,11,-1,1,-2,-2,1,8.0,4.0,4.0,1
3030,3030,2004-05,2004,2005,Bolton,Man United,Draw,Home,2004-09-11,1,6,6,9,9,2,5,5,8,4,1,4,1,1,8.0,3.0,5.0,2
3031,3031,2004-05,2004,2005,Bolton,Arsenal,Draw,Away,2004-09-18,1,4,7,7,10,6,9,12,15,-2,-2,-5,-5,0,8.0,1.0,7.0,2
3032,3032,2004-05,2004,2005,Bolton,Birmingham,Draw,Home,2004-09-25,1,2,5,8,8,1,1,4,4,1,4,4,4,1,8.0,10.0,-2.0,2
3033,3033,2004-05,2004,2005,Bolton,West Brom,Loss,Away,2004-10-02,0,2,3,6,9,1,1,1,2,1,2,5,7,0,8.0,21.0,-13.0,3
3034,3034,2004-05,2004,2005,Bolton,Crystal Palace,Win,Home,2004-10-16,3,1,2,3,6,4,4,4,4,-3,-2,-1,2,1,8.0,21.0,-13.0,3
3035,3035,2004-05,2004,2005,Bolton,Tottenham,Win,Away,2004-10-23,3,3,4,5,6,3,3,4,5,0,1,1,1,0,8.0,14.0,-6.0,3
3036,3036,2004-05,2004,2005,Bolton,Newcastle,Win,Home,2004-10-31,3,6,6,7,8,4,5,8,11,2,1,-1,-3,1,8.0,5.0,3.0,3
3037,3037,2004-05,2004,2005,Bolton,Middlesbrough,Draw,Away,2004-11-07,1,6,9,9,10,4,7,8,8,2,2,1,2,0,8.0,11.0,-3.0,4
3038,3038,2004-05,2004,2005,Bolton,Aston Villa,Loss,Home,2004-11-13,0,4,7,10,10,4,7,7,8,0,0,3,2,1,8.0,6.0,2.0,4
3039,3039,2004-05,2004,2005,Bolton,Chelsea,Draw,Away,2004-11-20,1,1,4,7,10,6,9,12,12,-5,-5,-5,-2,0,8.0,2.0,6.0,4
3040,3040,2004-05,2004,2005,Bolton,Portsmouth,Loss,Home,2004-11-27,0,1,2,5,8,0,0,3,4,1,2,2,4,1,8.0,13.0,-5.0,4
3041,3041,2004-05,2004,2005,Bolton,Everton,Loss,Away,2004-12-04,0,1,1,2,5,4,7,7,8,-3,-6,-5,-3,0,8.0,17.0,-9.0,5
3042,3042,2004-05,2004,2005,Bolton,Norwich,Loss,Away,2004-12-11,0,0,1,1,2,1,4,4,5,-1,-3,-3,-3,0,8.0,21.0,-13.0,5
3043,3043,2004-05,2004,2005,Bolton,Man City,Loss,Home,2004-12-18,0,0,0,1,1,0,3,6,7,0,-3,-5,-6,1,8.0,16.0,-8.0,5
3044,3044,2004-05,2004,2005,Bolton,Man United,Loss,Away,2004-12-26,0,0,0,0,1,4,7,10,13,-4,-7,-10,-12,0,8.0,3.0,5.0,5
3045,3045,2004-05,2004,2005,Bolton,Blackburn,Loss,Home,2004-12-28,0,0,0,0,0,2,3,3,6,-2,-3,-3,-6,1,8.0,15.0,-7.0,5
3046,3046,2004-05,2004,2005,Bolton,West Brom,Draw,Home,2005-01-01,1,0,0,0,0,1,1,1,1,-1,-1,-1,-1,1,8.0,21.0,-13.0,6
3047,3047,2004-05,2004,2005,Bolton,Birmingham,Win,Away,2005-01-04,3,1,1,1,1,3,6,9,12,-2,-5,-8,-11,0,8.0,10.0,-2.0,6
3048,3048,2004-05,2004,2005,Bolton,Arsenal,Win,Home,2005-01-15,3,4,4,4,4,4,7,10,13,0,-3,-6,-9,1,8.0,1.0,7.0,6
3049,3049,2004-05,2004,2005,Bolton,Blackburn,Win,Away,2005-01-24,3,6,7,7,7,6,6,9,10,0,1,-2,-3,0,8.0,15.0,-7.0,6
3050,3050,2004-05,2004,2005,Bolton,Tottenham,Win,Home,2005-02-01,3,6,9,10,10,0,1,4,5,6,8,6,5,1,8.0,14.0,-6.0,7
3051,3051,2004-05,2004,2005,Bolton,Crystal Palace,Win,Away,2005-02-05,3,6,9,12,13,4,4,7,7,2,5,5,6,0,8.0,21.0,-13.0,7
3052,3052,2004-05,2004,2005,Bolton,Middlesbrough,Draw,Home,2005-02-12,1,6,9,12,15,3,4,5,5,3,5,7,10,1,8.0,11.0,-3.0,7
3053,3053,2004-05,2004,2005,Bolton,Newcastle,Loss,Away,2005-02-27,0,4,7,10,13,2,2,5,6,2,5,5,7,0,8.0,5.0,3.0,7
3054,3054,2004-05,2004,2005,Bolton,Man City,Win,Away,2005-03-07,3,1,4,7,10,3,4,5,5,-2,0,2,5,0,8.0,16.0,-8.0,8
3055,3055,2004-05,2004,2005,Bolton,Norwich,Win,Home,2005-03-19,3,3,4,7,10,0,0,3,3,3,4,4,7,1,8.0,21.0,-13.0,8
3056,3056,2004-05,2004,2005,Bolton,Liverpool,Loss,Away,2005-04-02,0,6,6,7,10,4,4,4,7,2,2,3,3,0,8.0,4.0,4.0,9
3057,3057,2004-05,2004,2005,Bolton,Fulham,Win,Home,2005-04-09,3,3,6,6,7,3,4,4,4,0,2,2,3,1,8.0,9.0,-1.0,9
3058,3058,2004-05,2004,2005,Bolton,Charlton,Win,Away,2005-04-16,3,3,6,9,9,1,1,4,5,2,5,5,4,0,8.0,7.0,1.0,9
3059,3059,2004-05,2004,2005,Bolton,Southampton,Draw,Home,2005-04-19,1,6,6,9,12,0,0,3,6,6,6,6,6,1,8.0,12.0,-4.0,9
3060,3060,2004-05,2004,2005,Bolton,Aston Villa,Draw,Away,2005-04-23,1,4,7,7,10,4,5,8,8,0,2,-1,2,0,8.0,6.0,2.0,9
3061,3061,2004-05,2004,2005,Bolton,Chelsea,Loss,Home,2005-04-30,0,2,5,8,8,4,5,8,11,-2,0,0,-3,1,8.0,2.0,6.0,9
3062,3062,2004-05,2004,2005,Bolton,Portsmouth,Draw,Away,2005-05-07,1,1,2,5,8,3,3,4,7,-2,-1,1,1,0,8.0,13.0,-5.0,10
3063,3063,2004-05,2004,2005,Bolton,Everton,Win,Home,2005-05-15,3,1,2,3,6,3,3,4,7,-2,-1,-1,-1,1,8.0,17.0,-9.0,10
3064,3064,2005-06,2005,2006,Bolton,Aston Villa,Draw,Away,2005-08-13,1,4,4,5,6,0,0,1,2,4,4,4,4,0,6.0,10.0,-4.0,1
3065,3065,2005-06,2005,2006,Bolton,Everton,Loss,Home,2005-08-21,0,4,5,5,6,0,0,3,3,4,5,2,3,1,6.0,4.0,2.0,1
3066,3066,2005-06,2005,2006,Bolton,Newcastle,Win,Home,2005-08-24,3,1,4,5,5,1,2,2,5,0,2,3,0,1,6.0,14.0,-8.0,1
3067,3067,2005-06,2005,2006,Bolton,West Ham,Win,Away,2005-08-27,3,3,4,7,8,4,5,8,11,-1,-1,-1,-3,0,6.0,21.0,-15.0,1
3068,3068,2005-06,2005,2006,Bolton,Blackburn,Draw,Home,2005-09-11,1,6,6,7,10,1,4,4,5,5,2,3,5,1,6.0,15.0,-9.0,2
3069,3069,2005-06,2005,2006,Bolton,Man City,Win,Away,2005-09-18,3,4,7,7,8,4,7,10,11,0,0,-3,-3,0,6.0,8.0,-2.0,2
3070,3070,2005-06,2005,2006,Bolton,Portsmouth,Win,Home,2005-09-24,3,4,7,10,10,4,4,5,5,0,3,5,5,1,6.0,16.0,-10.0,2
3071,3071,2005-06,2005,2006,Bolton,Wigan,Loss,Away,2005-10-02,0,6,7,10,13,4,7,10,10,2,0,0,3,0,6.0,21.0,-15.0,3
3072,3072,2005-06,2005,2006,Bolton,Chelsea,Loss,Away,2005-10-15,0,3,6,7,10,6,9,12,15,-3,-3,-5,-5,0,6.0,1.0,5.0,3
3073,3073,2005-06,2005,2006,Bolton,West Brom,Win,Home,2005-10-23,3,0,3,6,7,3,3,4,4,-3,0,2,3,1,6.0,17.0,-11.0,3
3074,3074,2005-06,2005,2006,Bolton,Charlton,Win,Away,2005-10-29,3,3,3,6,9,4,4,7,7,-1,-1,-1,2,0,6.0,11.0,-5.0,3
3075,3075,2005-06,2005,2006,Bolton,Tottenham,Win,Home,2005-11-07,3,6,6,6,9,2,5,8,11,4,1,-2,-2,1,6.0,9.0,-3.0,4
3076,3076,2005-06,2005,2006,Bolton,Fulham,Loss,Away,2005-11-27,0,6,9,9,9,3,3,6,7,3,6,3,2,0,6.0,13.0,-7.0,4
3077,3077,2005-06,2005,2006,Bolton,Arsenal,Win,Home,2005-12-03,3,3,6,9,9,6,9,10,13,-3,-3,-1,-4,1,6.0,2.0,4.0,5
3078,3078,2005-06,2005,2006,Bolton,Aston Villa,Draw,Home,2005-12-10,1,3,6,9,12,4,7,7,7,-1,-1,2,5,1,6.0,10.0,-4.0,5
3079,3079,2005-06,2005,2006,Bolton,Everton,Win,Away,2005-12-17,3,4,4,7,10,1,4,7,7,3,0,0,3,0,6.0,4.0,2.0,5
3080,3080,2005-06,2005,2006,Bolton,Sunderland,Draw,Away,2005-12-26,1,4,7,7,10,0,0,0,0,4,7,7,10,0,6.0,21.0,-15.0,5
3081,3081,2005-06,2005,2006,Bolton,Man United,Loss,Away,2005-12-31,0,4,5,8,8,4,7,10,11,0,-2,-2,-3,0,6.0,3.0,3.0,5
3082,3082,2005-06,2005,2006,Bolton,Liverpool,Draw,Home,2006-01-02,1,1,4,5,8,6,9,12,15,-5,-5,-7,-7,1,6.0,5.0,1.0,6
3083,3083,2005-06,2005,2006,Bolton,Blackburn,Draw,Away,2006-01-14,1,1,2,5,6,6,9,9,12,-5,-7,-4,-6,0,6.0,15.0,-9.0,6
3084,3084,2005-06,2005,2006,Bolton,Man City,Win,Home,2006-01-21,3,2,2,3,6,3,4,4,4,-1,-2,-1,2,1,6.0,8.0,-2.0,6
3085,3085,2005-06,2005,2006,Bolton,Portsmouth,Draw,Away,2006-02-01,1,4,5,5,6,0,0,3,3,4,5,2,3,0,6.0,16.0,-10.0,7
3086,3086,2005-06,2005,2006,Bolton,Wigan,Draw,Home,2006-02-04,1,4,5,6,6,4,4,4,4,0,1,2,2,1,6.0,21.0,-15.0,7
3087,3087,2005-06,2005,2006,Bolton,Arsenal,Draw,Away,2006-02-11,1,2,5,6,7,3,3,6,7,-1,2,0,0,0,6.0,2.0,4.0,7
3088,3088,2005-06,2005,2006,Bolton,Fulham,Win,Home,2006-02-26,3,2,3,6,7,3,6,6,9,-1,-3,0,-2,1,6.0,13.0,-7.0,7
3089,3089,2005-06,2005,2006,Bolton,Newcastle,Loss,Away,2006-03-04,0,4,5,6,9,4,7,10,10,0,-2,-4,-1,0,6.0,14.0,-8.0,8
3090,3090,2005-06,2005,2006,Bolton,West Ham,Win,Home,2006-03-11,3,3,4,5,6,4,7,10,13,-1,-3,-5,-7,1,6.0,21.0,-15.0,8
3091,3091,2005-06,2005,2006,Bolton,Sunderland,Win,Home,2006-03-18,3,3,6,7,8,0,0,0,1,3,6,7,7,1,6.0,21.0,-15.0,8
3092,3092,2005-06,2005,2006,Bolton,Middlesbrough,Loss,Away,2006-03-26,0,6,6,9,10,0,3,6,9,6,3,3,1,0,6.0,7.0,-1.0,8
3093,3093,2005-06,2005,2006,Bolton,Man United,Loss,Home,2006-04-01,0,3,6,6,9,6,9,12,15,-3,-3,-6,-6,1,6.0,3.0,3.0,9
3094,3094,2005-06,2005,2006,Bolton,Birmingham,Loss,Away,2006-04-04,0,0,3,6,6,1,1,2,2,-1,2,4,4,0,6.0,12.0,-6.0,9
3095,3095,2005-06,2005,2006,Bolton,Liverpool,Loss,Away,2006-04-09,0,0,0,3,6,6,9,12,12,-6,-9,-9,-6,0,6.0,5.0,1.0,9
3096,3096,2005-06,2005,2006,Bolton,Chelsea,Loss,Home,2006-04-15,0,0,0,0,3,4,7,7,10,-4,-7,-7,-7,1,6.0,1.0,5.0,9
3097,3097,2005-06,2005,2006,Bolton,West Brom,Draw,Away,2006-04-17,1,0,0,0,0,1,1,1,1,-1,-1,-1,-1,0,6.0,17.0,-11.0,9
3098,3098,2005-06,2005,2006,Bolton,Charlton,Win,Home,2006-04-22,3,1,1,1,1,3,4,5,8,-2,-3,-4,-7,1,6.0,11.0,-5.0,9
3099,3099,2005-06,2005,2006,Bolton,Tottenham,Loss,Away,2006-04-30,0,4,4,4,4,1,4,7,7,3,0,-3,-3,0,6.0,9.0,-3.0,9
3100,3100,2005-06,2005,2006,Bolton,Middlesbrough,Draw,Home,2006-05-03,1,3,4,4,4,1,4,4,4,2,0,0,0,1,6.0,7.0,-1.0,10
3101,3101,2005-06,2005,2006,Bolton,Birmingham,Win,Home,2006-05-07,3,1,4,5,5,2,5,5,6,-1,-1,0,-1,1,6.0,12.0,-6.0,10
3102,3102,2006-07,2006,2007,Bolton,Tottenham,Win,Home,2006-08-19,3,4,4,7,8,3,4,4,7,1,0,3,1,1,8.0,5.0,3.0,1
3103,3103,2006-07,2006,2007,Bolton,Fulham,Draw,Away,2006-08-23,1,6,7,7,10,3,3,6,9,3,4,1,1,0,8.0,12.0,-4.0,1
3104,3104,2006-07,2006,2007,Bolton,Charlton,Loss,Away,2006-08-26,0,4,7,8,8,0,0,0,0,4,7,8,8,0,8.0,13.0,-5.0,1
3105,3105,2006-07,2006,2007,Bolton,Watford,Win,Home,2006-09-09,3,1,4,7,8,1,1,4,5,0,3,3,3,1,8.0,21.0,-13.0,2
3106,3106,2006-07,2006,2007,Bolton,Middlesbrough,Draw,Home,2006-09-16,1,3,4,7,10,1,4,4,4,2,0,3,6,1,8.0,14.0,-6.0,2
3107,3107,2006-07,2006,2007,Bolton,Portsmouth,Win,Away,2006-09-25,3,4,4,5,8,6,9,10,13,-2,-5,-5,-5,0,8.0,17.0,-9.0,2
3108,3108,2006-07,2006,2007,Bolton,Liverpool,Win,Home,2006-09-30,3,4,7,7,8,6,6,6,9,-2,1,1,-1,1,8.0,3.0,5.0,2
3109,3109,2006-07,2006,2007,Bolton,Newcastle,Win,Away,2006-10-15,3,6,7,10,10,1,1,4,4,5,6,6,6,0,8.0,7.0,1.0,3
3110,3110,2006-07,2006,2007,Bolton,Blackburn,Win,Away,2006-10-22,3,6,9,10,13,4,7,10,11,2,2,0,2,0,8.0,6.0,2.0,3
3111,3111,2006-07,2006,2007,Bolton,Man United,Loss,Home,2006-10-28,0,6,9,12,13,6,9,10,10,0,0,2,3,1,8.0,2.0,6.0,3
3112,3112,2006-07,2006,2007,Bolton,Wigan,Loss,Home,2006-11-04,0,3,6,9,12,6,6,6,7,-3,0,3,5,1,8.0,10.0,-2.0,4
3113,3113,2006-07,2006,2007,Bolton,Sheffield United,Draw,Away,2006-11-11,1,0,3,6,9,3,3,4,7,-3,0,2,2,0,8.0,21.0,-13.0,4
3114,3114,2006-07,2006,2007,Bolton,Everton,Loss,Away,2006-11-18,0,1,1,4,7,0,1,4,4,1,0,0,3,0,8.0,11.0,-3.0,4
3115,3115,2006-07,2006,2007,Bolton,Arsenal,Win,Home,2006-11-25,3,1,1,1,4,4,4,5,8,-3,-3,-4,-4,1,8.0,4.0,4.0,4
3116,3116,2006-07,2006,2007,Bolton,Chelsea,Loss,Home,2006-11-29,0,3,4,4,4,4,7,7,10,-1,-3,-3,-6,1,8.0,1.0,7.0,4
3117,3117,2006-07,2006,2007,Bolton,Reading,Loss,Away,2006-12-02,0,3,3,4,4,6,9,9,9,-3,-6,-5,-5,0,8.0,21.0,-13.0,5
3118,3118,2006-07,2006,2007,Bolton,West Ham,Win,Home,2006-12-09,3,0,3,3,4,0,3,3,3,0,0,0,1,1,8.0,9.0,-1.0,5
3119,3119,2006-07,2006,2007,Bolton,Aston Villa,Win,Away,2006-12-16,3,3,3,6,6,2,2,3,4,1,1,3,2,0,8.0,16.0,-8.0,5
3120,3120,2006-07,2006,2007,Bolton,Man City,Win,Away,2006-12-23,3,6,6,6,9,0,1,4,4,6,5,2,5,0,8.0,15.0,-7.0,5
3121,3121,2006-07,2006,2007,Bolton,Newcastle,Win,Home,2006-12-26,3,6,9,9,9,6,6,9,12,0,3,0,-3,1,8.0,7.0,1.0,5
3122,3122,2006-07,2006,2007,Bolton,Portsmouth,Win,Home,2006-12-30,3,6,9,12,12,6,7,10,11,0,2,2,1,1,8.0,17.0,-9.0,5
3123,3123,2006-07,2006,2007,Bolton,Liverpool,Loss,Away,2007-01-01,0,6,9,12,15,3,6,9,12,3,3,3,3,0,8.0,3.0,5.0,6
3124,3124,2006-07,2006,2007,Bolton,Man City,Draw,Home,2007-01-13,1,3,6,9,12,6,9,9,9,-3,-3,0,3,1,8.0,15.0,-7.0,6
3125,3125,2006-07,2006,2007,Bolton,Middlesbrough,Loss,Away,2007-01-20,0,1,4,7,10,6,6,7,10,-5,-2,0,0,0,8.0,14.0,-6.0,6
3126,3126,2006-07,2006,2007,Bolton,Charlton,Draw,Home,2007-01-31,1,1,1,4,7,3,3,6,7,-2,-2,-2,0,1,8.0,13.0,-5.0,6
3127,3127,2006-07,2006,2007,Bolton,Watford,Win,Away,2007-02-03,3,1,2,2,5,3,3,3,4,-2,-1,-1,1,0,8.0,21.0,-13.0,7
3128,3128,2006-07,2006,2007,Bolton,Fulham,Win,Home,2007-02-11,3,4,4,5,5,3,4,5,6,1,0,0,-1,1,8.0,12.0,-4.0,7
3129,3129,2006-07,2006,2007,Bolton,Tottenham,Loss,Away,2007-02-25,0,6,7,7,8,3,3,4,4,3,4,3,4,0,8.0,5.0,3.0,7
3130,3130,2006-07,2006,2007,Bolton,Blackburn,Loss,Home,2007-03-04,0,3,6,7,7,3,6,6,6,0,0,1,1,1,8.0,6.0,2.0,8
3131,3131,2006-07,2006,2007,Bolton,Man United,Loss,Away,2007-03-17,0,0,3,6,7,6,9,12,15,-6,-6,-6,-8,0,8.0,2.0,6.0,8
3132,3132,2006-07,2006,2007,Bolton,Sheffield United,Win,Home,2007-03-31,3,0,0,3,6,1,1,4,4,-1,-1,-1,2,1,8.0,21.0,-13.0,8
3133,3133,2006-07,2006,2007,Bolton,Wigan,Win,Away,2007-04-07,3,3,3,3,6,1,4,7,8,2,-1,-4,-2,0,8.0,10.0,-2.0,9
3134,3134,2006-07,2006,2007,Bolton,Everton,Draw,Home,2007-04-09,1,6,6,6,6,4,7,8,11,2,-1,-2,-5,1,8.0,11.0,-3.0,9
3135,3135,2006-07,2006,2007,Bolton,Arsenal,Loss,Away,2007-04-14,0,4,7,7,7,1,1,1,4,3,6,6,3,0,8.0,4.0,4.0,9
3136,3136,2006-07,2006,2007,Bolton,Reading,Loss,Home,2007-04-21,0,1,4,7,7,4,4,4,5,-3,0,3,2,1,8.0,21.0,-13.0,9
3137,3137,2006-07,2006,2007,Bolton,Chelsea,Draw,Away,2007-04-28,1,0,1,4,7,4,7,10,13,-4,-6,-6,-6,0,8.0,1.0,7.0,9
3138,3138,2006-07,2006,2007,Bolton,West Ham,Loss,Away,2007-05-05,0,1,1,2,5,6,6,6,9,-5,-5,-4,-4,0,8.0,9.0,-1.0,10
3139,3139,2006-07,2006,2007,Bolton,Aston Villa,Draw,Home,2007-05-13,1,1,1,1,2,6,7,10,11,-5,-6,-9,-9,1,8.0,16.0,-8.0,10
3140,3140,2007-08,2007,2008,Bolton,Newcastle,Loss,Home,2007-08-11,0,1,2,2,2,1,1,2,2,0,1,0,0,1,7.0,13.0,-6.0,1
3141,3141,2007-08,2007,2008,Bolton,Fulham,Loss,Away,2007-08-15,0,1,1,2,2,0,3,3,4,1,-2,-1,-2,0,7.0,16.0,-9.0,1
3142,3142,2007-08,2007,2008,Bolton,Portsmouth,Loss,Away,2007-08-18,0,0,1,1,2,2,3,3,6,-2,-2,-2,-4,0,7.0,9.0,-2.0,1
3143,3143,2007-08,2007,2008,Bolton,Reading,Win,Home,2007-08-25,3,0,0,1,1,3,4,5,5,-3,-4,-4,-4,1,7.0,8.0,-1.0,1
3144,3144,2007-08,2007,2008,Bolton,Everton,Loss,Home,2007-09-01,0,3,3,3,4,1,4,7,8,2,-1,-4,-4,1,7.0,6.0,1.0,2
3145,3145,2007-08,2007,2008,Bolton,Birmingham,Loss,Away,2007-09-15,0,3,3,3,3,3,3,4,4,0,0,-1,-1,0,7.0,21.0,-14.0,2
3146,3146,2007-08,2007,2008,Bolton,Tottenham,Draw,Home,2007-09-23,1,0,3,3,3,1,1,4,4,-1,2,-1,-1,1,7.0,5.0,2.0,2
3147,3147,2007-08,2007,2008,Bolton,Derby,Draw,Away,2007-09-29,1,1,1,4,4,3,3,3,3,-2,-2,1,1,0,7.0,21.0,-14.0,2
3148,3148,2007-08,2007,2008,Bolton,Chelsea,Loss,Home,2007-10-07,0,2,2,2,5,1,2,2,5,1,0,0,0,1,7.0,2.0,5.0,3
3149,3149,2007-08,2007,2008,Bolton,Arsenal,Loss,Away,2007-10-20,0,1,2,2,2,6,9,12,15,-5,-7,-10,-13,0,7.0,4.0,3.0,3
3150,3150,2007-08,2007,2008,Bolton,Aston Villa,Draw,Home,2007-10-28,1,0,1,2,2,3,4,7,7,-3,-3,-5,-5,1,7.0,11.0,-4.0,3
3151,3151,2007-08,2007,2008,Bolton,West Ham,Draw,Away,2007-11-04,1,1,1,2,3,4,4,4,4,-3,-3,-2,-1,0,7.0,15.0,-8.0,4
3152,3152,2007-08,2007,2008,Bolton,Middlesbrough,Draw,Home,2007-11-11,1,2,2,2,3,1,1,1,1,1,1,1,2,1,7.0,12.0,-5.0,4
3153,3153,2007-08,2007,2008,Bolton,Man United,Win,Home,2007-11-24,3,2,3,3,3,4,7,10,13,-2,-4,-7,-10,1,7.0,1.0,6.0,4
3154,3154,2007-08,2007,2008,Bolton,Liverpool,Loss,Away,2007-12-02,0,4,5,6,6,6,7,8,11,-2,-2,-2,-5,0,7.0,3.0,4.0,5
3155,3155,2007-08,2007,2008,Bolton,Wigan,Win,Home,2007-12-09,3,3,4,5,6,1,1,1,1,2,3,4,5,1,7.0,17.0,-10.0,5
3156,3156,2007-08,2007,2008,Bolton,Man City,Loss,Away,2007-12-15,0,3,6,7,8,1,4,5,8,2,2,2,0,0,7.0,14.0,-7.0,5
3157,3157,2007-08,2007,2008,Bolton,Birmingham,Win,Home,2007-12-22,3,3,3,6,7,1,4,4,4,2,-1,2,3,1,7.0,21.0,-14.0,5
3158,3158,2007-08,2007,2008,Bolton,Everton,Loss,Away,2007-12-26,0,3,6,6,9,3,6,7,10,0,0,-1,-1,0,7.0,6.0,1.0,5
3159,3159,2007-08,2007,2008,Bolton,Sunderland,Loss,Away,2007-12-29,0,3,3,6,6,0,1,1,4,3,2,5,2,0,7.0,21.0,-14.0,5
3160,3160,2007-08,2007,2008,Bolton,Derby,Win,Home,2008-01-02,3,0,3,3,6,0,1,1,1,0,2,2,5,1,7.0,21.0,-14.0,6
3161,3161,2007-08,2007,2008,Bolton,Blackburn,Loss,Home,2008-01-13,0,3,3,6,6,6,7,7,7,-3,-4,-1,-1,1,7.0,10.0,-3.0,6
3162,3162,2007-08,2007,2008,Bolton,Newcastle,Draw,Away,2008-01-19,1,3,3,3,6,0,0,0,1,3,3,3,5,0,7.0,13.0,-6.0,6
3163,3163,2007-08,2007,2008,Bolton,Fulham,Draw,Home,2008-01-29,1,1,4,4,4,0,0,1,1,1,4,3,3,1,7.0,16.0,-9.0,6
3164,3164,2007-08,2007,2008,Bolton,Reading,Win,Away,2008-02-02,3,2,2,5,5,0,0,0,0,2,2,5,5,0,7.0,8.0,-1.0,7
3165,3165,2007-08,2007,2008,Bolton,Portsmouth,Loss,Home,2008-02-09,0,4,5,5,8,1,4,4,7,3,1,1,1,1,7.0,9.0,-2.0,7
3166,3166,2007-08,2007,2008,Bolton,Blackburn,Loss,Away,2008-02-24,0,3,4,5,5,1,2,3,6,2,2,2,-1,0,7.0,10.0,-3.0,7
3167,3167,2007-08,2007,2008,Bolton,Liverpool,Loss,Home,2008-03-02,0,0,3,4,5,4,7,7,8,-4,-4,-3,-3,1,7.0,3.0,4.0,8
3168,3168,2007-08,2007,2008,Bolton,Wigan,Loss,Away,2008-03-16,0,0,0,3,4,2,5,5,8,-2,-5,-2,-4,0,7.0,17.0,-10.0,8
3169,3169,2007-08,2007,2008,Bolton,Man United,Loss,Away,2008-03-19,0,0,0,0,3,6,9,9,10,-6,-9,-9,-7,0,7.0,1.0,6.0,8
3170,3170,2007-08,2007,2008,Bolton,Man City,Draw,Home,2008-03-22,1,0,0,0,0,3,4,4,7,-3,-4,-4,-7,1,7.0,14.0,-7.0,8
3171,3171,2007-08,2007,2008,Bolton,Arsenal,Loss,Home,2008-03-29,0,1,1,1,1,1,2,3,4,0,-1,-2,-3,1,7.0,4.0,3.0,8
3172,3172,2007-08,2007,2008,Bolton,Aston Villa,Loss,Away,2008-04-05,0,1,1,1,1,0,0,1,2,1,1,0,-1,0,7.0,11.0,-4.0,9
3173,3173,2007-08,2007,2008,Bolton,West Ham,Win,Home,2008-04-12,3,0,1,1,1,0,1,4,4,0,0,-3,-3,1,7.0,15.0,-8.0,9
3174,3174,2007-08,2007,2008,Bolton,Middlesbrough,Win,Away,2008-04-19,3,3,3,4,4,2,2,5,6,1,1,-1,-2,0,7.0,12.0,-5.0,9
3175,3175,2007-08,2007,2008,Bolton,Tottenham,Draw,Away,2008-04-26,1,6,6,6,7,2,3,3,6,4,3,3,1,0,7.0,5.0,2.0,9
3176,3176,2007-08,2007,2008,Bolton,Sunderland,Win,Home,2008-05-03,3,4,7,7,7,3,3,6,9,1,4,1,-2,1,7.0,21.0,-14.0,10
3177,3177,2007-08,2007,2008,Bolton,Chelsea,Draw,Away,2008-05-11,1,4,7,10,10,6,9,10,13,-2,-2,0,-3,0,7.0,2.0,5.0,10
3178,3178,2008-09,2008,2009,Bolton,Stoke,Win,Home,2008-08-16,3,4,5,8,11,0,0,0,0,4,5,8,11,1,16.0,21.0,-5.0,1
3179,3179,2008-09,2008,2009,Bolton,Newcastle,Loss,Away,2008-08-23,0,4,7,8,11,1,1,2,5,3,6,6,6,0,16.0,12.0,4.0,1
3180,3180,2008-09,2008,2009,Bolton,West Brom,Draw,Home,2008-08-30,1,3,4,7,8,0,1,1,1,3,3,6,7,1,16.0,21.0,-5.0,1
3181,3181,2008-09,2008,2009,Bolton,Fulham,Loss,Away,2008-09-13,0,1,4,5,8,3,6,9,12,-2,-2,-4,-4,0,16.0,17.0,-1.0,2
3182,3182,2008-09,2008,2009,Bolton,Arsenal,Loss,Home,2008-09-20,0,1,1,4,5,6,6,9,12,-5,-5,-5,-7,1,16.0,3.0,13.0,2
3183,3183,2008-09,2008,2009,Bolton,Man United,Loss,Away,2008-09-27,0,0,1,1,4,1,4,5,8,-1,-3,-4,-4,0,16.0,1.0,15.0,2
3184,3184,2008-09,2008,2009,Bolton,West Ham,Win,Away,2008-10-05,3,0,0,1,1,6,6,9,9,-6,-6,-8,-8,0,16.0,10.0,6.0,3
3185,3185,2008-09,2008,2009,Bolton,Blackburn,Draw,Home,2008-10-18,1,3,3,3,4,3,6,6,6,0,-3,-3,-2,1,16.0,7.0,9.0,3
3186,3186,2008-09,2008,2009,Bolton,Tottenham,Loss,Away,2008-10-26,0,4,4,4,4,0,0,1,1,4,4,3,3,0,16.0,11.0,5.0,3
3187,3187,2008-09,2008,2009,Bolton,Everton,Loss,Home,2008-10-29,0,1,4,4,4,1,2,2,3,0,2,2,1,1,16.0,5.0,11.0,3
3188,3188,2008-09,2008,2009,Bolton,Man City,Win,Home,2008-11-02,3,0,1,4,4,3,4,4,4,-3,-3,0,0,1,16.0,9.0,7.0,4
3189,3189,2008-09,2008,2009,Bolton,Hull,Win,Away,2008-11-08,3,3,3,4,7,0,3,6,9,3,0,-2,-2,0,16.0,21.0,-5.0,4
3190,3190,2008-09,2008,2009,Bolton,Liverpool,Loss,Home,2008-11-15,0,6,6,6,7,3,6,9,12,3,0,-3,-5,1,16.0,4.0,12.0,4
3191,3191,2008-09,2008,2009,Bolton,Middlesbrough,Win,Away,2008-11-22,3,3,6,6,6,4,5,8,9,-1,1,-2,-3,0,16.0,13.0,3.0,4
3192,3192,2008-09,2008,2009,Bolton,Sunderland,Win,Away,2008-11-29,3,3,6,9,9,3,3,3,3,0,3,6,6,0,16.0,15.0,1.0,4
3193,3193,2008-09,2008,2009,Bolton,Chelsea,Loss,Home,2008-12-06,0,6,6,9,12,1,4,7,10,5,2,2,2,1,16.0,2.0,14.0,5
3194,3194,2008-09,2008,2009,Bolton,Aston Villa,Loss,Away,2008-12-13,0,3,6,6,9,4,5,8,8,-1,1,-2,1,0,16.0,6.0,10.0,5
3195,3195,2008-09,2008,2009,Bolton,Portsmouth,Win,Home,2008-12-20,3,0,3,6,6,1,4,5,6,-1,-1,1,0,1,16.0,8.0,8.0,5
3196,3196,2008-09,2008,2009,Bolton,Liverpool,Loss,Away,2008-12-26,0,3,3,6,9,2,5,6,7,1,-2,0,2,0,16.0,4.0,12.0,5
3197,3197,2008-09,2008,2009,Bolton,Wigan,Loss,Home,2008-12-28,0,3,3,3,6,6,6,9,12,-3,-3,-6,-6,1,16.0,14.0,2.0,5
3198,3198,2008-09,2008,2009,Bolton,Arsenal,Loss,Away,2009-01-10,0,0,3,3,3,4,5,6,9,-4,-2,-3,-6,0,16.0,3.0,13.0,6
3199,3199,2008-09,2008,2009,Bolton,Man United,Loss,Home,2009-01-17,0,0,0,3,3,6,9,12,13,-6,-9,-9,-10,1,16.0,1.0,15.0,6
3200,3200,2008-09,2008,2009,Bolton,Blackburn,Draw,Away,2009-01-28,1,0,0,0,3,4,5,8,8,-4,-5,-8,-5,0,16.0,7.0,9.0,6
3201,3201,2008-09,2008,2009,Bolton,Tottenham,Win,Home,2009-01-31,3,1,1,1,1,4,4,4,5,-3,-3,-3,-4,1,16.0,11.0,5.0,6
3202,3202,2008-09,2008,2009,Bolton,Everton,Loss,Away,2009-02-07,0,4,4,4,4,1,2,5,8,3,2,-1,-4,0,16.0,5.0,11.0,7
3203,3203,2008-09,2008,2009,Bolton,West Ham,Win,Home,2009-02-21,3,3,4,4,4,1,4,7,8,2,0,-3,-4,1,16.0,10.0,6.0,7
3204,3204,2008-09,2008,2009,Bolton,Newcastle,Win,Home,2009-03-01,3,3,6,7,7,4,5,5,5,-1,1,2,2,1,16.0,12.0,4.0,8
3205,3205,2008-09,2008,2009,Bolton,Stoke,Loss,Away,2009-03-04,0,6,6,9,10,2,2,5,5,4,4,4,5,0,16.0,21.0,-5.0,8
3206,3206,2008-09,2008,2009,Bolton,Fulham,Loss,Home,2009-03-14,0,3,6,6,9,0,1,4,4,3,5,2,5,1,16.0,17.0,-1.0,8
3207,3207,2008-09,2008,2009,Bolton,West Brom,Draw,Away,2009-03-21,1,0,3,6,6,1,1,1,1,-1,2,5,5,0,16.0,21.0,-5.0,8
3208,3208,2008-09,2008,2009,Bolton,Middlesbrough,Win,Home,2009-04-04,3,1,1,4,7,1,1,4,5,0,0,0,2,1,16.0,13.0,3.0,9
3209,3209,2008-09,2008,2009,Bolton,Chelsea,Loss,Away,2009-04-11,0,4,4,4,7,3,6,9,12,1,-2,-5,-5,0,16.0,2.0,14.0,9
3210,3210,2008-09,2008,2009,Bolton,Portsmouth,Loss,Away,2009-04-18,0,3,4,4,4,2,5,6,6,1,-1,-2,-2,0,16.0,8.0,8.0,9
3211,3211,2008-09,2008,2009,Bolton,Aston Villa,Draw,Home,2009-04-25,1,0,3,4,4,2,2,2,2,-2,1,2,2,1,16.0,6.0,10.0,9
3212,3212,2008-09,2008,2009,Bolton,Wigan,Draw,Away,2009-05-02,1,1,1,4,5,0,0,3,6,1,1,1,-1,0,16.0,14.0,2.0,10
3213,3213,2008-09,2008,2009,Bolton,Sunderland,Draw,Home,2009-05-09,1,2,2,2,5,0,3,3,3,2,-1,-1,2,1,16.0,15.0,1.0,10
3214,3214,2008-09,2008,2009,Bolton,Hull,Draw,Home,2009-05-16,1,2,3,3,3,0,0,0,0,2,3,3,3,1,16.0,21.0,-5.0,10
3215,3215,2008-09,2008,2009,Bolton,Man City,Loss,Away,2009-05-24,0,2,3,4,4,0,3,6,9,2,0,-2,-5,0,16.0,9.0,7.0,10
3216,3216,2009-10,2009,2010,Bolton,Sunderland,Loss,Home,2009-08-15,0,1,2,3,4,0,1,1,1,1,1,2,3,1,13.0,16.0,-3.0,1
3217,3217,2009-10,2009,2010,Bolton,Hull,Loss,Away,2009-08-22,0,0,1,2,3,0,0,1,1,0,1,1,2,0,13.0,17.0,-4.0,1
3218,3218,2009-10,2009,2010,Bolton,Liverpool,Loss,Home,2009-08-29,0,0,0,1,2,3,3,6,9,-3,-3,-5,-7,1,13.0,2.0,11.0,1
3219,3219,2009-10,2009,2010,Bolton,Portsmouth,Win,Away,2009-09-12,3,0,0,0,1,0,0,0,0,0,0,0,1,0,13.0,14.0,-1.0,2
3220,3220,2009-10,2009,2010,Bolton,Stoke,Draw,Home,2009-09-19,1,3,3,3,3,3,4,4,7,0,-1,-1,-4,1,13.0,12.0,1.0,2
3221,3221,2009-10,2009,2010,Bolton,Birmingham,Win,Away,2009-09-26,3,4,4,4,4,3,3,4,7,1,1,0,-3,0,13.0,21.0,-8.0,2
3222,3222,2009-10,2009,2010,Bolton,Tottenham,Draw,Home,2009-10-03,1,4,7,7,7,3,3,6,9,1,4,1,-2,1,13.0,8.0,5.0,3
3223,3223,2009-10,2009,2010,Bolton,Man United,Loss,Away,2009-10-17,0,4,5,8,8,4,7,10,13,0,-2,-2,-5,0,13.0,1.0,12.0,3
3224,3224,2009-10,2009,2010,Bolton,Everton,Win,Home,2009-10-25,3,1,4,5,8,2,5,8,8,-1,-1,-3,0,1,13.0,5.0,8.0,3
3225,3225,2009-10,2009,2010,Bolton,Chelsea,Loss,Home,2009-10-31,0,3,4,7,8,3,6,6,9,0,-2,1,-1,1,13.0,3.0,10.0,3
3226,3226,2009-10,2009,2010,Bolton,Aston Villa,Loss,Away,2009-11-07,0,3,3,4,7,1,2,5,6,2,1,-1,1,0,13.0,6.0,7.0,4
3227,3227,2009-10,2009,2010,Bolton,Blackburn,Loss,Home,2009-11-22,0,0,3,3,4,3,3,6,6,-3,0,-3,-2,1,13.0,15.0,-2.0,4
3228,3228,2009-10,2009,2010,Bolton,Fulham,Draw,Away,2009-11-28,1,0,0,3,3,3,4,7,8,-3,-4,-4,-5,0,13.0,7.0,6.0,4
3229,3229,2009-10,2009,2010,Bolton,Wolves,Loss,Away,2009-12-05,0,1,1,1,4,0,0,1,2,1,1,0,2,0,13.0,21.0,-8.0,5
3230,3230,2009-10,2009,2010,Bolton,Man City,Draw,Home,2009-12-12,1,1,1,1,1,4,5,6,7,-3,-4,-5,-6,1,13.0,10.0,3.0,5
3231,3231,2009-10,2009,2010,Bolton,West Ham,Win,Home,2009-12-15,3,1,2,2,2,0,3,4,4,1,-1,-2,-2,1,13.0,9.0,4.0,5
3232,3232,2009-10,2009,2010,Bolton,Burnley,Draw,Away,2009-12-26,1,4,4,5,5,1,2,2,2,3,2,3,3,0,13.0,21.0,-8.0,5
3233,3233,2009-10,2009,2010,Bolton,Hull,Draw,Home,2009-12-29,1,4,5,5,6,0,1,1,2,4,4,4,4,1,13.0,17.0,-4.0,5
3234,3234,2009-10,2009,2010,Bolton,Arsenal,Loss,Home,2010-01-17,0,2,5,6,6,4,7,10,11,-2,-2,-4,-5,1,13.0,4.0,9.0,6
3235,3235,2009-10,2009,2010,Bolton,Arsenal,Loss,Away,2010-01-20,0,1,2,5,6,4,7,10,13,-3,-5,-5,-7,0,13.0,4.0,9.0,6
3236,3236,2009-10,2009,2010,Bolton,Burnley,Win,Home,2010-01-26,3,0,1,2,5,0,1,1,2,0,0,1,3,1,13.0,21.0,-8.0,6
3237,3237,2009-10,2009,2010,Bolton,Liverpool,Loss,Away,2010-01-30,0,3,3,4,5,4,5,8,11,-1,-2,-4,-6,0,13.0,2.0,11.0,6
3238,3238,2009-10,2009,2010,Bolton,Fulham,Draw,Home,2010-02-06,1,3,3,3,4,3,3,3,3,0,0,0,1,1,13.0,7.0,6.0,7
3239,3239,2009-10,2009,2010,Bolton,Man City,Loss,Away,2010-02-09,0,1,4,4,4,3,3,6,9,-2,1,-2,-5,0,13.0,10.0,3.0,7
3240,3240,2009-10,2009,2010,Bolton,Wigan,Draw,Away,2010-02-17,1,1,1,4,4,2,2,2,5,-1,-1,2,-1,0,13.0,11.0,2.0,7
3241,3241,2009-10,2009,2010,Bolton,Blackburn,Loss,Away,2010-02-21,0,1,2,2,5,3,4,7,10,-2,-2,-5,-5,0,13.0,15.0,-2.0,7
3242,3242,2009-10,2009,2010,Bolton,Wolves,Win,Home,2010-02-27,3,1,1,2,2,3,3,4,5,-2,-2,-2,-3,1,13.0,21.0,-8.0,7
3243,3243,2009-10,2009,2010,Bolton,West Ham,Win,Away,2010-03-06,3,3,4,4,5,3,6,6,7,0,-2,-2,-2,0,13.0,9.0,4.0,8
3244,3244,2009-10,2009,2010,Bolton,Sunderland,Loss,Away,2010-03-09,0,6,6,7,7,1,2,3,4,5,4,4,3,0,13.0,16.0,-3.0,8
3245,3245,2009-10,2009,2010,Bolton,Wigan,Win,Home,2010-03-13,3,3,6,6,7,3,3,4,5,0,3,2,2,1,13.0,11.0,2.0,8
3246,3246,2009-10,2009,2010,Bolton,Everton,Loss,Away,2010-03-20,0,3,6,9,9,4,4,7,10,-1,2,2,-1,0,13.0,5.0,8.0,8
3247,3247,2009-10,2009,2010,Bolton,Man United,Loss,Home,2010-03-27,0,3,3,6,9,6,9,12,12,-3,-6,-6,-3,1,13.0,1.0,12.0,8
3248,3248,2009-10,2009,2010,Bolton,Aston Villa,Loss,Home,2010-04-03,0,0,3,3,6,1,2,5,6,-1,1,-2,0,1,13.0,6.0,7.0,9
3249,3249,2009-10,2009,2010,Bolton,Chelsea,Loss,Away,2010-04-13,0,0,0,3,3,6,9,10,13,-6,-9,-7,-10,0,13.0,3.0,10.0,9
3250,3250,2009-10,2009,2010,Bolton,Stoke,Win,Away,2010-04-17,3,0,0,0,3,4,7,7,8,-4,-7,-7,-5,0,13.0,12.0,1.0,9
3251,3251,2009-10,2009,2010,Bolton,Portsmouth,Draw,Home,2010-04-24,1,3,3,3,3,1,2,2,2,2,1,1,1,1,13.0,14.0,-1.0,9
3252,3252,2009-10,2009,2010,Bolton,Tottenham,Loss,Away,2010-05-01,0,4,4,4,4,3,6,6,9,1,-2,-2,-5,0,13.0,8.0,5.0,10
3253,3253,2009-10,2009,2010,Bolton,Birmingham,Win,Home,2010-05-09,3,1,4,4,4,3,4,4,5,-2,0,0,-1,1,13.0,21.0,-8.0,10
3254,3254,2010-11,2010,2011,Bolton,Fulham,Draw,Home,2010-08-14,1,3,4,7,7,0,3,3,4,3,1,4,3,1,14.0,12.0,2.0,1
3255,3255,2010-11,2010,2011,Bolton,West Ham,Win,Away,2010-08-21,3,4,4,5,8,1,1,4,4,3,3,1,4,0,14.0,17.0,-3.0,1
3256,3256,2010-11,2010,2011,Bolton,Birmingham,Draw,Home,2010-08-29,1,4,7,7,8,4,4,7,7,0,3,0,1,1,14.0,9.0,5.0,1
3257,3257,2010-11,2010,2011,Bolton,Arsenal,Loss,Away,2010-09-11,0,4,5,8,8,6,7,10,10,-2,-2,-2,-2,0,14.0,3.0,11.0,2
3258,3258,2010-11,2010,2011,Bolton,Aston Villa,Draw,Away,2010-09-18,1,1,4,5,8,3,3,6,6,-2,1,-1,2,0,14.0,6.0,8.0,2
3259,3259,2010-11,2010,2011,Bolton,Man United,Draw,Home,2010-09-26,1,1,2,5,6,4,7,8,11,-3,-5,-3,-5,1,14.0,2.0,12.0,2
3260,3260,2010-11,2010,2011,Bolton,West Brom,Draw,Away,2010-10-02,1,2,2,3,6,6,7,7,10,-4,-5,-4,-4,0,14.0,21.0,-7.0,3
3261,3261,2010-11,2010,2011,Bolton,Stoke,Win,Home,2010-10-16,3,2,3,3,4,6,7,10,10,-4,-4,-7,-6,1,14.0,11.0,3.0,3
3262,3262,2010-11,2010,2011,Bolton,Wigan,Draw,Away,2010-10-23,1,4,5,6,6,4,5,5,6,0,0,1,0,0,14.0,16.0,-2.0,3
3263,3263,2010-11,2010,2011,Bolton,Liverpool,Loss,Home,2010-10-31,0,4,5,6,7,3,3,4,4,1,2,2,3,1,14.0,7.0,7.0,3
3264,3264,2010-11,2010,2011,Bolton,Tottenham,Win,Home,2010-11-06,3,1,4,5,6,1,4,7,7,0,0,-2,-1,1,14.0,4.0,10.0,4
3265,3265,2010-11,2010,2011,Bolton,Everton,Draw,Away,2010-11-10,1,3,4,7,8,4,5,8,11,-1,-1,-1,-3,0,14.0,8.0,6.0,4
3266,3266,2010-11,2010,2011,Bolton,Wolves,Win,Away,2010-11-13,3,4,4,5,8,0,3,3,4,4,1,2,4,0,14.0,15.0,-1.0,4
3267,3267,2010-11,2010,2011,Bolton,Newcastle,Win,Home,2010-11-20,3,4,7,7,8,1,4,7,10,3,3,0,-2,1,14.0,21.0,-7.0,4
3268,3268,2010-11,2010,2011,Bolton,Blackpool,Draw,Home,2010-11-27,1,6,7,10,10,4,4,5,8,2,3,5,2,1,14.0,21.0,-7.0,4
3269,3269,2010-11,2010,2011,Bolton,Man City,Loss,Away,2010-12-04,0,4,7,8,11,4,5,6,9,0,2,2,2,0,14.0,5.0,9.0,5
3270,3270,2010-11,2010,2011,Bolton,Blackburn,Win,Home,2010-12-12,3,1,4,7,8,3,6,6,9,-2,-2,1,-1,1,14.0,10.0,4.0,5
3271,3271,2010-11,2010,2011,Bolton,Sunderland,Loss,Away,2010-12-18,0,3,4,7,10,4,4,5,8,-1,0,2,2,0,14.0,13.0,1.0,5
3272,3272,2010-11,2010,2011,Bolton,West Brom,Win,Home,2010-12-26,3,3,3,4,7,3,6,6,6,0,-3,-2,1,1,14.0,21.0,-7.0,5
3273,3273,2010-11,2010,2011,Bolton,Chelsea,Loss,Away,2010-12-29,0,3,6,6,7,1,2,3,3,2,4,3,4,0,14.0,1.0,13.0,5
3274,3274,2010-11,2010,2011,Bolton,Liverpool,Loss,Away,2011-01-01,0,3,3,6,6,0,3,3,6,3,0,3,0,0,14.0,7.0,7.0,6
3275,3275,2010-11,2010,2011,Bolton,Wigan,Draw,Home,2011-01-05,1,0,3,3,6,1,4,5,6,-1,-1,-2,0,1,14.0,16.0,-2.0,6
3276,3276,2010-11,2010,2011,Bolton,Stoke,Loss,Away,2011-01-15,0,1,1,4,4,3,3,6,6,-2,-2,-2,-2,0,14.0,11.0,3.0,6
3277,3277,2010-11,2010,2011,Bolton,Chelsea,Loss,Home,2011-01-24,0,1,1,1,4,3,4,7,7,-2,-3,-6,-3,1,14.0,1.0,13.0,6
3278,3278,2010-11,2010,2011,Bolton,Wolves,Win,Home,2011-02-02,3,0,1,1,1,0,3,3,6,0,-2,-2,-5,1,14.0,15.0,-1.0,7
3279,3279,2010-11,2010,2011,Bolton,Tottenham,Loss,Away,2011-02-05,0,3,3,4,4,4,5,5,8,-1,-2,-1,-4,0,14.0,4.0,10.0,7
3280,3280,2010-11,2010,2011,Bolton,Everton,Win,Home,2011-02-13,3,3,3,3,4,3,4,5,8,0,-1,-2,-4,1,14.0,8.0,6.0,7
3281,3281,2010-11,2010,2011,Bolton,Newcastle,Draw,Away,2011-02-26,1,3,6,6,6,4,5,5,6,-1,1,1,0,0,14.0,21.0,-7.0,7
3282,3282,2010-11,2010,2011,Bolton,Aston Villa,Win,Home,2011-03-05,3,4,4,7,7,4,5,5,8,0,-1,2,-1,1,14.0,6.0,8.0,8
3283,3283,2010-11,2010,2011,Bolton,Man United,Loss,Away,2011-03-19,0,4,7,7,10,0,3,6,6,4,4,1,4,0,14.0,2.0,12.0,8
3284,3284,2010-11,2010,2011,Bolton,Birmingham,Loss,Away,2011-04-02,0,3,4,7,7,1,1,1,4,2,3,6,3,0,14.0,9.0,5.0,9
3285,3285,2010-11,2010,2011,Bolton,West Ham,Win,Home,2011-04-09,3,0,3,4,7,1,4,7,8,-1,-1,-3,-1,1,14.0,17.0,-3.0,9
3286,3286,2010-11,2010,2011,Bolton,Arsenal,Win,Home,2011-04-24,3,3,3,6,7,2,5,6,7,1,-2,0,0,1,14.0,3.0,11.0,9
3287,3287,2010-11,2010,2011,Bolton,Fulham,Loss,Away,2011-04-27,0,6,6,6,9,1,4,4,7,5,2,2,2,0,14.0,12.0,2.0,9
3288,3288,2010-11,2010,2011,Bolton,Blackburn,Loss,Away,2011-04-30,0,3,6,6,6,0,1,2,3,3,5,4,3,0,14.0,10.0,4.0,9
3289,3289,2010-11,2010,2011,Bolton,Sunderland,Loss,Home,2011-05-07,0,0,3,6,6,3,3,3,3,-3,0,3,3,1,14.0,13.0,1.0,10
3290,3290,2010-11,2010,2011,Bolton,Blackpool,Loss,Away,2011-05-14,0,0,0,3,6,2,3,3,3,-2,-3,0,3,0,14.0,21.0,-7.0,10
3291,3291,2010-11,2010,2011,Bolton,Man City,Loss,Home,2011-05-22,0,0,0,0,3,6,6,9,12,-6,-6,-9,-9,1,14.0,5.0,9.0,10
3292,3292,2011-12,2011,2012,Bolton,QPR,Win,Away,2011-08-13,3,0,0,0,0,3,3,6,6,-3,-3,-6,-6,0,14.0,21.0,-7.0,1
3293,3293,2011-12,2011,2012,Bolton,Man City,Loss,Home,2011-08-21,0,3,3,3,3,6,9,12,12,-3,-6,-9,-9,1,14.0,3.0,11.0,1
3294,3294,2011-12,2011,2012,Bolton,Liverpool,Loss,Away,2011-08-27,0,3,3,3,3,4,4,4,7,-1,-1,-1,-4,0,14.0,6.0,8.0,1
3295,3295,2011-12,2011,2012,Bolton,Man United,Loss,Home,2011-09-10,0,0,3,3,3,6,9,12,13,-6,-6,-9,-10,1,14.0,1.0,13.0,2
3296,3296,2011-12,2011,2012,Bolton,Norwich,Loss,Home,2011-09-17,0,0,0,3,3,0,1,2,2,0,-1,1,1,1,14.0,21.0,-7.0,2
3297,3297,2011-12,2011,2012,Bolton,Arsenal,Loss,Away,2011-09-24,0,0,0,0,3,3,3,3,4,-3,-3,-3,-1,0,14.0,4.0,10.0,2
3298,3298,2011-12,2011,2012,Bolton,Chelsea,Loss,Home,2011-10-02,0,0,0,0,0,3,6,9,12,-3,-6,-9,-12,1,14.0,2.0,12.0,3
3299,3299,2011-12,2011,2012,Bolton,Wigan,Win,Away,2011-10-15,3,0,0,0,0,0,0,0,3,0,0,0,-3,0,14.0,16.0,-2.0,3
3300,3300,2011-12,2011,2012,Bolton,Sunderland,Loss,Home,2011-10-22,0,3,3,3,3,1,1,4,4,2,2,-1,-1,1,14.0,10.0,4.0,3
3301,3301,2011-12,2011,2012,Bolton,Swansea,Loss,Away,2011-10-29,0,3,3,3,3,1,4,4,7,2,-1,-1,-4,0,14.0,21.0,-7.0,3
3302,3302,2011-12,2011,2012,Bolton,Stoke,Win,Home,2011-11-06,3,0,3,3,3,0,3,3,4,0,0,0,-1,1,14.0,13.0,1.0,4
3303,3303,2011-12,2011,2012,Bolton,West Brom,Loss,Away,2011-11-19,0,3,3,6,6,0,3,6,7,3,0,0,-1,0,14.0,11.0,3.0,4
3304,3304,2011-12,2011,2012,Bolton,Everton,Loss,Home,2011-11-26,0,3,3,3,6,3,3,6,6,0,0,-3,0,1,14.0,7.0,7.0,4
3305,3305,2011-12,2011,2012,Bolton,Tottenham,Loss,Away,2011-12-03,0,0,3,3,3,6,9,12,15,-6,-6,-9,-12,0,14.0,5.0,9.0,5
3306,3306,2011-12,2011,2012,Bolton,Aston Villa,Loss,Home,2011-12-10,0,0,0,3,3,1,1,4,5,-1,-1,-1,-2,1,14.0,9.0,5.0,5
3307,3307,2011-12,2011,2012,Bolton,Fulham,Loss,Away,2011-12-17,0,0,0,0,3,3,4,5,5,-3,-4,-5,-2,0,14.0,8.0,6.0,5
3308,3308,2011-12,2011,2012,Bolton,Blackburn,Win,Away,2011-12-20,3,0,0,0,0,0,3,3,4,0,-3,-3,-4,0,14.0,15.0,-1.0,5
3309,3309,2011-12,2011,2012,Bolton,Newcastle,Loss,Home,2011-12-26,0,3,3,3,3,1,1,1,2,2,2,2,1,1,14.0,12.0,2.0,5
3310,3310,2011-12,2011,2012,Bolton,Wolves,Draw,Home,2011-12-31,1,3,3,3,3,2,2,2,5,1,1,1,-2,1,14.0,17.0,-3.0,5
3311,3311,2011-12,2011,2012,Bolton,Everton,Win,Away,2012-01-04,3,1,4,4,4,4,7,8,8,-3,-3,-4,-4,0,14.0,7.0,7.0,6
3312,3312,2011-12,2011,2012,Bolton,Man United,Loss,Away,2012-01-14,0,4,4,7,7,0,3,6,9,4,1,1,-2,0,14.0,1.0,13.0,6
3313,3313,2011-12,2011,2012,Bolton,Liverpool,Win,Home,2012-01-21,3,3,4,4,7,1,4,5,6,2,0,-1,1,1,14.0,6.0,8.0,6
3314,3314,2011-12,2011,2012,Bolton,Arsenal,Draw,Home,2012-02-01,1,3,6,7,7,0,0,3,4,3,6,4,3,1,14.0,4.0,10.0,7
3315,3315,2011-12,2011,2012,Bolton,Norwich,Loss,Away,2012-02-04,0,4,4,7,8,1,4,7,8,3,0,0,0,0,14.0,21.0,-7.0,7
3316,3316,2011-12,2011,2012,Bolton,Wigan,Loss,Home,2012-02-11,0,1,4,4,7,1,1,1,1,0,3,3,6,1,14.0,16.0,-2.0,7
3317,3317,2011-12,2011,2012,Bolton,Chelsea,Loss,Away,2012-02-25,0,0,1,4,4,1,2,3,6,-1,-1,1,-2,0,14.0,2.0,12.0,7
3318,3318,2011-12,2011,2012,Bolton,Man City,Loss,Away,2012-03-03,0,0,0,1,4,6,9,9,12,-6,-9,-8,-8,0,14.0,3.0,11.0,8
3319,3319,2011-12,2011,2012,Bolton,QPR,Win,Home,2012-03-10,3,0,0,0,1,1,1,1,2,-1,-1,-1,-1,1,14.0,21.0,-7.0,8
3320,3320,2011-12,2011,2012,Bolton,Blackburn,Win,Home,2012-03-24,3,3,3,3,3,6,7,7,10,-3,-4,-4,-7,1,14.0,15.0,-1.0,8
3321,3321,2011-12,2011,2012,Bolton,Wolves,Win,Away,2012-03-31,3,6,6,6,6,0,0,0,1,6,6,6,5,0,14.0,17.0,-3.0,8
3322,3322,2011-12,2011,2012,Bolton,Fulham,Loss,Home,2012-04-07,0,6,9,9,9,3,3,3,6,3,6,6,3,1,14.0,8.0,6.0,9
3323,3323,2011-12,2011,2012,Bolton,Newcastle,Loss,Away,2012-04-09,0,3,6,9,9,6,9,12,12,-3,-3,-3,-3,0,14.0,12.0,2.0,9
3324,3324,2011-12,2011,2012,Bolton,Swansea,Draw,Home,2012-04-21,1,0,3,6,9,3,3,3,3,-3,0,3,6,1,14.0,21.0,-7.0,9
3325,3325,2011-12,2011,2012,Bolton,Aston Villa,Win,Away,2012-04-24,3,1,1,4,7,1,2,3,3,0,-1,1,4,0,14.0,9.0,5.0,9
3326,3326,2011-12,2011,2012,Bolton,Sunderland,Draw,Away,2012-04-28,1,4,4,4,7,2,2,3,4,2,2,1,3,0,14.0,10.0,4.0,9
3327,3327,2011-12,2011,2012,Bolton,Tottenham,Loss,Home,2012-05-02,0,4,5,5,5,3,3,4,7,1,2,1,-2,1,14.0,5.0,9.0,10
3328,3328,2011-12,2011,2012,Bolton,West Brom,Draw,Home,2012-05-06,1,1,4,5,5,4,7,7,10,-3,-3,-2,-5,1,14.0,11.0,3.0,10
3329,3329,2011-12,2011,2012,Bolton,Stoke,Draw,Away,2012-05-13,1,1,2,5,6,1,2,2,3,0,0,3,3,0,14.0,13.0,1.0,10
3330,3330,2015-16,2015,2016,Bournemouth,Aston Villa,Loss,Home,2015-08-08,0,0,0,0,0,0,3,6,6,0,-3,-6,-6,1,21.0,17.0,4.0,1
3331,3331,2015-16,2015,2016,Bournemouth,Liverpool,Loss,Away,2015-08-17,0,0,0,0,0,3,3,4,7,-3,-3,-4,-7,0,21.0,6.0,15.0,1
3332,3332,2015-16,2015,2016,Bournemouth,West Ham,Win,Away,2015-08-22,3,0,0,0,0,3,3,3,3,-3,-3,-3,-3,0,21.0,12.0,9.0,1
3333,3333,2015-16,2015,2016,Bournemouth,Leicester,Draw,Home,2015-08-29,1,3,3,3,3,4,7,10,11,-1,-4,-7,-8,1,21.0,14.0,7.0,1
3334,3334,2015-16,2015,2016,Bournemouth,Norwich,Loss,Away,2015-09-12,0,4,4,4,4,1,4,4,4,3,0,0,0,0,21.0,21.0,0.0,2
3335,3335,2015-16,2015,2016,Bournemouth,Sunderland,Win,Home,2015-09-19,3,1,4,4,4,1,2,2,2,0,2,2,2,1,21.0,16.0,5.0,2
3336,3336,2015-16,2015,2016,Bournemouth,Stoke,Loss,Away,2015-09-26,0,3,4,7,7,1,1,2,3,2,3,5,4,0,21.0,9.0,12.0,2
3337,3337,2015-16,2015,2016,Bournemouth,Watford,Draw,Home,2015-10-03,1,3,3,4,7,3,6,6,7,0,-3,-2,0,1,21.0,21.0,0.0,3
3338,3338,2015-16,2015,2016,Bournemouth,Man City,Loss,Away,2015-10-17,0,1,4,4,5,3,3,6,9,-2,1,-2,-4,0,21.0,2.0,19.0,3
3339,3339,2015-16,2015,2016,Bournemouth,Tottenham,Loss,Home,2015-10-25,0,1,1,4,4,2,5,8,11,-1,-4,-4,-7,1,21.0,5.0,16.0,3
3340,3340,2015-16,2015,2016,Bournemouth,Southampton,Loss,Away,2015-11-01,0,0,1,1,4,2,5,8,8,-2,-4,-7,-4,0,21.0,7.0,14.0,4
3341,3341,2015-16,2015,2016,Bournemouth,Newcastle,Loss,Home,2015-11-07,0,0,0,1,1,1,4,4,5,-1,-4,-3,-4,1,21.0,15.0,6.0,4
3342,3342,2015-16,2015,2016,Bournemouth,Swansea,Draw,Away,2015-11-21,1,0,0,0,1,0,3,3,4,0,-3,-3,-3,0,21.0,8.0,13.0,4
3343,3343,2015-16,2015,2016,Bournemouth,Everton,Draw,Home,2015-11-28,1,1,1,1,1,4,7,7,7,-3,-6,-6,-6,1,21.0,11.0,10.0,4
3344,3344,2015-16,2015,2016,Bournemouth,Chelsea,Win,Away,2015-12-05,3,2,2,2,2,4,4,4,4,-2,-2,-2,-2,0,21.0,1.0,20.0,5
3345,3345,2015-16,2015,2016,Bournemouth,Man United,Win,Home,2015-12-12,3,4,5,5,5,2,5,8,9,2,0,-3,-4,1,21.0,4.0,17.0,5
3346,3346,2015-16,2015,2016,Bournemouth,West Brom,Win,Away,2015-12-19,3,6,7,8,8,2,3,6,6,4,4,2,2,0,21.0,13.0,8.0,5
3347,3347,2015-16,2015,2016,Bournemouth,Crystal Palace,Draw,Home,2015-12-26,1,6,9,10,11,6,7,10,10,0,2,0,1,1,21.0,10.0,11.0,5
3348,3348,2015-16,2015,2016,Bournemouth,Arsenal,Loss,Away,2015-12-28,0,4,7,10,11,3,6,9,10,1,1,1,1,0,21.0,3.0,18.0,5
3349,3349,2015-16,2015,2016,Bournemouth,Leicester,Draw,Away,2016-01-02,1,1,4,7,10,1,4,7,10,0,0,0,0,0,21.0,14.0,7.0,6
3350,3350,2015-16,2015,2016,Bournemouth,West Ham,Loss,Home,2016-01-12,0,1,2,5,8,6,7,8,9,-5,-5,-3,-1,1,21.0,12.0,9.0,6
3351,3351,2015-16,2015,2016,Bournemouth,Norwich,Win,Home,2016-01-16,3,1,1,2,5,3,6,6,9,-2,-5,-4,-4,1,21.0,21.0,0.0,6
3352,3352,2015-16,2015,2016,Bournemouth,Sunderland,Draw,Away,2016-01-23,1,3,4,4,5,3,6,6,6,0,-2,-2,-1,0,21.0,16.0,5.0,6
3353,3353,2015-16,2015,2016,Bournemouth,Crystal Palace,Win,Away,2016-02-02,3,4,4,5,5,0,0,0,1,4,4,5,4,0,21.0,10.0,11.0,7
3354,3354,2015-16,2015,2016,Bournemouth,Arsenal,Loss,Home,2016-02-07,0,4,7,7,8,1,2,3,6,3,5,4,2,1,21.0,3.0,18.0,7
3355,3355,2015-16,2015,2016,Bournemouth,Stoke,Loss,Home,2016-02-13,0,3,4,7,7,0,0,1,4,3,4,6,3,1,21.0,9.0,12.0,7
3356,3356,2015-16,2015,2016,Bournemouth,Watford,Draw,Away,2016-02-27,1,0,3,4,7,3,4,7,7,-3,-1,-3,0,0,21.0,21.0,0.0,7
3357,3357,2015-16,2015,2016,Bournemouth,Southampton,Win,Home,2016-03-01,3,1,1,4,5,3,6,7,10,-2,-5,-3,-5,1,21.0,7.0,14.0,8
3358,3358,2015-16,2015,2016,Bournemouth,Newcastle,Win,Away,2016-03-05,3,4,4,4,7,0,3,3,3,4,1,1,4,0,21.0,15.0,6.0,8
3359,3359,2015-16,2015,2016,Bournemouth,Swansea,Win,Home,2016-03-12,3,6,7,7,7,6,6,6,7,0,1,1,0,1,21.0,8.0,13.0,8
3360,3360,2015-16,2015,2016,Bournemouth,Tottenham,Loss,Away,2016-03-20,0,6,9,10,10,4,4,7,10,2,5,3,0,0,21.0,5.0,16.0,8
3361,3361,2015-16,2015,2016,Bournemouth,Man City,Loss,Home,2016-04-02,0,3,6,9,10,1,4,4,4,2,2,5,6,1,21.0,2.0,19.0,9
3362,3362,2015-16,2015,2016,Bournemouth,Aston Villa,Win,Away,2016-04-09,3,0,3,6,9,0,0,0,0,0,3,6,9,0,21.0,17.0,4.0,9
3363,3363,2015-16,2015,2016,Bournemouth,Liverpool,Loss,Home,2016-04-17,0,3,3,6,9,4,4,7,10,-1,-1,-1,-1,1,21.0,6.0,15.0,9
3364,3364,2015-16,2015,2016,Bournemouth,Chelsea,Loss,Home,2016-04-23,0,3,3,3,6,0,3,4,5,3,0,-1,1,1,21.0,1.0,20.0,9
3365,3365,2015-16,2015,2016,Bournemouth,Everton,Loss,Away,2016-04-30,0,0,3,3,3,1,2,3,3,-1,1,0,0,0,21.0,11.0,10.0,9
3366,3366,2015-16,2015,2016,Bournemouth,West Brom,Draw,Home,2016-05-07,1,0,0,3,3,1,1,1,1,-1,-1,2,2,1,21.0,13.0,8.0,10
3367,3367,2015-16,2015,2016,Bournemouth,Man United,Loss,Away,2016-05-17,0,1,1,1,4,3,4,7,10,-2,-3,-6,-6,0,21.0,4.0,17.0,10
3368,3368,2016-17,2016,2017,Bournemouth,Man United,Loss,Home,2016-08-14,0,1,1,1,1,3,6,7,10,-2,-5,-6,-9,1,16.0,5.0,11.0,1
3369,3369,2016-17,2016,2017,Bournemouth,West Ham,Loss,Away,2016-08-21,0,0,1,1,1,0,3,3,6,0,-2,-2,-5,0,16.0,7.0,9.0,1
3370,3370,2016-17,2016,2017,Bournemouth,Crystal Palace,Draw,Away,2016-08-27,1,0,0,1,1,0,0,3,3,0,0,-2,-2,0,16.0,15.0,1.0,1
3371,3371,2016-17,2016,2017,Bournemouth,West Brom,Win,Home,2016-09-10,3,1,1,1,2,1,4,5,6,0,-3,-4,-4,1,16.0,14.0,2.0,2
3372,3372,2016-17,2016,2017,Bournemouth,Man City,Loss,Away,2016-09-17,0,4,4,4,4,6,9,12,13,-2,-5,-8,-9,0,16.0,4.0,12.0,2
3373,3373,2016-17,2016,2017,Bournemouth,Everton,Win,Home,2016-09-24,3,3,4,4,4,6,9,12,13,-3,-5,-8,-9,1,16.0,11.0,5.0,2
3374,3374,2016-17,2016,2017,Bournemouth,Watford,Draw,Away,2016-10-01,1,3,6,7,7,3,6,6,6,0,0,1,1,0,16.0,13.0,3.0,3
3375,3375,2016-17,2016,2017,Bournemouth,Hull,Win,Home,2016-10-15,3,4,4,7,8,0,0,1,1,4,4,6,7,1,16.0,21.0,-5.0,3
3376,3376,2016-17,2016,2017,Bournemouth,Tottenham,Draw,Home,2016-10-22,1,4,7,7,10,4,7,10,13,0,0,-3,-3,1,16.0,3.0,13.0,3
3377,3377,2016-17,2016,2017,Bournemouth,Middlesbrough,Loss,Away,2016-10-29,0,4,5,8,8,1,2,2,2,3,3,6,6,0,16.0,21.0,-5.0,3
3378,3378,2016-17,2016,2017,Bournemouth,Sunderland,Loss,Home,2016-11-05,0,1,4,5,8,0,0,1,1,1,4,4,7,1,16.0,17.0,-1.0,4
3379,3379,2016-17,2016,2017,Bournemouth,Stoke,Win,Away,2016-11-19,3,0,1,4,5,4,7,10,11,-4,-6,-6,-6,0,16.0,9.0,7.0,4
3380,3380,2016-17,2016,2017,Bournemouth,Arsenal,Loss,Away,2016-11-27,0,3,3,4,7,2,5,6,9,1,-2,-2,-2,0,16.0,2.0,14.0,4
3381,3381,2016-17,2016,2017,Bournemouth,Liverpool,Win,Home,2016-12-04,3,3,3,3,4,4,7,10,13,-1,-4,-7,-9,1,16.0,8.0,8.0,5
3382,3382,2016-17,2016,2017,Bournemouth,Burnley,Loss,Away,2016-12-10,0,3,6,6,6,0,0,3,4,3,6,3,2,0,16.0,21.0,-5.0,5
3383,3383,2016-17,2016,2017,Bournemouth,Leicester,Win,Home,2016-12-13,3,3,3,6,6,3,4,4,4,0,-1,2,2,1,16.0,1.0,15.0,5
3384,3384,2016-17,2016,2017,Bournemouth,Southampton,Loss,Home,2016-12-18,0,3,6,6,9,4,4,7,8,-1,2,-1,1,1,16.0,6.0,10.0,5
3385,3385,2016-17,2016,2017,Bournemouth,Chelsea,Loss,Away,2016-12-26,0,3,3,6,6,6,9,12,15,-3,-6,-6,-9,0,16.0,10.0,6.0,5
3386,3386,2016-17,2016,2017,Bournemouth,Swansea,Win,Away,2016-12-31,3,0,3,3,6,0,0,3,3,0,3,0,3,0,16.0,12.0,4.0,5
3387,3387,2016-17,2016,2017,Bournemouth,Arsenal,Draw,Home,2017-01-03,1,3,3,6,6,6,6,6,9,-3,-3,0,-3,1,16.0,2.0,14.0,6
3388,3388,2016-17,2016,2017,Bournemouth,Hull,Loss,Away,2017-01-14,0,4,4,4,7,1,1,1,1,3,3,3,6,0,16.0,21.0,-5.0,6
3389,3389,2016-17,2016,2017,Bournemouth,Watford,Draw,Home,2017-01-21,1,1,4,4,4,1,1,2,2,0,3,2,2,1,16.0,13.0,3.0,6
3390,3390,2016-17,2016,2017,Bournemouth,Crystal Palace,Loss,Home,2017-01-31,0,1,2,5,5,0,0,0,1,1,2,5,4,1,16.0,15.0,1.0,6
3391,3391,2016-17,2016,2017,Bournemouth,Everton,Loss,Away,2017-02-04,0,1,1,2,5,4,7,10,11,-3,-6,-8,-6,0,16.0,11.0,5.0,7
3392,3392,2016-17,2016,2017,Bournemouth,Man City,Loss,Home,2017-02-13,0,0,1,1,2,6,7,7,10,-6,-6,-6,-8,1,16.0,4.0,12.0,7
3393,3393,2016-17,2016,2017,Bournemouth,West Brom,Loss,Away,2017-02-25,0,0,0,1,1,4,5,8,8,-4,-5,-7,-7,0,16.0,14.0,2.0,7
3394,3394,2016-17,2016,2017,Bournemouth,Man United,Draw,Away,2017-03-04,1,0,0,0,1,6,7,8,9,-6,-7,-8,-8,0,16.0,5.0,11.0,8
3395,3395,2016-17,2016,2017,Bournemouth,West Ham,Win,Home,2017-03-11,3,1,1,1,1,1,2,5,5,0,-1,-4,-4,1,16.0,7.0,9.0,8
3396,3396,2016-17,2016,2017,Bournemouth,Swansea,Win,Home,2017-03-18,3,4,4,4,4,3,3,6,6,1,1,-2,-2,1,16.0,12.0,4.0,8
3397,3397,2016-17,2016,2017,Bournemouth,Southampton,Draw,Away,2017-04-01,1,6,7,7,7,3,6,6,6,3,1,1,1,0,16.0,6.0,10.0,9
3398,3398,2016-17,2016,2017,Bournemouth,Liverpool,Draw,Away,2017-04-05,1,4,7,8,8,4,7,10,10,0,0,-2,-2,0,16.0,8.0,8.0,9
3399,3399,2016-17,2016,2017,Bournemouth,Chelsea,Loss,Home,2017-04-08,0,2,5,8,9,3,6,9,12,-1,-1,-1,-3,1,16.0,10.0,6.0,9
3400,3400,2016-17,2016,2017,Bournemouth,Tottenham,Loss,Away,2017-04-15,0,1,2,5,8,6,9,12,15,-5,-7,-7,-7,0,16.0,3.0,13.0,9
3401,3401,2016-17,2016,2017,Bournemouth,Middlesbrough,Win,Home,2017-04-22,3,0,1,2,5,1,1,2,2,-1,0,0,3,1,16.0,21.0,-5.0,9
3402,3402,2016-17,2016,2017,Bournemouth,Sunderland,Win,Away,2017-04-29,3,3,3,4,5,1,1,1,1,2,2,3,4,0,16.0,17.0,-1.0,9
3403,3403,2016-17,2016,2017,Bournemouth,Stoke,Draw,Home,2017-05-06,1,6,6,6,7,1,4,4,4,5,2,2,3,1,16.0,9.0,7.0,10
3404,3404,2016-17,2016,2017,Bournemouth,Burnley,Win,Home,2017-05-13,3,4,7,7,7,4,4,4,5,0,3,3,2,1,16.0,21.0,-5.0,10
3405,3405,2016-17,2016,2017,Bournemouth,Leicester,Draw,Away,2017-05-21,1,4,7,10,10,0,3,6,6,4,4,4,4,0,16.0,1.0,15.0,10
3406,3406,2017-18,2017,2018,Bournemouth,West Brom,Loss,Away,2017-08-12,0,4,5,8,11,0,0,1,1,4,5,7,10,0,9.0,10.0,-1.0,1
3407,3407,2017-18,2017,2018,Bournemouth,Watford,Loss,Home,2017-08-19,0,1,4,5,8,1,1,1,1,0,3,4,7,1,9.0,17.0,-8.0,1
3408,3408,2017-18,2017,2018,Bournemouth,Man City,Loss,Home,2017-08-26,0,0,1,4,5,4,7,10,13,-4,-6,-6,-8,1,9.0,3.0,6.0,1
3409,3409,2017-18,2017,2018,Bournemouth,Arsenal,Loss,Away,2017-09-09,0,0,0,1,4,0,3,6,9,0,-3,-5,-5,0,9.0,5.0,4.0,2
3410,3410,2017-18,2017,2018,Bournemouth,Brighton,Win,Home,2017-09-15,3,0,0,0,1,4,4,4,4,-4,-4,-4,-3,1,9.0,21.0,-12.0,2
3411,3411,2017-18,2017,2018,Bournemouth,Everton,Loss,Away,2017-09-23,0,3,3,3,3,0,0,1,4,3,3,2,-1,0,9.0,7.0,2.0,2
3412,3412,2017-18,2017,2018,Bournemouth,Leicester,Draw,Home,2017-09-30,1,3,3,3,3,1,1,1,4,2,2,2,-1,1,9.0,12.0,-3.0,2
3413,3413,2017-18,2017,2018,Bournemouth,Tottenham,Loss,Away,2017-10-14,0,1,4,4,4,6,7,10,11,-5,-3,-6,-7,0,9.0,2.0,7.0,3
3414,3414,2017-18,2017,2018,Bournemouth,Stoke,Win,Away,2017-10-21,3,1,1,4,4,3,3,3,4,-2,-2,1,0,0,9.0,13.0,-4.0,3
3415,3415,2017-18,2017,2018,Bournemouth,Chelsea,Loss,Home,2017-10-28,0,3,4,4,7,3,3,6,7,0,1,-2,0,1,9.0,1.0,8.0,3
3416,3416,2017-18,2017,2018,Bournemouth,Newcastle,Win,Away,2017-11-04,3,3,3,4,4,3,4,5,5,0,-1,-1,-1,0,9.0,21.0,-12.0,4
3417,3417,2017-18,2017,2018,Bournemouth,Huddersfield,Win,Home,2017-11-18,3,3,6,6,7,3,6,6,6,0,0,0,1,1,9.0,21.0,-12.0,4
3418,3418,2017-18,2017,2018,Bournemouth,Swansea,Draw,Away,2017-11-25,1,6,6,9,9,0,0,0,3,6,6,9,6,0,9.0,15.0,-6.0,4
3419,3419,2017-18,2017,2018,Bournemouth,Burnley,Loss,Home,2017-11-29,0,4,7,7,10,3,6,9,9,1,1,-2,1,1,9.0,16.0,-7.0,4
3420,3420,2017-18,2017,2018,Bournemouth,Southampton,Draw,Home,2017-12-03,1,1,4,7,7,3,3,3,4,-2,1,4,3,1,9.0,8.0,1.0,5
3421,3421,2017-18,2017,2018,Bournemouth,Crystal Palace,Draw,Away,2017-12-09,1,1,2,5,8,2,5,6,6,-1,-3,-1,2,0,9.0,14.0,-5.0,5
3422,3422,2017-18,2017,2018,Bournemouth,Man United,Loss,Away,2017-12-13,0,2,2,3,6,3,6,9,12,-1,-4,-6,-6,0,9.0,6.0,3.0,5
3423,3423,2017-18,2017,2018,Bournemouth,Liverpool,Loss,Home,2017-12-17,0,1,2,2,3,2,5,8,9,-1,-3,-6,-6,1,9.0,4.0,5.0,5
3424,3424,2017-18,2017,2018,Bournemouth,Man City,Loss,Away,2017-12-23,0,0,1,2,2,6,9,12,15,-6,-8,-10,-13,0,9.0,3.0,6.0,5
3425,3425,2017-18,2017,2018,Bournemouth,West Ham,Draw,Home,2017-12-26,1,0,0,1,2,3,4,7,7,-3,-4,-6,-5,1,9.0,11.0,-2.0,5
3426,3426,2017-18,2017,2018,Bournemouth,Everton,Win,Home,2017-12-30,3,1,1,1,2,2,5,8,9,-1,-4,-7,-7,1,9.0,7.0,2.0,5
3427,3427,2017-18,2017,2018,Bournemouth,Brighton,Draw,Away,2018-01-01,1,4,4,4,4,1,4,5,5,3,0,-1,-1,0,9.0,21.0,-12.0,6
3428,3428,2017-18,2017,2018,Bournemouth,Arsenal,Win,Home,2018-01-14,3,4,5,5,5,2,5,6,9,2,0,-1,-4,1,9.0,5.0,4.0,6
3429,3429,2017-18,2017,2018,Bournemouth,West Ham,Draw,Away,2018-01-20,1,4,7,8,8,4,7,8,8,0,0,0,0,0,9.0,11.0,-2.0,6
3430,3430,2017-18,2017,2018,Bournemouth,Chelsea,Win,Away,2018-01-31,3,4,5,8,9,4,5,8,11,0,0,0,-2,0,9.0,1.0,8.0,6
3431,3431,2017-18,2017,2018,Bournemouth,Stoke,Win,Home,2018-02-03,3,4,7,8,11,4,4,4,4,0,3,4,7,1,9.0,13.0,-4.0,7
3432,3432,2017-18,2017,2018,Bournemouth,Huddersfield,Loss,Away,2018-02-11,0,6,7,10,11,0,0,0,0,6,7,10,11,0,9.0,21.0,-12.0,7
3433,3433,2017-18,2017,2018,Bournemouth,Newcastle,Draw,Home,2018-02-24,1,3,6,7,10,4,5,5,6,-1,1,2,4,1,9.0,21.0,-12.0,7
3434,3434,2017-18,2017,2018,Bournemouth,Leicester,Draw,Away,2018-03-03,1,1,4,7,8,1,2,2,5,0,2,5,3,0,9.0,12.0,-3.0,8
3435,3435,2017-18,2017,2018,Bournemouth,Tottenham,Loss,Home,2018-03-11,0,2,2,5,8,6,9,10,13,-4,-7,-5,-5,1,9.0,2.0,7.0,8
3436,3436,2017-18,2017,2018,Bournemouth,West Brom,Win,Home,2018-03-17,3,1,2,2,5,0,0,0,0,1,2,2,5,1,9.0,10.0,-1.0,8
3437,3437,2017-18,2017,2018,Bournemouth,Watford,Draw,Away,2018-03-31,1,3,4,5,5,0,3,6,6,3,1,-1,-1,0,9.0,17.0,-8.0,8
3438,3438,2017-18,2017,2018,Bournemouth,Crystal Palace,Draw,Home,2018-04-07,1,4,4,5,6,3,3,3,3,1,1,2,3,1,9.0,14.0,-5.0,9
3439,3439,2017-18,2017,2018,Bournemouth,Liverpool,Loss,Away,2018-04-14,0,2,5,5,6,4,7,7,10,-2,-2,-2,-4,0,9.0,4.0,5.0,9
3440,3440,2017-18,2017,2018,Bournemouth,Man United,Loss,Home,2018-04-18,0,1,2,5,5,3,6,9,12,-2,-4,-4,-7,1,9.0,6.0,3.0,9
3441,3441,2017-18,2017,2018,Bournemouth,Southampton,Loss,Away,2018-04-28,0,0,1,2,5,1,1,1,1,-1,0,1,4,0,9.0,8.0,1.0,9
3442,3442,2017-18,2017,2018,Bournemouth,Swansea,Win,Home,2018-05-05,3,0,0,1,2,0,1,2,2,0,-1,-1,0,1,9.0,15.0,-6.0,10
3443,3443,2017-18,2017,2018,Bournemouth,Burnley,Win,Away,2018-05-13,3,3,3,3,4,1,2,2,5,2,1,1,-1,0,9.0,16.0,-7.0,10
3444,3444,1999-00,1999,2000,Bradford,Middlesbrough,Win,Away,1999-08-07,3,0,0,0,0,0,1,1,4,0,-1,-1,-4,0,21.0,9.0,12.0,1
3445,3445,1999-00,1999,2000,Bradford,Sheffield Weds,Draw,Home,1999-08-14,1,3,3,3,3,0,3,6,6,3,0,-3,-3,1,21.0,12.0,9.0,1
3446,3446,1999-00,1999,2000,Bradford,Watford,Loss,Away,1999-08-21,0,4,4,4,4,3,3,3,3,1,1,1,1,0,21.0,21.0,0.0,1
3447,3447,1999-00,1999,2000,Bradford,Arsenal,Loss,Away,1999-08-25,0,1,4,4,4,1,4,7,10,0,0,-3,-6,0,21.0,2.0,19.0,1
3448,3448,1999-00,1999,2000,Bradford,West Ham,Loss,Home,1999-08-28,0,0,1,4,4,4,7,10,10,-4,-6,-6,-6,1,21.0,5.0,16.0,1
3449,3449,1999-00,1999,2000,Bradford,Tottenham,Draw,Home,1999-09-12,1,0,0,1,4,3,6,9,9,-3,-6,-8,-5,1,21.0,11.0,10.0,2
3450,3450,1999-00,1999,2000,Bradford,Aston Villa,Loss,Away,1999-09-18,0,1,1,1,2,3,6,6,7,-2,-5,-5,-5,0,21.0,6.0,15.0,2
3451,3451,1999-00,1999,2000,Bradford,Derby,Win,Away,1999-09-25,3,1,1,1,1,1,4,7,7,0,-3,-6,-6,0,21.0,8.0,13.0,2
3452,3452,1999-00,1999,2000,Bradford,Sunderland,Loss,Home,1999-10-02,0,3,4,4,4,6,9,10,13,-3,-5,-6,-9,1,21.0,21.0,0.0,3
3453,3453,1999-00,1999,2000,Bradford,Wimbledon,Loss,Away,1999-10-16,0,3,3,4,4,1,2,3,3,2,1,1,1,0,21.0,16.0,5.0,3
3454,3454,1999-00,1999,2000,Bradford,Leicester,Win,Home,1999-10-23,3,0,3,3,4,6,9,10,10,-6,-6,-7,-6,1,21.0,10.0,11.0,3
3455,3455,1999-00,1999,2000,Bradford,Liverpool,Loss,Away,1999-11-01,0,3,3,6,6,4,7,8,8,-1,-4,-2,-2,0,21.0,7.0,14.0,4
3456,3456,1999-00,1999,2000,Bradford,Coventry,Draw,Home,1999-11-06,1,3,3,3,6,4,7,8,11,-1,-4,-5,-5,1,21.0,15.0,6.0,4
3457,3457,1999-00,1999,2000,Bradford,Leeds,Loss,Away,1999-11-20,0,1,4,4,4,3,4,7,10,-2,0,-3,-6,0,21.0,4.0,17.0,4
3458,3458,1999-00,1999,2000,Bradford,Chelsea,Loss,Away,1999-11-28,0,1,1,4,4,2,2,2,2,-1,-1,2,2,0,21.0,3.0,18.0,4
3459,3459,1999-00,1999,2000,Bradford,Middlesbrough,Draw,Home,1999-12-04,1,0,1,1,4,1,2,5,8,-1,-1,-4,-4,1,21.0,9.0,12.0,5
3460,3460,1999-00,1999,2000,Bradford,Newcastle,Win,Home,1999-12-18,3,1,1,2,2,6,7,8,9,-5,-6,-6,-7,1,21.0,13.0,8.0,5
3461,3461,1999-00,1999,2000,Bradford,Man United,Loss,Away,1999-12-26,0,4,4,4,5,6,9,12,15,-2,-5,-8,-10,0,21.0,1.0,20.0,5
3462,3462,1999-00,1999,2000,Bradford,Everton,Draw,Home,1999-12-28,1,3,4,4,4,6,6,7,8,-3,-2,-3,-4,1,21.0,14.0,7.0,5
3463,3463,1999-00,1999,2000,Bradford,Southampton,Loss,Away,2000-01-03,0,1,4,5,5,0,0,1,1,1,4,4,4,0,21.0,17.0,4.0,6
3464,3464,1999-00,1999,2000,Bradford,Chelsea,Draw,Home,2000-01-08,1,1,1,4,5,4,7,7,7,-3,-6,-3,-2,1,21.0,3.0,18.0,6
3465,3465,1999-00,1999,2000,Bradford,Sheffield Weds,Loss,Away,2000-01-15,0,1,2,2,5,1,4,4,4,0,-2,-2,1,0,21.0,12.0,9.0,6
3466,3466,1999-00,1999,2000,Bradford,Watford,Win,Home,2000-01-22,3,1,1,2,2,0,3,3,3,1,-2,-1,-1,1,21.0,21.0,0.0,6
3467,3467,1999-00,1999,2000,Bradford,Arsenal,Win,Home,2000-02-05,3,3,4,4,5,4,5,8,8,-1,-1,-4,-3,1,21.0,2.0,19.0,7
3468,3468,1999-00,1999,2000,Bradford,West Ham,Loss,Away,2000-02-12,0,6,6,7,7,3,4,5,6,3,2,2,1,0,21.0,5.0,16.0,7
3469,3469,1999-00,1999,2000,Bradford,Aston Villa,Draw,Home,2000-02-26,1,3,6,6,7,6,7,8,11,-3,-1,-2,-4,1,21.0,6.0,15.0,7
3470,3470,1999-00,1999,2000,Bradford,Tottenham,Draw,Away,2000-03-04,1,1,4,7,7,3,3,3,4,-2,1,4,3,0,21.0,11.0,10.0,8
3471,3471,1999-00,1999,2000,Bradford,Leeds,Loss,Home,2000-03-12,0,2,2,5,8,4,4,7,7,-2,-2,-2,1,1,21.0,4.0,17.0,8
3472,3472,1999-00,1999,2000,Bradford,Coventry,Loss,Away,2000-03-18,0,1,2,2,5,3,3,3,3,-2,-1,-1,2,0,21.0,15.0,6.0,8
3473,3473,1999-00,1999,2000,Bradford,Man United,Loss,Home,2000-03-25,0,0,1,2,2,6,7,8,11,-6,-6,-6,-9,1,21.0,1.0,20.0,8
3474,3474,1999-00,1999,2000,Bradford,Newcastle,Loss,Away,2000-04-01,0,0,0,1,2,3,6,6,9,-3,-6,-5,-7,0,21.0,13.0,8.0,9
3475,3475,1999-00,1999,2000,Bradford,Southampton,Loss,Home,2000-04-08,0,0,0,0,1,1,4,4,4,-1,-4,-4,-3,1,21.0,17.0,4.0,9
3476,3476,1999-00,1999,2000,Bradford,Everton,Loss,Away,2000-04-15,0,0,0,0,0,4,4,4,4,-4,-4,-4,-4,0,21.0,14.0,7.0,9
3477,3477,1999-00,1999,2000,Bradford,Derby,Draw,Home,2000-04-21,1,0,0,0,0,1,4,4,4,-1,-4,-4,-4,1,21.0,8.0,13.0,9
3478,3478,1999-00,1999,2000,Bradford,Sunderland,Win,Away,2000-04-24,3,1,1,1,1,3,6,9,12,-2,-5,-8,-11,0,21.0,21.0,0.0,9
3479,3479,1999-00,1999,2000,Bradford,Wimbledon,Win,Home,2000-04-30,3,4,4,4,4,0,0,0,0,4,4,4,4,1,21.0,16.0,5.0,9
3480,3480,1999-00,1999,2000,Bradford,Leicester,Loss,Away,2000-05-06,0,6,7,7,7,6,7,7,10,0,0,0,-3,0,21.0,10.0,11.0,10
3481,3481,1999-00,1999,2000,Bradford,Liverpool,Win,Home,2000-05-14,3,3,6,7,7,1,1,2,5,2,5,5,2,1,21.0,7.0,14.0,10
3482,3482,2000-01,2000,2001,Bradford,Liverpool,Loss,Away,2000-08-19,0,3,6,9,10,1,1,1,2,2,5,8,8,0,17.0,4.0,13.0,1
3483,3483,2000-01,2000,2001,Bradford,Chelsea,Win,Home,2000-08-22,3,3,3,6,9,6,6,9,9,-3,-3,-3,0,1,17.0,5.0,12.0,1
3484,3484,2000-01,2000,2001,Bradford,Leicester,Draw,Home,2000-08-26,1,3,6,6,9,4,4,7,10,-1,2,-1,-1,1,17.0,8.0,9.0,1
3485,3485,2000-01,2000,2001,Bradford,Man United,Loss,Away,2000-09-05,0,4,4,7,7,2,5,8,11,2,-1,-1,-4,0,17.0,1.0,16.0,2
3486,3486,2000-01,2000,2001,Bradford,Arsenal,Draw,Home,2000-09-09,1,1,4,4,7,4,7,7,7,-3,-3,-3,0,1,17.0,2.0,15.0,2
3487,3487,2000-01,2000,2001,Bradford,Aston Villa,Loss,Away,2000-09-16,0,1,2,5,5,3,4,5,5,-2,-2,0,0,0,17.0,6.0,11.0,2
3488,3488,2000-01,2000,2001,Bradford,Southampton,Loss,Home,2000-09-23,0,1,1,2,5,3,4,5,5,-2,-3,-3,0,1,17.0,15.0,2.0,2
3489,3489,2000-01,2000,2001,Bradford,West Ham,Draw,Away,2000-09-30,1,0,1,1,2,4,4,5,6,-4,-3,-4,-4,0,17.0,9.0,8.0,2
3490,3490,2000-01,2000,2001,Bradford,Man City,Loss,Away,2000-10-14,0,1,1,2,2,1,2,2,5,0,-1,0,-3,0,17.0,21.0,-4.0,3
3491,3491,2000-01,2000,2001,Bradford,Ipswich,Loss,Home,2000-10-21,0,1,1,1,2,4,5,8,8,-3,-4,-7,-6,1,17.0,21.0,-4.0,3
3492,3492,2000-01,2000,2001,Bradford,Leeds,Draw,Home,2000-10-29,1,0,1,1,1,3,6,7,7,-3,-5,-6,-6,1,17.0,3.0,14.0,3
3493,3493,2000-01,2000,2001,Bradford,Charlton,Loss,Away,2000-11-04,0,1,1,2,2,3,3,4,7,-2,-2,-2,-5,0,17.0,21.0,-4.0,4
3494,3494,2000-01,2000,2001,Bradford,Everton,Loss,Home,2000-11-11,0,1,1,1,2,0,3,4,4,1,-2,-3,-2,1,17.0,13.0,4.0,4
3495,3495,2000-01,2000,2001,Bradford,Derby,Loss,Away,2000-11-18,0,0,1,1,1,2,2,2,2,-2,-1,-1,-1,0,17.0,16.0,1.0,4
3496,3496,2000-01,2000,2001,Bradford,Middlesbrough,Draw,Away,2000-11-25,1,0,0,1,1,0,0,0,0,0,0,1,1,0,17.0,12.0,5.0,4
3497,3497,2000-01,2000,2001,Bradford,Coventry,Win,Home,2000-12-02,3,1,1,1,2,1,1,1,1,0,0,0,1,1,17.0,14.0,3.0,5
3498,3498,2000-01,2000,2001,Bradford,Tottenham,Draw,Home,2000-12-09,1,4,4,4,4,3,6,6,9,1,-2,-2,-5,1,17.0,10.0,7.0,5
3499,3499,2000-01,2000,2001,Bradford,Newcastle,Loss,Away,2000-12-16,0,4,5,5,5,1,4,4,5,3,1,1,0,0,17.0,11.0,6.0,5
3500,3500,2000-01,2000,2001,Bradford,Chelsea,Loss,Away,2000-12-23,0,1,4,5,5,3,6,6,6,-2,-2,-1,-1,0,17.0,5.0,12.0,5
3501,3501,2000-01,2000,2001,Bradford,Sunderland,Loss,Home,2000-12-26,0,0,1,4,5,3,6,9,12,-3,-5,-5,-7,1,17.0,7.0,10.0,5
3502,3502,2000-01,2000,2001,Bradford,Leicester,Win,Away,2001-01-01,3,0,0,1,4,3,6,6,9,-3,-6,-5,-5,0,17.0,8.0,9.0,6
3503,3503,2000-01,2000,2001,Bradford,Man United,Loss,Home,2001-01-13,0,3,3,3,4,4,7,10,10,-1,-4,-7,-6,1,17.0,1.0,16.0,6
3504,3504,2000-01,2000,2001,Bradford,Sunderland,Draw,Away,2001-01-21,1,3,3,3,3,6,7,10,13,-3,-4,-7,-10,0,17.0,7.0,10.0,6
3505,3505,2000-01,2000,2001,Bradford,Arsenal,Loss,Away,2001-01-30,0,1,4,4,4,2,2,3,6,-1,2,1,-2,0,17.0,2.0,15.0,6
3506,3506,2000-01,2000,2001,Bradford,Aston Villa,Loss,Home,2001-02-03,0,1,1,4,4,0,0,0,0,1,1,4,4,1,17.0,6.0,11.0,7
3507,3507,2000-01,2000,2001,Bradford,Southampton,Loss,Away,2001-02-10,0,0,1,1,4,4,5,5,8,-4,-4,-4,-4,0,17.0,15.0,2.0,7
3508,3508,2000-01,2000,2001,Bradford,West Ham,Loss,Home,2001-02-24,0,0,0,1,1,1,2,3,3,-1,-2,-2,-2,1,17.0,9.0,8.0,7
3509,3509,2000-01,2000,2001,Bradford,Ipswich,Loss,Away,2001-03-04,0,0,0,0,1,3,3,3,6,-3,-3,-3,-5,0,17.0,21.0,-4.0,8
3510,3510,2000-01,2000,2001,Bradford,Man City,Draw,Home,2001-03-17,1,0,0,0,0,3,3,4,5,-3,-3,-4,-5,1,17.0,21.0,-4.0,8
3511,3511,2000-01,2000,2001,Bradford,Newcastle,Draw,Home,2001-03-31,1,1,1,1,1,1,1,1,1,0,0,0,0,1,17.0,11.0,6.0,8
3512,3512,2000-01,2000,2001,Bradford,Tottenham,Loss,Away,2001-04-10,0,2,2,2,2,3,3,3,6,-1,-1,-1,-4,0,17.0,10.0,7.0,9
3513,3513,2000-01,2000,2001,Bradford,Charlton,Win,Home,2001-04-13,3,1,2,2,2,3,3,4,5,-2,-1,-2,-3,1,17.0,21.0,-4.0,9
3514,3514,2000-01,2000,2001,Bradford,Derby,Win,Home,2001-04-21,3,3,4,5,5,3,3,3,4,0,1,2,1,1,17.0,16.0,1.0,9
3515,3515,2000-01,2000,2001,Bradford,Everton,Loss,Away,2001-04-28,0,6,6,7,8,0,0,3,6,6,6,4,2,0,17.0,13.0,4.0,9
3516,3516,2000-01,2000,2001,Bradford,Liverpool,Loss,Home,2001-05-01,0,3,6,6,7,6,9,9,10,-3,-3,-3,-3,1,17.0,4.0,13.0,10
3517,3517,2000-01,2000,2001,Bradford,Middlesbrough,Draw,Home,2001-05-05,1,0,3,6,6,3,3,6,7,-3,0,0,-1,1,17.0,12.0,5.0,10
3518,3518,2000-01,2000,2001,Bradford,Leeds,Loss,Away,2001-05-13,0,1,1,4,7,3,6,9,12,-2,-5,-5,-5,0,17.0,3.0,14.0,10
3519,3519,2000-01,2000,2001,Bradford,Coventry,Draw,Away,2001-05-19,1,1,1,1,4,0,0,3,3,1,1,-2,1,0,17.0,14.0,3.0,10
3520,3520,2017-18,2017,2018,Brighton,Man City,Loss,Home,2017-08-12,0,0,0,0,0,6,9,12,13,-6,-9,-12,-13,1,21.0,3.0,18.0,1
3521,3521,2017-18,2017,2018,Brighton,Leicester,Loss,Away,2017-08-19,0,0,0,0,0,1,1,1,4,-1,-1,-1,-4,0,21.0,12.0,9.0,1
3522,3522,2017-18,2017,2018,Brighton,Watford,Draw,Away,2017-08-26,1,0,0,0,0,4,4,4,4,-4,-4,-4,-4,0,21.0,17.0,4.0,1
3523,3523,2017-18,2017,2018,Brighton,West Brom,Win,Home,2017-09-09,3,1,1,1,1,4,7,7,7,-3,-6,-6,-6,1,21.0,10.0,11.0,2
3524,3524,2017-18,2017,2018,Brighton,Bournemouth,Loss,Away,2017-09-15,0,4,4,4,4,0,0,0,1,4,4,4,3,0,21.0,9.0,12.0,2
3525,3525,2017-18,2017,2018,Brighton,Newcastle,Win,Home,2017-09-24,3,3,4,4,4,6,9,9,9,-3,-5,-5,-5,1,21.0,21.0,0.0,2
3526,3526,2017-18,2017,2018,Brighton,Arsenal,Loss,Away,2017-10-01,0,3,6,7,7,4,7,7,7,-1,-1,0,0,0,21.0,5.0,16.0,3
3527,3527,2017-18,2017,2018,Brighton,Everton,Draw,Home,2017-10-15,1,3,3,6,7,3,3,3,3,0,0,3,4,1,21.0,7.0,14.0,3
3528,3528,2017-18,2017,2018,Brighton,West Ham,Win,Away,2017-10-20,3,1,4,4,7,4,4,5,8,-3,0,-1,-1,0,21.0,11.0,10.0,3
3529,3529,2017-18,2017,2018,Brighton,Southampton,Draw,Home,2017-10-29,1,4,4,7,7,4,4,4,7,0,0,3,0,1,21.0,8.0,13.0,3
3530,3530,2017-18,2017,2018,Brighton,Swansea,Win,Away,2017-11-04,3,4,5,5,8,0,3,3,3,4,2,2,5,0,21.0,15.0,6.0,4
3531,3531,2017-18,2017,2018,Brighton,Stoke,Draw,Home,2017-11-20,1,4,7,8,8,4,4,4,7,0,3,4,1,1,21.0,13.0,8.0,4
3532,3532,2017-18,2017,2018,Brighton,Man United,Loss,Away,2017-11-25,0,4,5,8,9,3,6,6,7,1,-1,2,2,0,21.0,6.0,15.0,4
3533,3533,2017-18,2017,2018,Brighton,Crystal Palace,Draw,Home,2017-11-28,1,1,4,5,8,4,4,5,5,-3,0,0,3,1,21.0,14.0,7.0,4
3534,3534,2017-18,2017,2018,Brighton,Liverpool,Loss,Home,2017-12-02,0,1,2,5,6,4,7,10,13,-3,-5,-5,-7,1,21.0,4.0,17.0,5
3535,3535,2017-18,2017,2018,Brighton,Huddersfield,Loss,Away,2017-12-09,0,1,1,2,5,0,0,0,3,1,1,2,2,0,21.0,21.0,0.0,5
3536,3536,2017-18,2017,2018,Brighton,Tottenham,Loss,Away,2017-12-13,0,0,1,1,2,4,4,5,5,-4,-3,-4,-3,0,21.0,2.0,19.0,5
3537,3537,2017-18,2017,2018,Brighton,Burnley,Draw,Home,2017-12-16,1,0,0,1,1,6,6,9,9,-6,-6,-8,-8,1,21.0,16.0,5.0,5
3538,3538,2017-18,2017,2018,Brighton,Watford,Win,Home,2017-12-23,3,1,1,1,2,0,0,1,1,1,1,0,1,1,21.0,17.0,4.0,5
3539,3539,2017-18,2017,2018,Brighton,Chelsea,Loss,Away,2017-12-26,0,4,4,4,4,4,7,7,10,0,-3,-3,-6,0,21.0,1.0,20.0,5
3540,3540,2017-18,2017,2018,Brighton,Newcastle,Draw,Away,2017-12-30,1,3,4,4,4,3,3,3,3,0,1,1,1,0,21.0,21.0,0.0,5
3541,3541,2017-18,2017,2018,Brighton,Bournemouth,Draw,Home,2018-01-01,1,1,4,5,5,4,4,4,4,-3,0,1,1,1,21.0,9.0,12.0,6
3542,3542,2017-18,2017,2018,Brighton,West Brom,Loss,Away,2018-01-13,0,2,2,5,6,1,2,2,2,1,0,3,4,0,21.0,10.0,11.0,6
3543,3543,2017-18,2017,2018,Brighton,Chelsea,Loss,Home,2018-01-20,0,1,2,2,5,2,5,8,9,-1,-3,-6,-4,1,21.0,1.0,20.0,6
3544,3544,2017-18,2017,2018,Brighton,Southampton,Draw,Away,2018-01-31,1,0,1,2,2,2,2,3,3,-2,-1,-1,-1,0,21.0,8.0,13.0,6
3545,3545,2017-18,2017,2018,Brighton,West Ham,Win,Home,2018-02-03,3,1,1,2,3,2,5,6,9,-1,-4,-4,-6,1,21.0,11.0,10.0,7
3546,3546,2017-18,2017,2018,Brighton,Stoke,Draw,Away,2018-02-10,1,4,4,4,5,1,4,4,4,3,0,0,1,0,21.0,13.0,8.0,7
3547,3547,2017-18,2017,2018,Brighton,Swansea,Win,Home,2018-02-24,3,4,5,5,5,4,7,10,11,0,-2,-5,-6,1,21.0,15.0,6.0,7
3548,3548,2017-18,2017,2018,Brighton,Arsenal,Win,Home,2018-03-04,3,4,7,8,8,0,3,3,6,4,4,5,2,1,21.0,5.0,16.0,8
3549,3549,2017-18,2017,2018,Brighton,Everton,Loss,Away,2018-03-10,0,6,7,10,11,0,3,3,6,6,4,7,5,0,21.0,7.0,14.0,8
3550,3550,2017-18,2017,2018,Brighton,Leicester,Loss,Home,2018-03-31,0,3,6,7,10,4,5,5,6,-1,1,2,4,1,21.0,12.0,9.0,8
3551,3551,2017-18,2017,2018,Brighton,Huddersfield,Draw,Home,2018-04-07,1,0,3,6,7,0,1,1,4,0,2,5,3,1,21.0,21.0,0.0,9
3552,3552,2017-18,2017,2018,Brighton,Crystal Palace,Loss,Away,2018-04-14,0,1,1,4,7,1,4,4,4,0,-3,0,3,0,21.0,14.0,7.0,9
3553,3553,2017-18,2017,2018,Brighton,Tottenham,Draw,Home,2018-04-17,1,1,1,1,4,3,6,9,12,-2,-5,-8,-8,1,21.0,2.0,19.0,9
3554,3554,2017-18,2017,2018,Brighton,Burnley,Draw,Away,2018-04-28,1,1,2,2,2,1,4,7,10,0,-2,-5,-8,0,21.0,16.0,5.0,9
3555,3555,2017-18,2017,2018,Brighton,Man United,Win,Home,2018-05-04,3,2,2,3,3,6,6,9,12,-4,-4,-6,-9,1,21.0,6.0,15.0,10
3556,3556,2017-18,2017,2018,Brighton,Man City,Loss,Away,2018-05-09,0,4,5,5,6,4,7,10,10,0,-2,-5,-4,0,21.0,3.0,18.0,10
3557,3557,2017-18,2017,2018,Brighton,Liverpool,Loss,Away,2018-05-13,0,3,4,5,5,1,2,5,6,2,2,0,-1,0,21.0,4.0,17.0,10
3558,3558,2009-10,2009,2010,Burnley,Stoke,Loss,Away,2009-08-15,0,0,0,0,0,3,6,6,6,-3,-6,-6,-6,0,21.0,12.0,9.0,1
3559,3559,2009-10,2009,2010,Burnley,Man United,Win,Home,2009-08-19,3,0,0,0,0,6,7,10,13,-6,-7,-10,-13,1,21.0,1.0,20.0,1
3560,3560,2009-10,2009,2010,Burnley,Everton,Win,Home,2009-08-23,3,3,3,3,3,3,6,7,10,0,-3,-4,-7,1,21.0,5.0,16.0,1
3561,3561,2009-10,2009,2010,Burnley,Chelsea,Loss,Away,2009-08-29,0,6,6,6,6,6,9,12,15,0,-3,-6,-9,0,21.0,3.0,18.0,1
3562,3562,2009-10,2009,2010,Burnley,Liverpool,Loss,Away,2009-09-12,0,3,6,6,6,3,6,6,9,0,0,0,-3,0,21.0,2.0,19.0,2
3563,3563,2009-10,2009,2010,Burnley,Sunderland,Win,Home,2009-09-19,3,0,3,6,6,3,6,6,9,-3,-3,0,-3,1,21.0,16.0,5.0,2
3564,3564,2009-10,2009,2010,Burnley,Tottenham,Loss,Away,2009-09-26,0,3,3,6,9,0,3,6,9,3,0,0,0,0,21.0,8.0,13.0,2
3565,3565,2009-10,2009,2010,Burnley,Birmingham,Win,Home,2009-10-03,3,3,3,3,6,3,3,3,4,0,0,0,2,1,21.0,21.0,0.0,3
3566,3566,2009-10,2009,2010,Burnley,Blackburn,Loss,Away,2009-10-18,0,3,6,6,6,3,3,6,7,0,3,0,-1,0,21.0,15.0,6.0,3
3567,3567,2009-10,2009,2010,Burnley,Wigan,Loss,Home,2009-10-24,0,3,3,6,6,1,4,4,7,2,-1,2,-1,1,21.0,11.0,10.0,3
3568,3568,2009-10,2009,2010,Burnley,Hull,Win,Home,2009-10-31,3,0,3,3,6,1,4,4,4,-1,-1,-1,2,1,21.0,17.0,4.0,3
3569,3569,2009-10,2009,2010,Burnley,Man City,Draw,Away,2009-11-07,1,3,3,6,6,2,3,4,7,1,0,2,-1,0,21.0,10.0,11.0,4
3570,3570,2009-10,2009,2010,Burnley,Aston Villa,Draw,Home,2009-11-21,1,4,4,4,7,3,4,5,8,1,0,-1,-1,1,21.0,6.0,15.0,4
3571,3571,2009-10,2009,2010,Burnley,West Ham,Loss,Away,2009-11-28,0,2,5,5,5,1,4,5,6,1,1,0,-1,0,21.0,9.0,12.0,4
3572,3572,2009-10,2009,2010,Burnley,Portsmouth,Loss,Away,2009-12-05,0,1,2,5,5,0,0,3,4,1,2,2,1,0,21.0,14.0,7.0,5
3573,3573,2009-10,2009,2010,Burnley,Fulham,Draw,Home,2009-12-12,1,0,1,2,5,4,7,7,8,-4,-6,-5,-3,1,21.0,7.0,14.0,5
3574,3574,2009-10,2009,2010,Burnley,Arsenal,Draw,Home,2009-12-16,1,1,1,2,3,6,6,6,9,-5,-5,-4,-6,1,21.0,4.0,17.0,5
3575,3575,2009-10,2009,2010,Burnley,Wolves,Loss,Away,2009-12-20,0,2,2,2,3,3,6,6,6,-1,-4,-4,-3,0,21.0,21.0,0.0,5
3576,3576,2009-10,2009,2010,Burnley,Bolton,Draw,Home,2009-12-26,1,1,2,2,2,4,4,5,5,-3,-2,-3,-3,1,21.0,13.0,8.0,5
3577,3577,2009-10,2009,2010,Burnley,Everton,Loss,Away,2009-12-28,0,1,2,3,3,2,3,4,4,-1,-1,-1,-1,0,21.0,5.0,16.0,5
3578,3578,2009-10,2009,2010,Burnley,Man United,Loss,Away,2010-01-16,0,1,1,2,3,4,7,7,10,-3,-6,-5,-7,0,21.0,1.0,20.0,6
3579,3579,2009-10,2009,2010,Burnley,Bolton,Loss,Away,2010-01-26,0,0,1,1,2,0,1,2,5,0,0,-1,-3,0,21.0,13.0,8.0,6
3580,3580,2009-10,2009,2010,Burnley,Chelsea,Loss,Home,2010-01-30,0,0,0,1,1,6,9,10,11,-6,-9,-9,-10,1,21.0,3.0,18.0,6
3581,3581,2009-10,2009,2010,Burnley,West Ham,Win,Home,2010-02-06,3,0,0,0,1,2,3,3,6,-2,-3,-3,-5,1,21.0,9.0,12.0,7
3582,3582,2009-10,2009,2010,Burnley,Fulham,Loss,Away,2010-02-09,0,3,3,3,3,4,4,4,4,-1,-1,-1,-1,0,21.0,7.0,14.0,7
3583,3583,2009-10,2009,2010,Burnley,Aston Villa,Loss,Away,2010-02-21,0,3,3,3,3,2,5,6,7,1,-2,-3,-4,0,21.0,6.0,15.0,7
3584,3584,2009-10,2009,2010,Burnley,Portsmouth,Loss,Home,2010-02-27,0,0,3,3,3,1,1,1,1,-1,2,2,2,1,21.0,14.0,7.0,7
3585,3585,2009-10,2009,2010,Burnley,Arsenal,Loss,Away,2010-03-06,0,0,0,3,3,6,9,9,9,-6,-9,-6,-6,0,21.0,4.0,17.0,8
3586,3586,2009-10,2009,2010,Burnley,Stoke,Draw,Home,2010-03-10,1,0,0,0,3,3,4,5,8,-3,-4,-5,-5,1,21.0,12.0,9.0,8
3587,3587,2009-10,2009,2010,Burnley,Wolves,Loss,Home,2010-03-13,0,1,1,1,1,0,0,3,3,1,1,-2,-2,1,21.0,21.0,0.0,8
3588,3588,2009-10,2009,2010,Burnley,Wigan,Loss,Away,2010-03-20,0,1,1,1,1,0,3,3,3,1,-2,-2,-2,0,21.0,11.0,10.0,8
3589,3589,2009-10,2009,2010,Burnley,Blackburn,Loss,Home,2010-03-28,0,0,1,1,1,4,4,4,7,-4,-3,-3,-6,1,21.0,15.0,6.0,8
3590,3590,2009-10,2009,2010,Burnley,Man City,Loss,Home,2010-04-03,0,0,0,1,1,3,6,7,10,-3,-6,-6,-9,1,21.0,10.0,11.0,9
3591,3591,2009-10,2009,2010,Burnley,Hull,Win,Away,2010-04-10,3,0,0,0,1,3,3,3,3,-3,-3,-3,-2,0,21.0,17.0,4.0,9
3592,3592,2009-10,2009,2010,Burnley,Sunderland,Loss,Away,2010-04-17,0,3,3,3,3,3,3,4,7,0,0,-1,-4,0,21.0,16.0,5.0,9
3593,3593,2009-10,2009,2010,Burnley,Liverpool,Loss,Home,2010-04-25,0,3,3,3,3,4,5,8,8,-1,-2,-5,-5,1,21.0,2.0,19.0,9
3594,3594,2009-10,2009,2010,Burnley,Birmingham,Loss,Away,2010-05-01,0,0,3,3,3,1,1,2,3,-1,2,1,0,0,21.0,21.0,0.0,10
3595,3595,2009-10,2009,2010,Burnley,Tottenham,Win,Home,2010-05-09,3,0,0,3,3,6,6,9,12,-6,-6,-6,-9,1,21.0,8.0,13.0,10
3596,3596,2014-15,2014,2015,Burnley,Chelsea,Loss,Home,2014-08-18,0,3,3,3,6,4,7,7,10,-1,-4,-4,-4,1,21.0,3.0,18.0,1
3597,3597,2014-15,2014,2015,Burnley,Swansea,Loss,Away,2014-08-23,0,3,3,3,3,6,6,9,12,-3,-3,-6,-9,0,21.0,12.0,9.0,1
3598,3598,2014-15,2014,2015,Burnley,Man United,Draw,Home,2014-08-30,1,0,3,3,3,1,2,5,5,-1,1,-2,-2,1,21.0,7.0,14.0,1
3599,3599,2014-15,2014,2015,Burnley,Crystal Palace,Draw,Away,2014-09-13,1,1,1,4,4,1,1,2,3,0,0,2,1,0,21.0,11.0,10.0,2
3600,3600,2014-15,2014,2015,Burnley,Sunderland,Draw,Home,2014-09-20,1,2,2,2,5,1,2,3,3,1,0,-1,2,1,21.0,14.0,7.0,2
3601,3601,2014-15,2014,2015,Burnley,West Brom,Loss,Away,2014-09-28,0,2,3,3,3,3,3,4,5,-1,0,-1,-2,0,21.0,17.0,4.0,2
3602,3602,2014-15,2014,2015,Burnley,Leicester,Draw,Away,2014-10-04,1,1,2,3,3,3,6,7,7,-2,-4,-4,-4,0,21.0,21.0,0.0,3
3603,3603,2014-15,2014,2015,Burnley,West Ham,Loss,Home,2014-10-18,0,1,2,3,4,3,6,7,7,-2,-4,-4,-3,1,21.0,13.0,8.0,3
3604,3604,2014-15,2014,2015,Burnley,Everton,Loss,Home,2014-10-26,0,1,1,2,3,3,4,4,7,-2,-3,-2,-4,1,21.0,5.0,16.0,3
3605,3605,2014-15,2014,2015,Burnley,Arsenal,Loss,Away,2014-11-01,0,0,1,1,2,4,4,5,8,-4,-3,-4,-6,0,21.0,4.0,17.0,4
3606,3606,2014-15,2014,2015,Burnley,Hull,Win,Home,2014-11-08,3,0,0,1,1,1,2,5,5,-1,-2,-4,-4,1,21.0,16.0,5.0,4
3607,3607,2014-15,2014,2015,Burnley,Stoke,Win,Away,2014-11-22,3,3,3,3,4,4,4,7,7,-1,-1,-4,-3,0,21.0,9.0,12.0,4
3608,3608,2014-15,2014,2015,Burnley,Aston Villa,Draw,Home,2014-11-29,1,6,6,6,6,2,2,2,2,4,4,4,4,1,21.0,15.0,6.0,4
3609,3609,2014-15,2014,2015,Burnley,Newcastle,Draw,Home,2014-12-02,1,4,7,7,7,3,6,9,12,1,1,-2,-5,1,21.0,10.0,11.0,5
3610,3610,2014-15,2014,2015,Burnley,QPR,Loss,Away,2014-12-06,0,2,5,8,8,3,3,4,4,-1,2,4,4,0,21.0,21.0,0.0,5
3611,3611,2014-15,2014,2015,Burnley,Southampton,Win,Home,2014-12-13,3,1,2,5,8,0,0,1,4,1,2,4,4,1,21.0,8.0,13.0,5
3612,3612,2014-15,2014,2015,Burnley,Tottenham,Loss,Away,2014-12-20,0,3,4,5,8,4,4,7,10,-1,0,-2,-2,0,21.0,6.0,15.0,5
3613,3613,2014-15,2014,2015,Burnley,Liverpool,Loss,Home,2014-12-26,0,3,3,4,5,1,2,5,8,2,1,-1,-3,1,21.0,2.0,19.0,5
3614,3614,2014-15,2014,2015,Burnley,Man City,Draw,Away,2014-12-28,1,0,3,3,4,6,9,12,15,-6,-6,-9,-11,0,21.0,1.0,20.0,5
3615,3615,2014-15,2014,2015,Burnley,Newcastle,Draw,Away,2015-01-01,1,1,1,4,4,3,3,3,6,-2,-2,1,-2,0,21.0,10.0,11.0,6
3616,3616,2014-15,2014,2015,Burnley,QPR,Win,Home,2015-01-10,3,2,2,2,5,2,2,5,5,0,0,-3,0,1,21.0,21.0,0.0,6
3617,3617,2014-15,2014,2015,Burnley,Crystal Palace,Loss,Home,2015-01-17,0,4,5,5,5,4,5,5,5,0,0,0,0,1,21.0,11.0,10.0,6
3618,3618,2014-15,2014,2015,Burnley,Sunderland,Loss,Away,2015-01-31,0,3,4,5,5,0,0,1,1,3,4,4,4,0,21.0,14.0,7.0,6
3619,3619,2014-15,2014,2015,Burnley,West Brom,Draw,Home,2015-02-08,1,0,3,4,5,1,4,5,5,-1,-1,-1,0,1,21.0,17.0,4.0,7
3620,3620,2014-15,2014,2015,Burnley,Man United,Loss,Away,2015-02-11,0,1,1,4,5,4,7,7,8,-3,-6,-3,-3,0,21.0,7.0,14.0,7
3621,3621,2014-15,2014,2015,Burnley,Chelsea,Draw,Away,2015-02-21,1,1,1,1,4,6,7,10,13,-5,-6,-9,-9,0,21.0,3.0,18.0,7
3622,3622,2014-15,2014,2015,Burnley,Swansea,Loss,Home,2015-02-28,0,1,2,2,2,3,4,7,7,-2,-2,-5,-5,1,21.0,12.0,9.0,7
3623,3623,2014-15,2014,2015,Burnley,Liverpool,Loss,Away,2015-03-04,0,1,1,2,2,6,9,10,13,-5,-8,-8,-11,0,21.0,2.0,19.0,8
3624,3624,2014-15,2014,2015,Burnley,Man City,Win,Home,2015-03-14,3,0,1,1,2,3,6,9,10,-3,-5,-8,-8,1,21.0,1.0,20.0,8
3625,3625,2014-15,2014,2015,Burnley,Southampton,Loss,Away,2015-03-21,0,3,3,4,4,4,4,4,5,-1,-1,0,-1,0,21.0,8.0,13.0,8
3626,3626,2014-15,2014,2015,Burnley,Tottenham,Draw,Home,2015-04-05,1,3,3,3,4,3,6,9,10,0,-3,-6,-6,1,21.0,6.0,15.0,9
3627,3627,2014-15,2014,2015,Burnley,Arsenal,Loss,Home,2015-04-11,0,1,4,4,4,6,9,12,15,-5,-5,-8,-11,1,21.0,4.0,17.0,9
3628,3628,2014-15,2014,2015,Burnley,Everton,Loss,Away,2015-04-18,0,1,1,4,4,4,7,10,10,-3,-6,-6,-6,0,21.0,5.0,16.0,9
3629,3629,2014-15,2014,2015,Burnley,Leicester,Loss,Home,2015-04-25,0,0,1,1,4,6,9,9,10,-6,-8,-8,-6,1,21.0,21.0,0.0,9
3630,3630,2014-15,2014,2015,Burnley,West Ham,Loss,Away,2015-05-02,0,0,0,1,1,1,2,2,5,-1,-2,-1,-4,0,21.0,13.0,8.0,10
3631,3631,2014-15,2014,2015,Burnley,Hull,Win,Away,2015-05-09,3,0,0,0,1,3,6,6,6,-3,-6,-6,-5,0,21.0,16.0,5.0,10
3632,3632,2014-15,2014,2015,Burnley,Stoke,Draw,Home,2015-05-16,1,3,3,3,3,3,4,7,8,0,-1,-4,-5,1,21.0,9.0,12.0,10
3633,3633,2014-15,2014,2015,Burnley,Aston Villa,Win,Away,2015-05-24,3,4,4,4,4,3,6,6,9,1,-2,-2,-5,0,21.0,15.0,6.0,10
3634,3634,2016-17,2016,2017,Burnley,Swansea,Loss,Home,2016-08-13,0,4,7,7,7,4,7,7,7,0,0,0,0,1,21.0,12.0,9.0,1
3635,3635,2016-17,2016,2017,Burnley,Liverpool,Win,Home,2016-08-20,3,3,4,7,7,4,5,8,8,-1,-1,-1,-1,1,21.0,8.0,13.0,1
3636,3636,2016-17,2016,2017,Burnley,Chelsea,Loss,Away,2016-08-27,0,3,6,7,10,6,7,8,8,-3,-1,-1,2,0,21.0,10.0,11.0,1
3637,3637,2016-17,2016,2017,Burnley,Hull,Draw,Home,2016-09-10,1,3,3,6,7,3,6,7,7,0,-3,-1,0,1,21.0,21.0,0.0,2
3638,3638,2016-17,2016,2017,Burnley,Leicester,Loss,Away,2016-09-17,0,1,4,4,7,3,4,4,5,-2,0,0,2,0,21.0,1.0,20.0,2
3639,3639,2016-17,2016,2017,Burnley,Watford,Win,Home,2016-09-26,3,1,1,4,4,6,6,6,7,-5,-5,-2,-3,1,21.0,13.0,8.0,2
3640,3640,2016-17,2016,2017,Burnley,Arsenal,Loss,Home,2016-10-02,0,3,4,4,7,6,9,12,13,-3,-5,-8,-6,1,21.0,2.0,19.0,3
3641,3641,2016-17,2016,2017,Burnley,Southampton,Loss,Away,2016-10-16,0,3,3,4,4,4,7,7,8,-1,-4,-3,-4,0,21.0,6.0,15.0,3
3642,3642,2016-17,2016,2017,Burnley,Everton,Win,Home,2016-10-22,3,0,3,3,4,2,2,5,8,-2,1,-2,-4,1,21.0,11.0,10.0,3
3643,3643,2016-17,2016,2017,Burnley,Man United,Draw,Away,2016-10-29,1,3,3,6,6,1,2,5,5,2,1,1,1,0,21.0,5.0,16.0,3
3644,3644,2016-17,2016,2017,Burnley,Crystal Palace,Win,Home,2016-11-05,3,4,4,4,7,0,0,1,4,4,4,3,3,1,21.0,15.0,6.0,4
3645,3645,2016-17,2016,2017,Burnley,West Brom,Loss,Away,2016-11-21,0,4,7,7,7,3,3,4,5,1,4,3,2,0,21.0,14.0,7.0,4
3646,3646,2016-17,2016,2017,Burnley,Man City,Loss,Home,2016-11-26,0,3,4,7,7,4,7,8,9,-1,-3,-1,-2,1,21.0,4.0,17.0,4
3647,3647,2016-17,2016,2017,Burnley,Stoke,Loss,Away,2016-12-03,0,0,3,4,7,3,4,7,10,-3,-1,-3,-3,0,21.0,9.0,12.0,5
3648,3648,2016-17,2016,2017,Burnley,Bournemouth,Win,Home,2016-12-10,3,0,0,3,4,3,6,6,6,-3,-6,-3,-2,1,21.0,16.0,5.0,5
3649,3649,2016-17,2016,2017,Burnley,West Ham,Loss,Away,2016-12-14,0,3,3,3,6,1,2,2,3,2,1,1,3,0,21.0,7.0,14.0,5
3650,3650,2016-17,2016,2017,Burnley,Tottenham,Loss,Away,2016-12-18,0,3,3,3,3,3,6,6,9,0,-3,-3,-6,0,21.0,3.0,18.0,5
3651,3651,2016-17,2016,2017,Burnley,Middlesbrough,Win,Home,2016-12-26,3,0,3,3,3,3,3,6,7,-3,0,-3,-4,1,21.0,21.0,0.0,5
3652,3652,2016-17,2016,2017,Burnley,Sunderland,Win,Home,2016-12-31,3,3,3,6,6,3,3,3,6,0,0,3,0,1,21.0,17.0,4.0,5
3653,3653,2016-17,2016,2017,Burnley,Man City,Loss,Away,2017-01-02,0,6,6,6,9,3,6,9,9,3,0,-3,0,0,21.0,4.0,17.0,6
3654,3654,2016-17,2016,2017,Burnley,Southampton,Win,Home,2017-01-14,3,3,6,6,6,0,0,3,4,3,6,3,2,1,21.0,6.0,15.0,6
3655,3655,2016-17,2016,2017,Burnley,Arsenal,Loss,Away,2017-01-22,0,3,6,9,9,4,7,10,10,-1,-1,-1,-1,0,21.0,2.0,19.0,6
3656,3656,2016-17,2016,2017,Burnley,Leicester,Win,Home,2017-01-31,3,3,3,6,9,0,1,4,4,3,2,2,5,1,21.0,1.0,20.0,6
3657,3657,2016-17,2016,2017,Burnley,Watford,Loss,Away,2017-02-04,0,3,6,6,9,4,5,5,5,-1,1,1,4,0,21.0,13.0,8.0,7
3658,3658,2016-17,2016,2017,Burnley,Chelsea,Draw,Home,2017-02-12,1,3,3,6,6,4,7,10,10,-1,-4,-4,-4,1,21.0,10.0,11.0,7
3659,3659,2016-17,2016,2017,Burnley,Hull,Draw,Away,2017-02-25,1,1,4,4,7,3,4,4,7,-2,0,0,0,0,21.0,21.0,0.0,7
3660,3660,2016-17,2016,2017,Burnley,Swansea,Loss,Away,2017-03-04,0,2,2,5,5,3,3,6,9,-1,-1,-1,-4,0,21.0,12.0,9.0,8
3661,3661,2016-17,2016,2017,Burnley,Liverpool,Loss,Away,2017-03-12,0,1,2,2,5,3,6,6,7,-2,-4,-4,-2,0,21.0,8.0,13.0,8
3662,3662,2016-17,2016,2017,Burnley,Sunderland,Draw,Away,2017-03-18,1,0,1,2,2,0,0,3,4,0,1,-1,-2,0,21.0,17.0,4.0,8
3663,3663,2016-17,2016,2017,Burnley,Tottenham,Loss,Home,2017-04-01,0,1,1,2,3,6,9,9,12,-5,-8,-7,-9,1,21.0,3.0,18.0,9
3664,3664,2016-17,2016,2017,Burnley,Stoke,Win,Home,2017-04-04,3,1,1,1,2,0,1,4,4,1,0,-3,-2,1,21.0,9.0,12.0,9
3665,3665,2016-17,2016,2017,Burnley,Middlesbrough,Draw,Away,2017-04-08,1,3,4,4,4,1,1,1,1,2,3,3,3,0,21.0,21.0,0.0,9
3666,3666,2016-17,2016,2017,Burnley,Everton,Loss,Away,2017-04-15,0,4,4,5,5,4,4,7,10,0,0,-2,-5,0,21.0,11.0,10.0,9
3667,3667,2016-17,2016,2017,Burnley,Man United,Loss,Home,2017-04-23,0,1,4,4,5,6,7,8,11,-5,-3,-4,-6,1,21.0,5.0,16.0,9
3668,3668,2016-17,2016,2017,Burnley,Crystal Palace,Win,Away,2017-04-29,3,0,1,4,4,3,4,7,7,-3,-3,-3,-3,0,21.0,15.0,6.0,9
3669,3669,2016-17,2016,2017,Burnley,West Brom,Draw,Home,2017-05-06,1,3,3,4,7,0,0,0,1,3,3,4,6,1,21.0,14.0,7.0,10
3670,3670,2016-17,2016,2017,Burnley,Bournemouth,Loss,Away,2017-05-13,0,4,4,4,5,4,7,7,7,0,-3,-3,-2,0,21.0,16.0,5.0,10
3671,3671,2016-17,2016,2017,Burnley,West Ham,Loss,Home,2017-05-21,0,1,4,4,4,3,4,5,6,-2,0,-1,-2,1,21.0,7.0,14.0,10
3672,3672,2017-18,2017,2018,Burnley,Chelsea,Win,Away,2017-08-12,3,0,1,4,4,6,9,12,15,-6,-8,-8,-11,0,16.0,1.0,15.0,1
3673,3673,2017-18,2017,2018,Burnley,West Brom,Loss,Home,2017-08-19,0,3,3,4,7,3,3,3,4,0,0,1,3,1,16.0,10.0,6.0,1
3674,3674,2017-18,2017,2018,Burnley,Tottenham,Draw,Away,2017-08-27,1,3,3,3,4,3,6,9,12,0,-3,-6,-8,0,16.0,2.0,14.0,1
3675,3675,2017-18,2017,2018,Burnley,Crystal Palace,Win,Home,2017-09-10,3,1,4,4,4,0,0,0,3,1,4,4,1,1,16.0,14.0,2.0,2
3676,3676,2017-18,2017,2018,Burnley,Liverpool,Draw,Away,2017-09-16,1,4,4,7,7,3,6,7,10,1,-2,0,-3,0,16.0,4.0,12.0,2
3677,3677,2017-18,2017,2018,Burnley,Huddersfield,Draw,Home,2017-09-23,1,4,5,5,8,1,2,5,8,3,3,0,0,1,16.0,21.0,-5.0,2
3678,3678,2017-18,2017,2018,Burnley,Everton,Win,Away,2017-10-01,3,2,5,6,6,3,3,3,4,-1,2,3,2,0,16.0,7.0,9.0,3
3679,3679,2017-18,2017,2018,Burnley,West Ham,Draw,Home,2017-10-14,1,4,5,8,9,3,4,7,7,1,1,1,2,1,16.0,11.0,5.0,3
3680,3680,2017-18,2017,2018,Burnley,Man City,Loss,Away,2017-10-21,0,4,5,6,9,6,9,12,15,-2,-4,-6,-6,0,16.0,3.0,13.0,3
3681,3681,2017-18,2017,2018,Burnley,Newcastle,Win,Home,2017-10-30,3,1,4,5,6,4,5,5,8,-3,-1,0,-2,1,16.0,21.0,-5.0,3
3682,3682,2017-18,2017,2018,Burnley,Southampton,Win,Away,2017-11-04,3,3,4,7,8,4,5,5,5,-1,-1,2,3,0,16.0,8.0,8.0,4
3683,3683,2017-18,2017,2018,Burnley,Swansea,Win,Home,2017-11-18,3,6,6,7,10,0,0,3,3,6,6,4,7,1,16.0,15.0,1.0,4
3684,3684,2017-18,2017,2018,Burnley,Arsenal,Loss,Home,2017-11-26,0,6,9,9,10,3,6,9,9,3,3,0,1,1,16.0,5.0,11.0,4
3685,3685,2017-18,2017,2018,Burnley,Bournemouth,Win,Away,2017-11-29,3,3,6,9,9,4,7,7,10,-1,-1,2,-1,0,16.0,9.0,7.0,4
3686,3686,2017-18,2017,2018,Burnley,Leicester,Loss,Away,2017-12-02,0,3,6,9,12,4,4,5,8,-1,2,4,4,0,16.0,12.0,4.0,5
3687,3687,2017-18,2017,2018,Burnley,Watford,Win,Home,2017-12-09,3,3,3,6,9,1,4,7,7,2,-1,-1,2,1,16.0,17.0,-1.0,5
3688,3688,2017-18,2017,2018,Burnley,Stoke,Win,Home,2017-12-12,3,3,6,6,9,3,3,3,4,0,3,3,5,1,16.0,13.0,3.0,5
3689,3689,2017-18,2017,2018,Burnley,Brighton,Draw,Away,2017-12-16,1,6,6,9,9,0,0,1,1,6,6,8,8,0,16.0,21.0,-5.0,5
3690,3690,2017-18,2017,2018,Burnley,Tottenham,Loss,Home,2017-12-23,0,4,7,7,10,3,6,7,7,1,1,0,3,1,16.0,2.0,14.0,5
3691,3691,2017-18,2017,2018,Burnley,Man United,Draw,Away,2017-12-26,1,1,4,7,7,4,7,7,10,-3,-3,0,-3,0,16.0,6.0,10.0,5
3692,3692,2017-18,2017,2018,Burnley,Huddersfield,Draw,Away,2017-12-30,1,1,2,5,8,2,5,5,8,-1,-3,0,0,0,16.0,21.0,-5.0,5
3693,3693,2017-18,2017,2018,Burnley,Liverpool,Loss,Home,2018-01-01,0,2,2,3,6,6,7,10,11,-4,-5,-7,-5,1,16.0,4.0,12.0,6
3694,3694,2017-18,2017,2018,Burnley,Crystal Palace,Loss,Away,2018-01-13,0,1,2,2,3,4,4,5,8,-3,-2,-3,-5,0,16.0,14.0,2.0,6
3695,3695,2017-18,2017,2018,Burnley,Man United,Loss,Home,2018-01-20,0,0,1,2,2,6,7,8,9,-6,-6,-6,-7,1,16.0,6.0,10.0,6
3696,3696,2017-18,2017,2018,Burnley,Newcastle,Draw,Away,2018-01-31,1,0,0,1,2,1,4,5,5,-1,-4,-4,-3,0,16.0,21.0,-5.0,6
3697,3697,2017-18,2017,2018,Burnley,Man City,Draw,Home,2018-02-03,1,1,1,1,2,6,6,9,10,-5,-5,-8,-8,1,16.0,3.0,13.0,7
3698,3698,2017-18,2017,2018,Burnley,Swansea,Loss,Away,2018-02-10,0,2,2,2,2,4,7,8,8,-2,-5,-6,-6,0,16.0,15.0,1.0,7
3699,3699,2017-18,2017,2018,Burnley,Southampton,Draw,Home,2018-02-24,1,1,2,2,2,3,4,5,6,-2,-2,-3,-4,1,16.0,8.0,8.0,7
3700,3700,2017-18,2017,2018,Burnley,Everton,Win,Home,2018-03-03,3,1,2,3,3,3,3,6,7,-2,-1,-3,-4,1,16.0,7.0,9.0,8
3701,3701,2017-18,2017,2018,Burnley,West Ham,Win,Away,2018-03-10,3,4,4,5,6,0,3,3,4,4,1,2,2,0,16.0,11.0,5.0,8
3702,3702,2017-18,2017,2018,Burnley,West Brom,Win,Away,2018-03-31,3,6,7,7,8,0,0,0,0,6,7,7,8,0,16.0,10.0,6.0,8
3703,3703,2017-18,2017,2018,Burnley,Watford,Win,Away,2018-04-07,3,6,9,10,10,1,1,4,7,5,8,6,3,0,16.0,17.0,-1.0,9
3704,3704,2017-18,2017,2018,Burnley,Leicester,Win,Home,2018-04-14,3,6,9,12,13,3,6,7,8,3,3,5,5,1,16.0,12.0,4.0,9
3705,3705,2017-18,2017,2018,Burnley,Chelsea,Loss,Home,2018-04-19,0,6,9,12,15,4,4,7,7,2,5,5,8,1,16.0,1.0,15.0,9
3706,3706,2017-18,2017,2018,Burnley,Stoke,Draw,Away,2018-04-22,1,3,6,9,12,1,1,1,1,2,5,8,11,0,16.0,13.0,3.0,9
3707,3707,2017-18,2017,2018,Burnley,Brighton,Draw,Home,2018-04-28,1,1,4,7,10,1,2,2,2,0,2,5,8,1,16.0,21.0,-5.0,9
3708,3708,2017-18,2017,2018,Burnley,Arsenal,Loss,Away,2018-05-06,0,2,2,5,8,3,3,6,9,-1,-1,-1,-1,0,16.0,5.0,11.0,10
3709,3709,2017-18,2017,2018,Burnley,Bournemouth,Loss,Home,2018-05-13,0,1,2,2,5,3,3,3,4,-2,-1,-1,1,1,16.0,9.0,7.0,10
3710,3710,2013-14,2013,2014,Cardiff,West Ham,Loss,Away,2013-08-17,0,0,0,0,0,3,4,4,7,-3,-4,-4,-7,0,21.0,10.0,11.0,1
3711,3711,2013-14,2013,2014,Cardiff,Man City,Win,Home,2013-08-25,3,0,0,0,0,3,6,9,10,-3,-6,-9,-10,1,21.0,2.0,19.0,1
3712,3712,2013-14,2013,2014,Cardiff,Everton,Draw,Home,2013-08-31,1,3,3,3,3,2,2,5,6,1,1,-2,-3,1,21.0,6.0,15.0,1
3713,3713,2013-14,2013,2014,Cardiff,Hull,Draw,Away,2013-09-14,1,4,4,4,4,3,3,4,5,1,1,0,-1,0,21.0,21.0,0.0,2
3714,3714,2013-14,2013,2014,Cardiff,Tottenham,Loss,Home,2013-09-22,0,2,5,5,5,3,6,9,12,-1,-1,-4,-7,1,21.0,5.0,16.0,2
3715,3715,2013-14,2013,2014,Cardiff,Fulham,Win,Away,2013-09-28,3,1,2,5,5,1,1,1,4,0,1,4,1,0,21.0,12.0,9.0,2
3716,3716,2013-14,2013,2014,Cardiff,Newcastle,Loss,Home,2013-10-05,0,3,4,5,8,0,3,6,7,3,1,-1,1,1,21.0,16.0,5.0,3
3717,3717,2013-14,2013,2014,Cardiff,Chelsea,Loss,Away,2013-10-19,0,3,3,4,5,4,7,7,8,-1,-4,-3,-3,0,21.0,3.0,18.0,3
3718,3718,2013-14,2013,2014,Cardiff,Norwich,Draw,Away,2013-10-26,1,0,3,3,4,0,3,3,3,0,0,0,1,0,21.0,11.0,10.0,3
3719,3719,2013-14,2013,2014,Cardiff,Swansea,Win,Home,2013-11-03,3,1,1,4,4,4,4,4,7,-3,-3,0,-3,1,21.0,9.0,12.0,4
3720,3720,2013-14,2013,2014,Cardiff,Aston Villa,Loss,Away,2013-11-09,0,4,4,4,7,1,1,2,5,3,3,2,2,0,21.0,15.0,6.0,4
3721,3721,2013-14,2013,2014,Cardiff,Man United,Draw,Home,2013-11-24,1,3,4,4,4,6,9,10,13,-3,-5,-6,-9,1,21.0,1.0,20.0,4
3722,3722,2013-14,2013,2014,Cardiff,Arsenal,Loss,Home,2013-11-30,0,1,4,5,5,3,6,9,12,-2,-2,-4,-7,1,21.0,4.0,17.0,4
3723,3723,2013-14,2013,2014,Cardiff,Stoke,Draw,Away,2013-12-04,1,1,1,4,5,3,4,5,5,-2,-3,-1,0,0,21.0,13.0,8.0,5
3724,3724,2013-14,2013,2014,Cardiff,Crystal Palace,Loss,Away,2013-12-07,0,1,2,2,5,3,6,7,7,-2,-4,-5,-2,0,21.0,21.0,0.0,5
3725,3725,2013-14,2013,2014,Cardiff,West Brom,Win,Home,2013-12-14,3,1,1,2,2,0,0,1,2,1,1,1,0,1,21.0,8.0,13.0,5
3726,3726,2013-14,2013,2014,Cardiff,Liverpool,Loss,Away,2013-12-21,0,3,4,4,5,6,9,9,10,-3,-5,-5,-5,0,21.0,7.0,14.0,5
3727,3727,2013-14,2013,2014,Cardiff,Southampton,Loss,Home,2013-12-26,0,3,3,4,4,1,2,2,2,2,1,2,2,1,21.0,14.0,7.0,5
3728,3728,2013-14,2013,2014,Cardiff,Sunderland,Draw,Home,2013-12-28,1,0,3,3,4,4,5,5,5,-4,-2,-2,-1,1,21.0,17.0,4.0,5
3729,3729,2013-14,2013,2014,Cardiff,Arsenal,Loss,Away,2014-01-01,0,1,1,4,4,6,7,7,8,-5,-6,-3,-4,0,21.0,4.0,17.0,6
3730,3730,2013-14,2013,2014,Cardiff,West Ham,Loss,Home,2014-01-11,0,1,1,1,4,1,1,1,2,0,0,0,2,1,21.0,10.0,11.0,6
3731,3731,2013-14,2013,2014,Cardiff,Man City,Loss,Away,2014-01-18,0,0,1,1,1,6,9,12,15,-6,-8,-11,-14,0,21.0,2.0,19.0,6
3732,3732,2013-14,2013,2014,Cardiff,Man United,Loss,Away,2014-01-28,0,0,0,1,1,3,3,6,9,-3,-3,-5,-8,0,21.0,1.0,20.0,6
3733,3733,2013-14,2013,2014,Cardiff,Norwich,Win,Home,2014-02-01,3,0,0,0,1,4,4,5,5,-4,-4,-5,-4,1,21.0,11.0,10.0,7
3734,3734,2013-14,2013,2014,Cardiff,Swansea,Loss,Away,2014-02-08,0,3,3,3,3,3,3,3,3,0,0,0,0,0,21.0,9.0,12.0,7
3735,3735,2013-14,2013,2014,Cardiff,Aston Villa,Draw,Home,2014-02-11,1,3,3,3,3,0,3,4,4,3,0,-1,-1,1,21.0,15.0,6.0,7
3736,3736,2013-14,2013,2014,Cardiff,Hull,Loss,Home,2014-02-22,0,1,4,4,4,3,4,4,4,-2,0,0,0,1,21.0,21.0,0.0,7
3737,3737,2013-14,2013,2014,Cardiff,Tottenham,Loss,Away,2014-03-02,0,1,1,4,4,3,6,7,7,-2,-5,-3,-3,0,21.0,5.0,16.0,8
3738,3738,2013-14,2013,2014,Cardiff,Fulham,Win,Home,2014-03-08,3,0,1,1,4,1,1,2,2,-1,0,-1,2,1,21.0,12.0,9.0,8
3739,3739,2013-14,2013,2014,Cardiff,Everton,Loss,Away,2014-03-15,0,3,3,4,4,3,3,6,6,0,0,-2,-2,0,21.0,6.0,15.0,8
3740,3740,2013-14,2013,2014,Cardiff,Liverpool,Loss,Home,2014-03-22,0,3,3,3,4,6,9,12,15,-3,-6,-9,-11,1,21.0,7.0,14.0,8
3741,3741,2013-14,2013,2014,Cardiff,West Brom,Draw,Away,2014-03-29,1,0,3,3,3,3,3,4,5,-3,0,-1,-2,0,21.0,8.0,13.0,8
3742,3742,2013-14,2013,2014,Cardiff,Crystal Palace,Loss,Home,2014-04-05,0,1,1,4,4,3,4,4,5,-2,-3,0,-1,1,21.0,21.0,0.0,9
3743,3743,2013-14,2013,2014,Cardiff,Southampton,Win,Away,2014-04-12,3,1,1,1,4,3,3,6,9,-2,-2,-5,-5,0,21.0,14.0,7.0,9
3744,3744,2013-14,2013,2014,Cardiff,Stoke,Draw,Home,2014-04-19,1,3,4,4,4,3,6,9,12,0,-2,-5,-8,1,21.0,13.0,8.0,9
3745,3745,2013-14,2013,2014,Cardiff,Sunderland,Loss,Away,2014-04-27,0,4,4,5,5,4,4,4,4,0,0,1,1,0,21.0,17.0,4.0,9
3746,3746,2013-14,2013,2014,Cardiff,Newcastle,Loss,Away,2014-05-03,0,1,4,4,5,0,0,0,0,1,4,4,5,0,21.0,16.0,5.0,10
3747,3747,2013-14,2013,2014,Cardiff,Chelsea,Loss,Home,2014-05-11,0,0,1,4,4,4,4,7,10,-4,-3,-3,-6,1,21.0,3.0,18.0,10
3748,3748,1998-99,1998,1999,Charlton,Newcastle,Draw,Away,1998-08-15,1,0,0,0,0,3,4,4,5,-3,-4,-4,-5,0,21.0,13.0,8.0,1
3749,3749,1998-99,1998,1999,Charlton,Southampton,Win,Home,1998-08-22,3,1,1,1,1,1,1,4,4,0,0,-3,-3,1,21.0,12.0,9.0,1
3750,3750,1998-99,1998,1999,Charlton,Arsenal,Draw,Away,1998-08-29,1,4,4,4,4,4,4,4,7,0,0,0,-3,0,21.0,1.0,20.0,1
3751,3751,1998-99,1998,1999,Charlton,Man United,Loss,Away,1998-09-09,0,4,5,5,5,2,5,8,11,2,0,-3,-6,0,21.0,2.0,19.0,2
3752,3752,1998-99,1998,1999,Charlton,Derby,Loss,Home,1998-09-12,0,1,4,5,5,4,5,6,9,-3,-1,-1,-4,1,21.0,9.0,12.0,2
3753,3753,1998-99,1998,1999,Charlton,Liverpool,Draw,Away,1998-09-19,1,0,1,4,5,3,6,7,10,-3,-5,-3,-5,0,21.0,3.0,18.0,2
3754,3754,1998-99,1998,1999,Charlton,Coventry,Draw,Home,1998-09-26,1,1,1,2,5,0,0,1,1,1,1,1,4,1,21.0,11.0,10.0,2
3755,3755,1998-99,1998,1999,Charlton,Nott'm Forest,Win,Away,1998-10-03,3,2,2,2,3,1,1,1,4,1,1,1,-1,0,21.0,21.0,0.0,3
3756,3756,1998-99,1998,1999,Charlton,Chelsea,Loss,Away,1998-10-17,0,4,5,5,5,4,7,10,11,0,-2,-5,-6,0,21.0,4.0,17.0,3
3757,3757,1998-99,1998,1999,Charlton,West Ham,Win,Home,1998-10-24,3,3,4,5,5,1,4,5,8,2,0,0,-3,1,21.0,8.0,13.0,3
3758,3758,1998-99,1998,1999,Charlton,Tottenham,Draw,Away,1998-11-02,1,3,6,7,8,3,6,7,8,0,0,0,0,0,21.0,14.0,7.0,4
3759,3759,1998-99,1998,1999,Charlton,Leicester,Draw,Home,1998-11-07,1,4,4,7,8,4,7,10,11,0,-3,-3,-3,1,21.0,10.0,11.0,4
3760,3760,1998-99,1998,1999,Charlton,Middlesbrough,Draw,Home,1998-11-14,1,2,5,5,8,2,3,6,9,0,2,-1,-1,1,21.0,21.0,0.0,4
3761,3761,1998-99,1998,1999,Charlton,Leeds,Loss,Away,1998-11-21,0,2,3,6,6,6,7,8,9,-4,-4,-2,-3,0,21.0,5.0,16.0,4
3762,3762,1998-99,1998,1999,Charlton,Everton,Loss,Home,1998-11-28,0,1,2,3,6,3,3,3,4,-2,-1,0,2,1,21.0,17.0,4.0,4
3763,3763,1998-99,1998,1999,Charlton,Blackburn,Loss,Away,1998-12-05,0,0,1,2,3,0,0,0,1,0,1,2,2,0,21.0,6.0,15.0,5
3764,3764,1998-99,1998,1999,Charlton,Sheffield Weds,Loss,Away,1998-12-12,0,0,0,1,2,4,7,8,8,-4,-7,-7,-6,0,21.0,16.0,5.0,5
3765,3765,1998-99,1998,1999,Charlton,Aston Villa,Loss,Home,1998-12-21,0,0,0,0,1,3,4,5,5,-3,-4,-5,-4,1,21.0,7.0,14.0,5
3766,3766,1998-99,1998,1999,Charlton,Wimbledon,Loss,Away,1998-12-26,0,0,0,0,0,3,6,6,9,-3,-6,-6,-9,0,21.0,15.0,6.0,5
3767,3767,1998-99,1998,1999,Charlton,Arsenal,Loss,Home,1998-12-28,0,0,0,0,0,6,6,7,8,-6,-6,-7,-8,1,21.0,1.0,20.0,5
3768,3768,1998-99,1998,1999,Charlton,Southampton,Loss,Away,1999-01-09,0,0,0,0,0,1,4,4,4,-1,-4,-4,-4,0,21.0,12.0,9.0,6
3769,3769,1998-99,1998,1999,Charlton,Newcastle,Draw,Home,1999-01-17,1,0,0,0,0,0,0,3,4,0,0,-3,-4,1,21.0,13.0,8.0,6
3770,3770,1998-99,1998,1999,Charlton,Man United,Loss,Home,1999-01-31,0,1,1,1,1,6,7,10,10,-5,-6,-9,-9,1,21.0,2.0,19.0,6
3771,3771,1998-99,1998,1999,Charlton,Wimbledon,Win,Home,1999-02-08,3,1,1,1,1,2,5,6,9,-1,-4,-5,-8,1,21.0,15.0,6.0,7
3772,3772,1998-99,1998,1999,Charlton,Liverpool,Win,Home,1999-02-13,3,3,4,4,4,3,6,7,10,0,-2,-3,-6,1,21.0,3.0,18.0,7
3773,3773,1998-99,1998,1999,Charlton,Derby,Win,Away,1999-02-20,3,6,6,7,7,3,6,9,9,3,0,-2,-2,0,21.0,9.0,12.0,7
3774,3774,1998-99,1998,1999,Charlton,Nott'm Forest,Draw,Home,1999-02-27,1,6,9,9,10,0,0,3,3,6,9,6,7,1,21.0,21.0,0.0,7
3775,3775,1998-99,1998,1999,Charlton,Coventry,Loss,Away,1999-03-06,0,4,7,10,10,3,3,4,7,1,4,6,3,0,21.0,11.0,10.0,8
3776,3776,1998-99,1998,1999,Charlton,Leicester,Draw,Away,1999-03-13,1,1,4,7,10,3,3,3,4,-2,1,4,6,0,21.0,10.0,11.0,8
3777,3777,1998-99,1998,1999,Charlton,Chelsea,Loss,Home,1999-04-03,0,1,2,5,8,3,6,9,10,-2,-4,-4,-2,1,21.0,4.0,17.0,9
3778,3778,1998-99,1998,1999,Charlton,West Ham,Win,Away,1999-04-05,3,1,1,2,5,4,7,7,10,-3,-6,-5,-5,0,21.0,8.0,13.0,9
3779,3779,1998-99,1998,1999,Charlton,Middlesbrough,Loss,Away,1999-04-10,0,3,4,4,5,4,7,10,10,-1,-3,-6,-5,0,21.0,21.0,0.0,9
3780,3780,1998-99,1998,1999,Charlton,Leeds,Draw,Home,1999-04-17,1,3,3,4,4,4,7,10,13,-1,-4,-6,-9,1,21.0,5.0,16.0,9
3781,3781,1998-99,1998,1999,Charlton,Tottenham,Loss,Home,1999-04-20,0,1,4,4,5,4,4,7,7,-3,0,-3,-2,1,21.0,14.0,7.0,9
3782,3782,1998-99,1998,1999,Charlton,Everton,Loss,Away,1999-04-24,0,1,1,4,4,6,6,6,6,-5,-5,-2,-2,0,21.0,17.0,4.0,9
3783,3783,1998-99,1998,1999,Charlton,Blackburn,Draw,Home,1999-05-01,1,0,1,1,4,1,1,2,5,-1,0,-1,-1,1,21.0,6.0,15.0,10
3784,3784,1998-99,1998,1999,Charlton,Aston Villa,Win,Away,1999-05-08,3,1,1,2,2,3,6,9,10,-2,-5,-7,-8,0,21.0,7.0,14.0,10
3785,3785,1998-99,1998,1999,Charlton,Sheffield Weds,Loss,Home,1999-05-16,0,4,4,4,5,3,4,5,5,1,0,-1,0,1,21.0,16.0,5.0,10
3786,3786,2000-01,2000,2001,Charlton,Man City,Win,Home,2000-08-19,3,3,4,4,4,4,7,7,7,-1,-3,-3,-3,1,21.0,21.0,0.0,1
3787,3787,2000-01,2000,2001,Charlton,Everton,Loss,Away,2000-08-23,0,3,6,7,7,0,1,1,2,3,5,6,5,0,21.0,13.0,8.0,1
3788,3788,2000-01,2000,2001,Charlton,Arsenal,Loss,Away,2000-08-26,0,3,3,6,7,3,3,4,7,0,0,2,0,0,21.0,2.0,19.0,1
3789,3789,2000-01,2000,2001,Charlton,Southampton,Draw,Home,2000-09-06,1,0,3,3,6,1,2,5,6,-1,1,-2,0,1,21.0,15.0,6.0,2
3790,3790,2000-01,2000,2001,Charlton,Derby,Draw,Away,2000-09-10,1,1,1,4,4,2,2,3,3,-1,-1,1,1,0,21.0,16.0,5.0,2
3791,3791,2000-01,2000,2001,Charlton,Tottenham,Win,Home,2000-09-16,3,2,2,2,5,6,6,7,10,-4,-4,-5,-5,1,21.0,10.0,11.0,2
3792,3792,2000-01,2000,2001,Charlton,Newcastle,Win,Away,2000-09-23,3,4,5,5,5,1,4,7,10,3,1,-2,-5,0,21.0,11.0,10.0,2
3793,3793,2000-01,2000,2001,Charlton,Coventry,Draw,Home,2000-09-30,1,6,7,8,8,0,1,1,4,6,6,7,4,1,21.0,14.0,7.0,2
3794,3794,2000-01,2000,2001,Charlton,Leeds,Loss,Away,2000-10-14,0,4,7,8,9,4,4,5,5,0,3,3,4,0,21.0,3.0,18.0,3
3795,3795,2000-01,2000,2001,Charlton,Middlesbrough,Win,Home,2000-10-21,3,1,4,7,8,3,4,5,5,-2,0,2,3,1,21.0,12.0,9.0,3
3796,3796,2000-01,2000,2001,Charlton,Aston Villa,Loss,Away,2000-10-28,0,3,4,7,10,1,4,5,8,2,0,2,2,0,21.0,6.0,15.0,3
3797,3797,2000-01,2000,2001,Charlton,Bradford,Win,Home,2000-11-04,3,3,3,4,7,1,1,2,2,2,2,2,5,1,21.0,17.0,4.0,4
3798,3798,2000-01,2000,2001,Charlton,Ipswich,Loss,Away,2000-11-11,0,3,6,6,7,3,6,7,10,0,0,-1,-3,0,21.0,21.0,0.0,4
3799,3799,2000-01,2000,2001,Charlton,Chelsea,Win,Home,2000-11-18,3,3,3,6,6,1,4,7,7,2,-1,-1,-1,1,21.0,5.0,16.0,4
3800,3800,2000-01,2000,2001,Charlton,Sunderland,Loss,Home,2000-11-25,0,3,6,6,9,4,4,7,8,-1,2,-1,1,1,21.0,7.0,14.0,4
3801,3801,2000-01,2000,2001,Charlton,Liverpool,Loss,Away,2000-12-02,0,3,3,6,6,0,3,3,6,3,0,3,0,0,21.0,4.0,17.0,5
3802,3802,2000-01,2000,2001,Charlton,Man United,Draw,Home,2000-12-09,1,0,3,3,6,6,9,12,15,-6,-6,-9,-9,1,21.0,1.0,20.0,5
3803,3803,2000-01,2000,2001,Charlton,Leicester,Loss,Away,2000-12-16,0,1,1,4,4,3,3,6,7,-2,-2,-2,-3,0,21.0,8.0,13.0,5
3804,3804,2000-01,2000,2001,Charlton,Everton,Win,Home,2000-12-23,3,1,1,1,4,1,1,4,7,0,0,-3,-3,1,21.0,13.0,8.0,5
3805,3805,2000-01,2000,2001,Charlton,West Ham,Loss,Away,2000-12-26,0,3,4,4,4,1,2,5,8,2,2,-1,-4,0,21.0,9.0,12.0,5
3806,3806,2000-01,2000,2001,Charlton,Man City,Win,Away,2000-12-30,3,3,3,4,4,1,2,5,5,2,1,-1,-1,0,21.0,21.0,0.0,5
3807,3807,2000-01,2000,2001,Charlton,Arsenal,Win,Home,2001-01-01,3,3,6,6,7,4,4,5,8,-1,2,1,-1,1,21.0,2.0,19.0,6
3808,3808,2000-01,2000,2001,Charlton,Southampton,Draw,Away,2001-01-13,1,6,6,9,9,3,6,7,7,3,0,2,2,0,21.0,15.0,6.0,6
3809,3809,2000-01,2000,2001,Charlton,West Ham,Draw,Home,2001-01-22,1,4,7,7,10,0,3,3,4,4,4,4,6,1,21.0,9.0,12.0,6
3810,3810,2000-01,2000,2001,Charlton,Derby,Win,Home,2001-01-30,3,2,5,8,8,1,4,4,5,1,1,4,3,1,21.0,16.0,5.0,6
3811,3811,2000-01,2000,2001,Charlton,Tottenham,Draw,Away,2001-02-03,1,4,5,8,11,2,3,6,6,2,2,2,5,0,21.0,10.0,11.0,7
3812,3812,2000-01,2000,2001,Charlton,Newcastle,Win,Home,2001-02-11,3,4,5,6,9,3,6,6,7,1,-1,0,2,1,21.0,11.0,10.0,7
3813,3813,2000-01,2000,2001,Charlton,Coventry,Draw,Away,2001-02-24,1,4,7,8,9,1,1,1,1,3,6,7,8,0,21.0,14.0,7.0,7
3814,3814,2000-01,2000,2001,Charlton,Middlesbrough,Draw,Away,2001-03-03,1,4,5,8,9,1,2,3,4,3,3,5,5,0,21.0,12.0,9.0,8
3815,3815,2000-01,2000,2001,Charlton,Leeds,Loss,Home,2001-03-17,0,2,5,6,9,4,5,6,9,-2,0,0,0,1,21.0,3.0,18.0,8
3816,3816,2000-01,2000,2001,Charlton,Leicester,Win,Home,2001-04-01,3,1,2,5,6,3,6,6,9,-2,-4,-1,-3,1,21.0,8.0,13.0,9
3817,3817,2000-01,2000,2001,Charlton,Man United,Loss,Away,2001-04-10,0,3,4,5,8,3,4,7,8,0,0,-2,0,0,21.0,1.0,20.0,9
3818,3818,2000-01,2000,2001,Charlton,Bradford,Loss,Away,2001-04-13,0,3,3,4,5,1,2,2,2,2,1,2,3,0,21.0,17.0,4.0,9
3819,3819,2000-01,2000,2001,Charlton,Aston Villa,Draw,Home,2001-04-17,1,0,3,3,4,4,7,10,11,-4,-4,-7,-7,1,21.0,6.0,15.0,9
3820,3820,2000-01,2000,2001,Charlton,Chelsea,Win,Away,2001-04-21,3,1,1,4,4,6,9,12,12,-5,-8,-8,-8,0,21.0,5.0,16.0,9
3821,3821,2000-01,2000,2001,Charlton,Ipswich,Win,Home,2001-04-30,3,4,4,4,7,6,9,10,13,-2,-5,-6,-6,1,21.0,21.0,0.0,9
3822,3822,2000-01,2000,2001,Charlton,Sunderland,Loss,Away,2001-05-05,0,6,7,7,7,4,4,4,5,2,3,3,2,0,21.0,7.0,14.0,10
3823,3823,2000-01,2000,2001,Charlton,Liverpool,Loss,Home,2001-05-19,0,3,6,7,7,4,7,10,13,-1,-1,-3,-6,1,21.0,4.0,17.0,10
3824,3824,2001-02,2001,2002,Charlton,Everton,Loss,Home,2001-08-18,0,0,3,6,7,1,4,4,4,-1,-1,2,3,1,9.0,16.0,-7.0,1
3825,3825,2001-02,2001,2002,Charlton,Ipswich,Win,Away,2001-08-25,3,0,0,3,6,3,4,7,7,-3,-4,-4,-1,0,9.0,5.0,4.0,1
3826,3826,2001-02,2001,2002,Charlton,Fulham,Draw,Home,2001-09-09,1,3,3,3,6,4,4,4,4,-1,-1,-1,2,1,9.0,21.0,-12.0,2
3827,3827,2001-02,2001,2002,Charlton,Leeds,Loss,Home,2001-09-16,0,4,4,4,4,2,5,8,11,2,-1,-4,-7,1,9.0,4.0,5.0,2
3828,3828,2001-02,2001,2002,Charlton,Sunderland,Draw,Away,2001-09-22,1,1,4,4,4,1,4,5,5,0,0,-1,-1,0,9.0,7.0,2.0,2
3829,3829,2001-02,2001,2002,Charlton,Leicester,Win,Home,2001-09-29,3,1,2,5,5,1,1,4,5,0,1,1,0,1,9.0,13.0,-4.0,2
3830,3830,2001-02,2001,2002,Charlton,Middlesbrough,Draw,Home,2001-10-13,1,4,4,5,8,1,4,7,7,3,0,-2,1,1,9.0,14.0,-5.0,3
3831,3831,2001-02,2001,2002,Charlton,Derby,Draw,Away,2001-10-20,1,4,5,5,6,0,0,0,1,4,5,5,5,0,9.0,17.0,-8.0,3
3832,3832,2001-02,2001,2002,Charlton,Aston Villa,Loss,Away,2001-10-24,0,2,5,6,6,3,6,9,10,-1,-1,-3,-4,0,9.0,8.0,1.0,3
3833,3833,2001-02,2001,2002,Charlton,Liverpool,Loss,Home,2001-10-27,0,1,2,5,6,4,7,10,13,-3,-5,-5,-7,1,9.0,3.0,6.0,3
3834,3834,2001-02,2001,2002,Charlton,Arsenal,Win,Away,2001-11-04,3,0,1,2,5,2,5,8,9,-2,-4,-6,-4,0,9.0,2.0,7.0,4
3835,3835,2001-02,2001,2002,Charlton,West Ham,Draw,Home,2001-11-19,1,3,3,4,5,3,6,9,9,0,-3,-5,-4,1,9.0,15.0,-6.0,4
3836,3836,2001-02,2001,2002,Charlton,Southampton,Loss,Away,2001-11-24,0,4,4,4,5,0,0,1,1,4,4,3,4,0,9.0,10.0,-1.0,4
3837,3837,2001-02,2001,2002,Charlton,Newcastle,Draw,Home,2001-12-01,1,1,4,4,4,3,6,9,9,-2,-2,-5,-5,1,9.0,11.0,-2.0,5
3838,3838,2001-02,2001,2002,Charlton,Chelsea,Win,Away,2001-12-05,3,1,2,5,5,4,5,8,9,-3,-3,-3,-4,0,9.0,6.0,3.0,5
3839,3839,2001-02,2001,2002,Charlton,Tottenham,Win,Home,2001-12-08,3,4,4,5,8,6,7,7,10,-2,-3,-2,-2,1,9.0,12.0,-3.0,5
3840,3840,2001-02,2001,2002,Charlton,Bolton,Draw,Away,2001-12-15,1,6,7,7,8,0,1,4,5,6,6,3,3,0,9.0,21.0,-12.0,5
3841,3841,2001-02,2001,2002,Charlton,Blackburn,Loss,Home,2001-12-22,0,4,7,8,8,0,0,1,2,4,7,7,6,1,9.0,21.0,-12.0,5
3842,3842,2001-02,2001,2002,Charlton,Fulham,Draw,Away,2001-12-26,1,1,4,7,8,1,4,5,6,0,0,2,2,0,9.0,21.0,-12.0,5
3843,3843,2001-02,2001,2002,Charlton,Everton,Win,Away,2001-12-29,3,1,2,5,8,0,0,3,3,1,2,2,5,0,9.0,16.0,-7.0,5
3844,3844,2001-02,2001,2002,Charlton,Ipswich,Win,Home,2002-01-01,3,4,4,5,8,6,9,9,9,-2,-5,-4,-1,1,9.0,5.0,4.0,6
3845,3845,2001-02,2001,2002,Charlton,Blackburn,Loss,Away,2002-01-12,0,6,7,7,8,0,0,3,3,6,7,4,5,0,9.0,21.0,-12.0,6
3846,3846,2001-02,2001,2002,Charlton,Aston Villa,Loss,Home,2002-01-21,0,3,6,7,7,4,5,5,5,-1,1,2,2,1,9.0,8.0,1.0,6
3847,3847,2001-02,2001,2002,Charlton,Derby,Win,Home,2002-01-29,3,0,3,6,7,0,0,3,3,0,3,3,4,1,9.0,17.0,-8.0,6
3848,3848,2001-02,2001,2002,Charlton,Middlesbrough,Draw,Away,2002-02-03,1,3,3,6,9,4,4,7,7,-1,-1,-1,2,0,9.0,14.0,-5.0,7
3849,3849,2001-02,2001,2002,Charlton,Man United,Loss,Home,2002-02-10,0,4,4,4,7,6,6,9,12,-2,-2,-5,-5,1,9.0,1.0,8.0,7
3850,3850,2001-02,2001,2002,Charlton,Leeds,Draw,Away,2002-02-24,1,1,4,4,4,1,1,2,2,0,3,2,2,0,9.0,4.0,5.0,7
3851,3851,2001-02,2001,2002,Charlton,Chelsea,Win,Home,2002-03-02,3,1,2,5,5,4,7,10,11,-3,-5,-5,-6,1,9.0,6.0,3.0,8
3852,3852,2001-02,2001,2002,Charlton,Leicester,Draw,Away,2002-03-09,1,4,4,5,8,0,0,0,0,4,4,5,8,0,9.0,13.0,-4.0,8
3853,3853,2001-02,2001,2002,Charlton,Tottenham,Win,Away,2002-03-18,3,4,5,5,6,0,3,6,6,4,2,-1,0,0,9.0,12.0,-3.0,8
3854,3854,2001-02,2001,2002,Charlton,Bolton,Loss,Home,2002-03-23,0,4,7,8,8,0,1,2,5,4,6,6,3,1,9.0,21.0,-12.0,8
3855,3855,2001-02,2001,2002,Charlton,Liverpool,Loss,Away,2002-03-30,0,3,4,7,8,6,9,12,13,-3,-5,-5,-5,0,9.0,3.0,6.0,8
3856,3856,2001-02,2001,2002,Charlton,Arsenal,Loss,Home,2002-04-01,0,0,3,4,7,6,9,12,15,-6,-6,-8,-8,1,9.0,2.0,7.0,9
3857,3857,2001-02,2001,2002,Charlton,West Ham,Loss,Away,2002-04-06,0,0,0,3,4,6,6,9,9,-6,-6,-6,-5,0,9.0,15.0,-6.0,9
3858,3858,2001-02,2001,2002,Charlton,Southampton,Draw,Home,2002-04-13,1,0,0,0,3,3,4,5,6,-3,-4,-5,-3,1,9.0,10.0,-1.0,9
3859,3859,2001-02,2001,2002,Charlton,Newcastle,Loss,Away,2002-04-20,0,1,1,1,1,4,5,8,9,-3,-4,-7,-8,0,9.0,11.0,-2.0,9
3860,3860,2001-02,2001,2002,Charlton,Sunderland,Draw,Home,2002-04-27,1,1,1,1,1,0,0,3,3,1,1,-2,-2,1,9.0,7.0,2.0,9
3861,3861,2001-02,2001,2002,Charlton,Man United,Draw,Away,2002-05-11,1,1,2,2,2,3,6,9,12,-2,-4,-7,-10,0,9.0,1.0,8.0,10
3862,3862,2002-03,2002,2003,Charlton,Chelsea,Loss,Home,2002-08-17,0,2,2,3,3,3,3,4,7,-1,-1,-1,-4,1,14.0,6.0,8.0,1
3863,3863,2002-03,2002,2003,Charlton,Bolton,Win,Away,2002-08-24,3,1,2,2,3,0,0,0,1,1,2,2,2,0,14.0,16.0,-2.0,1
3864,3864,2002-03,2002,2003,Charlton,Tottenham,Loss,Home,2002-08-27,0,3,4,5,5,4,4,7,8,-1,0,-2,-3,1,14.0,9.0,5.0,1
3865,3865,2002-03,2002,2003,Charlton,West Ham,Win,Away,2002-08-31,3,3,3,4,5,1,4,4,4,2,-1,0,1,0,14.0,7.0,7.0,1
3866,3866,2002-03,2002,2003,Charlton,Aston Villa,Loss,Away,2002-09-11,0,3,6,6,7,3,3,3,6,0,3,3,1,0,14.0,8.0,6.0,2
3867,3867,2002-03,2002,2003,Charlton,Arsenal,Loss,Home,2002-09-14,0,3,3,6,6,4,7,8,11,-1,-4,-2,-5,1,14.0,1.0,13.0,2
3868,3868,2002-03,2002,2003,Charlton,Southampton,Draw,Away,2002-09-21,1,0,3,3,6,3,3,4,4,-3,0,-1,2,0,14.0,11.0,3.0,2
3869,3869,2002-03,2002,2003,Charlton,Man United,Loss,Home,2002-09-28,0,1,1,4,4,3,3,6,7,-2,-2,-2,-3,1,14.0,3.0,11.0,2
3870,3870,2002-03,2002,2003,Charlton,Fulham,Loss,Away,2002-10-06,0,1,1,1,4,1,4,7,7,0,-3,-6,-3,0,14.0,13.0,1.0,3
3871,3871,2002-03,2002,2003,Charlton,Middlesbrough,Win,Home,2002-10-20,3,0,1,1,1,6,9,9,12,-6,-8,-8,-11,1,14.0,12.0,2.0,3
3872,3872,2002-03,2002,2003,Charlton,Newcastle,Loss,Away,2002-10-26,0,3,3,4,4,3,6,9,9,0,-3,-5,-5,0,14.0,4.0,10.0,3
3873,3873,2002-03,2002,2003,Charlton,Sunderland,Draw,Home,2002-11-03,1,3,3,3,4,1,1,4,4,2,2,-1,0,1,14.0,17.0,-3.0,4
3874,3874,2002-03,2002,2003,Charlton,Everton,Loss,Away,2002-11-09,0,1,4,4,4,6,9,9,12,-5,-5,-5,-8,0,14.0,15.0,-1.0,4
3875,3875,2002-03,2002,2003,Charlton,Man City,Win,Away,2002-11-16,3,1,1,4,4,6,9,9,9,-5,-8,-5,-5,0,14.0,21.0,-7.0,4
3876,3876,2002-03,2002,2003,Charlton,Blackburn,Win,Home,2002-11-24,3,3,4,4,7,1,2,5,8,2,2,-1,-1,1,14.0,10.0,4.0,4
3877,3877,2002-03,2002,2003,Charlton,Leeds,Win,Away,2002-12-01,3,6,6,7,7,0,3,3,4,6,3,4,3,0,14.0,5.0,9.0,5
3878,3878,2002-03,2002,2003,Charlton,Liverpool,Win,Home,2002-12-07,3,6,9,9,10,0,1,1,4,6,8,8,6,1,14.0,2.0,12.0,5
3879,3879,2002-03,2002,2003,Charlton,Man City,Draw,Home,2002-12-14,1,6,9,12,12,6,6,6,9,0,3,6,3,1,14.0,21.0,-7.0,5
3880,3880,2002-03,2002,2003,Charlton,Birmingham,Draw,Away,2002-12-21,1,4,7,10,13,3,4,7,8,1,3,3,5,0,14.0,21.0,-7.0,5
3881,3881,2002-03,2002,2003,Charlton,Tottenham,Draw,Away,2002-12-26,1,2,5,8,11,4,7,8,11,-2,-2,0,0,0,14.0,9.0,5.0,5
3882,3882,2002-03,2002,2003,Charlton,West Brom,Win,Home,2002-12-28,3,2,3,6,9,1,1,1,4,1,2,5,5,1,14.0,21.0,-7.0,5
3883,3883,2002-03,2002,2003,Charlton,Chelsea,Loss,Away,2003-01-11,0,4,5,6,9,0,1,4,5,4,4,2,4,0,14.0,6.0,8.0,6
3884,3884,2002-03,2002,2003,Charlton,Bolton,Draw,Home,2003-01-18,1,3,4,5,6,1,2,5,6,2,2,0,0,1,14.0,16.0,-2.0,6
3885,3885,2002-03,2002,2003,Charlton,West Ham,Win,Home,2003-01-22,3,1,4,5,6,1,2,3,4,0,2,2,2,1,14.0,7.0,7.0,6
3886,3886,2002-03,2002,2003,Charlton,West Brom,Win,Away,2003-01-29,3,4,4,7,8,1,1,1,2,3,3,6,6,0,14.0,21.0,-7.0,6
3887,3887,2002-03,2002,2003,Charlton,Sunderland,Win,Away,2003-02-01,3,6,7,7,10,0,1,1,1,6,6,6,9,0,14.0,17.0,-3.0,7
3888,3888,2002-03,2002,2003,Charlton,Everton,Win,Home,2003-02-08,3,6,9,10,10,6,9,9,10,0,0,1,0,1,14.0,15.0,-1.0,7
3889,3889,2002-03,2002,2003,Charlton,Aston Villa,Win,Home,2003-02-22,3,6,9,12,13,3,6,6,7,3,3,6,6,1,14.0,8.0,6.0,7
3890,3890,2002-03,2002,2003,Charlton,Arsenal,Loss,Away,2003-03-02,0,6,9,12,15,4,7,8,11,2,2,4,4,0,14.0,1.0,13.0,8
3891,3891,2002-03,2002,2003,Charlton,Newcastle,Loss,Home,2003-03-15,0,3,6,9,12,3,6,7,10,0,0,2,2,1,14.0,4.0,10.0,8
3892,3892,2002-03,2002,2003,Charlton,Middlesbrough,Draw,Away,2003-03-22,1,0,3,6,9,6,7,10,11,-6,-4,-4,-2,0,14.0,12.0,2.0,8
3893,3893,2002-03,2002,2003,Charlton,Leeds,Loss,Home,2003-04-05,0,1,1,4,7,0,0,0,3,1,1,4,4,1,14.0,5.0,9.0,9
3894,3894,2002-03,2002,2003,Charlton,Blackburn,Loss,Away,2003-04-12,0,1,1,1,4,3,6,9,12,-2,-5,-8,-8,0,14.0,10.0,4.0,9
3895,3895,2002-03,2002,2003,Charlton,Birmingham,Loss,Home,2003-04-19,0,0,1,1,1,3,6,6,9,-3,-5,-5,-8,1,14.0,21.0,-7.0,9
3896,3896,2002-03,2002,2003,Charlton,Liverpool,Loss,Away,2003-04-21,0,0,0,1,1,6,6,9,12,-6,-6,-8,-11,0,14.0,2.0,12.0,9
3897,3897,2002-03,2002,2003,Charlton,Southampton,Win,Home,2003-04-26,3,0,0,0,1,3,4,5,6,-3,-4,-5,-5,1,14.0,11.0,3.0,9
3898,3898,2002-03,2002,2003,Charlton,Man United,Loss,Away,2003-05-03,0,3,3,3,3,6,7,10,13,-3,-4,-7,-10,0,14.0,3.0,11.0,10
3899,3899,2002-03,2002,2003,Charlton,Fulham,Loss,Home,2003-05-11,0,3,3,3,3,4,4,7,7,-1,-1,-4,-4,1,14.0,13.0,1.0,10
3900,3900,2003-04,2003,2004,Charlton,Man City,Loss,Home,2003-08-17,0,0,3,3,3,3,3,6,9,-3,0,-3,-6,1,12.0,9.0,3.0,1
3901,3901,2003-04,2003,2004,Charlton,Wolves,Win,Away,2003-08-23,3,0,0,3,3,0,0,0,0,0,0,3,3,0,12.0,21.0,-9.0,1
3902,3902,2003-04,2003,2004,Charlton,Everton,Draw,Home,2003-08-26,1,3,3,3,6,3,3,3,6,0,0,0,0,1,12.0,7.0,5.0,1
3903,3903,2003-04,2003,2004,Charlton,Bolton,Draw,Away,2003-08-30,1,4,4,4,4,1,1,4,5,3,3,0,-1,0,12.0,17.0,-5.0,1
3904,3904,2003-04,2003,2004,Charlton,Man United,Loss,Home,2003-09-13,0,2,5,5,5,3,6,9,12,-1,-1,-4,-7,1,12.0,1.0,11.0,2
3905,3905,2003-04,2003,2004,Charlton,Aston Villa,Loss,Away,2003-09-20,0,1,2,5,5,3,3,4,4,-2,-1,1,1,0,12.0,16.0,-4.0,2
3906,3906,2003-04,2003,2004,Charlton,Liverpool,Win,Home,2003-09-28,3,0,1,2,5,6,9,10,11,-6,-8,-8,-6,1,12.0,5.0,7.0,2
3907,3907,2003-04,2003,2004,Charlton,Portsmouth,Win,Away,2003-10-04,3,3,3,4,5,0,1,2,5,3,2,2,0,0,12.0,21.0,-9.0,3
3908,3908,2003-04,2003,2004,Charlton,Blackburn,Win,Away,2003-10-20,3,6,6,6,7,0,3,3,4,6,3,3,3,0,12.0,6.0,6.0,3
3909,3909,2003-04,2003,2004,Charlton,Arsenal,Draw,Home,2003-10-26,1,6,9,9,9,6,9,10,11,0,0,-1,-2,1,12.0,2.0,10.0,3
3910,3910,2003-04,2003,2004,Charlton,Birmingham,Win,Away,2003-11-03,3,4,7,10,10,4,5,5,8,0,2,5,2,0,12.0,13.0,-1.0,4
3911,3911,2003-04,2003,2004,Charlton,Fulham,Win,Home,2003-11-08,3,4,7,10,13,3,3,4,7,1,4,6,6,1,12.0,14.0,-2.0,4
3912,3912,2003-04,2003,2004,Charlton,Leicester,Draw,Away,2003-11-22,1,6,7,10,13,6,6,6,6,0,1,4,7,0,12.0,21.0,-9.0,4
3913,3913,2003-04,2003,2004,Charlton,Leeds,Loss,Home,2003-11-29,0,4,7,8,11,0,0,0,0,4,7,8,11,1,12.0,15.0,-3.0,4
3914,3914,2003-04,2003,2004,Charlton,Southampton,Loss,Away,2003-12-07,0,1,4,7,8,0,1,1,4,1,3,6,4,0,12.0,8.0,4.0,5
3915,3915,2003-04,2003,2004,Charlton,Middlesbrough,Draw,Away,2003-12-13,1,0,1,4,7,4,5,8,11,-4,-4,-4,-4,0,12.0,11.0,1.0,5
3916,3916,2003-04,2003,2004,Charlton,Newcastle,Draw,Home,2003-12-20,1,1,1,2,5,4,5,8,8,-3,-4,-6,-3,1,12.0,3.0,9.0,5
3917,3917,2003-04,2003,2004,Charlton,Chelsea,Win,Home,2003-12-26,3,2,2,2,3,3,4,7,10,-1,-2,-5,-7,1,12.0,4.0,8.0,5
3918,3918,2003-04,2003,2004,Charlton,Tottenham,Win,Away,2003-12-28,3,4,5,5,5,0,0,3,3,4,5,2,2,0,12.0,10.0,2.0,5
3919,3919,2003-04,2003,2004,Charlton,Man City,Draw,Away,2004-01-07,1,6,7,8,8,1,2,2,3,5,5,6,5,0,12.0,9.0,3.0,6
3920,3920,2003-04,2003,2004,Charlton,Wolves,Win,Home,2004-01-10,3,4,7,8,9,4,4,4,4,0,3,4,5,1,12.0,21.0,-9.0,6
3921,3921,2003-04,2003,2004,Charlton,Everton,Win,Away,2004-01-17,3,4,7,10,11,1,4,4,7,3,3,6,4,0,12.0,7.0,5.0,6
3922,3922,2003-04,2003,2004,Charlton,Bolton,Loss,Home,2004-01-31,0,6,7,10,13,6,6,7,7,0,1,3,6,1,12.0,17.0,-5.0,6
3923,3923,2003-04,2003,2004,Charlton,Chelsea,Loss,Away,2004-02-08,0,3,6,7,10,4,7,7,10,-1,-1,0,0,0,12.0,4.0,8.0,7
3924,3924,2003-04,2003,2004,Charlton,Tottenham,Loss,Home,2004-02-11,0,0,3,6,7,3,6,9,12,-3,-3,-3,-5,1,12.0,10.0,2.0,7
3925,3925,2003-04,2003,2004,Charlton,Blackburn,Win,Home,2004-02-21,3,0,0,3,6,4,4,5,5,-4,-4,-2,1,1,12.0,6.0,6.0,7
3926,3926,2003-04,2003,2004,Charlton,Arsenal,Loss,Away,2004-02-28,0,3,3,3,6,6,9,12,15,-3,-6,-9,-9,0,12.0,2.0,10.0,7
3927,3927,2003-04,2003,2004,Charlton,Middlesbrough,Win,Home,2004-03-13,3,3,3,3,3,3,3,6,6,0,0,-3,-3,1,12.0,11.0,1.0,8
3928,3928,2003-04,2003,2004,Charlton,Newcastle,Loss,Away,2004-03-20,0,3,6,6,6,1,4,5,8,2,2,1,-2,0,12.0,3.0,9.0,8
3929,3929,2003-04,2003,2004,Charlton,Aston Villa,Loss,Home,2004-03-27,0,3,3,6,6,3,3,4,7,0,0,2,-1,1,12.0,16.0,-4.0,8
3930,3930,2003-04,2003,2004,Charlton,Portsmouth,Draw,Home,2004-04-10,1,0,3,3,6,6,6,6,7,-6,-3,-3,-1,1,12.0,21.0,-9.0,9
3931,3931,2003-04,2003,2004,Charlton,Liverpool,Win,Away,2004-04-12,3,1,1,4,4,3,4,7,10,-2,-3,-3,-6,0,12.0,5.0,7.0,9
3932,3932,2003-04,2003,2004,Charlton,Birmingham,Draw,Home,2004-04-17,1,4,4,4,7,0,1,4,4,4,3,0,3,1,12.0,13.0,-1.0,9
3933,3933,2003-04,2003,2004,Charlton,Man United,Loss,Away,2004-04-20,0,4,5,5,5,3,6,7,10,1,-1,-2,-5,0,12.0,1.0,11.0,9
3934,3934,2003-04,2003,2004,Charlton,Fulham,Loss,Away,2004-04-24,0,1,4,5,5,1,4,5,6,0,0,0,-1,0,12.0,14.0,-2.0,9
3935,3935,2003-04,2003,2004,Charlton,Leicester,Draw,Home,2004-05-01,1,0,1,4,5,1,1,1,1,-1,0,3,4,1,12.0,21.0,-9.0,10
3936,3936,2003-04,2003,2004,Charlton,Leeds,Draw,Away,2004-05-08,1,1,1,2,5,0,0,1,4,1,1,1,1,0,12.0,15.0,-3.0,10
3937,3937,2003-04,2003,2004,Charlton,Southampton,Win,Home,2004-05-15,3,2,2,2,3,2,2,2,5,0,0,0,-2,1,12.0,8.0,4.0,10
3938,3938,2004-05,2004,2005,Charlton,Bolton,Loss,Away,2004-08-14,0,4,5,5,5,3,6,9,12,1,-1,-4,-7,0,7.0,8.0,-1.0,1
3939,3939,2004-05,2004,2005,Charlton,Portsmouth,Win,Home,2004-08-21,3,3,4,5,5,4,4,5,6,-1,0,0,-1,1,7.0,13.0,-6.0,1
3940,3940,2004-05,2004,2005,Charlton,Aston Villa,Win,Home,2004-08-25,3,3,6,7,8,4,4,5,8,-1,2,2,0,1,7.0,6.0,1.0,1
3941,3941,2004-05,2004,2005,Charlton,Man City,Loss,Away,2004-08-28,0,6,6,9,10,0,1,4,4,6,5,5,6,0,7.0,16.0,-9.0,1
3942,3942,2004-05,2004,2005,Charlton,Southampton,Draw,Home,2004-09-13,1,3,6,6,9,0,3,3,3,3,3,3,6,1,7.0,12.0,-5.0,2
3943,3943,2004-05,2004,2005,Charlton,Birmingham,Draw,Away,2004-09-18,1,1,4,7,7,0,3,3,4,1,1,4,3,0,7.0,10.0,-3.0,2
3944,3944,2004-05,2004,2005,Charlton,Blackburn,Win,Home,2004-09-27,3,2,2,5,8,3,4,4,4,-1,-2,1,4,1,7.0,15.0,-8.0,2
3945,3945,2004-05,2004,2005,Charlton,Arsenal,Loss,Away,2004-10-02,0,4,5,5,8,4,7,10,13,0,-2,-5,-5,0,7.0,1.0,6.0,3
3946,3946,2004-05,2004,2005,Charlton,Newcastle,Draw,Home,2004-10-17,1,3,4,5,5,4,7,10,10,-1,-3,-5,-5,1,7.0,5.0,2.0,3
3947,3947,2004-05,2004,2005,Charlton,Liverpool,Loss,Away,2004-10-23,0,1,4,5,6,3,6,6,9,-2,-2,-1,-3,0,7.0,4.0,3.0,3
3948,3948,2004-05,2004,2005,Charlton,Middlesbrough,Loss,Home,2004-10-30,0,1,1,4,5,4,5,5,5,-3,-4,-1,0,1,7.0,11.0,-4.0,3
3949,3949,2004-05,2004,2005,Charlton,Tottenham,Win,Away,2004-11-06,3,0,1,1,4,0,0,3,3,0,1,-2,1,0,7.0,14.0,-7.0,4
3950,3950,2004-05,2004,2005,Charlton,Norwich,Win,Home,2004-11-13,3,3,3,4,4,2,2,3,4,1,1,1,0,1,7.0,21.0,-14.0,4
3951,3951,2004-05,2004,2005,Charlton,Man United,Loss,Away,2004-11-20,0,6,6,6,7,4,4,7,8,2,2,-1,-1,0,7.0,3.0,4.0,4
3952,3952,2004-05,2004,2005,Charlton,Chelsea,Loss,Home,2004-11-27,0,3,6,6,6,4,7,10,13,-1,-1,-4,-7,1,7.0,2.0,5.0,4
3953,3953,2004-05,2004,2005,Charlton,Crystal Palace,Win,Away,2004-12-05,3,0,3,6,6,1,1,2,5,-1,2,4,1,0,7.0,21.0,-14.0,5
3954,3954,2004-05,2004,2005,Charlton,West Brom,Win,Away,2004-12-11,3,3,3,6,9,0,1,1,2,3,2,5,7,0,7.0,21.0,-14.0,5
3955,3955,2004-05,2004,2005,Charlton,Fulham,Win,Home,2004-12-20,3,6,6,6,9,4,4,4,4,2,2,2,5,1,7.0,9.0,-2.0,5
3956,3956,2004-05,2004,2005,Charlton,Southampton,Draw,Away,2004-12-26,1,6,9,9,9,1,1,2,2,5,8,7,7,0,7.0,12.0,-5.0,5
3957,3957,2004-05,2004,2005,Charlton,Everton,Win,Home,2004-12-28,3,4,7,10,10,4,7,10,11,0,0,0,-1,1,7.0,17.0,-10.0,5
3958,3958,2004-05,2004,2005,Charlton,Arsenal,Loss,Home,2005-01-01,0,4,7,10,13,6,9,10,13,-2,-2,0,0,1,7.0,1.0,6.0,6
3959,3959,2004-05,2004,2005,Charlton,Blackburn,Loss,Away,2005-01-03,0,3,4,7,10,3,4,5,6,0,0,2,4,0,7.0,15.0,-8.0,6
3960,3960,2004-05,2004,2005,Charlton,Birmingham,Win,Home,2005-01-15,3,0,3,4,7,0,3,6,9,0,0,-2,-2,1,7.0,10.0,-3.0,6
3961,3961,2004-05,2004,2005,Charlton,Everton,Win,Away,2005-01-22,3,3,3,6,7,4,4,4,7,-1,-1,2,0,0,7.0,17.0,-10.0,6
3962,3962,2004-05,2004,2005,Charlton,Liverpool,Loss,Home,2005-02-01,0,6,6,6,9,0,3,3,6,6,3,3,3,1,7.0,4.0,3.0,7
3963,3963,2004-05,2004,2005,Charlton,Newcastle,Draw,Away,2005-02-05,1,3,6,6,6,1,4,5,8,2,2,1,-2,0,7.0,5.0,2.0,7
3964,3964,2004-05,2004,2005,Charlton,Middlesbrough,Draw,Away,2005-02-27,1,1,4,7,7,4,4,5,6,-3,0,2,1,0,7.0,11.0,-4.0,7
3965,3965,2004-05,2004,2005,Charlton,Fulham,Draw,Away,2005-03-05,1,2,2,5,8,0,1,4,7,2,1,1,1,0,7.0,9.0,-2.0,8
3966,3966,2004-05,2004,2005,Charlton,Tottenham,Win,Home,2005-03-16,3,2,3,3,6,3,6,6,6,-1,-3,-3,0,1,7.0,14.0,-7.0,8
3967,3967,2004-05,2004,2005,Charlton,West Brom,Loss,Home,2005-03-19,0,4,5,6,6,3,4,4,5,1,1,2,1,1,7.0,21.0,-14.0,8
3968,3968,2004-05,2004,2005,Charlton,Man City,Draw,Home,2005-04-02,1,3,4,5,6,0,3,3,4,3,1,2,2,1,7.0,16.0,-9.0,9
3969,3969,2004-05,2004,2005,Charlton,Portsmouth,Loss,Away,2005-04-09,0,1,4,5,6,1,1,1,1,0,3,4,5,0,7.0,13.0,-6.0,9
3970,3970,2004-05,2004,2005,Charlton,Bolton,Loss,Home,2005-04-16,0,1,1,4,5,3,6,9,9,-2,-5,-5,-4,1,7.0,8.0,-1.0,9
3971,3971,2004-05,2004,2005,Charlton,Aston Villa,Draw,Away,2005-04-20,1,0,1,1,4,4,7,7,10,-4,-6,-6,-6,0,7.0,6.0,1.0,9
3972,3972,2004-05,2004,2005,Charlton,Norwich,Loss,Away,2005-04-23,0,1,1,2,2,4,7,7,7,-3,-6,-5,-5,0,7.0,21.0,-14.0,9
3973,3973,2004-05,2004,2005,Charlton,Man United,Loss,Home,2005-05-01,0,1,1,1,2,3,3,4,7,-2,-2,-3,-5,1,7.0,3.0,4.0,10
3974,3974,2004-05,2004,2005,Charlton,Chelsea,Loss,Away,2005-05-07,0,0,1,1,1,6,7,8,11,-6,-6,-7,-10,0,7.0,2.0,5.0,10
3975,3975,2004-05,2004,2005,Charlton,Crystal Palace,Draw,Home,2005-05-15,1,0,0,1,1,2,5,5,6,-2,-5,-4,-5,1,7.0,21.0,-14.0,10
3976,3976,2005-06,2005,2006,Charlton,Sunderland,Win,Away,2005-08-13,3,1,1,1,2,0,0,0,0,1,1,1,2,0,11.0,21.0,-10.0,1
3977,3977,2005-06,2005,2006,Charlton,Wigan,Win,Home,2005-08-20,3,4,4,4,4,0,0,0,0,4,4,4,4,1,11.0,21.0,-10.0,1
3978,3978,2005-06,2005,2006,Charlton,Middlesbrough,Win,Away,2005-08-28,3,6,7,7,7,3,4,5,8,3,3,2,-1,0,11.0,7.0,4.0,1
3979,3979,2005-06,2005,2006,Charlton,Birmingham,Win,Away,2005-09-10,3,6,9,10,10,3,3,4,7,3,6,6,3,0,11.0,12.0,-1.0,2
3980,3980,2005-06,2005,2006,Charlton,Chelsea,Loss,Home,2005-09-17,0,6,9,12,13,6,9,12,15,0,0,0,-2,1,11.0,1.0,10.0,2
3981,3981,2005-06,2005,2006,Charlton,West Brom,Win,Away,2005-09-24,3,3,6,9,12,1,1,1,4,2,5,8,8,0,11.0,17.0,-6.0,2
3982,3982,2005-06,2005,2006,Charlton,Tottenham,Loss,Home,2005-10-01,0,3,6,9,12,4,5,5,6,-1,1,4,6,1,11.0,9.0,2.0,3
3983,3983,2005-06,2005,2006,Charlton,Fulham,Draw,Home,2005-10-17,1,3,3,6,9,0,0,1,4,3,3,5,5,1,11.0,13.0,-2.0,3
3984,3984,2005-06,2005,2006,Charlton,Portsmouth,Win,Away,2005-10-22,3,1,4,4,7,2,2,3,6,-1,2,1,1,0,11.0,16.0,-5.0,3
3985,3985,2005-06,2005,2006,Charlton,Bolton,Loss,Home,2005-10-29,0,4,4,7,7,3,3,6,9,1,1,1,-2,1,11.0,6.0,5.0,3
3986,3986,2005-06,2005,2006,Charlton,Blackburn,Loss,Away,2005-11-05,0,3,4,4,7,3,3,6,9,0,1,-2,-2,0,11.0,15.0,-4.0,4
3987,3987,2005-06,2005,2006,Charlton,Man United,Loss,Home,2005-11-19,0,0,3,4,4,3,4,7,10,-3,-1,-3,-6,1,11.0,3.0,8.0,4
3988,3988,2005-06,2005,2006,Charlton,Aston Villa,Loss,Away,2005-11-26,0,0,0,3,4,3,3,3,6,-3,-3,0,-2,0,11.0,10.0,1.0,4
3989,3989,2005-06,2005,2006,Charlton,Man City,Loss,Home,2005-12-04,0,0,0,0,3,1,1,4,4,-1,-1,-4,-1,1,11.0,8.0,3.0,5
3990,3990,2005-06,2005,2006,Charlton,Sunderland,Win,Home,2005-12-10,3,0,0,0,0,0,0,0,0,0,0,0,0,1,11.0,21.0,-10.0,5
3991,3991,2005-06,2005,2006,Charlton,Wigan,Loss,Away,2005-12-17,0,3,3,3,3,0,0,0,0,3,3,3,3,0,11.0,21.0,-10.0,5
3992,3992,2005-06,2005,2006,Charlton,Arsenal,Loss,Home,2005-12-26,0,3,3,3,3,0,0,3,6,3,3,0,-3,1,11.0,2.0,9.0,5
3993,3993,2005-06,2005,2006,Charlton,West Ham,Win,Home,2005-12-31,3,0,3,3,3,1,1,4,4,-1,2,-1,-1,1,11.0,21.0,-10.0,5
3994,3994,2005-06,2005,2006,Charlton,Everton,Loss,Away,2006-01-02,0,3,3,6,6,3,3,3,3,0,0,3,3,0,11.0,4.0,7.0,6
3995,3995,2005-06,2005,2006,Charlton,Birmingham,Win,Home,2006-01-14,3,3,3,3,6,3,4,4,4,0,-1,-1,2,1,11.0,12.0,-1.0,6
3996,3996,2005-06,2005,2006,Charlton,Chelsea,Draw,Away,2006-01-22,1,3,6,6,6,6,9,12,15,-3,-3,-6,-9,0,11.0,1.0,10.0,6
3997,3997,2005-06,2005,2006,Charlton,West Brom,Draw,Home,2006-01-31,1,4,4,7,7,3,3,3,6,1,1,4,1,1,11.0,17.0,-6.0,6
3998,3998,2005-06,2005,2006,Charlton,Tottenham,Loss,Away,2006-02-05,0,2,5,5,8,1,1,4,7,1,4,1,1,0,11.0,9.0,2.0,7
3999,3999,2005-06,2005,2006,Charlton,Liverpool,Win,Home,2006-02-08,3,1,2,5,5,1,1,4,5,0,1,1,0,1,11.0,5.0,6.0,7
4000,4000,2005-06,2005,2006,Charlton,Man City,Loss,Away,2006-02-12,0,3,4,5,8,3,3,6,6,0,1,-1,2,0,11.0,8.0,3.0,7
4001,4001,2005-06,2005,2006,Charlton,Newcastle,Draw,Away,2006-02-22,1,3,3,4,5,6,6,6,6,-3,-3,-2,-1,0,11.0,14.0,-3.0,7
4002,4002,2005-06,2005,2006,Charlton,Aston Villa,Draw,Home,2006-02-25,1,1,4,4,5,3,4,5,5,-2,0,-1,0,1,11.0,10.0,1.0,7
4003,4003,2005-06,2005,2006,Charlton,Liverpool,Draw,Away,2006-03-04,1,2,2,5,5,6,9,9,9,-4,-7,-4,-4,0,11.0,5.0,6.0,8
4004,4004,2005-06,2005,2006,Charlton,Middlesbrough,Win,Home,2006-03-12,3,2,3,3,6,6,9,9,12,-4,-6,-6,-6,1,11.0,7.0,4.0,8
4005,4005,2005-06,2005,2006,Charlton,Arsenal,Loss,Away,2006-03-18,0,4,5,6,6,6,6,6,7,-2,-1,0,-1,0,11.0,2.0,9.0,8
4006,4006,2005-06,2005,2006,Charlton,Newcastle,Win,Home,2006-03-26,3,3,4,5,6,0,3,6,7,3,1,-1,-1,1,11.0,14.0,-3.0,8
4007,4007,2005-06,2005,2006,Charlton,West Ham,Draw,Away,2006-04-02,1,3,6,7,8,3,3,3,4,0,3,4,4,0,11.0,21.0,-10.0,9
4008,4008,2005-06,2005,2006,Charlton,Everton,Draw,Home,2006-04-08,1,4,4,7,8,1,4,7,8,3,0,0,0,1,11.0,4.0,7.0,9
4009,4009,2005-06,2005,2006,Charlton,Fulham,Loss,Away,2006-04-15,0,2,5,5,8,1,4,4,4,1,1,1,4,0,11.0,13.0,-2.0,9
4010,4010,2005-06,2005,2006,Charlton,Portsmouth,Win,Home,2006-04-17,3,1,2,5,5,4,5,8,11,-3,-3,-3,-6,1,11.0,16.0,-5.0,9
4011,4011,2005-06,2005,2006,Charlton,Bolton,Loss,Away,2006-04-22,0,3,4,5,8,1,1,1,1,2,3,4,7,0,11.0,6.0,5.0,9
4012,4012,2005-06,2005,2006,Charlton,Blackburn,Loss,Home,2006-04-29,0,3,3,4,5,0,1,2,5,3,2,2,0,1,11.0,15.0,-4.0,9
4013,4013,2005-06,2005,2006,Charlton,Man United,Loss,Away,2006-05-07,0,0,3,3,4,1,4,5,8,-1,-1,-2,-4,0,11.0,3.0,8.0,10
4014,4014,2006-07,2006,2007,Charlton,West Ham,Loss,Away,2006-08-19,0,0,0,3,3,6,6,6,9,-6,-6,-3,-6,0,13.0,9.0,4.0,1
4015,4015,2006-07,2006,2007,Charlton,Man United,Loss,Home,2006-08-23,0,0,0,0,3,6,7,7,10,-6,-7,-7,-7,1,13.0,2.0,11.0,1
4016,4016,2006-07,2006,2007,Charlton,Bolton,Win,Home,2006-08-26,3,0,0,0,0,4,7,8,8,-4,-7,-8,-8,1,13.0,8.0,5.0,1
4017,4017,2006-07,2006,2007,Charlton,Chelsea,Loss,Away,2006-09-09,0,3,3,3,3,3,6,6,6,0,-3,-3,-3,0,13.0,1.0,12.0,2
4018,4018,2006-07,2006,2007,Charlton,Portsmouth,Loss,Home,2006-09-16,0,3,3,3,3,6,7,10,10,-3,-4,-7,-7,1,13.0,17.0,-4.0,2
4019,4019,2006-07,2006,2007,Charlton,Aston Villa,Loss,Away,2006-09-23,0,0,3,3,3,2,5,8,9,-2,-2,-5,-6,0,13.0,16.0,-3.0,2
4020,4020,2006-07,2006,2007,Charlton,Arsenal,Loss,Home,2006-09-30,0,0,0,3,3,6,7,7,8,-6,-7,-4,-5,1,13.0,4.0,9.0,2
4021,4021,2006-07,2006,2007,Charlton,Fulham,Loss,Away,2006-10-16,0,0,0,0,3,1,2,5,8,-1,-2,-5,-5,0,13.0,12.0,1.0,3
4022,4022,2006-07,2006,2007,Charlton,Watford,Draw,Home,2006-10-21,1,0,0,0,0,1,2,3,3,-1,-2,-3,-3,1,13.0,21.0,-8.0,3
4023,4023,2006-07,2006,2007,Charlton,Newcastle,Draw,Away,2006-10-28,1,1,1,1,1,0,0,1,1,1,1,0,0,0,13.0,7.0,6.0,3
4024,4024,2006-07,2006,2007,Charlton,Man City,Win,Home,2006-11-04,3,2,2,2,2,3,4,5,8,-1,-2,-3,-6,1,13.0,15.0,-2.0,4
4025,4025,2006-07,2006,2007,Charlton,Wigan,Loss,Away,2006-11-11,0,4,5,5,5,6,9,9,9,-2,-4,-4,-4,0,13.0,10.0,3.0,4
4026,4026,2006-07,2006,2007,Charlton,Reading,Loss,Away,2006-11-18,0,3,4,5,5,3,3,3,3,0,1,2,2,0,13.0,21.0,-8.0,4
4027,4027,2006-07,2006,2007,Charlton,Everton,Draw,Home,2006-11-25,1,0,3,4,5,3,3,4,7,-3,0,0,-2,1,13.0,11.0,2.0,4
4028,4028,2006-07,2006,2007,Charlton,Sheffield United,Loss,Away,2006-12-02,0,1,1,4,5,3,3,4,7,-2,-2,0,-2,0,13.0,21.0,-8.0,5
4029,4029,2006-07,2006,2007,Charlton,Blackburn,Win,Home,2006-12-05,3,1,1,1,4,4,4,4,4,-3,-3,-3,0,1,13.0,6.0,7.0,5
4030,4030,2006-07,2006,2007,Charlton,Tottenham,Loss,Away,2006-12-09,0,3,4,4,4,3,6,7,7,0,-2,-3,-3,0,13.0,5.0,8.0,5
4031,4031,2006-07,2006,2007,Charlton,Liverpool,Loss,Home,2006-12-16,0,3,3,4,4,6,7,10,11,-3,-4,-6,-7,1,13.0,3.0,10.0,5
4032,4032,2006-07,2006,2007,Charlton,Middlesbrough,Loss,Away,2006-12-23,0,0,3,3,4,1,1,1,2,-1,2,2,2,0,13.0,14.0,-1.0,5
4033,4033,2006-07,2006,2007,Charlton,Fulham,Draw,Home,2006-12-27,1,0,0,3,3,4,4,4,7,-4,-4,-1,-4,1,13.0,12.0,1.0,5
4034,4034,2006-07,2006,2007,Charlton,Aston Villa,Win,Home,2006-12-30,3,1,1,1,4,0,0,1,2,1,1,0,2,1,13.0,16.0,-3.0,5
4035,4035,2006-07,2006,2007,Charlton,Arsenal,Loss,Away,2007-01-02,0,4,4,4,4,3,6,7,10,1,-2,-3,-6,0,13.0,4.0,9.0,6
4036,4036,2006-07,2006,2007,Charlton,Middlesbrough,Loss,Home,2007-01-13,0,3,4,4,4,3,4,7,7,0,0,-3,-3,1,13.0,14.0,-1.0,6
4037,4037,2006-07,2006,2007,Charlton,Portsmouth,Win,Away,2007-01-20,3,0,3,4,4,2,2,5,8,-2,1,-1,-4,0,13.0,17.0,-4.0,6
4038,4038,2006-07,2006,2007,Charlton,Bolton,Draw,Away,2007-01-31,1,3,3,6,7,1,1,4,7,2,2,2,0,0,13.0,8.0,5.0,6
4039,4039,2006-07,2006,2007,Charlton,Chelsea,Loss,Home,2007-02-03,0,4,4,4,7,3,6,7,8,1,-2,-3,-1,1,13.0,1.0,12.0,7
4040,4040,2006-07,2006,2007,Charlton,Man United,Loss,Away,2007-02-10,0,1,4,4,4,6,6,9,10,-5,-2,-5,-6,0,13.0,2.0,11.0,7
4041,4041,2006-07,2006,2007,Charlton,West Ham,Win,Home,2007-02-24,3,0,1,4,4,0,0,1,2,0,1,3,2,1,13.0,9.0,4.0,7
4042,4042,2006-07,2006,2007,Charlton,Watford,Draw,Away,2007-03-03,1,3,3,4,7,1,4,4,4,2,-1,0,3,0,13.0,21.0,-8.0,8
4043,4043,2006-07,2006,2007,Charlton,Newcastle,Win,Home,2007-03-18,3,4,4,4,5,1,4,4,7,3,0,0,-2,1,13.0,7.0,6.0,8
4044,4044,2006-07,2006,2007,Charlton,Wigan,Win,Home,2007-03-31,3,4,7,7,7,4,7,8,8,0,0,-1,-1,1,13.0,10.0,3.0,8
4045,4045,2006-07,2006,2007,Charlton,Man City,Draw,Away,2007-04-06,1,6,7,10,10,6,6,6,6,0,1,4,4,0,13.0,15.0,-2.0,9
4046,4046,2006-07,2006,2007,Charlton,Reading,Draw,Home,2007-04-09,1,4,7,8,11,0,1,1,1,4,6,7,10,1,13.0,21.0,-8.0,9
4047,4047,2006-07,2006,2007,Charlton,Everton,Loss,Away,2007-04-15,0,2,5,8,9,4,5,8,9,-2,0,0,0,0,13.0,11.0,2.0,9
4048,4048,2006-07,2006,2007,Charlton,Sheffield United,Draw,Home,2007-04-21,1,1,2,5,8,3,3,3,3,-2,-1,2,5,1,13.0,21.0,-8.0,9
4049,4049,2006-07,2006,2007,Charlton,Blackburn,Loss,Away,2007-04-28,0,1,2,3,6,4,4,4,4,-3,-2,-1,2,0,13.0,6.0,7.0,9
4050,4050,2006-07,2006,2007,Charlton,Tottenham,Loss,Home,2007-05-07,0,1,1,2,3,4,5,5,8,-3,-4,-3,-5,1,13.0,5.0,8.0,10
4051,4051,2006-07,2006,2007,Charlton,Liverpool,Draw,Away,2007-05-13,1,0,1,1,2,0,3,6,7,0,-2,-5,-5,0,13.0,3.0,10.0,10
4052,4052,1993-94,1993,1994,Chelsea,Blackburn,Loss,Home,1993-08-14,0,0,0,0,0,0,0,0,0,0,0,0,0,1,11.0,4.0,7.0,1
4053,4053,1993-94,1993,1994,Chelsea,Wimbledon,Draw,Away,1993-08-17,1,0,0,0,0,3,3,3,3,-3,-3,-3,-3,0,11.0,12.0,-1.0,1
4054,4054,1993-94,1993,1994,Chelsea,Ipswich,Loss,Away,1993-08-21,0,1,1,1,1,6,6,6,6,-5,-5,-5,-5,0,11.0,16.0,-5.0,1
4055,4055,1993-94,1993,1994,Chelsea,QPR,Win,Home,1993-08-25,3,1,1,1,1,3,3,3,3,-2,-2,-2,-2,1,11.0,5.0,6.0,1
4056,4056,1993-94,1993,1994,Chelsea,Sheffield Weds,Draw,Home,1993-08-28,1,3,4,4,4,0,1,1,1,3,3,3,3,1,11.0,7.0,4.0,1
4057,4057,1993-94,1993,1994,Chelsea,Tottenham,Draw,Away,1993-09-01,1,4,4,5,5,3,6,6,9,1,-2,-1,-4,0,11.0,8.0,3.0,2
4058,4058,1993-94,1993,1994,Chelsea,Man United,Win,Home,1993-09-11,3,2,5,5,6,6,9,10,13,-4,-4,-5,-7,1,11.0,1.0,10.0,2
4059,4059,1993-94,1993,1994,Chelsea,Coventry,Draw,Away,1993-09-18,1,4,5,8,8,4,5,6,7,0,0,2,1,0,11.0,15.0,-4.0,2
4060,4060,1993-94,1993,1994,Chelsea,Liverpool,Win,Home,1993-09-25,3,4,5,6,9,0,0,3,3,4,5,3,6,1,11.0,6.0,5.0,2
4061,4061,1993-94,1993,1994,Chelsea,West Ham,Loss,Away,1993-10-02,0,4,7,8,9,3,4,4,4,1,3,4,5,0,11.0,21.0,-10.0,3
4062,4062,1993-94,1993,1994,Chelsea,Norwich,Loss,Home,1993-10-16,0,3,4,7,8,6,7,7,8,-3,-3,0,0,1,11.0,3.0,8.0,3
4063,4063,1993-94,1993,1994,Chelsea,Aston Villa,Loss,Away,1993-10-23,0,0,3,4,7,1,2,5,6,-1,1,-1,1,0,11.0,2.0,9.0,3
4064,4064,1993-94,1993,1994,Chelsea,Oldham,Loss,Home,1993-10-30,0,0,0,3,4,1,2,3,3,-1,-2,0,1,1,11.0,19.0,-8.0,3
4065,4065,1993-94,1993,1994,Chelsea,Leeds,Loss,Away,1993-11-06,0,0,0,0,3,2,3,6,9,-2,-3,-6,-6,0,11.0,17.0,-6.0,4
4066,4066,1993-94,1993,1994,Chelsea,Arsenal,Loss,Home,1993-11-20,0,0,0,0,0,1,2,3,4,-1,-2,-3,-4,1,11.0,10.0,1.0,4
4067,4067,1993-94,1993,1994,Chelsea,Man City,Draw,Home,1993-11-22,1,0,0,0,0,1,1,2,3,-1,-1,-2,-3,1,11.0,9.0,2.0,4
4068,4068,1993-94,1993,1994,Chelsea,Sheffield United,Loss,Away,1993-11-27,0,1,1,1,1,0,0,1,2,1,1,0,-1,0,11.0,14.0,-3.0,4
4069,4069,1993-94,1993,1994,Chelsea,Blackburn,Loss,Away,1993-12-05,0,1,1,1,1,3,6,6,9,-2,-5,-5,-8,0,11.0,4.0,7.0,5
4070,4070,1993-94,1993,1994,Chelsea,Ipswich,Draw,Home,1993-12-11,1,0,1,1,1,4,7,8,9,-4,-6,-7,-8,1,11.0,16.0,-5.0,5
4071,4071,1993-94,1993,1994,Chelsea,Southampton,Loss,Away,1993-12-27,0,1,1,2,2,0,0,0,0,1,1,2,2,0,11.0,18.0,-7.0,5
4072,4072,1993-94,1993,1994,Chelsea,Newcastle,Win,Home,1993-12-28,3,1,1,1,2,4,5,8,8,-3,-4,-7,-6,1,11.0,21.0,-10.0,5
4073,4073,1993-94,1993,1994,Chelsea,Swindon,Win,Away,1994-01-01,3,3,4,4,4,1,4,5,5,2,0,-1,-1,0,11.0,21.0,-10.0,6
4074,4074,1993-94,1993,1994,Chelsea,Everton,Win,Home,1994-01-03,3,6,6,7,7,0,0,0,1,6,6,7,6,1,11.0,13.0,-2.0,6
4075,4075,1993-94,1993,1994,Chelsea,Norwich,Draw,Away,1994-01-15,1,6,9,9,10,3,3,6,6,3,6,3,4,0,11.0,3.0,8.0,6
4076,4076,1993-94,1993,1994,Chelsea,Aston Villa,Draw,Home,1994-01-22,1,4,7,10,10,3,6,6,6,1,1,4,4,1,11.0,2.0,9.0,6
4077,4077,1993-94,1993,1994,Chelsea,Everton,Loss,Away,1994-02-05,0,2,5,8,11,3,3,3,3,-1,2,5,8,0,11.0,13.0,-2.0,7
4078,4078,1993-94,1993,1994,Chelsea,Oldham,Loss,Away,1994-02-12,0,1,2,5,8,4,4,4,4,-3,-2,1,4,0,11.0,19.0,-8.0,7
4079,4079,1993-94,1993,1994,Chelsea,Tottenham,Win,Home,1994-02-27,3,0,1,2,5,0,0,0,0,0,1,2,5,1,11.0,8.0,3.0,7
4080,4080,1993-94,1993,1994,Chelsea,Man United,Win,Away,1994-03-05,3,3,3,4,5,4,7,10,11,-1,-4,-6,-6,0,11.0,1.0,10.0,8
4081,4081,1993-94,1993,1994,Chelsea,Wimbledon,Win,Home,1994-03-16,3,6,6,6,7,6,6,9,9,0,0,-3,-2,1,11.0,12.0,-1.0,8
4082,4082,1993-94,1993,1994,Chelsea,Liverpool,Loss,Away,1994-03-19,0,6,9,9,9,3,6,6,6,3,3,3,3,0,11.0,6.0,5.0,8
4083,4083,1993-94,1993,1994,Chelsea,West Ham,Win,Home,1994-03-26,3,3,6,9,9,1,2,3,4,2,4,6,5,1,11.0,21.0,-10.0,8
4084,4084,1993-94,1993,1994,Chelsea,Sheffield Weds,Loss,Away,1994-03-30,0,3,6,9,12,0,1,1,2,3,5,8,10,0,11.0,7.0,4.0,8
4085,4085,1993-94,1993,1994,Chelsea,Southampton,Win,Home,1994-04-02,3,3,3,6,9,1,1,2,3,2,2,4,6,1,11.0,18.0,-7.0,9
4086,4086,1993-94,1993,1994,Chelsea,Newcastle,Draw,Away,1994-04-04,1,3,6,6,9,4,7,10,13,-1,-1,-4,-4,0,11.0,21.0,-10.0,9
4087,4087,1993-94,1993,1994,Chelsea,QPR,Draw,Away,1994-04-13,1,4,4,7,7,0,0,3,6,4,4,4,1,0,11.0,5.0,6.0,9
4088,4088,1993-94,1993,1994,Chelsea,Arsenal,Loss,Away,1994-04-16,0,2,5,5,8,2,5,6,9,0,0,-1,-1,0,11.0,10.0,1.0,9
4089,4089,1993-94,1993,1994,Chelsea,Leeds,Draw,Home,1994-04-23,1,1,2,5,5,6,7,7,10,-5,-5,-2,-5,1,11.0,17.0,-6.0,9
4090,4090,1993-94,1993,1994,Chelsea,Swindon,Win,Home,1994-04-27,3,1,2,3,6,1,1,2,2,0,1,1,4,1,11.0,21.0,-10.0,9
4091,4091,1993-94,1993,1994,Chelsea,Man City,Draw,Away,1994-04-30,1,4,4,5,6,1,4,7,10,3,0,-2,-4,0,11.0,9.0,2.0,9
4092,4092,1993-94,1993,1994,Chelsea,Coventry,Loss,Home,1994-05-04,0,4,5,5,6,4,5,8,11,0,0,-3,-5,1,11.0,15.0,-4.0,10
4093,4093,1993-94,1993,1994,Chelsea,Sheffield United,Win,Home,1994-05-07,3,1,4,5,5,4,7,7,8,-3,-3,-2,-3,1,11.0,14.0,-3.0,10
4094,4094,1994-95,1994,1995,Chelsea,Norwich,Win,Home,1994-08-20,3,3,4,7,8,4,4,5,5,-1,0,2,3,1,14.0,12.0,2.0,1
4095,4095,1994-95,1994,1995,Chelsea,Leeds,Win,Away,1994-08-27,3,6,6,7,10,4,7,8,11,2,-1,-1,-1,0,14.0,5.0,9.0,1
4096,4096,1994-95,1994,1995,Chelsea,Man City,Win,Home,1994-08-31,3,6,9,9,10,6,6,7,8,0,3,2,2,1,14.0,16.0,-2.0,1
4097,4097,1994-95,1994,1995,Chelsea,Newcastle,Loss,Away,1994-09-10,0,6,9,12,12,6,9,12,15,0,0,0,-3,0,14.0,3.0,11.0,2
4098,4098,1994-95,1994,1995,Chelsea,Blackburn,Loss,Home,1994-09-18,0,3,6,9,12,4,7,10,11,-1,-1,-1,1,1,14.0,2.0,12.0,2
4099,4099,1994-95,1994,1995,Chelsea,Crystal Palace,Win,Away,1994-09-24,3,0,3,6,9,2,2,3,4,-2,1,3,5,0,14.0,21.0,-7.0,2
4100,4100,1994-95,1994,1995,Chelsea,West Ham,Loss,Home,1994-10-02,0,3,3,6,9,3,4,4,4,0,-1,2,5,1,14.0,13.0,1.0,3
4101,4101,1994-95,1994,1995,Chelsea,Leicester,Win,Home,1994-10-08,3,3,3,3,6,2,5,5,6,1,-2,-2,0,1,14.0,21.0,-7.0,3
4102,4102,1994-95,1994,1995,Chelsea,Arsenal,Loss,Away,1994-10-15,0,3,6,6,6,3,6,6,7,0,0,0,-1,0,14.0,4.0,10.0,3
4103,4103,1994-95,1994,1995,Chelsea,Ipswich,Win,Home,1994-10-23,3,3,3,6,6,0,0,3,3,3,3,3,3,1,14.0,19.0,-5.0,3
4104,4104,1994-95,1994,1995,Chelsea,Sheffield Weds,Draw,Away,1994-10-29,1,3,6,6,9,3,6,6,7,0,0,0,2,0,14.0,7.0,7.0,3
4105,4105,1994-95,1994,1995,Chelsea,Coventry,Draw,Home,1994-11-06,1,4,4,7,7,3,3,6,9,1,1,1,-2,1,14.0,11.0,3.0,4
4106,4106,1994-95,1994,1995,Chelsea,Liverpool,Loss,Away,1994-11-09,0,2,5,5,8,3,6,9,9,-1,-1,-4,-1,0,14.0,8.0,6.0,4
4107,4107,1994-95,1994,1995,Chelsea,Nott'm Forest,Win,Away,1994-11-19,3,1,2,5,5,1,1,4,7,0,1,1,-2,0,14.0,21.0,-7.0,4
4108,4108,1994-95,1994,1995,Chelsea,Tottenham,Draw,Away,1994-11-23,1,3,4,5,8,0,3,3,4,3,1,2,4,0,14.0,15.0,-1.0,4
4109,4109,1994-95,1994,1995,Chelsea,Everton,Loss,Home,1994-11-26,0,4,4,5,6,4,7,8,8,0,-3,-3,-2,1,14.0,17.0,-3.0,4
4110,4110,1994-95,1994,1995,Chelsea,Southampton,Win,Away,1994-12-03,3,1,4,4,5,4,5,6,6,-3,-1,-2,-1,0,14.0,18.0,-4.0,5
4111,4111,1994-95,1994,1995,Chelsea,Norwich,Loss,Away,1994-12-10,0,3,4,7,7,3,3,4,5,0,1,3,2,0,14.0,12.0,2.0,5
4112,4112,1994-95,1994,1995,Chelsea,Liverpool,Draw,Home,1994-12-18,1,3,3,4,7,2,3,3,6,1,0,1,1,1,14.0,8.0,6.0,5
4113,4113,1994-95,1994,1995,Chelsea,Man United,Loss,Home,1994-12-26,0,1,4,4,5,3,6,7,10,-2,-2,-3,-5,1,14.0,1.0,13.0,5
4114,4114,1994-95,1994,1995,Chelsea,Aston Villa,Loss,Away,1994-12-28,0,1,1,4,4,1,2,3,4,0,-1,1,0,0,14.0,10.0,4.0,5
4115,4115,1994-95,1994,1995,Chelsea,Wimbledon,Draw,Home,1994-12-31,1,0,1,1,4,6,7,10,10,-6,-6,-9,-6,1,14.0,6.0,8.0,5
4116,4116,1994-95,1994,1995,Chelsea,Sheffield Weds,Draw,Home,1995-01-14,1,1,1,2,2,4,7,10,10,-3,-6,-8,-8,1,14.0,7.0,7.0,6
4117,4117,1994-95,1994,1995,Chelsea,Ipswich,Draw,Away,1995-01-21,1,2,2,2,3,6,6,6,7,-4,-4,-4,-4,0,14.0,19.0,-5.0,6
4118,4118,1994-95,1994,1995,Chelsea,Nott'm Forest,Loss,Home,1995-01-25,0,2,3,3,3,0,3,3,6,2,0,0,-3,1,14.0,21.0,-7.0,6
4119,4119,1994-95,1994,1995,Chelsea,Coventry,Draw,Away,1995-02-04,1,1,2,3,3,1,2,2,2,0,0,1,1,0,14.0,11.0,3.0,7
4120,4120,1994-95,1994,1995,Chelsea,Tottenham,Draw,Home,1995-02-11,1,1,2,3,4,3,6,9,12,-2,-4,-6,-8,1,14.0,15.0,-1.0,7
4121,4121,1994-95,1994,1995,Chelsea,West Ham,Win,Away,1995-02-25,3,2,2,3,4,1,4,4,4,1,-2,-1,0,0,14.0,13.0,1.0,7
4122,4122,1994-95,1994,1995,Chelsea,Crystal Palace,Draw,Home,1995-03-05,1,4,5,5,6,0,3,4,4,4,2,1,2,1,14.0,21.0,-7.0,8
4123,4123,1994-95,1994,1995,Chelsea,Man City,Win,Away,1995-03-08,3,4,5,6,6,2,5,5,6,2,0,1,0,0,14.0,16.0,-2.0,8
4124,4124,1994-95,1994,1995,Chelsea,Leeds,Loss,Home,1995-03-11,0,4,7,8,9,1,4,5,6,3,3,3,3,1,14.0,5.0,9.0,8
4125,4125,1994-95,1994,1995,Chelsea,Blackburn,Loss,Away,1995-03-18,0,3,4,7,8,4,7,8,11,-1,-3,-1,-3,0,14.0,2.0,12.0,8
4126,4126,1994-95,1994,1995,Chelsea,QPR,Loss,Away,1995-03-22,0,0,3,4,7,3,6,9,10,-3,-3,-5,-3,0,14.0,9.0,5.0,8
4127,4127,1994-95,1994,1995,Chelsea,Newcastle,Draw,Home,1995-04-01,1,0,0,3,4,3,6,6,9,-3,-6,-3,-5,1,14.0,3.0,11.0,9
4128,4128,1994-95,1994,1995,Chelsea,Wimbledon,Draw,Away,1995-04-10,1,1,1,1,4,6,9,12,12,-5,-8,-11,-8,0,14.0,6.0,8.0,9
4129,4129,1994-95,1994,1995,Chelsea,Southampton,Loss,Home,1995-04-12,0,2,2,2,2,3,6,6,7,-1,-4,-4,-5,1,14.0,18.0,-4.0,9
4130,4130,1994-95,1994,1995,Chelsea,Aston Villa,Win,Home,1995-04-15,3,1,2,2,2,4,4,5,5,-3,-2,-3,-3,1,14.0,10.0,4.0,9
4131,4131,1994-95,1994,1995,Chelsea,Man United,Draw,Away,1995-04-17,1,3,4,5,5,4,7,7,8,-1,-3,-2,-3,0,14.0,1.0,13.0,9
4132,4132,1994-95,1994,1995,Chelsea,QPR,Win,Home,1995-04-29,3,4,4,5,6,0,3,6,6,4,1,-1,0,1,14.0,9.0,5.0,9
4133,4133,1994-95,1994,1995,Chelsea,Everton,Draw,Away,1995-05-03,1,4,7,7,8,2,5,5,8,2,2,2,0,0,14.0,17.0,-3.0,10
4134,4134,1994-95,1994,1995,Chelsea,Leicester,Draw,Away,1995-05-06,1,4,5,8,8,3,3,3,6,1,2,5,2,0,14.0,21.0,-7.0,10
4135,4135,1994-95,1994,1995,Chelsea,Arsenal,Win,Home,1995-05-14,3,2,5,6,9,2,5,8,8,0,0,-2,1,1,14.0,4.0,10.0,10
4136,4136,1995-96,1995,1996,Chelsea,Everton,Draw,Home,1995-08-19,1,4,5,8,9,4,5,6,7,0,0,2,2,1,11.0,15.0,-4.0,1
4137,4137,1995-96,1995,1996,Chelsea,Nott'm Forest,Draw,Away,1995-08-23,1,4,5,6,9,4,7,10,13,0,-2,-4,-4,0,11.0,3.0,8.0,1
4138,4138,1995-96,1995,1996,Chelsea,Middlesbrough,Loss,Away,1995-08-26,0,2,5,6,7,1,1,1,1,1,4,5,6,0,11.0,21.0,-10.0,1
4139,4139,1995-96,1995,1996,Chelsea,Coventry,Draw,Home,1995-08-30,1,1,2,5,6,4,4,5,8,-3,-2,0,-2,1,11.0,16.0,-5.0,1
4140,4140,1995-96,1995,1996,Chelsea,West Ham,Win,Away,1995-09-11,3,1,2,3,6,2,2,2,3,-1,0,1,3,0,11.0,14.0,-3.0,2
4141,4141,1995-96,1995,1996,Chelsea,Southampton,Win,Home,1995-09-16,3,4,4,5,6,4,5,5,5,0,-1,0,1,1,11.0,10.0,1.0,2
4142,4142,1995-96,1995,1996,Chelsea,Newcastle,Loss,Away,1995-09-24,0,6,7,7,8,3,6,9,12,3,1,-2,-4,0,11.0,6.0,5.0,2
4143,4143,1995-96,1995,1996,Chelsea,Arsenal,Win,Home,1995-09-30,3,3,6,7,7,6,9,10,11,-3,-3,-3,-4,1,11.0,12.0,-1.0,2
4144,4144,1995-96,1995,1996,Chelsea,Aston Villa,Win,Away,1995-10-14,3,3,6,9,10,4,7,8,11,-1,-1,1,-1,0,11.0,18.0,-7.0,3
4145,4145,1995-96,1995,1996,Chelsea,Man United,Loss,Home,1995-10-21,0,6,6,9,12,4,5,8,11,2,1,1,1,1,11.0,2.0,9.0,3
4146,4146,1995-96,1995,1996,Chelsea,Blackburn,Loss,Away,1995-10-28,0,3,6,6,9,4,4,7,7,-1,2,-1,2,0,11.0,1.0,10.0,3
4147,4147,1995-96,1995,1996,Chelsea,Sheffield Weds,Draw,Home,1995-11-04,1,0,3,6,6,3,3,3,4,-3,0,3,2,1,11.0,13.0,-2.0,4
4148,4148,1995-96,1995,1996,Chelsea,Leeds,Loss,Away,1995-11-18,0,1,1,4,7,4,5,5,8,-3,-4,-1,-1,0,11.0,5.0,6.0,4
4149,4149,1995-96,1995,1996,Chelsea,Bolton,Win,Home,1995-11-22,3,1,1,1,4,0,3,3,4,1,-2,-2,0,1,11.0,21.0,-10.0,4
4150,4150,1995-96,1995,1996,Chelsea,Tottenham,Draw,Home,1995-11-25,1,3,4,4,4,6,9,10,11,-3,-5,-6,-7,1,11.0,7.0,4.0,4
4151,4151,1995-96,1995,1996,Chelsea,Man United,Draw,Away,1995-12-02,1,4,4,5,5,4,7,7,10,0,-3,-2,-5,0,11.0,2.0,9.0,5
4152,4152,1995-96,1995,1996,Chelsea,Newcastle,Win,Home,1995-12-09,3,2,5,5,6,4,5,8,11,-2,0,-3,-5,1,11.0,6.0,5.0,5
4153,4153,1995-96,1995,1996,Chelsea,Arsenal,Draw,Away,1995-12-16,1,4,5,8,8,2,3,6,6,2,2,2,2,0,11.0,12.0,-1.0,5
4154,4154,1995-96,1995,1996,Chelsea,Man City,Win,Away,1995-12-23,3,4,5,6,9,1,4,7,10,3,1,-1,-1,0,11.0,17.0,-6.0,5
4155,4155,1995-96,1995,1996,Chelsea,Wimbledon,Loss,Home,1995-12-26,0,4,7,8,9,1,2,3,4,3,5,5,5,1,11.0,9.0,2.0,5
4156,4156,1995-96,1995,1996,Chelsea,Liverpool,Draw,Home,1995-12-30,1,3,4,7,8,6,9,10,10,-3,-5,-3,-2,1,11.0,4.0,7.0,5
4157,4157,1995-96,1995,1996,Chelsea,QPR,Win,Away,1996-01-02,3,1,4,5,8,0,3,6,6,1,1,-1,2,0,11.0,8.0,3.0,6
4158,4158,1995-96,1995,1996,Chelsea,Everton,Draw,Away,1996-01-13,1,4,4,7,8,6,9,9,9,-2,-5,-2,-1,0,11.0,15.0,-4.0,6
4159,4159,1995-96,1995,1996,Chelsea,Nott'm Forest,Win,Home,1996-01-20,3,4,5,5,8,3,6,9,9,1,-1,-4,-1,1,11.0,3.0,8.0,6
4160,4160,1995-96,1995,1996,Chelsea,Middlesbrough,Win,Home,1996-02-04,3,4,7,8,8,0,0,0,0,4,7,8,8,1,11.0,21.0,-10.0,7
4161,4161,1995-96,1995,1996,Chelsea,Coventry,Loss,Away,1996-02-10,0,6,7,10,11,1,2,2,3,5,5,8,8,0,11.0,16.0,-5.0,7
4162,4162,1995-96,1995,1996,Chelsea,West Ham,Loss,Home,1996-02-17,0,3,6,7,10,6,9,9,9,-3,-3,-2,1,1,11.0,14.0,-3.0,7
4163,4163,1995-96,1995,1996,Chelsea,Southampton,Win,Away,1996-02-24,3,0,3,6,7,2,5,5,6,-2,-2,1,1,0,11.0,10.0,1.0,7
4164,4164,1995-96,1995,1996,Chelsea,Wimbledon,Draw,Away,1996-03-02,1,3,3,6,9,1,1,4,4,2,2,2,5,0,11.0,9.0,2.0,8
4165,4165,1995-96,1995,1996,Chelsea,Man City,Draw,Home,1996-03-12,1,4,4,4,7,1,2,2,5,3,2,2,2,1,11.0,17.0,-6.0,8
4166,4166,1995-96,1995,1996,Chelsea,Liverpool,Loss,Away,1996-03-16,0,2,5,5,5,4,7,10,11,-2,-2,-5,-6,0,11.0,4.0,7.0,8
4167,4167,1995-96,1995,1996,Chelsea,QPR,Draw,Home,1996-03-23,1,1,2,5,5,1,1,2,5,0,1,3,0,1,11.0,8.0,3.0,8
4168,4168,1995-96,1995,1996,Chelsea,Aston Villa,Loss,Home,1996-04-06,0,1,2,3,6,1,4,7,7,0,-2,-4,-1,1,11.0,18.0,-7.0,9
4169,4169,1995-96,1995,1996,Chelsea,Bolton,Loss,Away,1996-04-08,0,1,1,2,3,1,4,4,7,0,-3,-2,-4,0,11.0,21.0,-10.0,9
4170,4170,1995-96,1995,1996,Chelsea,Leeds,Win,Home,1996-04-13,3,0,1,1,2,0,3,3,4,0,-2,-2,-2,1,11.0,5.0,6.0,9
4171,4171,1995-96,1995,1996,Chelsea,Sheffield Weds,Draw,Away,1996-04-17,1,3,3,4,4,3,3,3,6,0,0,1,-2,0,11.0,13.0,-2.0,9
4172,4172,1995-96,1995,1996,Chelsea,Tottenham,Draw,Away,1996-04-27,1,4,4,4,5,2,2,5,5,2,2,-1,0,0,11.0,7.0,4.0,9
4173,4173,1995-96,1995,1996,Chelsea,Blackburn,Loss,Home,1996-05-04,0,2,5,5,5,4,7,10,10,-2,-2,-5,-5,1,11.0,1.0,10.0,10
4174,4174,1996-97,1996,1997,Chelsea,Southampton,Draw,Away,1996-08-18,1,1,2,5,5,4,4,7,7,-3,-2,-2,-2,0,11.0,17.0,-6.0,1
4175,4175,1996-97,1996,1997,Chelsea,Middlesbrough,Win,Home,1996-08-21,3,1,2,3,6,1,1,1,2,0,1,2,4,1,11.0,12.0,-1.0,1
4176,4176,1996-97,1996,1997,Chelsea,Coventry,Win,Home,1996-08-24,3,4,4,5,6,1,2,5,6,3,2,0,0,1,11.0,16.0,-5.0,1
4177,4177,1996-97,1996,1997,Chelsea,Arsenal,Draw,Away,1996-09-04,1,6,7,7,8,3,6,9,10,3,1,-2,-2,0,11.0,5.0,6.0,2
4178,4178,1996-97,1996,1997,Chelsea,Sheffield Weds,Win,Away,1996-09-07,3,4,7,8,8,6,9,12,13,-2,-2,-4,-5,0,11.0,15.0,-4.0,2
4179,4179,1996-97,1996,1997,Chelsea,Aston Villa,Draw,Home,1996-09-15,1,4,7,10,11,4,7,10,10,0,0,0,1,1,11.0,4.0,7.0,2
4180,4180,1996-97,1996,1997,Chelsea,Liverpool,Loss,Away,1996-09-21,0,4,5,8,11,6,9,10,13,-2,-4,-2,-2,0,11.0,3.0,8.0,2
4181,4181,1996-97,1996,1997,Chelsea,Nott'm Forest,Draw,Home,1996-09-28,1,1,4,5,8,0,1,2,3,1,3,3,5,1,11.0,9.0,2.0,2
4182,4182,1996-97,1996,1997,Chelsea,Leicester,Win,Away,1996-10-12,3,1,2,5,6,6,6,7,7,-5,-4,-2,-1,0,11.0,21.0,-10.0,3
4183,4183,1996-97,1996,1997,Chelsea,Wimbledon,Loss,Home,1996-10-19,0,4,4,5,8,6,9,12,15,-2,-5,-7,-7,1,11.0,14.0,-3.0,3
4184,4184,1996-97,1996,1997,Chelsea,Tottenham,Win,Home,1996-10-26,3,3,4,4,5,6,6,6,9,-3,-2,-2,-4,1,11.0,8.0,3.0,3
4185,4185,1996-97,1996,1997,Chelsea,Man United,Win,Away,1996-11-02,3,3,6,7,7,0,3,6,7,3,3,1,0,0,11.0,1.0,10.0,4
4186,4186,1996-97,1996,1997,Chelsea,Blackburn,Draw,Away,1996-11-16,1,6,6,9,10,3,4,4,5,3,2,5,5,0,11.0,7.0,4.0,4
4187,4187,1996-97,1996,1997,Chelsea,Newcastle,Draw,Home,1996-11-23,1,4,7,7,10,4,4,7,10,0,3,0,0,1,11.0,2.0,9.0,4
4188,4188,1996-97,1996,1997,Chelsea,Leeds,Loss,Away,1996-12-01,0,2,5,8,8,3,6,6,6,-1,-1,2,2,0,11.0,13.0,-2.0,5
4189,4189,1996-97,1996,1997,Chelsea,Everton,Draw,Home,1996-12-07,1,1,2,5,8,3,4,7,8,-2,-2,-2,0,1,11.0,6.0,5.0,5
4190,4190,1996-97,1996,1997,Chelsea,Sunderland,Loss,Away,1996-12-15,0,1,2,3,6,3,4,4,4,-2,-2,-1,2,0,11.0,21.0,-10.0,5
4191,4191,1996-97,1996,1997,Chelsea,West Ham,Win,Home,1996-12-21,3,1,1,2,3,1,2,3,4,0,-1,-1,-1,1,11.0,10.0,1.0,5
4192,4192,1996-97,1996,1997,Chelsea,Aston Villa,Win,Away,1996-12-26,3,3,4,4,5,6,9,12,15,-3,-5,-8,-10,0,11.0,4.0,7.0,5
4193,4193,1996-97,1996,1997,Chelsea,Sheffield Weds,Draw,Home,1996-12-28,1,6,6,7,7,2,3,6,7,4,3,1,0,1,11.0,15.0,-4.0,5
4194,4194,1996-97,1996,1997,Chelsea,Liverpool,Win,Home,1997-01-01,3,4,7,7,8,4,5,8,11,0,2,-1,-3,1,11.0,3.0,8.0,6
4195,4195,1996-97,1996,1997,Chelsea,Nott'm Forest,Loss,Away,1997-01-11,0,4,7,10,10,4,4,7,7,0,3,3,3,0,11.0,9.0,2.0,6
4196,4196,1996-97,1996,1997,Chelsea,Derby,Win,Home,1997-01-18,3,3,4,7,10,2,2,2,2,1,2,5,8,1,11.0,21.0,-10.0,6
4197,4197,1996-97,1996,1997,Chelsea,Tottenham,Win,Away,1997-02-01,3,3,6,7,10,3,3,3,6,0,3,4,4,0,11.0,8.0,3.0,7
4198,4198,1996-97,1996,1997,Chelsea,Man United,Draw,Home,1997-02-22,1,6,6,9,10,6,9,12,15,0,-3,-3,-5,1,11.0,1.0,10.0,7
4199,4199,1996-97,1996,1997,Chelsea,Derby,Loss,Away,1997-03-01,0,4,7,7,10,1,4,4,5,3,3,3,5,0,11.0,21.0,-10.0,8
4200,4200,1996-97,1996,1997,Chelsea,Blackburn,Draw,Home,1997-03-05,1,1,4,7,7,4,7,7,8,-3,-3,0,-1,1,11.0,7.0,4.0,8
4201,4201,1996-97,1996,1997,Chelsea,West Ham,Loss,Away,1997-03-12,0,1,2,5,8,3,3,3,3,-2,-1,2,5,0,11.0,10.0,1.0,8
4202,4202,1996-97,1996,1997,Chelsea,Sunderland,Win,Home,1997-03-16,3,1,1,2,5,3,3,3,3,-2,-2,-1,2,1,11.0,21.0,-10.0,8
4203,4203,1996-97,1996,1997,Chelsea,Southampton,Win,Home,1997-03-19,3,3,4,4,5,1,2,5,6,2,2,-1,-1,1,11.0,17.0,-6.0,8
4204,4204,1996-97,1996,1997,Chelsea,Middlesbrough,Loss,Away,1997-03-22,0,6,6,7,7,6,9,9,9,0,-3,-2,-2,0,11.0,12.0,-1.0,8
4205,4205,1996-97,1996,1997,Chelsea,Arsenal,Loss,Home,1997-04-05,0,3,6,6,7,3,6,9,9,0,0,-3,-2,1,11.0,5.0,6.0,9
4206,4206,1996-97,1996,1997,Chelsea,Coventry,Loss,Away,1997-04-09,0,0,3,6,6,3,3,4,5,-3,0,2,1,0,11.0,16.0,-5.0,9
4207,4207,1996-97,1996,1997,Chelsea,Newcastle,Loss,Away,1997-04-16,0,0,0,3,6,2,3,6,6,-2,-3,-3,0,0,11.0,2.0,9.0,9
4208,4208,1996-97,1996,1997,Chelsea,Leicester,Win,Home,1997-04-19,3,0,0,0,3,1,2,3,3,-1,-2,-3,0,1,11.0,21.0,-10.0,9
4209,4209,1996-97,1996,1997,Chelsea,Wimbledon,Win,Away,1997-04-22,3,3,3,3,3,3,3,3,4,0,0,0,-1,0,11.0,14.0,-3.0,9
4210,4210,1996-97,1996,1997,Chelsea,Leeds,Draw,Home,1997-05-03,1,6,6,6,6,2,2,3,4,4,4,3,2,1,11.0,13.0,-2.0,10
4211,4211,1996-97,1996,1997,Chelsea,Everton,Win,Away,1997-05-11,3,4,7,7,7,1,2,5,6,3,5,2,1,0,11.0,6.0,5.0,10
4212,4212,1997-98,1997,1998,Chelsea,Coventry,Loss,Away,1997-08-09,0,4,7,10,10,3,4,5,8,1,3,5,2,0,6.0,17.0,-11.0,1
4213,4213,1997-98,1997,1998,Chelsea,Barnsley,Win,Away,1997-08-24,3,3,4,7,10,3,3,3,3,0,1,4,7,0,6.0,21.0,-15.0,1
4214,4214,1997-98,1997,1998,Chelsea,Wimbledon,Win,Away,1997-08-27,3,3,6,7,10,2,5,8,9,1,1,-1,1,0,6.0,8.0,-2.0,1
4215,4215,1997-98,1997,1998,Chelsea,Southampton,Win,Home,1997-08-30,3,6,6,9,10,3,3,3,3,3,3,6,7,1,6.0,16.0,-10.0,1
4216,4216,1997-98,1997,1998,Chelsea,Crystal Palace,Win,Away,1997-09-13,3,6,9,9,12,0,3,3,6,6,6,6,6,0,6.0,21.0,-15.0,2
4217,4217,1997-98,1997,1998,Chelsea,Arsenal,Loss,Home,1997-09-21,0,6,9,12,12,4,5,8,11,2,4,4,1,1,6.0,3.0,3.0,2
4218,4218,1997-98,1997,1998,Chelsea,Man United,Draw,Away,1997-09-24,1,3,6,9,12,4,7,10,11,-1,-1,-1,1,0,6.0,1.0,5.0,2
4219,4219,1997-98,1997,1998,Chelsea,Newcastle,Win,Home,1997-09-27,3,1,4,7,10,6,6,9,12,-5,-2,-2,-2,1,6.0,2.0,4.0,2
4220,4220,1997-98,1997,1998,Chelsea,Liverpool,Loss,Away,1997-10-05,0,4,4,7,10,3,4,7,10,1,0,0,0,0,6.0,4.0,2.0,3
4221,4221,1997-98,1997,1998,Chelsea,Leicester,Win,Home,1997-10-18,3,3,4,4,7,3,4,7,10,0,0,-3,-3,1,6.0,9.0,-3.0,3
4222,4222,1997-98,1997,1998,Chelsea,Bolton,Loss,Away,1997-10-26,0,3,6,7,7,0,1,2,3,3,5,5,4,0,6.0,21.0,-15.0,3
4223,4223,1997-98,1997,1998,Chelsea,Aston Villa,Win,Away,1997-11-01,3,3,3,6,7,1,4,5,5,2,-1,1,2,0,6.0,5.0,1.0,4
4224,4224,1997-98,1997,1998,Chelsea,West Ham,Win,Home,1997-11-09,3,3,6,6,9,3,3,6,6,0,3,0,3,1,6.0,14.0,-8.0,4
4225,4225,1997-98,1997,1998,Chelsea,Blackburn,Loss,Away,1997-11-22,0,6,6,9,9,4,5,8,11,2,1,1,-2,0,6.0,13.0,-7.0,4
4226,4226,1997-98,1997,1998,Chelsea,Everton,Win,Home,1997-11-26,3,3,6,6,9,0,0,1,4,3,6,5,5,1,6.0,15.0,-9.0,4
4227,4227,1997-98,1997,1998,Chelsea,Derby,Win,Home,1997-11-29,3,3,6,9,9,3,6,6,7,0,0,3,2,1,6.0,12.0,-6.0,4
4228,4228,1997-98,1997,1998,Chelsea,Tottenham,Win,Away,1997-12-06,3,6,6,9,12,3,3,3,3,3,3,6,9,0,6.0,10.0,-4.0,5
4229,4229,1997-98,1997,1998,Chelsea,Leeds,Draw,Home,1997-12-13,1,6,9,9,12,4,7,10,13,2,2,-1,-1,1,6.0,11.0,-5.0,5
4230,4230,1997-98,1997,1998,Chelsea,Sheffield Weds,Win,Away,1997-12-20,3,4,7,10,10,3,6,9,12,1,1,1,-2,0,6.0,7.0,-1.0,5
4231,4231,1997-98,1997,1998,Chelsea,Wimbledon,Draw,Home,1997-12-26,1,4,7,10,13,4,4,4,7,0,3,6,6,1,6.0,8.0,-2.0,5
4232,4232,1997-98,1997,1998,Chelsea,Southampton,Loss,Away,1997-12-29,0,4,5,8,11,2,5,5,5,2,0,3,6,0,6.0,16.0,-10.0,5
4233,4233,1997-98,1997,1998,Chelsea,Coventry,Win,Home,1998-01-10,3,1,4,5,8,3,3,6,6,-2,1,-1,2,1,6.0,17.0,-11.0,6
4234,4234,1997-98,1997,1998,Chelsea,Everton,Loss,Away,1998-01-18,0,3,4,7,8,6,6,9,10,-3,-2,-2,-2,0,6.0,15.0,-9.0,6
4235,4235,1997-98,1997,1998,Chelsea,Barnsley,Win,Home,1998-01-31,3,3,3,4,7,3,6,7,7,0,-3,-3,0,1,6.0,21.0,-15.0,6
4236,4236,1997-98,1997,1998,Chelsea,Arsenal,Loss,Away,1998-02-08,0,3,6,6,7,4,7,8,11,-1,-1,-2,-4,0,6.0,3.0,3.0,7
4237,4237,1997-98,1997,1998,Chelsea,Leicester,Loss,Away,1998-02-21,0,3,3,6,6,4,7,8,9,-1,-4,-2,-3,0,6.0,9.0,-3.0,7
4238,4238,1997-98,1997,1998,Chelsea,Man United,Loss,Home,1998-02-28,0,0,3,3,6,6,7,7,7,-6,-4,-4,-1,1,6.0,1.0,5.0,7
4239,4239,1997-98,1997,1998,Chelsea,Aston Villa,Loss,Home,1998-03-08,0,0,0,3,3,3,3,6,6,-3,-3,-3,-3,1,6.0,5.0,1.0,8
4240,4240,1997-98,1997,1998,Chelsea,Crystal Palace,Win,Home,1998-03-11,3,0,0,0,3,0,0,0,0,0,0,0,3,1,6.0,21.0,-15.0,8
4241,4241,1997-98,1997,1998,Chelsea,West Ham,Loss,Away,1998-03-14,0,3,3,3,3,2,3,6,7,1,0,-3,-4,0,6.0,14.0,-8.0,8
4242,4242,1997-98,1997,1998,Chelsea,Derby,Win,Away,1998-04-05,3,3,3,3,3,0,3,3,6,3,0,0,-3,0,6.0,12.0,-6.0,9
4243,4243,1997-98,1997,1998,Chelsea,Leeds,Loss,Away,1998-04-08,0,3,6,6,6,3,6,9,12,0,0,-3,-6,0,6.0,11.0,-5.0,9
4244,4244,1997-98,1997,1998,Chelsea,Tottenham,Win,Home,1998-04-11,3,3,3,6,6,4,5,5,8,-1,-2,1,-2,1,6.0,10.0,-4.0,9
4245,4245,1997-98,1997,1998,Chelsea,Sheffield Weds,Win,Home,1998-04-19,3,3,6,6,9,1,4,4,4,2,2,2,5,1,6.0,7.0,-1.0,9
4246,4246,1997-98,1997,1998,Chelsea,Liverpool,Win,Home,1998-04-25,3,6,6,9,9,4,5,8,9,2,1,1,0,1,6.0,4.0,2.0,9
4247,4247,1997-98,1997,1998,Chelsea,Blackburn,Loss,Home,1998-04-29,0,6,9,9,12,1,1,1,1,5,8,8,11,1,6.0,13.0,-7.0,9
4248,4248,1997-98,1997,1998,Chelsea,Newcastle,Loss,Away,1998-05-02,0,3,6,9,9,1,2,5,5,2,4,4,4,0,6.0,2.0,4.0,10
4249,4249,1997-98,1997,1998,Chelsea,Bolton,Win,Home,1998-05-10,3,0,3,6,9,6,6,6,9,-6,-3,0,0,1,6.0,21.0,-15.0,10
4250,4250,1998-99,1998,1999,Chelsea,Coventry,Loss,Away,1998-08-15,0,3,3,6,9,4,5,6,7,-1,-2,0,2,0,4.0,11.0,-7.0,1
4251,4251,1998-99,1998,1999,Chelsea,Newcastle,Draw,Home,1998-08-22,1,3,3,3,6,1,4,5,5,2,-1,-2,1,1,4.0,13.0,-9.0,1
4252,4252,1998-99,1998,1999,Chelsea,Arsenal,Draw,Home,1998-09-09,1,1,4,4,4,2,5,5,5,-1,-1,-1,-1,1,4.0,1.0,3.0,2
4253,4253,1998-99,1998,1999,Chelsea,Nott'm Forest,Win,Home,1998-09-12,3,2,2,5,5,3,6,6,6,-1,-4,-1,-1,1,4.0,21.0,-17.0,2
4254,4254,1998-99,1998,1999,Chelsea,Blackburn,Win,Away,1998-09-21,3,4,5,5,8,0,3,3,4,4,2,2,4,0,4.0,6.0,-2.0,2
4255,4255,1998-99,1998,1999,Chelsea,Middlesbrough,Win,Home,1998-09-26,3,6,7,8,8,4,7,8,8,2,0,0,0,1,4.0,21.0,-17.0,2
4256,4256,1998-99,1998,1999,Chelsea,Liverpool,Draw,Away,1998-10-04,1,6,9,10,11,1,1,4,7,5,8,6,4,0,4.0,3.0,1.0,3
4257,4257,1998-99,1998,1999,Chelsea,Charlton,Win,Home,1998-10-17,3,4,7,10,11,4,5,5,5,0,2,5,6,1,4.0,21.0,-17.0,3
4258,4258,1998-99,1998,1999,Chelsea,Leeds,Draw,Away,1998-10-25,1,4,7,10,13,1,2,3,4,3,5,7,9,0,4.0,5.0,-1.0,3
4259,4259,1998-99,1998,1999,Chelsea,West Ham,Draw,Away,1998-11-08,1,4,5,8,11,3,4,4,7,1,1,4,4,0,4.0,8.0,-4.0,4
4260,4260,1998-99,1998,1999,Chelsea,Wimbledon,Win,Home,1998-11-14,3,2,5,6,9,4,5,5,5,-2,0,1,4,1,4.0,15.0,-11.0,4
4261,4261,1998-99,1998,1999,Chelsea,Leicester,Win,Away,1998-11-21,3,4,5,8,9,1,4,5,8,3,1,3,1,0,4.0,10.0,-6.0,4
4262,4262,1998-99,1998,1999,Chelsea,Sheffield Weds,Draw,Home,1998-11-28,1,6,7,8,11,4,4,5,6,2,3,3,5,1,4.0,16.0,-12.0,4
4263,4263,1998-99,1998,1999,Chelsea,Everton,Draw,Away,1998-12-05,1,4,7,8,9,6,6,6,6,-2,1,2,3,0,4.0,17.0,-13.0,5
4264,4264,1998-99,1998,1999,Chelsea,Aston Villa,Win,Home,1998-12-09,3,2,5,8,9,2,2,5,8,0,3,3,1,1,4.0,7.0,-3.0,5
4265,4265,1998-99,1998,1999,Chelsea,Derby,Draw,Away,1998-12-12,1,4,5,8,11,4,4,5,8,0,1,3,3,0,4.0,9.0,-5.0,5
4266,4266,1998-99,1998,1999,Chelsea,Man United,Draw,Away,1998-12-16,1,4,5,6,9,2,5,5,8,2,0,1,1,0,4.0,2.0,2.0,5
4267,4267,1998-99,1998,1999,Chelsea,Tottenham,Win,Home,1998-12-19,3,2,5,6,7,4,4,7,8,-2,1,-1,-1,1,4.0,14.0,-10.0,5
4268,4268,1998-99,1998,1999,Chelsea,Southampton,Win,Away,1998-12-26,3,4,5,8,9,3,3,3,6,1,2,5,3,0,4.0,12.0,-8.0,5
4269,4269,1998-99,1998,1999,Chelsea,Man United,Draw,Home,1998-12-29,1,6,7,8,11,3,4,5,6,3,3,3,5,1,4.0,2.0,2.0,5
4270,4270,1998-99,1998,1999,Chelsea,Newcastle,Win,Away,1999-01-09,3,4,7,8,9,0,3,4,5,4,4,4,4,0,4.0,13.0,-9.0,6
4271,4271,1998-99,1998,1999,Chelsea,Coventry,Win,Home,1999-01-16,3,4,7,10,11,3,4,5,5,1,3,5,6,1,4.0,11.0,-7.0,6
4272,4272,1998-99,1998,1999,Chelsea,Arsenal,Loss,Away,1999-01-31,0,6,7,10,13,4,7,10,13,2,0,0,0,0,4.0,1.0,3.0,6
4273,4273,1998-99,1998,1999,Chelsea,Southampton,Win,Home,1999-02-06,3,3,6,7,10,3,6,7,7,0,0,0,3,1,4.0,12.0,-8.0,7
4274,4274,1998-99,1998,1999,Chelsea,Blackburn,Draw,Home,1999-02-17,1,3,6,9,10,4,4,7,8,-1,2,2,2,1,4.0,6.0,-2.0,7
4275,4275,1998-99,1998,1999,Chelsea,Nott'm Forest,Win,Away,1999-02-20,3,4,4,7,10,0,3,3,3,4,1,4,7,0,4.0,21.0,-17.0,7
4276,4276,1998-99,1998,1999,Chelsea,Liverpool,Win,Home,1999-02-27,3,4,7,7,10,1,4,4,7,3,3,3,3,1,4.0,3.0,1.0,7
4277,4277,1998-99,1998,1999,Chelsea,West Ham,Loss,Home,1999-03-13,0,6,7,10,10,3,4,7,7,3,3,3,3,1,4.0,8.0,-4.0,8
4278,4278,1998-99,1998,1999,Chelsea,Aston Villa,Win,Away,1999-03-21,3,3,6,7,10,0,0,1,1,3,6,6,9,0,4.0,7.0,-3.0,8
4279,4279,1998-99,1998,1999,Chelsea,Charlton,Win,Away,1999-04-03,3,3,6,9,10,1,2,5,8,2,4,4,2,0,4.0,21.0,-17.0,9
4280,4280,1998-99,1998,1999,Chelsea,Wimbledon,Win,Away,1999-04-11,3,6,6,9,12,1,1,1,1,5,5,8,11,0,4.0,15.0,-11.0,9
4281,4281,1998-99,1998,1999,Chelsea,Middlesbrough,Draw,Away,1999-04-14,1,6,9,9,12,6,7,10,13,0,2,-1,-1,0,4.0,21.0,-17.0,9
4282,4282,1998-99,1998,1999,Chelsea,Leicester,Draw,Home,1999-04-18,1,4,7,10,10,2,5,6,9,2,2,4,1,1,4.0,10.0,-6.0,9
4283,4283,1998-99,1998,1999,Chelsea,Sheffield Weds,Draw,Away,1999-04-25,1,2,5,8,11,1,4,4,4,1,1,4,7,0,4.0,16.0,-12.0,9
4284,4284,1998-99,1998,1999,Chelsea,Everton,Win,Home,1999-05-01,3,2,3,6,9,6,9,9,9,-4,-6,-3,0,1,4.0,17.0,-13.0,10
4285,4285,1998-99,1998,1999,Chelsea,Leeds,Win,Home,1999-05-05,3,4,5,6,9,4,5,6,9,0,0,0,0,1,4.0,5.0,-1.0,10
4286,4286,1998-99,1998,1999,Chelsea,Tottenham,Draw,Away,1999-05-10,1,6,7,8,9,0,0,3,6,6,7,5,3,0,4.0,14.0,-10.0,10
4287,4287,1998-99,1998,1999,Chelsea,Derby,Win,Home,1999-05-16,3,4,7,8,9,4,4,5,5,0,3,3,4,1,4.0,9.0,-5.0,10
4288,4288,1999-00,1999,2000,Chelsea,Sunderland,Win,Home,1999-08-07,3,4,7,10,11,3,3,6,6,1,4,4,5,1,3.0,21.0,-18.0,1
4289,4289,1999-00,1999,2000,Chelsea,Leicester,Draw,Away,1999-08-14,1,6,7,10,13,3,3,6,6,3,4,4,7,0,3.0,10.0,-7.0,1
4290,4290,1999-00,1999,2000,Chelsea,Aston Villa,Win,Home,1999-08-21,3,4,7,8,11,4,7,7,7,0,0,1,4,1,3.0,6.0,-3.0,1
4291,4291,1999-00,1999,2000,Chelsea,Wimbledon,Win,Away,1999-08-28,3,4,7,10,11,1,2,2,5,3,5,8,6,0,3.0,16.0,-13.0,1
4292,4292,1999-00,1999,2000,Chelsea,Newcastle,Win,Home,1999-09-11,3,6,7,10,13,0,1,1,1,6,6,9,12,1,3.0,13.0,-10.0,2
4293,4293,1999-00,1999,2000,Chelsea,Watford,Loss,Away,1999-09-18,0,6,9,10,13,0,0,3,6,6,9,7,7,0,3.0,21.0,-18.0,2
4294,4294,1999-00,1999,2000,Chelsea,Middlesbrough,Win,Away,1999-09-25,3,3,6,9,10,3,3,3,6,0,3,6,4,0,3.0,9.0,-6.0,2
4295,4295,1999-00,1999,2000,Chelsea,Man United,Win,Home,1999-10-03,3,3,6,9,12,2,5,8,11,1,1,1,1,1,3.0,1.0,2.0,3
4296,4296,1999-00,1999,2000,Chelsea,Liverpool,Loss,Away,1999-10-16,0,6,6,9,12,1,2,2,5,5,4,7,7,0,3.0,7.0,-4.0,3
4297,4297,1999-00,1999,2000,Chelsea,Arsenal,Loss,Home,1999-10-23,0,3,6,6,9,3,6,9,12,0,0,-3,-3,1,3.0,2.0,1.0,3
4298,4298,1999-00,1999,2000,Chelsea,Derby,Loss,Away,1999-10-30,0,0,3,6,6,0,1,1,1,0,2,5,5,0,3.0,8.0,-5.0,3
4299,4299,1999-00,1999,2000,Chelsea,West Ham,Draw,Home,1999-11-07,1,0,0,3,6,0,1,1,4,0,-1,2,2,1,3.0,5.0,-2.0,4
4300,4300,1999-00,1999,2000,Chelsea,Everton,Draw,Away,1999-11-20,1,1,1,1,4,1,2,2,3,0,-1,-1,1,0,3.0,14.0,-11.0,4
4301,4301,1999-00,1999,2000,Chelsea,Bradford,Win,Home,1999-11-28,3,2,2,2,2,1,1,4,4,1,1,-2,-2,1,3.0,21.0,-18.0,4
4302,4302,1999-00,1999,2000,Chelsea,Sunderland,Loss,Away,1999-12-04,0,4,5,5,5,3,4,7,8,1,1,-2,-3,0,3.0,21.0,-18.0,5
4303,4303,1999-00,1999,2000,Chelsea,Leeds,Loss,Home,1999-12-19,0,3,4,5,5,6,9,9,12,-3,-5,-4,-7,1,3.0,4.0,-1.0,5
4304,4304,1999-00,1999,2000,Chelsea,Southampton,Win,Away,1999-12-26,3,0,3,4,5,1,1,1,4,-1,2,3,1,0,3.0,17.0,-14.0,5
4305,4305,1999-00,1999,2000,Chelsea,Sheffield Weds,Win,Home,1999-12-29,3,3,3,6,7,3,3,3,4,0,0,3,3,1,3.0,12.0,-9.0,5
4306,4306,1999-00,1999,2000,Chelsea,Coventry,Draw,Away,2000-01-04,1,6,6,6,9,3,4,4,7,3,2,2,2,0,3.0,15.0,-12.0,6
4307,4307,1999-00,1999,2000,Chelsea,Bradford,Draw,Away,2000-01-08,1,4,7,7,7,1,1,4,5,3,6,3,2,0,3.0,21.0,-18.0,6
4308,4308,1999-00,1999,2000,Chelsea,Tottenham,Win,Home,2000-01-12,3,2,5,8,8,4,7,7,8,-2,-2,1,0,1,3.0,11.0,-8.0,6
4309,4309,1999-00,1999,2000,Chelsea,Leicester,Draw,Home,2000-01-15,1,4,5,8,11,1,1,1,1,3,4,7,10,1,3.0,10.0,-7.0,6
4310,4310,1999-00,1999,2000,Chelsea,Aston Villa,Draw,Away,2000-01-22,1,4,5,6,9,4,5,8,11,0,0,-2,-2,0,3.0,6.0,-3.0,6
4311,4311,1999-00,1999,2000,Chelsea,Tottenham,Win,Away,2000-02-05,3,2,5,6,7,1,1,4,5,1,4,2,2,0,3.0,11.0,-8.0,7
4312,4312,1999-00,1999,2000,Chelsea,Wimbledon,Win,Home,2000-02-12,3,4,5,8,9,3,3,6,6,1,2,2,3,1,3.0,16.0,-13.0,7
4313,4313,1999-00,1999,2000,Chelsea,Watford,Win,Home,2000-02-26,3,6,7,8,11,1,1,1,1,5,6,7,10,1,3.0,21.0,-18.0,7
4314,4314,1999-00,1999,2000,Chelsea,Newcastle,Win,Away,2000-03-04,3,6,9,10,11,6,7,7,10,0,2,3,1,0,3.0,13.0,-10.0,8
4315,4315,1999-00,1999,2000,Chelsea,Everton,Draw,Home,2000-03-11,1,6,9,12,13,4,7,10,10,2,2,2,3,1,3.0,14.0,-11.0,8
4316,4316,1999-00,1999,2000,Chelsea,West Ham,Draw,Away,2000-03-18,1,4,7,10,13,3,6,6,9,1,1,4,4,0,3.0,5.0,-2.0,8
4317,4317,1999-00,1999,2000,Chelsea,Southampton,Draw,Home,2000-03-25,1,2,5,8,11,3,3,4,4,-1,2,4,7,1,3.0,17.0,-14.0,8
4318,4318,1999-00,1999,2000,Chelsea,Leeds,Win,Away,2000-04-01,3,2,3,6,9,3,6,9,10,-1,-3,-3,-1,0,3.0,4.0,-1.0,9
4319,4319,1999-00,1999,2000,Chelsea,Coventry,Win,Home,2000-04-12,3,4,5,6,9,0,3,6,6,4,2,0,3,1,3.0,15.0,-12.0,9
4320,4320,1999-00,1999,2000,Chelsea,Sheffield Weds,Loss,Away,2000-04-15,0,6,7,8,9,3,3,3,6,3,4,5,3,0,3.0,12.0,-9.0,9
4321,4321,1999-00,1999,2000,Chelsea,Middlesbrough,Draw,Home,2000-04-22,1,3,6,7,8,0,3,6,7,3,3,1,1,1,3.0,9.0,-6.0,9
4322,4322,1999-00,1999,2000,Chelsea,Man United,Loss,Away,2000-04-24,0,1,4,7,8,6,9,12,15,-5,-5,-5,-7,0,3.0,1.0,2.0,9
4323,4323,1999-00,1999,2000,Chelsea,Liverpool,Win,Home,2000-04-29,3,1,1,4,7,4,7,10,13,-3,-6,-6,-6,1,3.0,7.0,-4.0,9
4324,4324,1999-00,1999,2000,Chelsea,Arsenal,Loss,Away,2000-05-06,0,3,4,4,7,6,9,12,15,-3,-5,-8,-8,0,3.0,2.0,1.0,10
4325,4325,1999-00,1999,2000,Chelsea,Derby,Win,Home,2000-05-14,3,3,3,4,4,2,5,6,6,1,-2,-2,-2,1,3.0,8.0,-5.0,10
4326,4326,2000-01,2000,2001,Chelsea,West Ham,Win,Home,2000-08-19,3,3,6,6,7,1,1,1,4,2,5,5,3,1,5.0,9.0,-4.0,1
4327,4327,2000-01,2000,2001,Chelsea,Bradford,Loss,Away,2000-08-22,0,6,6,9,9,3,3,6,9,3,3,3,0,0,5.0,17.0,-12.0,1
4328,4328,2000-01,2000,2001,Chelsea,Aston Villa,Draw,Away,2000-08-27,1,3,6,6,9,1,2,3,4,2,4,3,5,0,5.0,6.0,-1.0,1
4329,4329,2000-01,2000,2001,Chelsea,Arsenal,Draw,Home,2000-09-06,1,1,4,7,7,6,6,6,7,-5,-2,1,0,1,5.0,2.0,3.0,2
4330,4330,2000-01,2000,2001,Chelsea,Newcastle,Draw,Away,2000-09-09,1,2,2,5,8,6,9,9,12,-4,-7,-4,-4,0,5.0,11.0,-6.0,2
4331,4331,2000-01,2000,2001,Chelsea,Leicester,Loss,Home,2000-09-17,0,2,3,3,6,6,7,10,11,-4,-4,-7,-5,1,5.0,8.0,-3.0,2
4332,4332,2000-01,2000,2001,Chelsea,Man United,Draw,Away,2000-09-23,1,1,2,3,3,6,9,10,11,-5,-7,-7,-8,0,5.0,1.0,4.0,2
4333,4333,2000-01,2000,2001,Chelsea,Liverpool,Win,Home,2000-10-01,3,1,2,3,4,2,5,8,9,-1,-3,-5,-5,1,5.0,4.0,1.0,3
4334,4334,2000-01,2000,2001,Chelsea,Sunderland,Loss,Away,2000-10-14,0,4,4,5,6,2,5,5,6,2,-1,0,0,0,5.0,7.0,-2.0,3
4335,4335,2000-01,2000,2001,Chelsea,Coventry,Win,Home,2000-10-21,3,3,4,4,5,4,4,4,5,-1,0,0,0,1,5.0,14.0,-9.0,3
4336,4336,2000-01,2000,2001,Chelsea,Tottenham,Win,Home,2000-10-28,3,3,6,7,7,3,3,4,4,0,3,3,3,1,5.0,10.0,-5.0,3
4337,4337,2000-01,2000,2001,Chelsea,Southampton,Loss,Away,2000-11-04,0,6,6,9,10,0,1,1,4,6,5,8,6,0,5.0,15.0,-10.0,4
4338,4338,2000-01,2000,2001,Chelsea,Leeds,Draw,Home,2000-11-12,1,3,6,6,9,4,4,7,10,-1,2,-1,-1,1,5.0,3.0,2.0,4
4339,4339,2000-01,2000,2001,Chelsea,Charlton,Loss,Away,2000-11-18,0,1,4,7,7,3,3,6,6,-2,1,1,1,0,5.0,21.0,-16.0,4
4340,4340,2000-01,2000,2001,Chelsea,Everton,Loss,Away,2000-11-25,0,1,1,4,7,6,6,6,9,-5,-5,-2,-2,0,5.0,13.0,-8.0,4
4341,4341,2000-01,2000,2001,Chelsea,Man City,Win,Home,2000-12-03,3,0,1,1,4,0,0,0,0,0,1,1,4,1,5.0,21.0,-16.0,5
4342,4342,2000-01,2000,2001,Chelsea,Derby,Win,Home,2000-12-09,3,3,3,4,4,3,6,7,8,0,-3,-3,-4,1,5.0,16.0,-11.0,5
4343,4343,2000-01,2000,2001,Chelsea,Middlesbrough,Loss,Away,2000-12-16,0,6,6,6,7,0,1,1,1,6,5,5,6,0,5.0,12.0,-7.0,5
4344,4344,2000-01,2000,2001,Chelsea,Bradford,Win,Home,2000-12-23,3,3,6,6,6,1,4,5,5,2,2,1,1,1,5.0,17.0,-12.0,5
4345,4345,2000-01,2000,2001,Chelsea,Ipswich,Draw,Away,2000-12-26,1,3,6,9,9,3,6,6,9,0,0,3,0,0,5.0,21.0,-16.0,5
4346,4346,2000-01,2000,2001,Chelsea,Aston Villa,Win,Home,2001-01-01,3,4,4,7,10,3,4,5,6,1,0,2,4,1,5.0,6.0,-1.0,6
4347,4347,2000-01,2000,2001,Chelsea,Arsenal,Draw,Away,2001-01-13,1,4,7,7,10,1,4,4,5,3,3,3,5,0,5.0,2.0,3.0,6
4348,4348,2000-01,2000,2001,Chelsea,Ipswich,Win,Home,2001-01-20,3,4,5,8,8,3,6,7,7,1,-1,1,1,1,5.0,21.0,-16.0,6
4349,4349,2000-01,2000,2001,Chelsea,Newcastle,Win,Home,2001-01-31,3,4,7,8,11,6,6,7,10,-2,1,1,1,1,5.0,11.0,-6.0,6
4350,4350,2000-01,2000,2001,Chelsea,Leicester,Loss,Away,2001-02-03,0,6,7,10,11,1,1,1,1,5,6,9,10,0,5.0,8.0,-3.0,7
4351,4351,2000-01,2000,2001,Chelsea,Man United,Draw,Home,2001-02-10,1,3,6,7,10,6,9,12,15,-3,-3,-5,-5,1,5.0,1.0,4.0,7
4352,4352,2000-01,2000,2001,Chelsea,Coventry,Draw,Away,2001-03-03,1,1,4,7,8,2,2,2,2,-1,2,5,6,0,5.0,14.0,-9.0,8
4353,4353,2000-01,2000,2001,Chelsea,West Ham,Win,Away,2001-03-07,3,2,2,5,8,3,4,4,5,-1,-2,1,3,0,5.0,9.0,-4.0,8
4354,4354,2000-01,2000,2001,Chelsea,Sunderland,Loss,Home,2001-03-17,0,4,5,5,8,1,2,2,2,3,3,3,6,1,5.0,7.0,-2.0,8
4355,4355,2000-01,2000,2001,Chelsea,Middlesbrough,Win,Home,2001-03-31,3,3,4,5,5,4,4,5,6,-1,0,0,-1,1,5.0,12.0,-7.0,8
4356,4356,2000-01,2000,2001,Chelsea,Derby,Win,Away,2001-04-07,3,3,6,7,8,1,4,7,8,2,2,0,0,0,5.0,16.0,-11.0,9
4357,4357,2000-01,2000,2001,Chelsea,Southampton,Win,Home,2001-04-14,3,6,6,9,10,0,3,6,9,6,3,3,1,1,5.0,15.0,-10.0,9
4358,4358,2000-01,2000,2001,Chelsea,Tottenham,Win,Away,2001-04-17,3,6,9,9,12,6,6,9,9,0,3,0,3,0,5.0,10.0,-5.0,9
4359,4359,2000-01,2000,2001,Chelsea,Charlton,Loss,Home,2001-04-21,0,6,9,12,12,1,1,4,4,5,8,8,8,1,5.0,21.0,-16.0,9
4360,4360,2000-01,2000,2001,Chelsea,Leeds,Loss,Away,2001-04-28,0,3,6,9,12,6,9,12,15,-3,-3,-3,-3,0,5.0,3.0,2.0,9
4361,4361,2000-01,2000,2001,Chelsea,Everton,Win,Home,2001-05-05,3,0,3,6,9,3,3,3,6,-3,0,3,3,1,5.0,13.0,-8.0,10
4362,4362,2000-01,2000,2001,Chelsea,Liverpool,Draw,Away,2001-05-08,1,3,3,6,9,6,9,12,15,-3,-6,-6,-6,0,5.0,4.0,1.0,10
4363,4363,2000-01,2000,2001,Chelsea,Man City,Win,Away,2001-05-19,3,4,4,4,7,3,4,7,7,1,0,-3,0,0,5.0,21.0,-16.0,10
4364,4364,2001-02,2001,2002,Chelsea,Newcastle,Draw,Home,2001-08-19,1,4,7,7,7,4,4,5,8,0,3,2,-1,1,6.0,11.0,-5.0,1
4365,4365,2001-02,2001,2002,Chelsea,Southampton,Win,Away,2001-08-25,3,4,5,8,8,3,6,6,7,1,-1,2,1,0,6.0,10.0,-4.0,1
4366,4366,2001-02,2001,2002,Chelsea,Arsenal,Draw,Home,2001-09-08,1,4,7,8,11,3,6,6,7,1,1,2,4,1,6.0,2.0,4.0,2
4367,4367,2001-02,2001,2002,Chelsea,Tottenham,Win,Away,2001-09-16,3,4,5,8,9,3,4,5,8,1,1,3,1,0,6.0,12.0,-6.0,2
4368,4368,2001-02,2001,2002,Chelsea,Middlesbrough,Draw,Home,2001-09-23,1,4,7,8,11,6,6,6,6,-2,1,2,5,1,6.0,14.0,-8.0,2
4369,4369,2001-02,2001,2002,Chelsea,Fulham,Draw,Away,2001-09-30,1,4,5,8,9,1,2,3,6,3,3,5,3,0,6.0,21.0,-15.0,2
4370,4370,2001-02,2001,2002,Chelsea,Leicester,Win,Home,2001-10-13,3,2,5,6,9,0,1,1,4,2,4,5,5,1,6.0,13.0,-7.0,3
4371,4371,2001-02,2001,2002,Chelsea,Leeds,Draw,Away,2001-10-21,1,4,5,8,9,4,7,10,11,0,-2,-2,-2,0,6.0,4.0,2.0,3
4372,4372,2001-02,2001,2002,Chelsea,West Ham,Loss,Away,2001-10-24,0,4,5,6,9,3,3,6,6,1,2,0,3,0,6.0,15.0,-9.0,3
4373,4373,2001-02,2001,2002,Chelsea,Derby,Draw,Away,2001-10-28,1,1,4,5,6,1,1,1,1,0,3,4,5,0,6.0,17.0,-11.0,3
4374,4374,2001-02,2001,2002,Chelsea,Ipswich,Win,Home,2001-11-04,3,1,2,5,6,1,2,3,3,0,0,2,3,1,6.0,5.0,1.0,4
4375,4375,2001-02,2001,2002,Chelsea,Everton,Draw,Away,2001-11-18,1,4,4,5,8,1,4,5,8,3,0,0,0,0,6.0,16.0,-10.0,4
4376,4376,2001-02,2001,2002,Chelsea,Blackburn,Draw,Home,2001-11-24,1,4,5,5,6,4,5,6,9,0,0,-1,-3,1,6.0,21.0,-15.0,4
4377,4377,2001-02,2001,2002,Chelsea,Man United,Win,Away,2001-12-01,3,2,5,6,6,3,3,4,4,-1,2,2,2,0,6.0,1.0,5.0,5
4378,4378,2001-02,2001,2002,Chelsea,Charlton,Loss,Home,2001-12-05,0,4,5,8,9,1,2,5,5,3,3,3,4,1,6.0,9.0,-3.0,5
4379,4379,2001-02,2001,2002,Chelsea,Sunderland,Draw,Away,2001-12-09,1,3,4,5,8,3,6,6,7,0,-2,-1,1,0,6.0,7.0,-1.0,5
4380,4380,2001-02,2001,2002,Chelsea,Liverpool,Win,Home,2001-12-16,3,1,4,5,6,4,7,10,11,-3,-3,-5,-5,1,6.0,3.0,3.0,5
4381,4381,2001-02,2001,2002,Chelsea,Bolton,Win,Home,2001-12-23,3,4,4,7,8,1,1,2,5,3,3,5,3,1,6.0,21.0,-15.0,5
4382,4382,2001-02,2001,2002,Chelsea,Arsenal,Loss,Away,2001-12-26,0,6,7,7,10,3,4,7,10,3,3,0,0,0,6.0,2.0,4.0,5
4383,4383,2001-02,2001,2002,Chelsea,Newcastle,Win,Away,2001-12-29,3,3,6,7,7,6,9,12,15,-3,-3,-5,-8,0,6.0,11.0,-5.0,5
4384,4384,2001-02,2001,2002,Chelsea,Southampton,Loss,Home,2002-01-01,0,3,6,9,10,3,3,6,9,0,3,3,1,1,6.0,10.0,-4.0,6
4385,4385,2001-02,2001,2002,Chelsea,Bolton,Draw,Away,2002-01-12,1,3,3,6,9,2,2,2,3,1,1,4,6,0,6.0,21.0,-15.0,6
4386,4386,2001-02,2001,2002,Chelsea,West Ham,Win,Home,2002-01-20,3,1,4,4,7,3,4,7,8,-2,0,-3,-1,1,6.0,15.0,-9.0,6
4387,4387,2001-02,2001,2002,Chelsea,Leeds,Win,Home,2002-01-30,3,4,4,7,7,1,4,7,10,3,0,0,-3,1,6.0,4.0,2.0,6
4388,4388,2001-02,2001,2002,Chelsea,Leicester,Win,Away,2002-02-02,3,6,7,7,10,0,1,1,2,6,6,6,8,0,6.0,13.0,-7.0,7
4389,4389,2001-02,2001,2002,Chelsea,Aston Villa,Draw,Away,2002-02-09,1,6,9,10,10,2,5,8,9,4,4,2,1,0,6.0,8.0,-2.0,7
4390,4390,2001-02,2001,2002,Chelsea,Charlton,Loss,Away,2002-03-02,0,4,7,10,11,1,2,5,5,3,5,5,6,0,6.0,9.0,-3.0,8
4391,4391,2001-02,2001,2002,Chelsea,Fulham,Win,Home,2002-03-06,3,1,4,7,10,0,0,3,4,1,4,4,6,1,6.0,21.0,-15.0,8
4392,4392,2001-02,2001,2002,Chelsea,Tottenham,Win,Home,2002-03-13,3,3,4,7,10,3,6,6,6,0,-2,1,4,1,6.0,12.0,-6.0,8
4393,4393,2001-02,2001,2002,Chelsea,Sunderland,Win,Home,2002-03-16,3,6,6,7,10,3,3,6,6,3,3,1,4,1,6.0,7.0,-1.0,8
4394,4394,2001-02,2001,2002,Chelsea,Liverpool,Loss,Away,2002-03-24,0,6,9,9,10,6,9,10,13,0,0,-1,-3,0,6.0,3.0,3.0,8
4395,4395,2001-02,2001,2002,Chelsea,Derby,Win,Home,2002-03-30,3,3,6,9,9,3,3,4,7,0,3,5,2,1,6.0,17.0,-11.0,8
4396,4396,2001-02,2001,2002,Chelsea,Ipswich,Draw,Away,2002-04-01,1,3,6,9,12,1,2,2,2,2,4,7,10,0,6.0,5.0,1.0,9
4397,4397,2001-02,2001,2002,Chelsea,Everton,Win,Home,2002-04-06,3,4,4,7,10,3,6,9,9,1,-2,-2,1,1,6.0,16.0,-10.0,9
4398,4398,2001-02,2001,2002,Chelsea,Blackburn,Draw,Away,2002-04-10,1,4,7,7,10,3,3,6,9,1,4,1,1,0,6.0,21.0,-15.0,9
4399,4399,2001-02,2001,2002,Chelsea,Man United,Loss,Home,2002-04-20,0,4,5,8,8,6,6,9,12,-2,-1,-1,-4,1,6.0,1.0,5.0,9
4400,4400,2001-02,2001,2002,Chelsea,Middlesbrough,Win,Away,2002-04-27,3,1,4,5,8,0,3,6,7,1,1,-1,1,0,6.0,14.0,-8.0,9
4401,4401,2001-02,2001,2002,Chelsea,Aston Villa,Loss,Home,2002-05-11,0,3,4,7,8,4,4,4,5,-1,0,3,3,1,6.0,8.0,-2.0,10
4402,4402,2002-03,2002,2003,Chelsea,Charlton,Win,Away,2002-08-17,3,3,3,4,7,2,2,3,3,1,1,1,4,0,6.0,14.0,-8.0,1
4403,4403,2002-03,2002,2003,Chelsea,Man United,Draw,Home,2002-08-23,1,3,6,6,7,4,4,7,10,-1,2,-1,-3,1,6.0,3.0,3.0,1
4404,4404,2002-03,2002,2003,Chelsea,Southampton,Draw,Away,2002-08-28,1,4,4,7,7,1,4,4,4,3,0,3,3,0,6.0,11.0,-5.0,1
4405,4405,2002-03,2002,2003,Chelsea,Arsenal,Draw,Home,2002-09-01,1,2,5,5,8,4,7,10,13,-2,-2,-5,-5,1,6.0,1.0,5.0,2
4406,4406,2002-03,2002,2003,Chelsea,Blackburn,Win,Away,2002-09-11,3,2,3,6,6,1,4,5,8,1,-1,1,-2,0,6.0,10.0,-4.0,2
4407,4407,2002-03,2002,2003,Chelsea,Newcastle,Win,Home,2002-09-14,3,4,5,6,9,1,1,4,4,3,4,2,5,1,6.0,4.0,2.0,2
4408,4408,2002-03,2002,2003,Chelsea,Fulham,Draw,Away,2002-09-23,1,6,7,8,9,6,6,7,10,0,1,1,-1,0,6.0,13.0,-7.0,2
4409,4409,2002-03,2002,2003,Chelsea,West Ham,Loss,Home,2002-09-28,0,4,7,8,9,1,1,1,2,3,6,7,7,1,6.0,7.0,-1.0,2
4410,4410,2002-03,2002,2003,Chelsea,Liverpool,Loss,Away,2002-10-06,0,1,4,7,8,6,9,10,11,-5,-5,-3,-3,0,6.0,2.0,4.0,3
4411,4411,2002-03,2002,2003,Chelsea,Man City,Win,Away,2002-10-19,3,0,1,4,7,0,1,2,2,0,0,2,5,0,6.0,21.0,-15.0,3
4412,4412,2002-03,2002,2003,Chelsea,West Brom,Win,Home,2002-10-26,3,3,3,4,7,1,1,1,4,2,2,3,3,1,6.0,21.0,-15.0,3
4413,4413,2002-03,2002,2003,Chelsea,Tottenham,Draw,Away,2002-11-03,1,6,6,6,7,3,6,6,6,3,0,0,1,0,6.0,9.0,-3.0,4
4414,4414,2002-03,2002,2003,Chelsea,Birmingham,Win,Home,2002-11-09,3,4,7,7,7,3,4,7,7,1,3,0,0,1,6.0,21.0,-15.0,4
4415,4415,2002-03,2002,2003,Chelsea,Middlesbrough,Win,Home,2002-11-16,3,4,7,10,10,3,4,4,7,1,3,6,3,1,6.0,12.0,-6.0,4
4416,4416,2002-03,2002,2003,Chelsea,Bolton,Draw,Away,2002-11-23,1,6,7,10,13,4,4,5,5,2,3,5,8,0,6.0,16.0,-10.0,4
4417,4417,2002-03,2002,2003,Chelsea,Sunderland,Win,Home,2002-11-30,3,4,7,8,11,1,4,5,6,3,3,3,5,1,6.0,17.0,-11.0,4
4418,4418,2002-03,2002,2003,Chelsea,Everton,Win,Away,2002-12-07,3,4,7,10,11,3,6,9,12,1,1,1,-1,0,6.0,15.0,-9.0,5
4419,4419,2002-03,2002,2003,Chelsea,Middlesbrough,Draw,Away,2002-12-14,1,6,7,10,13,1,4,4,7,5,3,6,6,0,6.0,12.0,-6.0,5
4420,4420,2002-03,2002,2003,Chelsea,Aston Villa,Win,Home,2002-12-21,3,4,7,8,11,3,3,6,7,1,4,2,4,1,6.0,8.0,-2.0,5
4421,4421,2002-03,2002,2003,Chelsea,Southampton,Draw,Home,2002-12-26,1,4,7,10,11,2,5,8,11,2,2,2,0,1,6.0,11.0,-5.0,5
4422,4422,2002-03,2002,2003,Chelsea,Leeds,Loss,Away,2002-12-28,0,4,5,8,11,4,7,7,7,0,-2,1,4,0,6.0,5.0,1.0,5
4423,4423,2002-03,2002,2003,Chelsea,Arsenal,Loss,Away,2003-01-01,0,1,4,5,8,4,7,8,8,-3,-3,-3,0,0,6.0,1.0,5.0,6
4424,4424,2002-03,2002,2003,Chelsea,Charlton,Win,Home,2003-01-11,3,0,1,4,5,4,5,6,9,-4,-4,-2,-4,1,6.0,14.0,-8.0,6
4425,4425,2002-03,2002,2003,Chelsea,Man United,Loss,Away,2003-01-18,0,3,3,4,7,6,9,9,9,-3,-6,-5,-2,0,6.0,3.0,3.0,6
4426,4426,2002-03,2002,2003,Chelsea,Leeds,Win,Home,2003-01-28,3,3,3,3,4,1,4,7,10,2,-1,-4,-6,1,6.0,5.0,1.0,6
4427,4427,2002-03,2002,2003,Chelsea,Tottenham,Draw,Home,2003-02-01,1,3,6,6,6,3,6,6,6,0,0,0,0,1,6.0,9.0,-3.0,7
4428,4428,2002-03,2002,2003,Chelsea,Birmingham,Win,Away,2003-02-08,3,4,4,7,7,0,1,1,1,4,3,6,6,0,6.0,21.0,-15.0,7
4429,4429,2002-03,2002,2003,Chelsea,Blackburn,Loss,Home,2003-02-22,0,4,7,7,10,3,3,4,5,1,4,3,5,1,6.0,10.0,-4.0,7
4430,4430,2002-03,2002,2003,Chelsea,Newcastle,Loss,Away,2003-03-01,0,3,4,7,7,4,7,10,13,-1,-3,-3,-6,0,6.0,4.0,2.0,8
4431,4431,2002-03,2002,2003,Chelsea,West Brom,Win,Away,2003-03-16,3,0,3,4,7,0,0,1,4,0,3,3,3,0,6.0,21.0,-15.0,8
4432,4432,2002-03,2002,2003,Chelsea,Man City,Win,Home,2003-03-22,3,3,3,6,7,3,3,4,4,0,0,2,3,1,6.0,21.0,-15.0,8
4433,4433,2002-03,2002,2003,Chelsea,Sunderland,Win,Away,2003-04-05,3,6,6,6,9,0,0,0,0,6,6,6,9,0,6.0,17.0,-11.0,9
4434,4434,2002-03,2002,2003,Chelsea,Bolton,Win,Home,2003-04-12,3,6,9,9,9,6,9,9,10,0,0,0,-1,1,6.0,16.0,-10.0,9
4435,4435,2002-03,2002,2003,Chelsea,Aston Villa,Loss,Away,2003-04-19,0,6,9,12,12,2,3,3,3,4,6,9,9,0,6.0,8.0,-2.0,9
4436,4436,2002-03,2002,2003,Chelsea,Everton,Win,Home,2003-04-21,3,3,6,9,12,3,6,6,7,0,0,3,5,1,6.0,15.0,-9.0,9
4437,4437,2002-03,2002,2003,Chelsea,Fulham,Draw,Home,2003-04-26,1,3,6,9,12,3,3,3,3,0,3,6,9,1,6.0,13.0,-7.0,9
4438,4438,2002-03,2002,2003,Chelsea,West Ham,Loss,Away,2003-05-03,0,4,4,7,10,6,6,7,8,-2,-2,0,2,0,6.0,7.0,-1.0,10
4439,4439,2002-03,2002,2003,Chelsea,Liverpool,Win,Home,2003-05-11,3,1,4,4,7,3,6,9,12,-2,-2,-5,-5,1,6.0,2.0,4.0,10
4440,4440,2003-04,2003,2004,Chelsea,Liverpool,Win,Away,2003-08-17,3,3,4,7,7,0,3,6,9,3,1,1,-2,0,4.0,5.0,-1.0,1
4441,4441,2003-04,2003,2004,Chelsea,Leicester,Win,Home,2003-08-23,3,6,6,7,10,4,5,6,7,2,1,1,3,1,4.0,21.0,-17.0,1
4442,4442,2003-04,2003,2004,Chelsea,Blackburn,Draw,Home,2003-08-30,1,6,9,9,10,1,4,7,8,5,5,2,2,1,4.0,6.0,-2.0,1
4443,4443,2003-04,2003,2004,Chelsea,Tottenham,Win,Home,2003-09-13,3,4,7,10,10,1,4,4,4,3,3,6,6,1,4.0,10.0,-6.0,2
4444,4444,2003-04,2003,2004,Chelsea,Wolves,Win,Away,2003-09-20,3,4,7,10,13,1,1,1,1,3,6,9,12,0,4.0,21.0,-17.0,2
4445,4445,2003-04,2003,2004,Chelsea,Aston Villa,Win,Home,2003-09-27,3,6,7,10,13,3,6,6,7,3,1,4,6,1,4.0,16.0,-12.0,2
4446,4446,2003-04,2003,2004,Chelsea,Middlesbrough,Win,Away,2003-10-05,3,6,9,10,13,6,6,6,7,0,3,4,6,0,4.0,11.0,-7.0,3
4447,4447,2003-04,2003,2004,Chelsea,Birmingham,Draw,Away,2003-10-14,1,6,9,12,13,3,6,7,10,3,3,5,3,0,4.0,13.0,-9.0,3
4448,4448,2003-04,2003,2004,Chelsea,Arsenal,Loss,Away,2003-10-18,0,4,7,10,13,6,7,8,11,-2,0,2,2,0,4.0,2.0,2.0,3
4449,4449,2003-04,2003,2004,Chelsea,Man City,Win,Home,2003-10-25,3,1,4,7,10,3,4,5,8,-2,0,2,2,1,4.0,9.0,-5.0,3
4450,4450,2003-04,2003,2004,Chelsea,Everton,Win,Away,2003-11-01,3,3,4,7,10,2,2,5,5,1,2,2,5,0,4.0,7.0,-3.0,4
4451,4451,2003-04,2003,2004,Chelsea,Newcastle,Win,Home,2003-11-09,3,6,6,7,10,4,7,10,13,2,-1,-3,-3,1,4.0,3.0,1.0,4
4452,4452,2003-04,2003,2004,Chelsea,Southampton,Win,Away,2003-11-22,3,6,9,9,10,1,4,5,5,5,5,4,5,0,4.0,8.0,-4.0,4
4453,4453,2003-04,2003,2004,Chelsea,Man United,Win,Home,2003-11-30,3,6,9,12,12,6,9,9,12,0,0,3,0,1,4.0,1.0,3.0,4
4454,4454,2003-04,2003,2004,Chelsea,Leeds,Draw,Away,2003-12-06,1,6,9,12,15,3,3,3,3,3,6,9,12,0,4.0,15.0,-11.0,5
4455,4455,2003-04,2003,2004,Chelsea,Bolton,Loss,Home,2003-12-13,0,4,7,10,13,3,6,7,10,1,1,3,3,1,4.0,17.0,-13.0,5
4456,4456,2003-04,2003,2004,Chelsea,Fulham,Win,Away,2003-12-20,3,1,4,7,10,3,4,7,7,-2,0,0,3,0,4.0,14.0,-10.0,5
4457,4457,2003-04,2003,2004,Chelsea,Charlton,Loss,Away,2003-12-26,0,3,4,7,10,2,2,2,3,1,2,5,7,0,4.0,12.0,-8.0,5
4458,4458,2003-04,2003,2004,Chelsea,Portsmouth,Win,Home,2003-12-28,3,3,3,4,7,3,3,4,4,0,0,0,3,1,4.0,21.0,-17.0,5
4459,4459,2003-04,2003,2004,Chelsea,Liverpool,Loss,Home,2004-01-07,0,3,6,6,7,4,4,5,8,-1,2,1,-1,1,4.0,5.0,-1.0,6
4460,4460,2003-04,2003,2004,Chelsea,Leicester,Win,Away,2004-01-11,3,3,3,6,6,2,3,3,3,1,0,3,3,0,4.0,21.0,-17.0,6
4461,4461,2003-04,2003,2004,Chelsea,Birmingham,Draw,Home,2004-01-18,1,3,6,6,9,3,3,6,9,0,3,0,0,1,4.0,13.0,-9.0,6
4462,4462,2003-04,2003,2004,Chelsea,Blackburn,Win,Away,2004-02-01,3,4,4,7,7,1,2,5,6,3,2,2,1,0,4.0,6.0,-2.0,7
4463,4463,2003-04,2003,2004,Chelsea,Charlton,Win,Home,2004-02-08,3,4,7,7,10,3,6,7,10,1,1,0,0,1,4.0,12.0,-8.0,7
4464,4464,2003-04,2003,2004,Chelsea,Portsmouth,Win,Away,2004-02-11,3,6,7,10,10,1,1,4,4,5,6,6,6,0,4.0,21.0,-17.0,7
4465,4465,2003-04,2003,2004,Chelsea,Arsenal,Loss,Home,2004-02-21,0,6,9,10,13,6,9,12,15,0,0,-2,-2,1,4.0,2.0,2.0,7
4466,4466,2003-04,2003,2004,Chelsea,Man City,Win,Away,2004-02-28,3,3,6,9,10,3,4,4,5,0,2,5,5,0,4.0,9.0,-5.0,7
4467,4467,2003-04,2003,2004,Chelsea,Bolton,Win,Away,2004-03-13,3,3,6,9,12,0,1,2,5,3,5,7,7,0,4.0,17.0,-13.0,8
4468,4468,2003-04,2003,2004,Chelsea,Fulham,Win,Home,2004-03-20,3,6,6,9,12,4,4,4,5,2,2,5,7,1,4.0,14.0,-10.0,8
4469,4469,2003-04,2003,2004,Chelsea,Wolves,Win,Home,2004-03-27,3,6,9,9,12,0,1,4,4,6,8,5,8,1,4.0,21.0,-17.0,8
4470,4470,2003-04,2003,2004,Chelsea,Tottenham,Win,Away,2004-04-03,3,6,9,12,12,0,3,3,4,6,6,9,8,0,4.0,10.0,-6.0,9
4471,4471,2003-04,2003,2004,Chelsea,Middlesbrough,Draw,Home,2004-04-10,1,6,9,12,15,4,7,7,10,2,2,5,5,1,4.0,11.0,-7.0,9
4472,4472,2003-04,2003,2004,Chelsea,Aston Villa,Loss,Away,2004-04-12,0,4,7,10,13,2,5,5,8,2,2,5,5,0,4.0,16.0,-12.0,9
4473,4473,2003-04,2003,2004,Chelsea,Everton,Draw,Home,2004-04-17,1,1,4,7,10,4,4,5,6,-3,0,2,4,1,4.0,7.0,-3.0,9
4474,4474,2003-04,2003,2004,Chelsea,Newcastle,Loss,Away,2004-04-25,0,1,2,5,8,2,5,5,8,-1,-3,0,0,0,4.0,3.0,1.0,9
4475,4475,2003-04,2003,2004,Chelsea,Southampton,Win,Home,2004-05-01,3,1,1,2,5,3,3,6,9,-2,-2,-4,-4,1,4.0,8.0,-4.0,10
4476,4476,2003-04,2003,2004,Chelsea,Man United,Draw,Away,2004-05-08,1,3,4,4,5,0,3,3,6,3,1,1,-1,0,4.0,1.0,3.0,10
4477,4477,2003-04,2003,2004,Chelsea,Leeds,Win,Home,2004-05-15,3,4,4,5,5,1,1,1,2,3,3,4,3,1,4.0,15.0,-11.0,10
4478,4478,2004-05,2004,2005,Chelsea,Man United,Win,Home,2004-08-15,3,4,7,7,8,4,4,4,7,0,3,3,1,1,2.0,3.0,-1.0,1
4479,4479,2004-05,2004,2005,Chelsea,Birmingham,Win,Away,2004-08-21,3,6,7,10,10,2,2,3,4,4,5,7,6,0,2.0,10.0,-8.0,1
4480,4480,2004-05,2004,2005,Chelsea,Crystal Palace,Win,Away,2004-08-24,3,6,9,10,13,1,4,5,5,5,5,5,8,0,2.0,21.0,-19.0,1
4481,4481,2004-05,2004,2005,Chelsea,Southampton,Win,Home,2004-08-28,3,6,9,12,13,3,3,3,4,3,6,9,9,1,2.0,12.0,-10.0,1
4482,4482,2004-05,2004,2005,Chelsea,Aston Villa,Draw,Away,2004-09-11,1,6,9,12,15,3,4,7,7,3,5,5,8,0,2.0,6.0,-4.0,2
4483,4483,2004-05,2004,2005,Chelsea,Tottenham,Draw,Home,2004-09-19,1,4,7,10,13,4,5,8,9,0,2,2,4,1,2.0,14.0,-12.0,2
4484,4484,2004-05,2004,2005,Chelsea,Middlesbrough,Win,Away,2004-09-25,3,2,5,8,11,3,6,9,9,-1,-1,-1,2,0,2.0,11.0,-9.0,2
4485,4485,2004-05,2004,2005,Chelsea,Liverpool,Win,Home,2004-10-03,3,4,5,8,11,3,6,6,9,1,-1,2,2,1,2.0,4.0,-2.0,3
4486,4486,2004-05,2004,2005,Chelsea,Man City,Loss,Away,2004-10-16,0,6,7,8,11,1,4,4,7,5,3,4,4,0,2.0,16.0,-14.0,3
4487,4487,2004-05,2004,2005,Chelsea,Blackburn,Win,Home,2004-10-23,3,3,6,7,8,1,1,4,4,2,5,3,4,1,2.0,15.0,-13.0,3
4488,4488,2004-05,2004,2005,Chelsea,West Brom,Win,Away,2004-10-30,3,3,6,9,10,1,4,4,5,2,2,5,5,0,2.0,21.0,-19.0,3
4489,4489,2004-05,2004,2005,Chelsea,Everton,Win,Home,2004-11-06,3,6,6,9,12,4,7,7,10,2,-1,2,2,1,2.0,17.0,-15.0,4
4490,4490,2004-05,2004,2005,Chelsea,Fulham,Win,Away,2004-11-13,3,6,9,9,12,6,6,6,6,0,3,3,6,0,2.0,9.0,-7.0,4
4491,4491,2004-05,2004,2005,Chelsea,Bolton,Draw,Home,2004-11-20,1,6,9,12,12,1,4,7,10,5,5,5,2,1,2.0,8.0,-6.0,4
4492,4492,2004-05,2004,2005,Chelsea,Charlton,Win,Away,2004-11-27,3,4,7,10,13,3,6,6,6,1,1,4,7,0,2.0,7.0,-5.0,4
4493,4493,2004-05,2004,2005,Chelsea,Newcastle,Win,Home,2004-12-04,3,4,7,10,13,4,4,4,4,0,3,6,9,1,2.0,5.0,-3.0,5
4494,4494,2004-05,2004,2005,Chelsea,Arsenal,Draw,Away,2004-12-12,1,6,7,10,13,3,4,7,8,3,3,3,5,0,2.0,1.0,1.0,5
4495,4495,2004-05,2004,2005,Chelsea,Norwich,Win,Home,2004-12-18,3,4,7,8,11,3,4,7,7,1,3,1,4,1,2.0,21.0,-19.0,5
4496,4496,2004-05,2004,2005,Chelsea,Aston Villa,Win,Home,2004-12-26,3,4,7,10,11,0,1,1,4,4,6,9,7,1,2.0,6.0,-4.0,5
4497,4497,2004-05,2004,2005,Chelsea,Portsmouth,Win,Away,2004-12-28,3,6,7,10,13,3,4,5,8,3,3,5,5,0,2.0,13.0,-11.0,5
4498,4498,2004-05,2004,2005,Chelsea,Liverpool,Win,Away,2005-01-01,3,6,9,10,13,6,9,10,10,0,0,0,3,0,2.0,4.0,-2.0,6
4499,4499,2004-05,2004,2005,Chelsea,Middlesbrough,Win,Home,2005-01-04,3,6,9,12,13,3,3,6,7,3,6,6,6,1,2.0,11.0,-9.0,6
4500,4500,2004-05,2004,2005,Chelsea,Tottenham,Win,Away,2005-01-15,3,6,9,12,15,4,5,8,11,2,4,4,4,0,2.0,14.0,-12.0,6
4501,4501,2004-05,2004,2005,Chelsea,Portsmouth,Win,Home,2005-01-22,3,6,9,12,15,0,1,1,4,6,8,11,11,1,2.0,13.0,-11.0,6
4502,4502,2004-05,2004,2005,Chelsea,Blackburn,Win,Away,2005-02-02,3,6,9,12,15,3,6,6,9,3,3,6,6,0,2.0,15.0,-13.0,7
4503,4503,2004-05,2004,2005,Chelsea,Man City,Draw,Home,2005-02-06,1,6,9,12,15,1,4,5,8,5,5,7,7,1,2.0,16.0,-14.0,7
4504,4504,2004-05,2004,2005,Chelsea,Everton,Win,Away,2005-02-12,3,4,7,10,13,4,4,5,8,0,3,5,5,0,2.0,17.0,-15.0,7
4505,4505,2004-05,2004,2005,Chelsea,Norwich,Win,Away,2005-03-05,3,4,7,10,13,0,3,3,4,4,4,7,9,0,2.0,21.0,-19.0,8
4506,4506,2004-05,2004,2005,Chelsea,West Brom,Win,Home,2005-03-15,3,6,7,10,13,4,4,5,8,2,3,5,5,1,2.0,21.0,-19.0,8
4507,4507,2004-05,2004,2005,Chelsea,Crystal Palace,Win,Home,2005-03-19,3,6,9,10,13,4,4,4,5,2,5,6,8,1,2.0,21.0,-19.0,8
4508,4508,2004-05,2004,2005,Chelsea,Southampton,Win,Away,2005-04-02,3,6,9,12,13,6,7,8,9,0,2,4,4,0,2.0,12.0,-10.0,9
4509,4509,2004-05,2004,2005,Chelsea,Birmingham,Draw,Home,2005-04-09,1,6,9,12,15,4,4,4,7,2,5,8,8,1,2.0,10.0,-8.0,9
4510,4510,2004-05,2004,2005,Chelsea,Arsenal,Draw,Home,2005-04-20,1,4,7,10,13,6,9,12,13,-2,-2,-2,0,1,2.0,1.0,1.0,9
4511,4511,2004-05,2004,2005,Chelsea,Fulham,Win,Home,2005-04-23,3,2,5,8,11,2,2,5,5,0,3,3,6,1,2.0,9.0,-7.0,9
4512,4512,2004-05,2004,2005,Chelsea,Bolton,Win,Away,2005-04-30,3,4,5,8,11,2,5,8,8,2,0,0,3,0,2.0,8.0,-6.0,9
4513,4513,2004-05,2004,2005,Chelsea,Charlton,Win,Home,2005-05-07,3,6,7,8,11,0,1,1,1,6,6,7,10,1,2.0,7.0,-5.0,10
4514,4514,2004-05,2004,2005,Chelsea,Man United,Win,Away,2005-05-10,3,6,9,10,11,4,7,7,7,2,2,3,4,0,2.0,3.0,-1.0,10
4515,4515,2004-05,2004,2005,Chelsea,Newcastle,Draw,Away,2005-05-15,1,6,9,12,13,3,4,5,5,3,5,7,8,0,2.0,5.0,-3.0,10
4516,4516,2005-06,2005,2006,Chelsea,Wigan,Win,Away,2005-08-14,3,4,7,10,13,0,0,0,0,4,7,10,13,0,1.0,21.0,-20.0,1
4517,4517,2005-06,2005,2006,Chelsea,Arsenal,Win,Home,2005-08-21,3,4,7,10,13,3,6,9,12,1,1,1,1,1,1.0,2.0,-1.0,1
4518,4518,2005-06,2005,2006,Chelsea,West Brom,Win,Home,2005-08-24,3,6,7,10,13,4,7,8,8,2,0,2,5,1,1.0,17.0,-16.0,1
4519,4519,2005-06,2005,2006,Chelsea,Tottenham,Win,Away,2005-08-27,3,6,9,10,13,4,7,8,8,2,2,2,5,0,1.0,9.0,-8.0,1
4520,4520,2005-06,2005,2006,Chelsea,Sunderland,Win,Home,2005-09-10,3,6,9,12,13,0,0,0,0,6,9,12,13,1,1.0,21.0,-20.0,2
4521,4521,2005-06,2005,2006,Chelsea,Charlton,Win,Away,2005-09-17,3,6,9,12,15,6,9,12,13,0,0,0,2,0,1.0,11.0,-10.0,2
4522,4522,2005-06,2005,2006,Chelsea,Aston Villa,Win,Home,2005-09-24,3,6,9,12,15,1,4,5,5,5,5,7,10,1,1.0,10.0,-9.0,2
4523,4523,2005-06,2005,2006,Chelsea,Liverpool,Win,Away,2005-10-02,3,6,9,12,15,2,3,6,7,4,6,6,8,0,1.0,5.0,-4.0,3
4524,4524,2005-06,2005,2006,Chelsea,Bolton,Win,Home,2005-10-15,3,6,9,12,15,3,6,7,10,3,3,5,5,1,1.0,6.0,-5.0,3
4525,4525,2005-06,2005,2006,Chelsea,Everton,Draw,Away,2005-10-23,1,6,9,12,15,0,0,0,0,6,9,12,15,0,1.0,4.0,-3.0,3
4526,4526,2005-06,2005,2006,Chelsea,Blackburn,Win,Home,2005-10-29,3,4,7,10,13,3,6,9,9,1,1,1,4,1,1.0,15.0,-14.0,3
4527,4527,2005-06,2005,2006,Chelsea,Man United,Loss,Away,2005-11-06,0,4,7,10,13,1,4,7,7,3,3,3,6,0,1.0,3.0,-2.0,4
4528,4528,2005-06,2005,2006,Chelsea,Newcastle,Win,Home,2005-11-19,3,3,4,7,10,6,9,9,10,-3,-5,-2,0,1,1.0,14.0,-13.0,4
4529,4529,2005-06,2005,2006,Chelsea,Portsmouth,Win,Away,2005-11-26,3,3,6,7,10,0,3,3,4,3,3,4,6,0,1.0,16.0,-15.0,4
4530,4530,2005-06,2005,2006,Chelsea,Middlesbrough,Win,Home,2005-12-03,3,6,6,9,10,4,4,7,7,2,2,2,3,1,1.0,7.0,-6.0,5
4531,4531,2005-06,2005,2006,Chelsea,Wigan,Win,Home,2005-12-10,3,6,9,9,12,0,0,3,6,6,9,6,6,1,1.0,21.0,-20.0,5
4532,4532,2005-06,2005,2006,Chelsea,Arsenal,Win,Away,2005-12-18,3,6,9,12,12,0,3,6,9,6,6,6,3,0,1.0,2.0,-1.0,5
4533,4533,2005-06,2005,2006,Chelsea,Fulham,Win,Home,2005-12-26,3,6,9,12,15,3,4,7,7,3,5,5,8,1,1.0,13.0,-12.0,5
4534,4534,2005-06,2005,2006,Chelsea,Man City,Win,Away,2005-12-28,3,6,9,12,15,3,3,6,6,3,6,6,9,0,1.0,8.0,-7.0,5
4535,4535,2005-06,2005,2006,Chelsea,Birmingham,Win,Home,2005-12-31,3,6,9,12,15,1,1,4,4,5,8,8,11,1,1.0,12.0,-11.0,5
4536,4536,2005-06,2005,2006,Chelsea,West Ham,Win,Away,2006-01-02,3,6,9,12,15,0,1,1,4,6,8,11,11,0,1.0,21.0,-20.0,6
4537,4537,2005-06,2005,2006,Chelsea,Sunderland,Win,Away,2006-01-15,3,6,9,12,15,0,1,1,1,6,8,11,14,0,1.0,21.0,-20.0,6
4538,4538,2005-06,2005,2006,Chelsea,Charlton,Draw,Home,2006-01-22,1,6,9,12,15,3,6,6,6,3,3,6,9,1,1.0,11.0,-10.0,6
4539,4539,2005-06,2005,2006,Chelsea,Aston Villa,Draw,Away,2006-02-01,1,4,7,10,13,1,4,5,6,3,3,5,7,0,1.0,10.0,-9.0,7
4540,4540,2005-06,2005,2006,Chelsea,Liverpool,Win,Home,2006-02-05,3,2,5,8,11,1,4,5,8,1,1,3,3,1,1.0,5.0,-4.0,7
4541,4541,2005-06,2005,2006,Chelsea,Middlesbrough,Loss,Away,2006-02-11,0,4,5,8,11,3,3,3,4,1,2,5,7,0,1.0,7.0,-6.0,7
4542,4542,2005-06,2005,2006,Chelsea,Portsmouth,Win,Home,2006-02-25,3,3,4,5,8,0,1,1,1,3,3,4,7,1,1.0,16.0,-15.0,7
4543,4543,2005-06,2005,2006,Chelsea,West Brom,Win,Away,2006-03-04,3,3,6,7,8,0,3,4,4,3,3,3,4,0,1.0,17.0,-16.0,8
4544,4544,2005-06,2005,2006,Chelsea,Tottenham,Win,Home,2006-03-11,3,6,6,9,10,4,5,8,8,2,1,1,2,1,1.0,9.0,-8.0,8
4545,4545,2005-06,2005,2006,Chelsea,Fulham,Loss,Away,2006-03-19,0,6,9,9,12,0,0,0,3,6,9,9,9,0,1.0,13.0,-12.0,8
4546,4546,2005-06,2005,2006,Chelsea,Man City,Win,Home,2006-03-25,3,3,6,9,9,0,3,3,6,3,3,6,3,1,1.0,8.0,-7.0,8
4547,4547,2005-06,2005,2006,Chelsea,Birmingham,Draw,Away,2006-04-01,1,3,6,9,12,0,1,1,4,3,5,8,8,0,1.0,12.0,-11.0,9
4548,4548,2005-06,2005,2006,Chelsea,West Ham,Win,Home,2006-04-09,3,4,4,7,10,1,4,4,4,3,0,3,6,1,1.0,21.0,-20.0,9
4549,4549,2005-06,2005,2006,Chelsea,Bolton,Win,Away,2006-04-15,3,4,7,7,10,0,0,0,3,4,7,7,7,0,1.0,6.0,-5.0,9
4550,4550,2005-06,2005,2006,Chelsea,Everton,Win,Home,2006-04-17,3,6,7,10,10,1,2,2,5,5,5,8,5,1,1.0,4.0,-3.0,9
4551,4551,2005-06,2005,2006,Chelsea,Man United,Win,Home,2006-04-29,3,6,9,10,13,4,7,10,13,2,2,0,0,1,1.0,3.0,-2.0,9
4552,4552,2005-06,2005,2006,Chelsea,Blackburn,Loss,Away,2006-05-02,0,6,9,12,13,3,3,4,5,3,6,8,8,0,1.0,15.0,-14.0,10
4553,4553,2005-06,2005,2006,Chelsea,Newcastle,Loss,Away,2006-05-07,0,3,6,9,12,4,7,10,13,-1,-1,-1,-1,0,1.0,14.0,-13.0,10
4554,4554,2006-07,2006,2007,Chelsea,Man City,Win,Home,2006-08-20,3,0,3,6,9,0,0,3,3,0,3,3,6,1,1.0,15.0,-14.0,1
4555,4555,2006-07,2006,2007,Chelsea,Middlesbrough,Loss,Away,2006-08-23,0,3,3,6,9,0,1,2,2,3,2,4,7,0,1.0,14.0,-13.0,1
4556,4556,2006-07,2006,2007,Chelsea,Blackburn,Win,Away,2006-08-27,3,3,3,3,6,1,4,7,10,2,-1,-4,-4,0,1.0,6.0,-5.0,1
4557,4557,2006-07,2006,2007,Chelsea,Charlton,Win,Home,2006-09-09,3,3,6,6,6,3,3,3,3,0,3,3,3,1,1.0,13.0,-12.0,2
4558,4558,2006-07,2006,2007,Chelsea,Liverpool,Win,Home,2006-09-17,3,6,6,9,9,3,4,7,10,3,2,2,-1,1,1.0,3.0,-2.0,2
4559,4559,2006-07,2006,2007,Chelsea,Fulham,Win,Away,2006-09-23,3,6,9,9,12,4,7,8,8,2,2,1,4,0,1.0,12.0,-11.0,2
4560,4560,2006-07,2006,2007,Chelsea,Aston Villa,Draw,Home,2006-09-30,1,6,9,12,12,4,5,8,11,2,4,4,1,1,1.0,16.0,-15.0,2
4561,4561,2006-07,2006,2007,Chelsea,Reading,Win,Away,2006-10-14,3,4,7,10,13,4,7,10,10,0,0,0,3,0,1.0,21.0,-20.0,3
4562,4562,2006-07,2006,2007,Chelsea,Portsmouth,Win,Home,2006-10-21,3,4,7,10,13,3,3,6,9,1,4,4,4,1,1.0,17.0,-16.0,3
4563,4563,2006-07,2006,2007,Chelsea,Sheffield United,Win,Away,2006-10-28,3,6,7,10,13,1,4,4,4,5,3,6,9,0,1.0,21.0,-20.0,3
4564,4564,2006-07,2006,2007,Chelsea,Tottenham,Loss,Away,2006-11-05,0,6,9,10,13,4,5,8,8,2,4,2,5,0,1.0,5.0,-4.0,4
4565,4565,2006-07,2006,2007,Chelsea,Watford,Win,Home,2006-11-11,3,3,6,9,10,4,5,5,6,-1,1,4,4,1,1.0,21.0,-20.0,4
4566,4566,2006-07,2006,2007,Chelsea,West Ham,Win,Home,2006-11-18,3,3,6,9,12,3,6,6,6,0,0,3,6,1,1.0,9.0,-8.0,4
4567,4567,2006-07,2006,2007,Chelsea,Man United,Draw,Away,2006-11-26,1,6,6,9,12,6,9,12,15,0,-3,-3,-3,0,1.0,2.0,-1.0,4
4568,4568,2006-07,2006,2007,Chelsea,Bolton,Win,Away,2006-11-29,3,4,7,7,10,3,4,4,4,1,3,3,6,0,1.0,8.0,-7.0,4
4569,4569,2006-07,2006,2007,Chelsea,Arsenal,Draw,Home,2006-12-10,1,4,7,10,10,3,3,4,7,1,4,6,3,1,1.0,4.0,-3.0,5
4570,4570,2006-07,2006,2007,Chelsea,Newcastle,Win,Home,2006-12-13,3,4,5,8,11,6,9,10,11,-2,-4,-2,0,1,1.0,7.0,-6.0,5
4571,4571,2006-07,2006,2007,Chelsea,Everton,Win,Away,2006-12-17,3,4,7,8,11,3,3,4,7,1,4,4,4,0,1.0,11.0,-10.0,5
4572,4572,2006-07,2006,2007,Chelsea,Wigan,Win,Away,2006-12-23,3,6,7,10,11,0,1,4,4,6,6,6,7,0,1.0,10.0,-9.0,5
4573,4573,2006-07,2006,2007,Chelsea,Reading,Draw,Home,2006-12-26,1,6,9,10,13,0,1,1,4,6,8,9,9,1,1.0,21.0,-20.0,5
4574,4574,2006-07,2006,2007,Chelsea,Fulham,Draw,Home,2006-12-30,1,4,7,10,11,2,5,5,5,2,2,5,6,1,1.0,12.0,-11.0,5
4575,4575,2006-07,2006,2007,Chelsea,Aston Villa,Draw,Away,2007-01-02,1,2,5,8,11,0,0,0,1,2,5,8,10,0,1.0,16.0,-15.0,6
4576,4576,2006-07,2006,2007,Chelsea,Wigan,Win,Home,2007-01-13,3,2,3,6,9,0,0,0,0,2,3,6,9,1,1.0,10.0,-9.0,6
4577,4577,2006-07,2006,2007,Chelsea,Liverpool,Loss,Away,2007-01-20,0,4,5,6,9,6,9,9,12,-2,-4,-3,-3,0,1.0,3.0,-2.0,6
4578,4578,2006-07,2006,2007,Chelsea,Blackburn,Win,Home,2007-01-31,3,3,4,5,6,3,3,6,9,0,1,-1,-3,1,1.0,6.0,-5.0,6
4579,4579,2006-07,2006,2007,Chelsea,Charlton,Win,Away,2007-02-03,3,3,6,7,8,4,4,4,7,-1,2,3,1,0,1.0,13.0,-12.0,7
4580,4580,2006-07,2006,2007,Chelsea,Middlesbrough,Win,Home,2007-02-10,3,6,6,9,10,2,5,8,11,4,1,1,-1,1,1.0,14.0,-13.0,7
4581,4581,2006-07,2006,2007,Chelsea,Portsmouth,Win,Away,2007-03-03,3,6,9,9,12,3,3,4,4,3,6,5,8,0,1.0,17.0,-16.0,8
4582,4582,2006-07,2006,2007,Chelsea,Man City,Win,Away,2007-03-14,3,6,9,12,12,0,0,0,1,6,9,12,11,0,1.0,15.0,-14.0,8
4583,4583,2006-07,2006,2007,Chelsea,Sheffield United,Win,Home,2007-03-17,3,6,9,12,15,1,4,4,7,5,5,8,8,1,1.0,21.0,-20.0,8
4584,4584,2006-07,2006,2007,Chelsea,Watford,Win,Away,2007-03-31,3,6,9,12,15,1,1,2,5,5,8,10,10,0,1.0,21.0,-20.0,8
4585,4585,2006-07,2006,2007,Chelsea,Tottenham,Win,Home,2007-04-07,3,6,9,12,15,6,9,12,15,0,0,0,0,1,1.0,5.0,-4.0,9
4586,4586,2006-07,2006,2007,Chelsea,West Ham,Win,Away,2007-04-18,3,6,9,12,15,3,6,9,9,3,3,3,6,0,1.0,9.0,-8.0,9
4587,4587,2006-07,2006,2007,Chelsea,Newcastle,Draw,Away,2007-04-22,1,6,9,12,15,1,4,4,4,5,5,8,11,0,1.0,7.0,-6.0,9
4588,4588,2006-07,2006,2007,Chelsea,Bolton,Draw,Home,2007-04-28,1,4,7,10,13,0,1,4,7,4,6,6,6,1,1.0,8.0,-7.0,9
4589,4589,2006-07,2006,2007,Chelsea,Arsenal,Draw,Away,2007-05-06,1,2,5,8,11,4,7,10,11,-2,-2,-2,0,0,1.0,4.0,-3.0,10
4590,4590,2006-07,2006,2007,Chelsea,Man United,Draw,Home,2007-05-09,1,2,3,6,9,6,7,10,10,-4,-4,-4,-1,1,1.0,2.0,-1.0,10
4591,4591,2006-07,2006,2007,Chelsea,Everton,Draw,Home,2007-05-13,1,2,3,4,7,3,3,6,7,-1,0,-2,0,1,1.0,11.0,-10.0,10
4592,4592,2007-08,2007,2008,Chelsea,Birmingham,Win,Home,2007-08-12,3,2,3,4,5,1,2,5,5,1,1,-1,0,1,2.0,21.0,-19.0,1
4593,4593,2007-08,2007,2008,Chelsea,Reading,Win,Away,2007-08-15,3,4,5,6,7,2,2,5,8,2,3,1,-1,0,2.0,8.0,-6.0,1
4594,4594,2007-08,2007,2008,Chelsea,Liverpool,Draw,Away,2007-08-19,1,6,7,8,9,4,4,4,7,2,3,4,2,0,2.0,3.0,-1.0,1
4595,4595,2007-08,2007,2008,Chelsea,Portsmouth,Win,Home,2007-08-25,3,4,7,8,9,4,5,6,6,0,2,2,3,1,2.0,9.0,-7.0,1
4596,4596,2007-08,2007,2008,Chelsea,Aston Villa,Loss,Away,2007-09-02,0,4,7,10,11,4,4,5,8,0,3,5,3,0,2.0,11.0,-9.0,2
4597,4597,2007-08,2007,2008,Chelsea,Blackburn,Draw,Home,2007-09-15,1,3,4,7,10,4,5,8,9,-1,-1,-1,1,1,2.0,10.0,-8.0,2
4598,4598,2007-08,2007,2008,Chelsea,Man United,Loss,Away,2007-09-23,0,1,4,5,8,6,9,9,10,-5,-5,-4,-2,0,2.0,1.0,1.0,2
4599,4599,2007-08,2007,2008,Chelsea,Fulham,Draw,Home,2007-09-29,1,1,1,4,5,2,3,3,3,-1,-2,1,2,1,2.0,16.0,-14.0,2
4600,4600,2007-08,2007,2008,Chelsea,Bolton,Win,Away,2007-10-07,3,1,2,2,5,2,2,2,5,-1,0,0,0,0,2.0,7.0,-5.0,3
4601,4601,2007-08,2007,2008,Chelsea,Middlesbrough,Win,Away,2007-10-20,3,4,4,5,5,0,1,1,4,4,3,4,1,0,2.0,12.0,-10.0,3
4602,4602,2007-08,2007,2008,Chelsea,Man City,Win,Home,2007-10-27,3,6,7,7,8,6,9,10,13,0,-2,-3,-5,1,2.0,14.0,-12.0,3
4603,4603,2007-08,2007,2008,Chelsea,Wigan,Win,Away,2007-11-03,3,6,9,10,10,0,0,0,0,6,9,10,10,0,2.0,17.0,-15.0,4
4604,4604,2007-08,2007,2008,Chelsea,Everton,Draw,Home,2007-11-11,1,6,9,12,13,6,6,6,9,0,3,6,4,1,2.0,6.0,-4.0,4
4605,4605,2007-08,2007,2008,Chelsea,Derby,Win,Away,2007-11-24,3,4,7,10,13,0,0,1,1,4,7,9,12,0,2.0,21.0,-19.0,4
4606,4606,2007-08,2007,2008,Chelsea,West Ham,Win,Home,2007-12-01,3,4,7,10,13,4,5,6,9,0,2,4,4,1,2.0,15.0,-13.0,5
4607,4607,2007-08,2007,2008,Chelsea,Sunderland,Win,Home,2007-12-08,3,6,7,10,13,3,4,4,5,3,3,6,8,1,2.0,21.0,-19.0,5
4608,4608,2007-08,2007,2008,Chelsea,Arsenal,Loss,Away,2007-12-16,0,6,9,10,13,1,4,7,10,5,5,3,3,0,2.0,4.0,-2.0,5
4609,4609,2007-08,2007,2008,Chelsea,Blackburn,Win,Away,2007-12-23,3,3,6,9,10,0,3,3,4,3,3,6,6,0,2.0,10.0,-8.0,5
4610,4610,2007-08,2007,2008,Chelsea,Aston Villa,Draw,Home,2007-12-26,1,3,6,9,12,2,2,2,5,1,4,7,7,1,2.0,11.0,-9.0,5
4611,4611,2007-08,2007,2008,Chelsea,Newcastle,Win,Home,2007-12-29,3,4,4,7,10,1,4,7,8,3,0,0,2,1,2.0,13.0,-11.0,5
4612,4612,2007-08,2007,2008,Chelsea,Fulham,Win,Away,2008-01-01,3,4,7,7,10,1,2,2,2,3,5,5,8,0,2.0,16.0,-14.0,6
4613,4613,2007-08,2007,2008,Chelsea,Tottenham,Win,Home,2008-01-12,3,6,7,10,10,3,6,6,9,3,1,4,1,1,2.0,5.0,-3.0,6
4614,4614,2007-08,2007,2008,Chelsea,Birmingham,Win,Away,2008-01-19,3,6,9,10,13,1,2,5,5,5,7,5,8,0,2.0,21.0,-19.0,6
4615,4615,2007-08,2007,2008,Chelsea,Reading,Win,Home,2008-01-30,3,6,9,12,13,0,0,0,1,6,9,12,12,1,2.0,8.0,-6.0,6
4616,4616,2007-08,2007,2008,Chelsea,Portsmouth,Draw,Away,2008-02-02,1,6,9,12,15,3,3,6,6,3,6,6,9,0,2.0,9.0,-7.0,7
4617,4617,2007-08,2007,2008,Chelsea,Liverpool,Draw,Home,2008-02-10,1,4,7,10,13,3,4,5,6,1,3,5,7,1,2.0,3.0,-1.0,7
4618,4618,2007-08,2007,2008,Chelsea,West Ham,Win,Away,2008-03-01,3,2,5,8,11,4,4,7,8,-2,1,1,3,0,2.0,15.0,-13.0,8
4619,4619,2007-08,2007,2008,Chelsea,Derby,Win,Home,2008-03-12,3,4,5,8,11,1,1,2,3,3,4,6,8,1,2.0,21.0,-19.0,8
4620,4620,2007-08,2007,2008,Chelsea,Sunderland,Win,Away,2008-03-15,3,6,7,8,11,1,1,4,4,5,6,4,7,0,2.0,21.0,-19.0,8
4621,4621,2007-08,2007,2008,Chelsea,Tottenham,Draw,Away,2008-03-19,1,6,9,10,11,3,3,6,7,3,6,4,4,0,2.0,5.0,-3.0,8
4622,4622,2007-08,2007,2008,Chelsea,Arsenal,Win,Home,2008-03-23,3,4,7,10,11,2,3,4,7,2,4,6,4,1,2.0,4.0,-2.0,8
4623,4623,2007-08,2007,2008,Chelsea,Middlesbrough,Win,Home,2008-03-30,3,4,7,10,13,4,5,5,5,0,2,5,8,1,2.0,12.0,-10.0,8
4624,4624,2007-08,2007,2008,Chelsea,Man City,Win,Away,2008-04-05,3,6,7,10,13,1,4,4,5,5,3,6,8,0,2.0,14.0,-12.0,9
4625,4625,2007-08,2007,2008,Chelsea,Wigan,Draw,Home,2008-04-14,1,6,9,10,13,3,3,6,7,3,6,4,6,1,2.0,17.0,-15.0,9
4626,4626,2007-08,2007,2008,Chelsea,Everton,Win,Away,2008-04-17,3,4,7,10,11,4,4,5,5,0,3,5,6,0,2.0,6.0,-4.0,9
4627,4627,2007-08,2007,2008,Chelsea,Man United,Win,Home,2008-04-26,3,4,7,10,13,4,5,8,11,0,2,2,2,1,2.0,1.0,1.0,9
4628,4628,2007-08,2007,2008,Chelsea,Newcastle,Win,Away,2008-05-05,3,6,7,10,13,4,5,8,11,2,2,2,2,0,2.0,13.0,-11.0,10
4629,4629,2007-08,2007,2008,Chelsea,Bolton,Draw,Home,2008-05-11,1,6,9,10,13,4,7,10,10,2,2,0,3,1,2.0,7.0,-5.0,10
4630,4630,2008-09,2008,2009,Chelsea,Portsmouth,Win,Home,2008-08-17,3,4,7,10,11,0,0,0,1,4,7,10,10,1,2.0,8.0,-6.0,1
4631,4631,2008-09,2008,2009,Chelsea,Wigan,Win,Away,2008-08-24,3,4,7,10,13,0,3,4,5,4,4,6,8,0,2.0,14.0,-12.0,1
4632,4632,2008-09,2008,2009,Chelsea,Tottenham,Draw,Home,2008-08-31,1,6,7,10,13,0,0,3,4,6,7,7,9,1,2.0,11.0,-9.0,1
4633,4633,2008-09,2008,2009,Chelsea,Man City,Win,Away,2008-09-13,3,4,7,8,11,6,6,6,6,-2,1,2,5,0,2.0,9.0,-7.0,2
4634,4634,2008-09,2008,2009,Chelsea,Man United,Draw,Home,2008-09-21,1,4,7,10,11,3,4,7,10,1,3,3,1,1,2.0,1.0,1.0,2
4635,4635,2008-09,2008,2009,Chelsea,Stoke,Win,Away,2008-09-27,3,4,5,8,11,1,1,4,4,3,4,4,7,0,2.0,21.0,-19.0,2
4636,4636,2008-09,2008,2009,Chelsea,Aston Villa,Win,Home,2008-10-05,3,4,7,8,11,6,9,10,10,-2,-2,-2,1,1,2.0,6.0,-4.0,3
4637,4637,2008-09,2008,2009,Chelsea,Middlesbrough,Win,Away,2008-10-18,3,6,7,10,11,3,3,3,6,3,4,7,5,0,2.0,13.0,-11.0,3
4638,4638,2008-09,2008,2009,Chelsea,Liverpool,Loss,Home,2008-10-26,0,6,9,10,13,6,9,10,13,0,0,0,0,1,2.0,4.0,-2.0,3
4639,4639,2008-09,2008,2009,Chelsea,Hull,Win,Away,2008-10-29,3,3,6,9,10,6,9,12,13,-3,-3,-3,-3,0,2.0,21.0,-19.0,3
4640,4640,2008-09,2008,2009,Chelsea,Sunderland,Win,Home,2008-11-01,3,3,6,9,12,3,4,5,5,0,2,4,7,1,2.0,15.0,-13.0,4
4641,4641,2008-09,2008,2009,Chelsea,Blackburn,Win,Away,2008-11-09,3,6,6,9,12,1,2,3,3,5,4,6,9,0,2.0,7.0,-5.0,4
4642,4642,2008-09,2008,2009,Chelsea,West Brom,Win,Away,2008-11-15,3,6,9,9,12,1,1,1,1,5,8,8,11,0,2.0,21.0,-19.0,4
4643,4643,2008-09,2008,2009,Chelsea,Newcastle,Draw,Home,2008-11-22,1,6,9,12,12,1,4,7,7,5,5,5,5,1,2.0,12.0,-10.0,4
4644,4644,2008-09,2008,2009,Chelsea,Arsenal,Loss,Home,2008-11-30,0,4,7,10,13,0,3,3,4,4,4,7,9,1,2.0,3.0,-1.0,4
4645,4645,2008-09,2008,2009,Chelsea,Bolton,Win,Away,2008-12-06,3,1,4,7,10,6,6,9,12,-5,-2,-2,-2,0,2.0,16.0,-14.0,5
4646,4646,2008-09,2008,2009,Chelsea,West Ham,Draw,Home,2008-12-14,1,3,4,7,10,1,4,5,5,2,0,2,5,1,2.0,10.0,-8.0,5
4647,4647,2008-09,2008,2009,Chelsea,Everton,Draw,Away,2008-12-22,1,4,4,5,8,3,6,6,7,1,-2,-1,1,0,2.0,5.0,-3.0,5
4648,4648,2008-09,2008,2009,Chelsea,West Brom,Win,Home,2008-12-26,3,2,5,5,6,3,4,4,4,-1,1,1,2,1,2.0,21.0,-19.0,5
4649,4649,2008-09,2008,2009,Chelsea,Fulham,Draw,Away,2008-12-28,1,4,5,8,8,4,5,6,7,0,0,2,1,0,2.0,17.0,-15.0,5
4650,4650,2008-09,2008,2009,Chelsea,Man United,Loss,Away,2009-01-11,0,4,5,6,9,6,7,10,13,-2,-2,-4,-4,0,2.0,1.0,1.0,6
4651,4651,2008-09,2008,2009,Chelsea,Stoke,Win,Home,2009-01-17,3,1,4,5,6,1,1,1,2,0,3,4,4,1,2.0,21.0,-19.0,6
4652,4652,2008-09,2008,2009,Chelsea,Middlesbrough,Win,Home,2009-01-28,3,3,4,7,8,1,1,1,1,2,3,6,7,1,2.0,13.0,-11.0,6
4653,4653,2008-09,2008,2009,Chelsea,Liverpool,Loss,Away,2009-02-01,0,6,6,7,10,2,3,6,9,4,3,1,1,0,2.0,4.0,-2.0,7
4654,4654,2008-09,2008,2009,Chelsea,Hull,Draw,Home,2009-02-07,1,3,6,6,7,1,1,1,1,2,5,5,6,1,2.0,21.0,-19.0,7
4655,4655,2008-09,2008,2009,Chelsea,Aston Villa,Win,Away,2009-02-21,3,1,4,7,7,4,7,10,13,-3,-3,-3,-6,0,2.0,6.0,-4.0,7
4656,4656,2008-09,2008,2009,Chelsea,Wigan,Win,Home,2009-02-28,3,4,4,7,10,2,3,4,4,2,1,3,6,1,2.0,14.0,-12.0,7
4657,4657,2008-09,2008,2009,Chelsea,Portsmouth,Win,Away,2009-03-03,3,6,7,7,10,4,4,4,4,2,3,3,6,0,2.0,8.0,-6.0,8
4658,4658,2008-09,2008,2009,Chelsea,Man City,Win,Home,2009-03-15,3,6,9,10,10,3,4,4,7,3,5,6,3,1,2.0,9.0,-7.0,8
4659,4659,2008-09,2008,2009,Chelsea,Tottenham,Loss,Away,2009-03-21,0,6,9,12,13,4,7,10,11,2,2,2,2,0,2.0,11.0,-9.0,8
4660,4660,2008-09,2008,2009,Chelsea,Newcastle,Win,Away,2009-04-04,3,3,6,9,12,1,1,1,2,2,5,8,10,0,2.0,12.0,-10.0,9
4661,4661,2008-09,2008,2009,Chelsea,Bolton,Win,Home,2009-04-11,3,3,6,9,12,4,4,4,7,-1,2,5,5,1,2.0,16.0,-14.0,9
4662,4662,2008-09,2008,2009,Chelsea,Everton,Draw,Home,2009-04-22,1,6,6,9,12,4,4,7,8,2,2,2,4,1,2.0,5.0,-3.0,9
4663,4663,2008-09,2008,2009,Chelsea,West Ham,Win,Away,2009-04-25,3,4,7,7,10,1,4,5,6,3,3,2,4,0,2.0,10.0,-8.0,9
4664,4664,2008-09,2008,2009,Chelsea,Fulham,Win,Home,2009-05-02,3,4,7,10,10,4,7,7,10,0,0,3,0,1,2.0,17.0,-15.0,10
4665,4665,2008-09,2008,2009,Chelsea,Arsenal,Win,Away,2009-05-10,3,6,7,10,13,6,7,10,13,0,0,0,0,0,2.0,3.0,-1.0,10
4666,4666,2008-09,2008,2009,Chelsea,Blackburn,Win,Home,2009-05-17,3,6,9,10,13,3,6,6,6,3,3,4,7,1,2.0,7.0,-5.0,10
4667,4667,2008-09,2008,2009,Chelsea,Sunderland,Win,Away,2009-05-24,3,6,9,12,13,1,1,1,4,5,8,11,9,0,2.0,15.0,-13.0,10
4668,4668,2009-10,2009,2010,Chelsea,Hull,Win,Home,2009-08-15,3,6,9,12,15,1,1,1,1,5,8,11,14,1,3.0,17.0,-14.0,1
4669,4669,2009-10,2009,2010,Chelsea,Sunderland,Win,Away,2009-08-18,3,6,9,12,15,3,3,4,4,3,6,8,11,0,3.0,16.0,-13.0,1
4670,4670,2009-10,2009,2010,Chelsea,Fulham,Win,Away,2009-08-23,3,6,9,12,15,3,6,9,9,3,3,3,6,0,3.0,7.0,-4.0,1
4671,4671,2009-10,2009,2010,Chelsea,Burnley,Win,Home,2009-08-29,3,6,9,12,15,6,6,6,6,0,3,6,9,1,3.0,21.0,-18.0,1
4672,4672,2009-10,2009,2010,Chelsea,Stoke,Win,Away,2009-09-12,3,6,9,12,15,4,4,7,7,2,5,5,8,0,3.0,12.0,-9.0,2
4673,4673,2009-10,2009,2010,Chelsea,Tottenham,Win,Home,2009-09-20,3,6,9,12,15,3,6,9,12,3,3,3,3,1,3.0,8.0,-5.0,2
4674,4674,2009-10,2009,2010,Chelsea,Wigan,Loss,Away,2009-09-26,0,6,9,12,15,3,3,3,3,3,6,9,12,0,3.0,11.0,-8.0,2
4675,4675,2009-10,2009,2010,Chelsea,Liverpool,Win,Home,2009-10-04,3,3,6,9,12,6,9,12,12,-3,-3,-3,0,1,3.0,2.0,1.0,3
4676,4676,2009-10,2009,2010,Chelsea,Aston Villa,Loss,Away,2009-10-17,0,3,6,9,12,1,4,7,10,2,2,2,2,0,3.0,6.0,-3.0,3
4677,4677,2009-10,2009,2010,Chelsea,Blackburn,Win,Home,2009-10-24,3,3,3,6,9,3,6,6,9,0,-3,0,0,1,3.0,15.0,-12.0,3
4678,4678,2009-10,2009,2010,Chelsea,Bolton,Win,Away,2009-10-31,3,3,6,6,9,3,4,7,8,0,2,-1,1,0,3.0,13.0,-10.0,3
4679,4679,2009-10,2009,2010,Chelsea,Man United,Win,Home,2009-11-08,3,6,6,9,9,3,6,7,10,3,0,2,-1,1,3.0,1.0,2.0,4
4680,4680,2009-10,2009,2010,Chelsea,Wolves,Win,Home,2009-11-21,3,6,9,9,12,1,2,3,3,5,7,6,9,1,3.0,21.0,-18.0,4
4681,4681,2009-10,2009,2010,Chelsea,Arsenal,Win,Away,2009-11-29,3,6,9,12,12,3,6,7,10,3,3,5,2,0,3.0,4.0,-1.0,4
4682,4682,2009-10,2009,2010,Chelsea,Man City,Loss,Away,2009-12-05,0,6,9,12,15,2,3,4,5,4,6,8,10,0,3.0,10.0,-7.0,5
4683,4683,2009-10,2009,2010,Chelsea,Everton,Draw,Home,2009-12-12,1,3,6,9,12,1,1,1,4,2,5,8,8,1,3.0,5.0,-2.0,5
4684,4684,2009-10,2009,2010,Chelsea,Portsmouth,Win,Home,2009-12-16,3,1,4,7,10,4,4,4,4,-3,0,3,6,1,3.0,14.0,-11.0,5
4685,4685,2009-10,2009,2010,Chelsea,West Ham,Draw,Away,2009-12-20,1,4,4,7,10,0,0,3,4,4,4,4,6,0,3.0,9.0,-6.0,5
4686,4686,2009-10,2009,2010,Chelsea,Birmingham,Draw,Away,2009-12-26,1,4,5,5,8,4,7,10,13,0,-2,-5,-5,0,3.0,21.0,-18.0,5
4687,4687,2009-10,2009,2010,Chelsea,Fulham,Win,Home,2009-12-28,3,2,5,6,6,4,5,8,9,-2,0,-2,-3,1,3.0,7.0,-4.0,5
4688,4688,2009-10,2009,2010,Chelsea,Sunderland,Win,Home,2010-01-16,3,4,5,8,9,2,2,2,3,2,3,6,6,1,3.0,16.0,-13.0,6
4689,4689,2009-10,2009,2010,Chelsea,Birmingham,Win,Home,2010-01-27,3,6,7,8,11,4,5,6,9,2,2,2,2,1,3.0,21.0,-18.0,6
4690,4690,2009-10,2009,2010,Chelsea,Burnley,Win,Away,2010-01-30,3,6,9,10,11,0,0,1,1,6,9,9,10,0,3.0,21.0,-18.0,6
4691,4691,2009-10,2009,2010,Chelsea,Hull,Draw,Away,2010-02-02,1,6,9,12,13,1,2,3,3,5,7,9,10,0,3.0,17.0,-14.0,7
4692,4692,2009-10,2009,2010,Chelsea,Arsenal,Win,Home,2010-02-07,3,4,7,10,13,1,4,7,8,3,3,3,5,1,3.0,4.0,-1.0,7
4693,4693,2009-10,2009,2010,Chelsea,Everton,Loss,Away,2010-02-10,0,4,7,10,13,3,6,9,10,1,1,1,3,0,3.0,5.0,-2.0,7
4694,4694,2009-10,2009,2010,Chelsea,Wolves,Win,Away,2010-02-20,3,3,4,7,10,3,4,5,5,0,0,2,5,0,3.0,21.0,-18.0,7
4695,4695,2009-10,2009,2010,Chelsea,Man City,Loss,Home,2010-02-27,0,3,6,7,10,2,5,5,8,1,1,2,2,1,3.0,10.0,-7.0,7
4696,4696,2009-10,2009,2010,Chelsea,West Ham,Win,Home,2010-03-13,3,3,3,6,7,0,3,6,6,3,0,0,1,1,3.0,9.0,-6.0,8
4697,4697,2009-10,2009,2010,Chelsea,Blackburn,Draw,Away,2010-03-21,1,3,6,6,9,0,3,6,6,3,3,0,3,0,3.0,15.0,-12.0,8
4698,4698,2009-10,2009,2010,Chelsea,Portsmouth,Win,Away,2010-03-24,3,4,4,7,7,3,3,6,6,1,1,1,1,0,3.0,14.0,-11.0,8
4699,4699,2009-10,2009,2010,Chelsea,Aston Villa,Win,Home,2010-03-27,3,4,7,7,10,2,5,6,9,2,2,1,1,1,3.0,6.0,-3.0,8
4700,4700,2009-10,2009,2010,Chelsea,Man United,Win,Away,2010-04-03,3,6,7,10,10,6,9,12,15,0,-2,-2,-5,0,3.0,1.0,2.0,9
4701,4701,2009-10,2009,2010,Chelsea,Bolton,Win,Home,2010-04-13,3,6,9,10,13,0,0,3,3,6,9,7,10,1,3.0,13.0,-10.0,9
4702,4702,2009-10,2009,2010,Chelsea,Tottenham,Loss,Away,2010-04-17,0,6,9,12,13,3,6,9,12,3,3,3,1,0,3.0,8.0,-5.0,9
4703,4703,2009-10,2009,2010,Chelsea,Stoke,Win,Home,2010-04-25,3,3,6,9,12,1,4,7,7,2,2,2,5,1,3.0,12.0,-9.0,9
4704,4704,2009-10,2009,2010,Chelsea,Liverpool,Win,Away,2010-05-02,3,3,6,9,12,6,7,8,11,-3,-1,1,1,0,3.0,2.0,1.0,10
4705,4705,2009-10,2009,2010,Chelsea,Wigan,Win,Home,2010-05-09,3,6,6,9,12,1,4,5,5,5,2,4,7,1,3.0,11.0,-8.0,10
4706,4706,2010-11,2010,2011,Chelsea,West Brom,Win,Home,2010-08-14,3,6,9,9,12,1,4,4,7,5,5,5,5,1,1.0,21.0,-20.0,1
4707,4707,2010-11,2010,2011,Chelsea,Wigan,Win,Away,2010-08-21,3,6,9,12,12,0,1,1,4,6,8,11,8,0,1.0,16.0,-15.0,1
4708,4708,2010-11,2010,2011,Chelsea,Stoke,Win,Home,2010-08-28,3,6,9,12,15,0,0,3,4,6,9,9,11,1,1.0,11.0,-10.0,1
4709,4709,2010-11,2010,2011,Chelsea,West Ham,Win,Away,2010-09-11,3,6,9,12,15,0,0,1,1,6,9,11,14,0,1.0,17.0,-16.0,2
4710,4710,2010-11,2010,2011,Chelsea,Blackpool,Win,Home,2010-09-19,3,6,9,12,15,4,4,7,7,2,5,5,8,1,1.0,21.0,-20.0,2
4711,4711,2010-11,2010,2011,Chelsea,Man City,Loss,Away,2010-09-25,0,6,9,12,15,4,4,7,8,2,5,5,7,0,1.0,5.0,-4.0,2
4712,4712,2010-11,2010,2011,Chelsea,Arsenal,Win,Home,2010-10-03,3,3,6,9,12,1,4,7,10,2,2,2,2,1,1.0,3.0,-2.0,3
4713,4713,2010-11,2010,2011,Chelsea,Aston Villa,Draw,Away,2010-10-16,1,3,6,9,12,3,4,4,7,0,2,5,5,0,1.0,6.0,-5.0,3
4714,4714,2010-11,2010,2011,Chelsea,Wolves,Win,Home,2010-10-23,3,4,4,7,10,1,1,1,1,3,3,6,9,1,1.0,15.0,-14.0,3
4715,4715,2010-11,2010,2011,Chelsea,Blackburn,Win,Away,2010-10-30,3,4,7,7,10,1,1,4,5,3,6,3,5,0,1.0,10.0,-9.0,3
4716,4716,2010-11,2010,2011,Chelsea,Liverpool,Loss,Away,2010-11-07,0,6,7,10,10,6,6,6,7,0,1,4,3,0,1.0,7.0,-6.0,4
4717,4717,2010-11,2010,2011,Chelsea,Fulham,Win,Home,2010-11-10,3,3,6,7,10,4,4,4,5,-1,2,3,5,1,1.0,12.0,-11.0,4
4718,4718,2010-11,2010,2011,Chelsea,Sunderland,Loss,Home,2010-11-14,0,3,6,9,10,4,4,7,8,-1,2,2,2,1,1.0,13.0,-12.0,4
4719,4719,2010-11,2010,2011,Chelsea,Birmingham,Loss,Away,2010-11-20,0,3,3,6,9,1,2,3,6,2,1,3,3,0,1.0,9.0,-8.0,4
4720,4720,2010-11,2010,2011,Chelsea,Newcastle,Draw,Away,2010-11-28,1,0,3,3,6,1,1,4,7,-1,2,-1,-1,0,1.0,21.0,-20.0,4
4721,4721,2010-11,2010,2011,Chelsea,Everton,Draw,Home,2010-12-04,1,1,1,4,4,1,1,2,3,0,0,2,1,1,1.0,8.0,-7.0,5
4722,4722,2010-11,2010,2011,Chelsea,Tottenham,Draw,Away,2010-12-12,1,2,2,2,5,4,7,10,11,-2,-5,-8,-6,0,1.0,4.0,-3.0,5
4723,4723,2010-11,2010,2011,Chelsea,Arsenal,Loss,Away,2010-12-27,0,2,3,3,3,3,6,6,9,-1,-3,-3,-6,0,1.0,3.0,-2.0,5
4724,4724,2010-11,2010,2011,Chelsea,Bolton,Win,Home,2010-12-29,3,1,2,3,3,3,6,6,7,-2,-4,-3,-4,1,1.0,14.0,-13.0,5
4725,4725,2010-11,2010,2011,Chelsea,Aston Villa,Draw,Home,2011-01-02,1,3,4,5,6,0,3,3,3,3,1,2,3,1,1.0,6.0,-5.0,6
4726,4726,2010-11,2010,2011,Chelsea,Wolves,Loss,Away,2011-01-05,0,4,4,5,6,3,3,6,6,1,1,-1,0,0,1.0,15.0,-14.0,6
4727,4727,2010-11,2010,2011,Chelsea,Blackburn,Win,Home,2011-01-15,3,1,4,4,5,3,6,6,7,-2,-2,-2,-2,1,1.0,10.0,-9.0,6
4728,4728,2010-11,2010,2011,Chelsea,Bolton,Win,Away,2011-01-24,3,3,4,7,7,1,1,1,4,2,3,6,3,0,1.0,14.0,-13.0,6
4729,4729,2010-11,2010,2011,Chelsea,Sunderland,Win,Away,2011-02-01,3,6,6,7,10,4,7,10,10,2,-1,-3,0,0,1.0,13.0,-12.0,7
4730,4730,2010-11,2010,2011,Chelsea,Liverpool,Loss,Home,2011-02-06,0,6,9,9,10,6,9,10,10,0,0,-1,0,1,1.0,7.0,-6.0,7
4731,4731,2010-11,2010,2011,Chelsea,Fulham,Draw,Away,2011-02-14,1,3,6,9,9,4,4,7,8,-1,2,2,1,0,1.0,12.0,-11.0,7
4732,4732,2010-11,2010,2011,Chelsea,Man United,Win,Home,2011-03-01,3,1,4,7,10,6,6,9,12,-5,-2,-2,-2,1,1.0,2.0,-1.0,8
4733,4733,2010-11,2010,2011,Chelsea,Blackpool,Win,Away,2011-03-07,3,4,4,7,10,3,4,4,4,1,0,3,6,0,1.0,21.0,-20.0,8
4734,4734,2010-11,2010,2011,Chelsea,Man City,Win,Home,2011-03-20,3,6,7,7,10,4,4,7,8,2,3,0,2,1,1.0,5.0,-4.0,8
4735,4735,2010-11,2010,2011,Chelsea,Stoke,Draw,Away,2011-04-02,1,6,9,10,10,3,4,4,4,3,5,6,6,0,1.0,11.0,-10.0,9
4736,4736,2010-11,2010,2011,Chelsea,Wigan,Win,Home,2011-04-09,3,4,7,10,11,4,4,4,5,0,3,6,6,1,1.0,16.0,-15.0,9
4737,4737,2010-11,2010,2011,Chelsea,West Brom,Win,Away,2011-04-16,3,4,7,10,13,6,7,10,11,-2,0,0,2,0,1.0,21.0,-20.0,9
4738,4738,2010-11,2010,2011,Chelsea,Birmingham,Win,Home,2011-04-20,3,6,7,10,13,4,7,7,8,2,0,3,5,1,1.0,9.0,-8.0,9
4739,4739,2010-11,2010,2011,Chelsea,West Ham,Win,Home,2011-04-23,3,6,9,10,13,0,0,1,4,6,9,9,9,1,1.0,17.0,-16.0,9
4740,4740,2010-11,2010,2011,Chelsea,Tottenham,Win,Home,2011-04-30,3,6,9,12,13,2,5,6,7,4,4,6,6,1,1.0,4.0,-3.0,9
4741,4741,2010-11,2010,2011,Chelsea,Man United,Loss,Away,2011-05-08,0,6,9,12,15,3,4,7,10,3,5,5,5,0,1.0,2.0,-1.0,10
4742,4742,2010-11,2010,2011,Chelsea,Newcastle,Draw,Home,2011-05-15,1,3,6,9,12,3,4,5,5,0,2,4,7,1,1.0,21.0,-20.0,10
4743,4743,2010-11,2010,2011,Chelsea,Everton,Loss,Away,2011-05-22,0,1,4,7,10,3,4,4,7,-2,0,3,3,0,1.0,8.0,-7.0,10
4744,4744,2011-12,2011,2012,Chelsea,Stoke,Draw,Away,2011-08-14,1,1,1,4,7,0,3,4,7,1,-2,0,0,0,2.0,13.0,-11.0,1
4745,4745,2011-12,2011,2012,Chelsea,West Brom,Win,Home,2011-08-20,3,1,2,2,5,1,4,4,7,0,-2,-2,-2,1,2.0,11.0,-9.0,1
4746,4746,2011-12,2011,2012,Chelsea,Norwich,Win,Home,2011-08-27,3,4,4,5,5,2,2,5,5,2,2,0,0,1,2.0,21.0,-19.0,1
4747,4747,2011-12,2011,2012,Chelsea,Sunderland,Win,Away,2011-09-10,3,6,7,7,8,1,2,5,5,5,5,2,3,0,2.0,10.0,-8.0,2
4748,4748,2011-12,2011,2012,Chelsea,Man United,Loss,Away,2011-09-18,0,6,9,10,10,6,9,12,15,0,0,-2,-5,0,2.0,1.0,1.0,2
4749,4749,2011-12,2011,2012,Chelsea,Swansea,Win,Home,2011-09-24,3,3,6,9,10,3,4,5,5,0,2,4,5,1,2.0,21.0,-19.0,2
4750,4750,2011-12,2011,2012,Chelsea,Bolton,Win,Away,2011-10-02,3,3,6,9,12,0,0,0,0,3,6,9,12,0,2.0,14.0,-12.0,3
4751,4751,2011-12,2011,2012,Chelsea,Everton,Win,Home,2011-10-15,3,6,6,9,12,0,3,4,7,6,3,5,5,1,2.0,7.0,-5.0,3
4752,4752,2011-12,2011,2012,Chelsea,QPR,Loss,Away,2011-10-23,0,6,9,9,12,1,2,5,6,5,7,4,6,0,2.0,21.0,-19.0,3
4753,4753,2011-12,2011,2012,Chelsea,Arsenal,Loss,Home,2011-10-29,0,3,6,9,9,6,6,9,9,-3,0,0,0,1,2.0,4.0,-2.0,3
4754,4754,2011-12,2011,2012,Chelsea,Blackburn,Win,Away,2011-11-05,3,0,3,6,9,1,2,2,2,-1,1,4,7,0,2.0,15.0,-13.0,4
4755,4755,2011-12,2011,2012,Chelsea,Liverpool,Loss,Home,2011-11-20,0,3,3,6,9,4,5,6,9,-1,-2,0,0,1,2.0,6.0,-4.0,4
4756,4756,2011-12,2011,2012,Chelsea,Wolves,Win,Home,2011-11-26,3,3,3,3,6,3,3,4,4,0,0,-1,2,1,2.0,17.0,-15.0,4
4757,4757,2011-12,2011,2012,Chelsea,Newcastle,Win,Away,2011-12-03,3,3,6,6,6,1,4,7,10,2,2,-1,-4,0,2.0,12.0,-10.0,5
4758,4758,2011-12,2011,2012,Chelsea,Man City,Win,Home,2011-12-12,3,6,6,9,9,4,7,10,13,2,-1,-1,-4,1,2.0,3.0,-1.0,5
4759,4759,2011-12,2011,2012,Chelsea,Wigan,Draw,Away,2011-12-17,1,6,9,9,12,3,6,7,7,3,3,2,5,0,2.0,16.0,-14.0,5
4760,4760,2011-12,2011,2012,Chelsea,Tottenham,Draw,Away,2011-12-22,1,4,7,10,10,3,6,9,12,1,1,1,-2,0,2.0,5.0,-3.0,5
4761,4761,2011-12,2011,2012,Chelsea,Fulham,Draw,Home,2011-12-26,1,2,5,8,11,3,3,6,7,-1,2,2,4,1,2.0,8.0,-6.0,5
4762,4762,2011-12,2011,2012,Chelsea,Aston Villa,Loss,Home,2011-12-31,0,2,3,6,9,1,1,4,4,1,2,2,5,1,2.0,9.0,-7.0,5
4763,4763,2011-12,2011,2012,Chelsea,Wolves,Win,Away,2012-01-02,3,1,2,3,6,2,3,3,3,-1,-1,0,3,0,2.0,17.0,-15.0,6
4764,4764,2011-12,2011,2012,Chelsea,Sunderland,Win,Home,2012-01-14,3,3,4,5,6,6,7,10,10,-3,-3,-5,-4,1,2.0,10.0,-8.0,6
4765,4765,2011-12,2011,2012,Chelsea,Norwich,Draw,Away,2012-01-21,1,6,6,7,8,6,7,7,8,0,-1,0,0,0,2.0,21.0,-19.0,6
4766,4766,2011-12,2011,2012,Chelsea,Swansea,Draw,Away,2012-01-31,1,4,7,7,8,3,6,7,8,1,1,0,0,0,2.0,21.0,-19.0,6
4767,4767,2011-12,2011,2012,Chelsea,Man United,Draw,Home,2012-02-05,1,2,5,8,8,6,9,9,9,-4,-4,-1,-1,1,2.0,1.0,1.0,7
4768,4768,2011-12,2011,2012,Chelsea,Everton,Loss,Away,2012-02-11,0,2,3,6,9,4,5,6,6,-2,-2,0,3,0,2.0,7.0,-5.0,7
4769,4769,2011-12,2011,2012,Chelsea,Bolton,Win,Home,2012-02-25,3,1,2,3,6,0,1,4,4,1,1,-1,2,1,2.0,14.0,-12.0,7
4770,4770,2011-12,2011,2012,Chelsea,West Brom,Loss,Away,2012-03-03,0,3,4,5,6,6,6,7,10,-3,-2,-2,-4,0,2.0,11.0,-9.0,8
4771,4771,2011-12,2011,2012,Chelsea,Stoke,Win,Home,2012-03-10,3,3,3,4,5,6,6,6,6,-3,-3,-2,-1,1,2.0,13.0,-11.0,8
4772,4772,2011-12,2011,2012,Chelsea,Man City,Loss,Away,2012-03-21,0,3,6,6,7,3,6,9,12,0,0,-3,-5,0,2.0,3.0,-1.0,8
4773,4773,2011-12,2011,2012,Chelsea,Tottenham,Draw,Home,2012-03-24,1,3,3,6,6,1,1,1,4,2,2,5,2,1,2.0,5.0,-3.0,8
4774,4774,2011-12,2011,2012,Chelsea,Aston Villa,Win,Away,2012-03-31,3,1,4,4,7,3,4,5,5,-2,0,-1,2,0,2.0,9.0,-7.0,8
4775,4775,2011-12,2011,2012,Chelsea,Wigan,Win,Home,2012-04-07,3,4,4,7,7,6,7,8,8,-2,-3,-1,-1,1,2.0,16.0,-14.0,9
4776,4776,2011-12,2011,2012,Chelsea,Fulham,Draw,Away,2012-04-09,1,6,7,7,10,6,6,6,6,0,1,1,4,0,2.0,8.0,-6.0,9
4777,4777,2011-12,2011,2012,Chelsea,Arsenal,Draw,Away,2012-04-21,1,4,7,8,8,3,6,6,9,1,1,2,-1,0,2.0,4.0,-2.0,9
4778,4778,2011-12,2011,2012,Chelsea,QPR,Win,Home,2012-04-29,3,2,5,8,9,3,6,6,9,-1,-1,2,0,1,2.0,21.0,-19.0,9
4779,4779,2011-12,2011,2012,Chelsea,Newcastle,Loss,Home,2012-05-02,0,4,5,8,11,3,6,9,12,1,-1,-1,-1,1,2.0,12.0,-10.0,10
4780,4780,2011-12,2011,2012,Chelsea,Liverpool,Loss,Away,2012-05-08,0,3,4,5,8,3,3,6,7,0,1,-1,1,0,2.0,6.0,-4.0,10
4781,4781,2011-12,2011,2012,Chelsea,Blackburn,Win,Home,2012-05-13,3,0,3,4,5,0,3,3,3,0,0,1,2,1,2.0,15.0,-13.0,10
4782,4782,2012-13,2012,2013,Chelsea,Wigan,Win,Away,2012-08-19,3,3,3,6,7,6,9,9,12,-3,-6,-3,-5,0,6.0,15.0,-9.0,1
4783,4783,2012-13,2012,2013,Chelsea,Reading,Win,Home,2012-08-22,3,6,6,6,9,4,4,5,5,2,2,1,4,1,6.0,21.0,-15.0,1
4784,4784,2012-13,2012,2013,Chelsea,Newcastle,Win,Home,2012-08-25,3,6,9,9,9,3,3,6,6,3,6,3,3,1,6.0,5.0,1.0,1
4785,4785,2012-13,2012,2013,Chelsea,QPR,Draw,Away,2012-09-15,1,6,9,12,12,1,1,1,4,5,8,11,8,0,6.0,17.0,-11.0,2
4786,4786,2012-13,2012,2013,Chelsea,Stoke,Win,Home,2012-09-22,3,4,7,10,13,2,3,4,5,2,4,6,8,1,6.0,14.0,-8.0,2
4787,4787,2012-13,2012,2013,Chelsea,Arsenal,Win,Away,2012-09-29,3,4,7,10,13,4,7,8,9,0,0,2,4,0,6.0,3.0,3.0,2
4788,4788,2012-13,2012,2013,Chelsea,Norwich,Win,Home,2012-10-06,3,6,7,10,13,0,1,2,3,6,6,8,10,1,6.0,12.0,-6.0,3
4789,4789,2012-13,2012,2013,Chelsea,Tottenham,Win,Away,2012-10-20,3,6,9,10,13,6,9,12,13,0,0,-2,0,0,6.0,4.0,2.0,3
4790,4790,2012-13,2012,2013,Chelsea,Man United,Loss,Home,2012-10-28,0,6,9,12,13,6,6,9,12,0,3,3,1,1,6.0,2.0,4.0,3
4791,4791,2012-13,2012,2013,Chelsea,Swansea,Draw,Away,2012-11-03,1,3,6,9,12,3,4,4,4,0,2,5,8,0,6.0,11.0,-5.0,4
4792,4792,2012-13,2012,2013,Chelsea,Liverpool,Draw,Home,2012-11-11,1,1,4,7,10,2,5,6,9,-1,-1,1,1,1,6.0,8.0,-2.0,4
4793,4793,2012-13,2012,2013,Chelsea,West Brom,Loss,Away,2012-11-17,0,2,2,5,8,6,6,6,9,-4,-4,-1,-1,0,6.0,10.0,-4.0,4
4794,4794,2012-13,2012,2013,Chelsea,Man City,Draw,Home,2012-11-25,1,1,2,2,5,6,7,10,13,-5,-5,-8,-8,1,6.0,1.0,5.0,4
4795,4795,2012-13,2012,2013,Chelsea,Fulham,Draw,Home,2012-11-28,1,1,2,3,3,0,1,2,3,1,1,1,0,1,6.0,9.0,-3.0,4
4796,4796,2012-13,2012,2013,Chelsea,West Ham,Loss,Away,2012-12-01,0,2,2,3,4,0,1,4,5,2,1,-1,-1,0,6.0,21.0,-15.0,5
4797,4797,2012-13,2012,2013,Chelsea,Sunderland,Win,Away,2012-12-08,3,1,2,2,3,1,1,4,4,0,1,-2,-1,0,6.0,13.0,-7.0,5
4798,4798,2012-13,2012,2013,Chelsea,Aston Villa,Win,Home,2012-12-23,3,3,4,5,5,4,5,8,9,-1,-1,-3,-4,1,6.0,16.0,-10.0,5
4799,4799,2012-13,2012,2013,Chelsea,Norwich,Win,Away,2012-12-26,3,6,6,7,8,3,6,9,10,3,0,-2,-2,0,6.0,12.0,-6.0,5
4800,4800,2012-13,2012,2013,Chelsea,Everton,Win,Away,2012-12-30,3,6,9,9,10,6,7,10,11,0,2,-1,-1,0,6.0,7.0,-1.0,5
4801,4801,2012-13,2012,2013,Chelsea,QPR,Loss,Home,2013-01-02,0,6,9,12,12,0,0,3,4,6,9,9,8,1,6.0,17.0,-11.0,6
4802,4802,2012-13,2012,2013,Chelsea,Stoke,Win,Away,2013-01-12,3,3,6,9,12,1,4,5,6,2,2,4,6,0,6.0,14.0,-8.0,6
4803,4803,2012-13,2012,2013,Chelsea,Southampton,Draw,Home,2013-01-16,1,3,6,9,12,4,5,6,6,-1,1,3,6,1,6.0,21.0,-15.0,6
4804,4804,2012-13,2012,2013,Chelsea,Arsenal,Win,Home,2013-01-20,3,4,4,7,10,1,4,7,10,3,0,0,0,1,6.0,3.0,3.0,6
4805,4805,2012-13,2012,2013,Chelsea,Reading,Draw,Away,2013-01-30,1,4,7,7,10,6,6,9,10,-2,1,-2,0,0,6.0,21.0,-15.0,6
4806,4806,2012-13,2012,2013,Chelsea,Newcastle,Loss,Away,2013-02-02,0,4,5,8,8,3,4,4,4,1,1,4,4,0,6.0,5.0,1.0,7
4807,4807,2012-13,2012,2013,Chelsea,Wigan,Win,Home,2013-02-09,3,1,4,5,8,2,2,3,3,-1,2,2,5,1,6.0,15.0,-9.0,7
4808,4808,2012-13,2012,2013,Chelsea,Man City,Loss,Away,2013-02-24,0,3,4,7,8,1,2,5,8,2,2,2,0,0,6.0,1.0,5.0,7
4809,4809,2012-13,2012,2013,Chelsea,West Brom,Win,Home,2013-03-02,3,3,3,4,7,6,6,6,7,-3,-3,-2,0,1,6.0,10.0,-4.0,8
4810,4810,2012-13,2012,2013,Chelsea,West Ham,Win,Home,2013-03-17,3,3,6,6,7,3,3,6,6,0,3,0,1,1,6.0,21.0,-15.0,8
4811,4811,2012-13,2012,2013,Chelsea,Southampton,Loss,Away,2013-03-30,0,6,6,9,9,4,4,4,7,2,2,5,2,0,6.0,21.0,-15.0,8
4812,4812,2012-13,2012,2013,Chelsea,Sunderland,Win,Home,2013-04-07,3,3,6,6,9,1,1,2,2,2,5,4,7,1,6.0,13.0,-7.0,9
4813,4813,2012-13,2012,2013,Chelsea,Fulham,Win,Away,2013-04-17,3,3,6,9,9,1,4,7,8,2,2,2,1,0,6.0,9.0,-3.0,9
4814,4814,2012-13,2012,2013,Chelsea,Liverpool,Draw,Away,2013-04-21,1,6,6,9,12,2,5,5,8,4,1,4,4,0,6.0,8.0,-2.0,9
4815,4815,2012-13,2012,2013,Chelsea,Swansea,Win,Home,2013-04-28,3,4,7,7,10,2,2,2,2,2,5,5,8,1,6.0,11.0,-5.0,9
4816,4816,2012-13,2012,2013,Chelsea,Man United,Win,Away,2013-05-05,3,4,7,10,10,4,5,8,8,0,2,2,2,0,6.0,2.0,4.0,10
4817,4817,2012-13,2012,2013,Chelsea,Tottenham,Draw,Home,2013-05-08,1,6,7,10,13,4,7,8,11,2,0,2,2,1,6.0,4.0,2.0,10
4818,4818,2012-13,2012,2013,Chelsea,Aston Villa,Win,Away,2013-05-11,3,4,7,8,11,6,6,7,10,-2,1,1,1,0,6.0,16.0,-10.0,10
4819,4819,2012-13,2012,2013,Chelsea,Everton,Win,Home,2013-05-19,3,4,7,10,11,4,7,7,8,0,0,3,3,1,6.0,7.0,-1.0,10
4820,4820,2013-14,2013,2014,Chelsea,Hull,Win,Home,2013-08-18,3,6,7,10,13,2,2,2,3,4,5,8,10,1,3.0,21.0,-18.0,1
4821,4821,2013-14,2013,2014,Chelsea,Aston Villa,Win,Home,2013-08-21,3,6,9,10,13,4,4,7,10,2,5,3,3,1,3.0,15.0,-12.0,1
4822,4822,2013-14,2013,2014,Chelsea,Man United,Draw,Away,2013-08-26,1,6,9,12,13,4,7,7,8,2,2,5,5,0,3.0,1.0,2.0,1
4823,4823,2013-14,2013,2014,Chelsea,Everton,Loss,Away,2013-09-14,0,4,7,10,13,2,3,3,6,2,4,7,7,0,3.0,6.0,-3.0,2
4824,4824,2013-14,2013,2014,Chelsea,Fulham,Win,Home,2013-09-21,3,1,4,7,10,1,1,4,7,0,3,3,3,1,3.0,12.0,-9.0,2
4825,4825,2013-14,2013,2014,Chelsea,Tottenham,Draw,Away,2013-09-28,1,3,4,7,10,6,6,9,12,-3,-2,-2,-2,0,3.0,5.0,-2.0,2
4826,4826,2013-14,2013,2014,Chelsea,Norwich,Win,Away,2013-10-06,3,4,4,5,8,3,3,6,6,1,1,-1,2,0,3.0,11.0,-8.0,3
4827,4827,2013-14,2013,2014,Chelsea,Cardiff,Win,Home,2013-10-19,3,4,7,7,8,3,3,4,5,1,4,3,3,1,3.0,21.0,-18.0,3
4828,4828,2013-14,2013,2014,Chelsea,Man City,Win,Home,2013-10-27,3,6,7,10,10,6,6,9,10,0,1,1,0,1,3.0,2.0,1.0,3
4829,4829,2013-14,2013,2014,Chelsea,Newcastle,Loss,Away,2013-11-02,0,6,9,10,13,1,4,4,4,5,5,6,9,0,3.0,16.0,-13.0,4
4830,4830,2013-14,2013,2014,Chelsea,West Brom,Draw,Home,2013-11-09,1,3,6,9,10,3,4,5,8,0,2,4,2,1,3.0,8.0,-5.0,4
4831,4831,2013-14,2013,2014,Chelsea,West Ham,Win,Away,2013-11-23,3,1,4,7,10,1,2,2,5,0,2,5,5,0,3.0,10.0,-7.0,4
4832,4832,2013-14,2013,2014,Chelsea,Southampton,Win,Home,2013-12-01,3,4,4,7,10,3,4,7,8,1,0,0,2,1,3.0,14.0,-11.0,5
4833,4833,2013-14,2013,2014,Chelsea,Sunderland,Win,Away,2013-12-04,3,6,7,7,10,1,4,4,7,5,3,3,3,0,3.0,17.0,-14.0,5
4834,4834,2013-14,2013,2014,Chelsea,Stoke,Loss,Away,2013-12-07,0,6,9,10,10,1,4,5,6,5,5,5,4,0,3.0,13.0,-10.0,5
4835,4835,2013-14,2013,2014,Chelsea,Crystal Palace,Win,Home,2013-12-14,3,3,6,9,10,6,6,9,10,-3,0,0,0,1,3.0,21.0,-18.0,5
4836,4836,2013-14,2013,2014,Chelsea,Arsenal,Draw,Away,2013-12-23,1,3,6,9,12,1,4,7,10,2,2,2,2,0,3.0,4.0,-1.0,5
4837,4837,2013-14,2013,2014,Chelsea,Swansea,Win,Home,2013-12-26,3,4,4,7,10,1,2,5,5,3,2,2,5,1,3.0,9.0,-6.0,5
4838,4838,2013-14,2013,2014,Chelsea,Liverpool,Win,Home,2013-12-29,3,4,7,7,10,3,6,9,12,1,1,-2,-2,1,3.0,7.0,-4.0,5
4839,4839,2013-14,2013,2014,Chelsea,Southampton,Win,Away,2014-01-01,3,6,7,10,10,3,3,4,5,3,4,6,5,0,3.0,14.0,-11.0,6
4840,4840,2013-14,2013,2014,Chelsea,Hull,Win,Away,2014-01-11,3,6,9,10,13,3,3,4,5,3,6,6,8,0,3.0,21.0,-18.0,6
4841,4841,2013-14,2013,2014,Chelsea,Man United,Win,Home,2014-01-19,3,6,9,12,13,3,6,9,12,3,3,3,1,1,3.0,1.0,2.0,6
4842,4842,2013-14,2013,2014,Chelsea,West Ham,Draw,Home,2014-01-29,1,6,9,12,15,3,3,4,4,3,6,8,11,1,3.0,10.0,-7.0,6
4843,4843,2013-14,2013,2014,Chelsea,Man City,Win,Away,2014-02-03,3,4,7,10,13,6,9,12,15,-2,-2,-2,-2,0,3.0,2.0,1.0,7
4844,4844,2013-14,2013,2014,Chelsea,Newcastle,Win,Home,2014-02-08,3,4,7,10,13,1,4,4,4,3,3,6,9,1,3.0,16.0,-13.0,7
4845,4845,2013-14,2013,2014,Chelsea,West Brom,Draw,Away,2014-02-11,1,6,7,10,13,1,1,2,2,5,6,8,11,0,3.0,8.0,-5.0,7
4846,4846,2013-14,2013,2014,Chelsea,Everton,Win,Home,2014-02-22,3,4,7,8,11,3,3,4,7,1,4,4,4,1,3.0,6.0,-3.0,7
4847,4847,2013-14,2013,2014,Chelsea,Fulham,Win,Away,2014-03-01,3,4,7,10,11,1,2,2,2,3,5,8,9,0,3.0,12.0,-9.0,8
4848,4848,2013-14,2013,2014,Chelsea,Tottenham,Win,Home,2014-03-08,3,6,7,10,13,3,6,9,10,3,1,1,3,1,3.0,5.0,-2.0,8
4849,4849,2013-14,2013,2014,Chelsea,Aston Villa,Loss,Away,2014-03-15,0,6,9,10,13,3,4,4,4,3,5,6,9,0,3.0,15.0,-12.0,8
4850,4850,2013-14,2013,2014,Chelsea,Arsenal,Win,Home,2014-03-22,3,3,6,9,10,3,6,7,7,0,0,2,3,1,3.0,4.0,-1.0,8
4851,4851,2013-14,2013,2014,Chelsea,Crystal Palace,Loss,Away,2014-03-29,0,3,6,9,12,1,1,2,2,2,5,7,10,0,3.0,21.0,-18.0,8
4852,4852,2013-14,2013,2014,Chelsea,Stoke,Win,Home,2014-04-05,3,3,3,6,9,6,9,10,13,-3,-6,-4,-4,1,3.0,13.0,-10.0,9
4853,4853,2013-14,2013,2014,Chelsea,Swansea,Win,Away,2014-04-13,3,3,6,6,9,3,4,4,4,0,2,2,5,0,3.0,9.0,-6.0,9
4854,4854,2013-14,2013,2014,Chelsea,Sunderland,Loss,Home,2014-04-19,0,6,6,9,9,1,1,1,1,5,5,8,8,1,3.0,17.0,-14.0,9
4855,4855,2013-14,2013,2014,Chelsea,Liverpool,Win,Away,2014-04-27,3,3,6,6,9,6,9,12,15,-3,-3,-6,-6,0,3.0,7.0,-4.0,9
4856,4856,2013-14,2013,2014,Chelsea,Norwich,Draw,Home,2014-05-04,1,3,6,9,9,0,0,0,0,3,6,9,9,1,3.0,11.0,-8.0,10
4857,4857,2013-14,2013,2014,Chelsea,Cardiff,Win,Away,2014-05-11,3,4,4,7,10,0,1,4,4,4,3,3,6,0,3.0,21.0,-18.0,10
4858,4858,2014-15,2014,2015,Chelsea,Burnley,Win,Away,2014-08-18,3,4,7,7,10,3,3,3,6,1,4,4,4,0,3.0,21.0,-18.0,1
4859,4859,2014-15,2014,2015,Chelsea,Leicester,Win,Home,2014-08-23,3,6,7,10,10,1,4,5,6,5,3,5,4,1,3.0,21.0,-18.0,1
4860,4860,2014-15,2014,2015,Chelsea,Everton,Win,Away,2014-08-30,3,6,9,10,13,2,5,5,5,4,4,5,8,0,3.0,5.0,-2.0,1
4861,4861,2014-15,2014,2015,Chelsea,Swansea,Win,Home,2014-09-13,3,6,9,12,13,6,9,12,12,0,0,0,1,1,3.0,12.0,-9.0,2
4862,4862,2014-15,2014,2015,Chelsea,Man City,Draw,Away,2014-09-21,1,6,9,12,15,1,4,7,10,5,5,5,5,0,3.0,1.0,2.0,2
4863,4863,2014-15,2014,2015,Chelsea,Aston Villa,Win,Home,2014-09-27,3,4,7,10,13,3,6,7,10,1,1,3,3,1,3.0,15.0,-12.0,2
4864,4864,2014-15,2014,2015,Chelsea,Arsenal,Win,Home,2014-10-05,3,4,7,10,13,4,5,6,7,0,2,4,6,1,3.0,4.0,-1.0,3
4865,4865,2014-15,2014,2015,Chelsea,Crystal Palace,Win,Away,2014-10-18,3,6,7,10,13,3,6,7,8,3,1,3,5,0,3.0,11.0,-8.0,3
4866,4866,2014-15,2014,2015,Chelsea,Man United,Draw,Away,2014-10-26,1,6,9,10,13,4,7,7,10,2,2,3,3,0,3.0,7.0,-4.0,3
4867,4867,2014-15,2014,2015,Chelsea,QPR,Win,Home,2014-11-01,3,4,7,10,11,3,3,3,4,1,4,7,7,1,3.0,21.0,-18.0,4
4868,4868,2014-15,2014,2015,Chelsea,Liverpool,Win,Away,2014-11-08,3,4,7,10,13,1,4,7,8,3,3,3,5,0,3.0,2.0,1.0,4
4869,4869,2014-15,2014,2015,Chelsea,West Brom,Win,Home,2014-11-22,3,6,7,10,13,3,4,5,5,3,3,5,8,1,3.0,17.0,-14.0,4
4870,4870,2014-15,2014,2015,Chelsea,Sunderland,Draw,Away,2014-11-29,1,6,9,10,13,2,5,5,5,4,4,5,8,0,3.0,14.0,-11.0,4
4871,4871,2014-15,2014,2015,Chelsea,Tottenham,Win,Home,2014-12-03,3,4,7,10,11,6,6,9,9,-2,1,1,2,1,3.0,6.0,-3.0,5
4872,4872,2014-15,2014,2015,Chelsea,Newcastle,Loss,Away,2014-12-06,0,4,7,10,13,1,4,7,10,3,3,3,3,0,3.0,10.0,-7.0,5
4873,4873,2014-15,2014,2015,Chelsea,Hull,Win,Home,2014-12-13,3,3,4,7,10,2,2,2,2,1,2,5,8,1,3.0,16.0,-13.0,5
4874,4874,2014-15,2014,2015,Chelsea,Stoke,Win,Away,2014-12-22,3,3,6,7,10,4,4,4,4,-1,2,3,6,0,3.0,9.0,-6.0,5
4875,4875,2014-15,2014,2015,Chelsea,West Ham,Win,Home,2014-12-26,3,6,6,9,10,4,7,10,13,2,-1,-1,-3,1,3.0,13.0,-10.0,5
4876,4876,2014-15,2014,2015,Chelsea,Southampton,Draw,Away,2014-12-28,1,6,9,9,12,6,6,6,6,0,3,3,6,0,3.0,8.0,-5.0,5
4877,4877,2014-15,2014,2015,Chelsea,Tottenham,Loss,Away,2015-01-01,0,4,7,10,10,4,7,10,11,0,0,0,-1,0,3.0,6.0,-3.0,6
4878,4878,2014-15,2014,2015,Chelsea,Newcastle,Win,Home,2015-01-10,3,1,4,7,10,4,4,4,4,-3,0,3,6,1,3.0,10.0,-7.0,6
4879,4879,2014-15,2014,2015,Chelsea,Swansea,Win,Away,2015-01-17,3,3,4,7,10,2,2,5,8,1,2,2,2,0,3.0,12.0,-9.0,6
4880,4880,2014-15,2014,2015,Chelsea,Man City,Draw,Home,2015-01-31,1,6,6,7,10,1,4,5,8,5,2,2,2,1,3.0,1.0,2.0,6
4881,4881,2014-15,2014,2015,Chelsea,Aston Villa,Win,Away,2015-02-07,3,4,7,7,8,0,0,1,2,4,7,6,6,0,3.0,15.0,-12.0,7
4882,4882,2014-15,2014,2015,Chelsea,Everton,Win,Home,2015-02-11,3,4,7,10,10,4,5,6,6,0,2,4,4,1,3.0,5.0,-2.0,7
4883,4883,2014-15,2014,2015,Chelsea,Burnley,Draw,Home,2015-02-21,1,6,7,10,13,1,1,1,4,5,6,9,9,1,3.0,21.0,-18.0,7
4884,4884,2014-15,2014,2015,Chelsea,West Ham,Win,Away,2015-03-04,3,4,7,8,11,1,2,3,3,3,5,5,8,0,3.0,13.0,-10.0,8
4885,4885,2014-15,2014,2015,Chelsea,Southampton,Draw,Home,2015-03-15,1,4,7,10,11,3,3,4,7,1,4,6,4,1,3.0,8.0,-5.0,8
4886,4886,2014-15,2014,2015,Chelsea,Hull,Win,Away,2015-03-22,3,4,5,8,11,2,2,5,8,2,3,3,3,0,3.0,16.0,-13.0,8
4887,4887,2014-15,2014,2015,Chelsea,Stoke,Win,Home,2015-04-04,3,4,7,8,11,0,3,6,9,4,4,2,2,1,3.0,9.0,-6.0,9
4888,4888,2014-15,2014,2015,Chelsea,QPR,Win,Away,2015-04-12,3,6,7,10,11,4,4,4,4,2,3,6,7,0,3.0,21.0,-18.0,9
4889,4889,2014-15,2014,2015,Chelsea,Man United,Win,Home,2015-04-18,3,6,9,10,13,6,9,12,15,0,0,-2,-2,1,3.0,7.0,-4.0,9
4890,4890,2014-15,2014,2015,Chelsea,Arsenal,Draw,Away,2015-04-26,1,6,9,12,13,6,9,12,15,0,0,0,-2,0,3.0,4.0,-1.0,9
4891,4891,2014-15,2014,2015,Chelsea,Leicester,Win,Away,2015-04-29,3,4,7,10,13,6,9,12,12,-2,-2,-2,1,0,3.0,21.0,-18.0,9
4892,4892,2014-15,2014,2015,Chelsea,Crystal Palace,Win,Home,2015-05-03,3,4,7,10,13,0,3,6,9,4,4,4,4,1,3.0,11.0,-8.0,10
4893,4893,2014-15,2014,2015,Chelsea,Liverpool,Draw,Home,2015-05-10,1,6,7,10,13,3,4,7,7,3,3,3,6,1,3.0,2.0,1.0,10
4894,4894,2014-15,2014,2015,Chelsea,West Brom,Loss,Away,2015-05-18,0,4,7,8,11,4,5,8,8,0,2,0,3,0,3.0,17.0,-14.0,10
4895,4895,2014-15,2014,2015,Chelsea,Sunderland,Win,Home,2015-05-24,3,1,4,7,8,2,5,8,9,-1,-1,-1,-1,1,3.0,14.0,-11.0,10
4896,4896,2015-16,2015,2016,Chelsea,Swansea,Draw,Home,2015-08-08,1,3,4,7,10,0,3,6,9,3,1,1,1,1,1.0,8.0,-7.0,1
4897,4897,2015-16,2015,2016,Chelsea,Man City,Loss,Away,2015-08-16,0,4,4,5,8,6,9,12,15,-2,-5,-7,-7,0,1.0,2.0,-1.0,1
4898,4898,2015-16,2015,2016,Chelsea,West Brom,Win,Away,2015-08-23,3,1,4,4,5,1,1,4,5,0,3,0,0,0,1.0,13.0,-12.0,1
4899,4899,2015-16,2015,2016,Chelsea,Crystal Palace,Loss,Home,2015-08-29,0,3,4,7,7,3,6,9,12,0,-2,-2,-5,1,1.0,10.0,-9.0,1
4900,4900,2015-16,2015,2016,Chelsea,Everton,Loss,Away,2015-09-12,0,3,3,4,7,1,4,5,5,2,-1,-1,2,0,1.0,11.0,-10.0,2
4901,4901,2015-16,2015,2016,Chelsea,Arsenal,Win,Home,2015-09-19,3,0,3,3,4,6,7,10,10,-6,-4,-7,-6,1,1.0,3.0,-2.0,2
4902,4902,2015-16,2015,2016,Chelsea,Newcastle,Draw,Away,2015-09-26,1,3,3,6,6,0,0,1,1,3,3,5,5,0,1.0,15.0,-14.0,2
4903,4903,2015-16,2015,2016,Chelsea,Southampton,Loss,Home,2015-10-03,0,4,4,4,7,3,4,7,8,1,0,-3,-1,1,1.0,7.0,-6.0,3
4904,4904,2015-16,2015,2016,Chelsea,Aston Villa,Win,Home,2015-10-17,3,1,4,4,4,0,0,0,1,1,4,4,3,1,1.0,17.0,-16.0,3
4905,4905,2015-16,2015,2016,Chelsea,West Ham,Loss,Away,2015-10-24,0,3,4,7,7,4,5,8,11,-1,-1,-1,-4,0,1.0,12.0,-11.0,3
4906,4906,2015-16,2015,2016,Chelsea,Liverpool,Loss,Home,2015-10-31,0,3,3,4,7,2,3,6,7,1,0,-2,0,1,1.0,6.0,-5.0,3
4907,4907,2015-16,2015,2016,Chelsea,Stoke,Loss,Away,2015-11-07,0,0,3,3,4,1,4,7,10,-1,-1,-4,-6,0,1.0,9.0,-8.0,4
4908,4908,2015-16,2015,2016,Chelsea,Norwich,Win,Home,2015-11-21,3,0,0,3,3,3,3,3,3,-3,-3,0,0,1,1.0,21.0,-20.0,4
4909,4909,2015-16,2015,2016,Chelsea,Tottenham,Draw,Away,2015-11-29,1,3,3,3,6,4,7,10,11,-1,-4,-7,-5,0,1.0,5.0,-4.0,4
4910,4910,2015-16,2015,2016,Chelsea,Bournemouth,Loss,Home,2015-12-05,0,4,4,4,4,2,2,2,2,2,2,2,2,1,1.0,21.0,-20.0,5
4911,4911,2015-16,2015,2016,Chelsea,Leicester,Loss,Away,2015-12-14,0,1,4,4,4,4,7,10,13,-3,-3,-6,-9,0,1.0,14.0,-13.0,5
4912,4912,2015-16,2015,2016,Chelsea,Sunderland,Win,Home,2015-12-19,3,0,1,4,4,0,3,6,6,0,-2,-2,-2,1,1.0,16.0,-15.0,5
4913,4913,2015-16,2015,2016,Chelsea,Watford,Draw,Home,2015-12-26,1,3,3,4,7,6,9,12,12,-3,-6,-8,-5,1,1.0,21.0,-20.0,5
4914,4914,2015-16,2015,2016,Chelsea,Man United,Draw,Away,2015-12-28,1,4,4,4,5,0,0,1,2,4,4,3,3,0,1.0,4.0,-3.0,5
4915,4915,2015-16,2015,2016,Chelsea,Crystal Palace,Win,Away,2016-01-03,3,2,5,5,5,2,5,8,9,0,0,-3,-4,0,1.0,10.0,-9.0,6
4916,4916,2015-16,2015,2016,Chelsea,West Brom,Draw,Home,2016-01-13,1,4,5,8,8,6,6,6,7,-2,-1,2,1,1,1.0,13.0,-12.0,6
4917,4917,2015-16,2015,2016,Chelsea,Everton,Draw,Home,2016-01-16,1,4,5,6,9,2,2,5,5,2,3,1,4,1,1.0,11.0,-10.0,6
4918,4918,2015-16,2015,2016,Chelsea,Arsenal,Win,Away,2016-01-24,3,2,5,6,7,2,5,8,8,0,0,-2,-1,0,1.0,3.0,-2.0,6
4919,4919,2015-16,2015,2016,Chelsea,Watford,Draw,Away,2016-02-03,1,4,5,8,9,3,3,3,3,1,2,5,6,0,1.0,21.0,-20.0,7
4920,4920,2015-16,2015,2016,Chelsea,Man United,Draw,Home,2016-02-07,1,4,5,6,9,3,6,7,10,1,-1,-1,-1,1,1.0,4.0,-3.0,7
4921,4921,2015-16,2015,2016,Chelsea,Newcastle,Win,Home,2016-02-13,3,2,5,6,7,3,3,6,7,-1,2,0,0,1,1.0,15.0,-14.0,7
4922,4922,2015-16,2015,2016,Chelsea,Southampton,Win,Away,2016-02-27,3,4,5,8,9,6,7,10,13,-2,-2,-2,-4,0,1.0,7.0,-6.0,7
4923,4923,2015-16,2015,2016,Chelsea,Norwich,Win,Away,2016-03-01,3,6,7,8,11,1,1,1,1,5,6,7,10,0,1.0,21.0,-20.0,8
4924,4924,2015-16,2015,2016,Chelsea,Stoke,Draw,Home,2016-03-05,1,6,9,10,11,6,9,9,9,0,0,1,2,1,1.0,9.0,-8.0,8
4925,4925,2015-16,2015,2016,Chelsea,West Ham,Draw,Home,2016-03-19,1,4,7,10,11,6,9,10,10,-2,-2,0,1,1,1.0,12.0,-11.0,8
4926,4926,2015-16,2015,2016,Chelsea,Aston Villa,Win,Away,2016-04-02,3,2,5,8,11,0,0,0,0,2,5,8,11,0,1.0,17.0,-16.0,9
4927,4927,2015-16,2015,2016,Chelsea,Swansea,Loss,Away,2016-04-09,0,4,5,8,11,4,4,7,10,0,1,1,1,0,1.0,8.0,-7.0,9
4928,4928,2015-16,2015,2016,Chelsea,Man City,Loss,Home,2016-04-16,0,3,4,5,8,6,6,7,10,-3,-2,-2,-2,1,1.0,2.0,-1.0,9
4929,4929,2015-16,2015,2016,Chelsea,Bournemouth,Win,Away,2016-04-23,3,0,3,4,5,3,3,3,6,-3,0,1,-1,0,1.0,21.0,-20.0,9
4930,4930,2015-16,2015,2016,Chelsea,Tottenham,Draw,Home,2016-05-02,1,3,3,6,7,4,7,8,11,-1,-4,-2,-4,1,1.0,5.0,-4.0,10
4931,4931,2015-16,2015,2016,Chelsea,Sunderland,Loss,Away,2016-05-07,0,4,4,4,7,2,5,5,6,2,-1,-1,1,0,1.0,16.0,-15.0,10
4932,4932,2015-16,2015,2016,Chelsea,Liverpool,Draw,Away,2016-05-11,1,1,4,4,4,3,4,7,10,-2,0,-3,-6,0,1.0,6.0,-5.0,10
4933,4933,2015-16,2015,2016,Chelsea,Leicester,Draw,Home,2016-05-15,1,1,2,5,5,4,7,8,11,-3,-5,-3,-6,1,1.0,14.0,-13.0,10
4934,4934,2016-17,2016,2017,Chelsea,West Ham,Win,Home,2016-08-15,3,2,2,3,6,3,3,6,9,-1,-1,-3,-3,1,10.0,7.0,3.0,1
4935,4935,2016-17,2016,2017,Chelsea,Watford,Win,Away,2016-08-20,3,4,5,5,6,2,2,2,5,2,3,3,1,0,10.0,13.0,-3.0,1
4936,4936,2016-17,2016,2017,Chelsea,Burnley,Win,Home,2016-08-27,3,6,7,8,8,3,6,7,10,3,1,1,-2,1,10.0,21.0,-11.0,1
4937,4937,2016-17,2016,2017,Chelsea,Swansea,Draw,Away,2016-09-11,1,6,9,10,11,0,3,4,7,6,6,6,4,0,10.0,12.0,-2.0,2
4938,4938,2016-17,2016,2017,Chelsea,Liverpool,Loss,Home,2016-09-16,0,4,7,10,11,4,4,7,8,0,3,3,3,1,10.0,8.0,2.0,2
4939,4939,2016-17,2016,2017,Chelsea,Arsenal,Loss,Away,2016-09-24,0,1,4,7,10,6,9,10,10,-5,-5,-3,0,0,10.0,2.0,8.0,2
4940,4940,2016-17,2016,2017,Chelsea,Hull,Win,Away,2016-10-01,3,0,1,4,7,0,1,1,4,0,0,3,3,0,10.0,21.0,-11.0,3
4941,4941,2016-17,2016,2017,Chelsea,Leicester,Win,Home,2016-10-15,3,3,3,4,7,1,4,4,7,2,-1,0,0,1,10.0,1.0,9.0,3
4942,4942,2016-17,2016,2017,Chelsea,Man United,Win,Home,2016-10-23,3,6,6,6,7,2,5,5,5,4,1,1,2,1,10.0,5.0,5.0,3
4943,4943,2016-17,2016,2017,Chelsea,Southampton,Win,Away,2016-10-30,3,6,9,9,9,4,5,8,11,2,4,1,-2,0,10.0,6.0,4.0,3
4944,4944,2016-17,2016,2017,Chelsea,Everton,Win,Home,2016-11-05,3,6,9,12,12,3,4,5,5,3,5,7,7,1,10.0,11.0,-1.0,4
4945,4945,2016-17,2016,2017,Chelsea,Middlesbrough,Win,Away,2016-11-20,3,6,9,12,15,4,5,5,6,2,4,7,9,0,10.0,21.0,-11.0,4
4946,4946,2016-17,2016,2017,Chelsea,Tottenham,Win,Home,2016-11-26,3,6,9,12,15,4,5,6,7,2,4,6,8,1,10.0,3.0,7.0,4
4947,4947,2016-17,2016,2017,Chelsea,Man City,Win,Away,2016-12-03,3,6,9,12,15,6,7,10,11,0,2,2,4,0,10.0,4.0,6.0,5
4948,4948,2016-17,2016,2017,Chelsea,West Brom,Win,Home,2016-12-11,3,6,9,12,15,4,7,10,10,2,2,2,5,1,10.0,14.0,-4.0,5
4949,4949,2016-17,2016,2017,Chelsea,Sunderland,Win,Away,2016-12-14,3,6,9,12,15,3,3,6,9,3,6,6,6,0,10.0,17.0,-7.0,5
4950,4950,2016-17,2016,2017,Chelsea,Crystal Palace,Win,Away,2016-12-17,3,6,9,12,15,1,4,4,4,5,5,8,11,0,10.0,15.0,-5.0,5
4951,4951,2016-17,2016,2017,Chelsea,Bournemouth,Win,Home,2016-12-26,3,6,9,12,15,3,3,6,6,3,6,6,9,1,10.0,16.0,-6.0,5
4952,4952,2016-17,2016,2017,Chelsea,Stoke,Win,Home,2016-12-31,3,6,9,12,15,1,2,2,5,5,7,10,10,1,10.0,9.0,1.0,5
4953,4953,2016-17,2016,2017,Chelsea,Tottenham,Loss,Away,2017-01-04,0,6,9,12,15,6,9,12,12,0,0,0,3,0,10.0,3.0,7.0,6
4954,4954,2016-17,2016,2017,Chelsea,Leicester,Win,Away,2017-01-14,3,3,6,9,12,4,4,5,5,-1,2,4,7,0,10.0,1.0,9.0,6
4955,4955,2016-17,2016,2017,Chelsea,Hull,Win,Home,2017-01-22,3,3,6,9,12,3,4,4,4,0,2,5,8,1,10.0,21.0,-11.0,6
4956,4956,2016-17,2016,2017,Chelsea,Liverpool,Draw,Away,2017-01-31,1,6,6,9,12,1,2,5,8,5,4,4,4,0,10.0,8.0,2.0,6
4957,4957,2016-17,2016,2017,Chelsea,Arsenal,Win,Home,2017-02-04,3,4,7,7,10,3,6,7,10,1,1,0,0,1,10.0,2.0,8.0,7
4958,4958,2016-17,2016,2017,Chelsea,Burnley,Draw,Away,2017-02-12,1,4,7,10,10,3,3,6,6,1,4,4,4,0,10.0,21.0,-11.0,7
4959,4959,2016-17,2016,2017,Chelsea,Swansea,Win,Home,2017-02-25,3,4,5,8,11,3,6,9,9,1,-1,-1,2,1,10.0,12.0,-2.0,7
4960,4960,2016-17,2016,2017,Chelsea,West Ham,Win,Away,2017-03-06,3,4,7,8,11,2,5,5,8,2,2,3,3,0,10.0,7.0,3.0,8
4961,4961,2016-17,2016,2017,Chelsea,Stoke,Win,Away,2017-03-18,3,6,7,10,11,4,4,7,7,2,3,3,4,0,10.0,9.0,1.0,8
4962,4962,2016-17,2016,2017,Chelsea,Crystal Palace,Loss,Home,2017-04-01,0,6,9,10,13,6,9,9,9,0,0,1,4,1,10.0,15.0,-5.0,9
4963,4963,2016-17,2016,2017,Chelsea,Man City,Win,Home,2017-04-05,3,3,6,9,10,2,3,6,9,1,3,3,1,1,10.0,4.0,6.0,9
4964,4964,2016-17,2016,2017,Chelsea,Bournemouth,Win,Away,2017-04-08,3,3,6,9,12,2,5,8,9,1,1,1,3,0,10.0,16.0,-6.0,9
4965,4965,2016-17,2016,2017,Chelsea,Man United,Loss,Away,2017-04-16,0,6,6,9,12,4,5,8,9,2,1,1,3,0,10.0,5.0,5.0,9
4966,4966,2016-17,2016,2017,Chelsea,Southampton,Win,Home,2017-04-25,3,3,6,6,9,3,6,7,7,0,0,-1,2,1,10.0,6.0,4.0,9
4967,4967,2016-17,2016,2017,Chelsea,Everton,Win,Away,2017-04-30,3,3,6,9,9,4,7,8,8,-1,-1,1,1,0,10.0,11.0,-1.0,9
4968,4968,2016-17,2016,2017,Chelsea,Middlesbrough,Win,Home,2017-05-08,3,6,6,9,12,4,4,4,5,2,2,5,7,1,10.0,21.0,-11.0,10
4969,4969,2016-17,2016,2017,Chelsea,West Brom,Win,Away,2017-05-12,3,6,9,9,12,1,1,1,1,5,8,8,11,0,10.0,14.0,-4.0,10
4970,4970,2016-17,2016,2017,Chelsea,Watford,Win,Home,2017-05-15,3,6,9,12,12,0,0,0,3,6,9,12,9,1,10.0,13.0,-3.0,10
4971,4971,2016-17,2016,2017,Chelsea,Sunderland,Win,Home,2017-05-21,3,6,9,12,15,0,3,3,3,6,6,9,12,1,10.0,17.0,-7.0,10
4972,4972,2017-18,2017,2018,Chelsea,Burnley,Loss,Home,2017-08-12,0,6,9,12,15,0,1,4,4,6,8,8,11,1,1.0,16.0,-15.0,1
4973,4973,2017-18,2017,2018,Chelsea,Tottenham,Win,Away,2017-08-20,3,3,6,9,12,6,9,12,12,-3,-3,-3,0,0,1.0,2.0,-1.0,1
4974,4974,2017-18,2017,2018,Chelsea,Everton,Win,Home,2017-08-27,3,3,6,9,12,4,4,7,7,-1,2,2,5,1,1.0,7.0,-6.0,1
4975,4975,2017-18,2017,2018,Chelsea,Leicester,Win,Away,2017-09-09,3,6,6,9,12,3,3,4,4,3,3,5,8,0,1.0,12.0,-11.0,2
4976,4976,2017-18,2017,2018,Chelsea,Arsenal,Draw,Home,2017-09-17,1,6,9,9,12,3,3,6,9,3,6,3,3,1,1.0,5.0,-4.0,2
4977,4977,2017-18,2017,2018,Chelsea,Stoke,Win,Away,2017-09-23,3,4,7,10,10,1,2,5,5,3,5,5,5,0,1.0,13.0,-12.0,2
4978,4978,2017-18,2017,2018,Chelsea,Man City,Loss,Home,2017-09-30,0,4,7,10,13,6,9,12,13,-2,-2,-2,0,1,1.0,3.0,-2.0,2
4979,4979,2017-18,2017,2018,Chelsea,Crystal Palace,Loss,Away,2017-10-14,0,3,4,7,10,0,0,0,0,3,4,7,10,0,1.0,14.0,-13.0,3
4980,4980,2017-18,2017,2018,Chelsea,Watford,Win,Home,2017-10-21,3,0,3,4,7,4,7,7,10,-4,-4,-3,-3,1,1.0,17.0,-16.0,3
4981,4981,2017-18,2017,2018,Chelsea,Bournemouth,Win,Away,2017-10-28,3,3,3,6,7,3,4,4,7,0,-1,2,0,0,1.0,9.0,-8.0,3
4982,4982,2017-18,2017,2018,Chelsea,Man United,Win,Home,2017-11-05,3,6,6,6,9,3,4,7,10,3,2,-1,-1,1,1.0,6.0,-5.0,4
4983,4983,2017-18,2017,2018,Chelsea,West Brom,Win,Away,2017-11-18,3,6,9,9,9,0,0,1,2,6,9,8,7,0,1.0,10.0,-9.0,4
4984,4984,2017-18,2017,2018,Chelsea,Liverpool,Draw,Away,2017-11-25,1,6,9,12,12,6,9,9,10,0,0,3,2,0,1.0,4.0,-3.0,4
4985,4985,2017-18,2017,2018,Chelsea,Swansea,Win,Home,2017-11-29,3,4,7,10,13,1,1,1,1,3,6,9,12,1,1.0,15.0,-14.0,4
4986,4986,2017-18,2017,2018,Chelsea,Newcastle,Win,Home,2017-12-02,3,4,7,10,13,1,1,1,1,3,6,9,12,1,1.0,21.0,-20.0,5
4987,4987,2017-18,2017,2018,Chelsea,West Ham,Loss,Away,2017-12-09,0,6,7,10,13,0,1,1,1,6,6,9,12,0,1.0,11.0,-10.0,5
4988,4988,2017-18,2017,2018,Chelsea,Huddersfield,Win,Away,2017-12-12,3,3,6,7,10,3,3,3,3,0,3,4,7,0,1.0,21.0,-20.0,5
4989,4989,2017-18,2017,2018,Chelsea,Southampton,Win,Home,2017-12-16,3,3,6,9,10,1,2,2,5,2,4,7,5,1,1.0,8.0,-7.0,5
4990,4990,2017-18,2017,2018,Chelsea,Everton,Draw,Away,2017-12-23,1,6,6,9,12,6,7,10,13,0,-1,-1,-1,0,1.0,7.0,-6.0,5
4991,4991,2017-18,2017,2018,Chelsea,Brighton,Win,Home,2017-12-26,3,4,7,7,10,4,4,4,4,0,3,3,6,1,1.0,21.0,-20.0,5
4992,4992,2017-18,2017,2018,Chelsea,Stoke,Win,Home,2017-12-30,3,4,7,10,10,4,4,4,4,0,3,6,6,1,1.0,13.0,-12.0,5
4993,4993,2017-18,2017,2018,Chelsea,Arsenal,Draw,Away,2018-01-03,1,6,7,10,13,4,5,8,9,2,2,2,4,0,1.0,5.0,-4.0,6
4994,4994,2017-18,2017,2018,Chelsea,Leicester,Draw,Home,2018-01-13,1,4,7,8,11,3,3,4,4,1,4,4,7,1,1.0,12.0,-11.0,6
4995,4995,2017-18,2017,2018,Chelsea,Brighton,Win,Away,2018-01-20,3,2,5,8,9,1,2,2,5,1,3,6,4,0,1.0,21.0,-20.0,6
4996,4996,2017-18,2017,2018,Chelsea,Bournemouth,Loss,Home,2018-01-31,0,4,5,8,11,4,5,8,9,0,0,0,2,1,1.0,9.0,-8.0,6
4997,4997,2017-18,2017,2018,Chelsea,Watford,Loss,Away,2018-02-05,0,3,4,5,8,1,2,2,2,2,2,3,6,0,1.0,17.0,-16.0,7
4998,4998,2017-18,2017,2018,Chelsea,West Brom,Win,Home,2018-02-12,3,0,3,4,5,0,1,4,4,0,2,0,1,1,1.0,10.0,-9.0,7
4999,4999,2017-18,2017,2018,Chelsea,Man United,Loss,Away,2018-02-25,0,3,3,6,7,3,3,6,9,0,0,0,-2,0,1.0,6.0,-5.0,7
5000,5000,2017-18,2017,2018,Chelsea,Man City,Loss,Away,2018-03-04,0,3,3,3,6,6,7,10,13,-3,-4,-7,-7,0,1.0,3.0,-2.0,8
5001,5001,2017-18,2017,2018,Chelsea,Crystal Palace,Win,Home,2018-03-10,3,0,3,3,3,0,0,1,2,0,3,2,1,1,1.0,14.0,-13.0,8
5002,5002,2017-18,2017,2018,Chelsea,Tottenham,Loss,Home,2018-04-01,0,3,3,6,6,6,9,12,13,-3,-6,-6,-7,1,1.0,2.0,-1.0,9
5003,5003,2017-18,2017,2018,Chelsea,West Ham,Draw,Home,2018-04-08,1,3,3,3,6,3,3,3,6,0,0,0,0,1,1.0,11.0,-10.0,9
5004,5004,2017-18,2017,2018,Chelsea,Southampton,Win,Away,2018-04-14,3,1,4,4,4,0,0,1,2,1,4,3,2,0,1.0,8.0,-7.0,9
5005,5005,2017-18,2017,2018,Chelsea,Burnley,Win,Away,2018-04-19,3,4,4,7,7,6,9,12,15,-2,-5,-5,-8,0,1.0,16.0,-15.0,9
5006,5006,2017-18,2017,2018,Chelsea,Swansea,Win,Away,2018-04-28,3,6,7,7,10,1,2,2,3,5,5,5,7,0,1.0,15.0,-14.0,9
5007,5007,2017-18,2017,2018,Chelsea,Liverpool,Win,Home,2018-05-06,3,6,9,10,10,2,5,6,9,4,4,4,1,1,1.0,4.0,-3.0,10
5008,5008,2017-18,2017,2018,Chelsea,Huddersfield,Draw,Home,2018-05-09,1,6,9,12,13,1,4,5,5,5,5,7,8,1,1.0,21.0,-20.0,10
5009,5009,2017-18,2017,2018,Chelsea,Newcastle,Loss,Away,2018-05-13,0,4,7,10,13,0,0,0,3,4,7,10,10,0,1.0,21.0,-20.0,10
5010,5010,1993-94,1993,1994,Coventry,Arsenal,Win,Away,1993-08-14,3,0,0,0,0,0,0,0,0,0,0,0,0,0,15.0,10.0,5.0,1
5011,5011,1993-94,1993,1994,Coventry,Newcastle,Win,Home,1993-08-18,3,3,3,3,3,0,0,0,0,3,3,3,3,1,15.0,21.0,-6.0,1
5012,5012,1993-94,1993,1994,Coventry,West Ham,Draw,Home,1993-08-21,1,6,6,6,6,0,0,0,0,6,6,6,6,1,15.0,21.0,-6.0,1
5013,5013,1993-94,1993,1994,Coventry,Oldham,Draw,Away,1993-08-24,1,4,7,7,7,3,3,3,3,1,4,4,4,0,15.0,19.0,-4.0,1
5014,5014,1993-94,1993,1994,Coventry,Man City,Draw,Away,1993-08-27,1,2,5,8,8,0,0,1,1,2,5,7,7,0,15.0,9.0,6.0,1
5015,5015,1993-94,1993,1994,Coventry,Liverpool,Win,Home,1993-09-01,3,2,3,6,9,3,6,9,12,-1,-3,-3,-3,1,15.0,6.0,9.0,2
5016,5016,1993-94,1993,1994,Coventry,Aston Villa,Draw,Away,1993-09-11,1,4,5,6,9,6,6,7,8,-2,-1,-1,1,0,15.0,2.0,13.0,2
5017,5017,1993-94,1993,1994,Coventry,Chelsea,Draw,Home,1993-09-18,1,4,5,6,7,4,5,8,8,0,0,-2,-1,1,15.0,11.0,4.0,2
5018,5018,1993-94,1993,1994,Coventry,Leeds,Loss,Home,1993-09-25,0,2,5,6,7,6,9,9,9,-4,-4,-3,-2,1,15.0,17.0,-2.0,2
5019,5019,1993-94,1993,1994,Coventry,Norwich,Loss,Away,1993-10-02,0,1,2,5,6,4,4,5,6,-3,-2,0,0,0,15.0,3.0,12.0,3
5020,5020,1993-94,1993,1994,Coventry,Southampton,Draw,Home,1993-10-16,1,0,1,2,5,1,1,1,1,-1,0,1,4,1,15.0,18.0,-3.0,3
5021,5021,1993-94,1993,1994,Coventry,QPR,Loss,Away,1993-10-23,0,1,1,2,3,6,7,8,8,-5,-6,-6,-5,0,15.0,5.0,10.0,3
5022,5022,1993-94,1993,1994,Coventry,Sheffield United,Draw,Home,1993-10-31,1,1,1,1,2,2,3,3,3,-1,-2,-2,-1,1,15.0,14.0,1.0,3
5023,5023,1993-94,1993,1994,Coventry,Everton,Win,Home,1993-11-06,3,1,2,2,2,3,4,4,4,-2,-2,-2,-2,1,15.0,13.0,2.0,4
5024,5024,1993-94,1993,1994,Coventry,Sheffield Weds,Draw,Away,1993-11-20,1,4,4,5,5,4,5,6,6,0,-1,-1,-1,0,15.0,7.0,8.0,4
5025,5025,1993-94,1993,1994,Coventry,Blackburn,Loss,Away,1993-11-23,0,4,5,5,6,3,6,7,8,1,-1,-2,-2,0,15.0,4.0,11.0,4
5026,5026,1993-94,1993,1994,Coventry,Man United,Loss,Home,1993-11-27,0,1,4,5,5,4,7,10,13,-3,-3,-5,-8,1,15.0,1.0,14.0,4
5027,5027,1993-94,1993,1994,Coventry,Arsenal,Win,Home,1993-12-04,3,0,1,4,5,4,7,7,8,-4,-6,-3,-3,1,15.0,10.0,5.0,5
5028,5028,1993-94,1993,1994,Coventry,West Ham,Loss,Away,1993-12-11,0,3,3,4,7,3,6,7,10,0,-3,-3,-3,0,15.0,21.0,-6.0,5
5029,5029,1993-94,1993,1994,Coventry,Oldham,Draw,Home,1993-12-18,1,3,3,3,4,3,4,7,7,0,-1,-4,-3,1,15.0,19.0,-4.0,5
5030,5030,1993-94,1993,1994,Coventry,Wimbledon,Win,Away,1993-12-26,3,1,4,4,4,6,6,7,8,-5,-2,-3,-4,0,15.0,12.0,3.0,5
5031,5031,1993-94,1993,1994,Coventry,Tottenham,Win,Away,1994-01-01,3,4,4,7,7,3,4,7,8,1,0,0,-1,0,15.0,8.0,7.0,6
5032,5032,1993-94,1993,1994,Coventry,Swindon,Draw,Home,1994-01-03,1,6,7,7,10,1,1,4,5,5,6,3,5,1,15.0,21.0,-6.0,6
5033,5033,1993-94,1993,1994,Coventry,Southampton,Loss,Away,1994-01-15,0,4,7,8,8,1,4,4,4,3,3,4,4,0,15.0,18.0,-3.0,6
5034,5034,1993-94,1993,1994,Coventry,QPR,Loss,Home,1994-01-22,0,1,4,7,8,1,1,2,5,0,3,5,3,1,15.0,5.0,10.0,6
5035,5035,1993-94,1993,1994,Coventry,Ipswich,Win,Home,1994-02-02,3,0,1,4,7,2,2,3,6,-2,-1,1,1,1,15.0,16.0,-1.0,7
5036,5036,1993-94,1993,1994,Coventry,Swindon,Loss,Away,1994-02-05,0,3,3,4,7,3,4,4,5,0,-1,0,2,0,15.0,21.0,-6.0,7
5037,5037,1993-94,1993,1994,Coventry,Sheffield United,Draw,Away,1994-02-12,1,3,3,3,4,0,1,4,4,3,2,-1,0,0,15.0,14.0,1.0,7
5038,5038,1993-94,1993,1994,Coventry,Man City,Win,Home,1994-02-19,3,1,4,4,4,4,4,5,5,-3,0,-1,-1,1,15.0,9.0,6.0,7
5039,5039,1993-94,1993,1994,Coventry,Newcastle,Loss,Away,1994-02-23,0,4,4,7,7,0,0,3,6,4,4,4,1,0,15.0,21.0,-6.0,7
5040,5040,1993-94,1993,1994,Coventry,Liverpool,Loss,Away,1994-02-26,0,3,4,4,7,0,1,4,7,3,3,0,0,0,15.0,6.0,9.0,7
5041,5041,1993-94,1993,1994,Coventry,Aston Villa,Loss,Home,1994-03-06,0,0,3,4,4,2,5,8,9,-2,-2,-4,-5,1,15.0,2.0,13.0,8
5042,5042,1993-94,1993,1994,Coventry,Leeds,Loss,Away,1994-03-19,0,0,0,3,4,4,5,6,9,-4,-5,-3,-5,0,15.0,17.0,-2.0,8
5043,5043,1993-94,1993,1994,Coventry,Norwich,Win,Home,1994-03-26,3,0,0,0,3,3,3,4,5,-3,-3,-4,-2,1,15.0,3.0,12.0,8
5044,5044,1993-94,1993,1994,Coventry,Wimbledon,Loss,Home,1994-04-02,0,3,3,3,3,6,6,6,9,-3,-3,-3,-6,1,15.0,12.0,3.0,9
5045,5045,1993-94,1993,1994,Coventry,Ipswich,Win,Away,1994-04-04,3,3,3,3,3,1,1,1,2,2,2,2,1,0,15.0,16.0,-1.0,9
5046,5046,1993-94,1993,1994,Coventry,Tottenham,Win,Home,1994-04-09,3,3,6,6,6,3,6,7,8,0,0,-1,-2,1,15.0,8.0,7.0,9
5047,5047,1993-94,1993,1994,Coventry,Sheffield Weds,Draw,Home,1994-04-16,1,6,6,9,9,6,9,12,12,0,-3,-3,-3,1,15.0,7.0,8.0,9
5048,5048,1993-94,1993,1994,Coventry,Everton,Draw,Away,1994-04-23,1,4,7,7,10,3,3,3,4,1,4,4,6,0,15.0,13.0,2.0,9
5049,5049,1993-94,1993,1994,Coventry,Blackburn,Win,Home,1994-05-02,3,2,5,8,8,4,4,7,10,-2,1,1,-2,1,15.0,4.0,11.0,10
5050,5050,1993-94,1993,1994,Coventry,Chelsea,Win,Away,1994-05-04,3,4,5,8,11,4,5,5,6,0,0,3,5,0,15.0,11.0,4.0,10
5051,5051,1993-94,1993,1994,Coventry,Man United,Draw,Away,1994-05-08,1,6,7,8,11,6,9,12,12,0,-2,-4,-1,0,15.0,1.0,14.0,10
5052,5052,1994-95,1994,1995,Coventry,Wimbledon,Draw,Home,1994-08-20,1,4,7,8,9,3,6,9,10,1,1,-1,-1,1,11.0,6.0,5.0,1
5053,5053,1994-95,1994,1995,Coventry,Newcastle,Loss,Away,1994-08-24,0,2,5,8,9,6,6,9,12,-4,-1,-1,-3,0,11.0,3.0,8.0,1
5054,5054,1994-95,1994,1995,Coventry,Blackburn,Loss,Away,1994-08-27,0,1,2,5,8,4,5,5,8,-3,-3,0,0,0,11.0,2.0,9.0,1
5055,5055,1994-95,1994,1995,Coventry,Aston Villa,Loss,Home,1994-08-29,0,0,1,2,5,2,3,6,6,-2,-2,-4,-1,1,11.0,10.0,1.0,1
5056,5056,1994-95,1994,1995,Coventry,QPR,Draw,Away,1994-09-10,1,0,0,1,2,1,4,4,7,-1,-4,-3,-5,0,11.0,9.0,2.0,2
5057,5057,1994-95,1994,1995,Coventry,Leeds,Win,Home,1994-09-17,3,1,1,1,2,6,6,9,10,-5,-5,-8,-8,1,11.0,5.0,6.0,2
5058,5058,1994-95,1994,1995,Coventry,Southampton,Loss,Home,1994-09-24,0,4,4,4,4,4,4,4,5,0,0,0,-1,1,11.0,18.0,-7.0,2
5059,5059,1994-95,1994,1995,Coventry,Leicester,Draw,Away,1994-10-03,1,3,4,4,4,4,4,5,5,-1,0,-1,-1,0,11.0,21.0,-10.0,3
5060,5060,1994-95,1994,1995,Coventry,Ipswich,Win,Home,1994-10-10,3,1,4,5,5,3,3,3,3,-2,1,2,2,1,11.0,19.0,-8.0,3
5061,5061,1994-95,1994,1995,Coventry,Everton,Win,Away,1994-10-15,3,4,4,7,8,0,1,2,2,4,3,5,6,0,11.0,17.0,-6.0,3
5062,5062,1994-95,1994,1995,Coventry,Arsenal,Loss,Away,1994-10-23,0,6,7,7,10,6,6,9,9,0,1,-2,1,0,11.0,4.0,7.0,3
5063,5063,1994-95,1994,1995,Coventry,Man City,Win,Home,1994-10-29,3,3,6,7,7,6,7,7,10,-3,-1,0,-3,1,11.0,16.0,-5.0,3
5064,5064,1994-95,1994,1995,Coventry,Crystal Palace,Loss,Home,1994-11-02,0,3,6,9,10,6,6,6,9,-3,0,3,1,1,11.0,21.0,-10.0,4
5065,5065,1994-95,1994,1995,Coventry,Chelsea,Draw,Away,1994-11-06,1,3,3,6,9,4,4,7,7,-1,-1,-1,2,0,11.0,14.0,-3.0,4
5066,5066,1994-95,1994,1995,Coventry,Norwich,Win,Home,1994-11-19,3,1,4,4,7,2,2,5,6,-1,2,-1,1,1,11.0,12.0,-1.0,4
5067,5067,1994-95,1994,1995,Coventry,West Ham,Win,Away,1994-11-26,3,4,4,7,7,3,3,3,6,1,1,4,1,0,11.0,13.0,-2.0,4
5068,5068,1994-95,1994,1995,Coventry,Liverpool,Draw,Home,1994-12-03,1,6,7,7,10,1,4,7,7,5,3,0,3,1,11.0,8.0,3.0,5
5069,5069,1994-95,1994,1995,Coventry,Wimbledon,Loss,Away,1994-12-10,0,4,7,8,8,0,3,6,6,4,4,2,2,0,11.0,6.0,5.0,5
5070,5070,1994-95,1994,1995,Coventry,Newcastle,Draw,Home,1994-12-17,1,1,4,7,8,3,4,4,5,-2,0,3,3,1,11.0,3.0,8.0,5
5071,5071,1994-95,1994,1995,Coventry,Nott'm Forest,Draw,Home,1994-12-26,1,1,2,5,8,6,7,7,7,-5,-5,-2,1,1,11.0,21.0,-10.0,5
5072,5072,1994-95,1994,1995,Coventry,Sheffield Weds,Loss,Away,1994-12-28,0,2,2,3,6,3,3,6,7,-1,-1,-3,-1,0,11.0,7.0,4.0,5
5073,5073,1994-95,1994,1995,Coventry,Tottenham,Loss,Home,1994-12-31,0,1,2,2,3,4,5,8,11,-3,-3,-6,-8,1,11.0,15.0,-4.0,5
5074,5074,1994-95,1994,1995,Coventry,Man United,Loss,Away,1995-01-03,0,0,1,2,2,2,5,5,8,-2,-4,-3,-6,0,11.0,1.0,10.0,6
5075,5075,1994-95,1994,1995,Coventry,Man City,Draw,Away,1995-01-14,1,0,0,1,2,2,2,2,2,-2,-2,-1,0,0,11.0,16.0,-5.0,6
5076,5076,1994-95,1994,1995,Coventry,Arsenal,Loss,Home,1995-01-21,0,1,1,1,2,1,1,4,5,0,0,-3,-3,1,11.0,4.0,7.0,6
5077,5077,1994-95,1994,1995,Coventry,Norwich,Draw,Away,1995-01-25,1,1,1,1,1,0,3,3,3,1,-2,-2,-2,0,11.0,12.0,-1.0,6
5078,5078,1994-95,1994,1995,Coventry,Chelsea,Draw,Home,1995-02-04,1,1,2,2,2,1,2,3,3,0,0,-1,-1,1,11.0,14.0,-3.0,7
5079,5079,1994-95,1994,1995,Coventry,Crystal Palace,Win,Away,1995-02-11,3,2,2,3,3,4,4,7,7,-2,-2,-4,-4,0,11.0,21.0,-10.0,7
5080,5080,1994-95,1994,1995,Coventry,West Ham,Win,Home,1995-02-18,3,4,5,5,6,4,4,4,4,0,1,1,2,1,11.0,13.0,-2.0,7
5081,5081,1994-95,1994,1995,Coventry,Leicester,Win,Home,1995-02-25,3,6,7,8,8,2,2,5,5,4,5,3,3,1,11.0,21.0,-10.0,7
5082,5082,1994-95,1994,1995,Coventry,Southampton,Draw,Away,1995-03-04,1,6,9,10,11,1,2,3,4,5,7,7,7,0,11.0,18.0,-7.0,8
5083,5083,1994-95,1994,1995,Coventry,Aston Villa,Draw,Away,1995-03-06,1,4,7,10,11,0,1,4,7,4,6,6,4,0,11.0,10.0,1.0,8
5084,5084,1994-95,1994,1995,Coventry,Blackburn,Draw,Home,1995-03-11,1,2,5,8,11,6,7,10,13,-4,-2,-2,-2,1,11.0,2.0,9.0,8
5085,5085,1994-95,1994,1995,Coventry,Liverpool,Win,Away,1995-03-14,3,2,3,6,9,6,7,8,9,-4,-4,-2,0,0,11.0,8.0,3.0,8
5086,5086,1994-95,1994,1995,Coventry,Leeds,Loss,Away,1995-03-18,0,4,5,6,9,6,6,7,10,-2,-1,-1,-1,0,11.0,5.0,6.0,8
5087,5087,1994-95,1994,1995,Coventry,QPR,Loss,Home,1995-04-01,0,3,4,5,6,3,6,9,12,0,-2,-4,-6,1,11.0,9.0,2.0,9
5088,5088,1994-95,1994,1995,Coventry,Sheffield Weds,Win,Home,1995-04-15,3,0,3,4,5,3,3,3,3,-3,0,1,2,1,11.0,7.0,4.0,9
5089,5089,1994-95,1994,1995,Coventry,Nott'm Forest,Loss,Away,1995-04-17,0,3,3,6,7,4,7,10,13,-1,-4,-4,-6,0,11.0,21.0,-10.0,9
5090,5090,1994-95,1994,1995,Coventry,Man United,Loss,Home,1995-05-01,0,3,3,3,6,4,5,8,8,-1,-2,-5,-2,1,11.0,1.0,10.0,10
5091,5091,1994-95,1994,1995,Coventry,Ipswich,Loss,Away,1995-05-06,0,0,3,3,3,1,1,1,1,-1,2,2,2,0,11.0,19.0,-8.0,10
5092,5092,1994-95,1994,1995,Coventry,Tottenham,Win,Away,1995-05-09,3,0,0,3,3,1,2,5,6,-1,-2,-2,-3,0,11.0,15.0,-4.0,10
5093,5093,1994-95,1994,1995,Coventry,Everton,Draw,Home,1995-05-14,1,3,3,3,6,4,5,6,7,-1,-2,-3,-1,1,11.0,17.0,-6.0,10
5094,5094,1995-96,1995,1996,Coventry,Newcastle,Loss,Away,1995-08-19,0,4,4,4,4,3,4,5,5,1,0,-1,-1,0,16.0,6.0,10.0,1
5095,5095,1995-96,1995,1996,Coventry,Man City,Win,Home,1995-08-23,3,1,4,4,4,1,1,2,3,0,3,2,1,1,16.0,17.0,-1.0,1
5096,5096,1995-96,1995,1996,Coventry,Arsenal,Draw,Home,1995-08-26,1,3,4,7,7,4,4,5,6,-1,0,2,1,1,16.0,12.0,4.0,1
5097,5097,1995-96,1995,1996,Coventry,Chelsea,Draw,Away,1995-08-30,1,4,4,5,8,1,2,5,6,3,2,0,2,0,16.0,11.0,5.0,1
5098,5098,1995-96,1995,1996,Coventry,Nott'm Forest,Draw,Home,1995-09-09,1,2,5,5,6,2,3,6,7,0,2,-1,-1,1,16.0,3.0,13.0,2
5099,5099,1995-96,1995,1996,Coventry,Middlesbrough,Loss,Away,1995-09-16,0,2,3,6,6,2,2,5,6,0,1,1,0,0,16.0,21.0,-5.0,2
5100,5100,1995-96,1995,1996,Coventry,Blackburn,Loss,Away,1995-09-23,0,1,2,3,6,1,1,1,1,0,1,2,5,0,16.0,1.0,15.0,2
5101,5101,1995-96,1995,1996,Coventry,Aston Villa,Loss,Home,1995-09-30,0,0,1,2,3,4,5,8,8,-4,-4,-6,-5,1,16.0,18.0,-2.0,2
5102,5102,1995-96,1995,1996,Coventry,Liverpool,Draw,Away,1995-10-14,1,0,0,1,2,4,7,7,10,-4,-7,-6,-8,0,16.0,4.0,12.0,3
5103,5103,1995-96,1995,1996,Coventry,Sheffield Weds,Loss,Home,1995-10-21,0,1,1,1,2,0,1,1,4,1,0,0,-2,1,16.0,13.0,3.0,3
5104,5104,1995-96,1995,1996,Coventry,Leeds,Loss,Away,1995-10-28,0,1,1,1,1,1,4,7,7,0,-3,-6,-6,0,16.0,5.0,11.0,3
5105,5105,1995-96,1995,1996,Coventry,Tottenham,Loss,Home,1995-11-04,0,0,1,1,1,2,2,5,8,-2,-1,-4,-7,1,16.0,7.0,9.0,4
5106,5106,1995-96,1995,1996,Coventry,QPR,Draw,Away,1995-11-19,1,0,0,1,1,1,1,1,4,-1,-1,0,-3,0,16.0,8.0,8.0,4
5107,5107,1995-96,1995,1996,Coventry,Man United,Loss,Home,1995-11-22,0,1,1,1,2,3,6,9,12,-2,-5,-8,-10,1,16.0,2.0,14.0,4
5108,5108,1995-96,1995,1996,Coventry,Wimbledon,Draw,Home,1995-11-25,1,1,1,1,1,1,1,1,1,0,0,0,0,1,16.0,9.0,7.0,4
5109,5109,1995-96,1995,1996,Coventry,Sheffield Weds,Loss,Away,1995-12-04,0,1,2,2,2,1,2,3,3,0,0,-1,-1,0,16.0,13.0,3.0,5
5110,5110,1995-96,1995,1996,Coventry,Blackburn,Win,Home,1995-12-09,3,1,1,2,2,4,7,7,7,-3,-6,-5,-5,1,16.0,1.0,15.0,5
5111,5111,1995-96,1995,1996,Coventry,Aston Villa,Loss,Away,1995-12-16,0,3,4,4,5,2,2,5,6,1,2,-1,-1,0,16.0,18.0,-2.0,5
5112,5112,1995-96,1995,1996,Coventry,Everton,Win,Home,1995-12-23,3,3,3,4,4,3,4,5,8,0,-1,-1,-4,1,16.0,15.0,1.0,5
5113,5113,1995-96,1995,1996,Coventry,Bolton,Win,Away,1995-12-30,3,3,6,6,7,1,1,1,2,2,5,5,5,0,16.0,21.0,-5.0,5
5114,5114,1995-96,1995,1996,Coventry,Southampton,Draw,Home,1996-01-01,1,6,6,9,9,2,2,3,4,4,4,6,5,1,16.0,10.0,6.0,6
5115,5115,1995-96,1995,1996,Coventry,Newcastle,Loss,Home,1996-01-14,0,4,7,7,10,3,6,9,9,1,1,-2,1,1,16.0,6.0,10.0,6
5116,5116,1995-96,1995,1996,Coventry,Man City,Draw,Away,1996-01-20,1,1,4,7,7,3,3,3,4,-2,1,4,3,0,16.0,17.0,-1.0,6
5117,5117,1995-96,1995,1996,Coventry,West Ham,Loss,Away,1996-01-31,0,1,2,5,8,0,0,0,3,1,2,5,5,0,16.0,14.0,2.0,6
5118,5118,1995-96,1995,1996,Coventry,Arsenal,Draw,Away,1996-02-03,1,1,1,2,5,3,3,3,6,-2,-2,-1,-1,0,16.0,12.0,4.0,7
5119,5119,1995-96,1995,1996,Coventry,Chelsea,Win,Home,1996-02-10,3,1,2,2,3,6,7,10,11,-5,-5,-8,-8,1,16.0,11.0,5.0,7
5120,5120,1995-96,1995,1996,Coventry,Middlesbrough,Draw,Home,1996-02-24,1,4,4,5,5,0,0,0,0,4,4,5,5,1,16.0,21.0,-5.0,7
5121,5121,1995-96,1995,1996,Coventry,West Ham,Draw,Home,1996-03-02,1,4,5,5,6,3,6,9,12,1,-1,-4,-6,1,16.0,14.0,2.0,8
5122,5122,1995-96,1995,1996,Coventry,Everton,Draw,Away,1996-03-09,1,2,5,6,6,6,6,9,10,-4,-1,-3,-4,0,16.0,15.0,1.0,8
5123,5123,1995-96,1995,1996,Coventry,Bolton,Loss,Home,1996-03-16,0,2,3,6,7,3,6,6,6,-1,-3,0,1,1,16.0,21.0,-5.0,8
5124,5124,1995-96,1995,1996,Coventry,Southampton,Loss,Away,1996-03-25,0,1,2,3,6,0,0,0,1,1,2,3,5,0,16.0,10.0,6.0,8
5125,5125,1995-96,1995,1996,Coventry,Tottenham,Loss,Away,1996-03-30,0,0,1,2,3,3,3,6,9,-3,-2,-4,-6,0,16.0,7.0,9.0,8
5126,5126,1995-96,1995,1996,Coventry,Liverpool,Win,Home,1996-04-06,3,0,0,1,2,3,6,7,10,-3,-6,-6,-8,1,16.0,4.0,12.0,9
5127,5127,1995-96,1995,1996,Coventry,Man United,Loss,Away,1996-04-08,0,3,3,3,4,6,9,10,13,-3,-6,-7,-9,0,16.0,2.0,14.0,9
5128,5128,1995-96,1995,1996,Coventry,QPR,Win,Home,1996-04-13,3,3,3,3,3,3,6,7,8,0,-3,-4,-5,1,16.0,8.0,8.0,9
5129,5129,1995-96,1995,1996,Coventry,Nott'm Forest,Draw,Away,1996-04-17,1,3,6,6,6,3,6,6,9,0,0,0,-3,0,16.0,3.0,13.0,9
5130,5130,1995-96,1995,1996,Coventry,Wimbledon,Win,Away,1996-04-27,3,4,4,7,7,3,6,7,10,1,-2,0,-3,0,16.0,9.0,7.0,9
5131,5131,1995-96,1995,1996,Coventry,Leeds,Draw,Home,1996-05-04,1,4,7,7,10,0,0,0,0,4,7,7,10,1,16.0,5.0,11.0,10
5132,5132,1996-97,1996,1997,Coventry,Nott'm Forest,Loss,Home,1996-08-17,0,4,5,8,8,4,4,5,5,0,1,3,3,1,16.0,9.0,7.0,1
5133,5133,1996-97,1996,1997,Coventry,West Ham,Draw,Away,1996-08-21,1,1,4,5,8,1,1,2,5,0,3,3,3,0,16.0,10.0,6.0,1
5134,5134,1996-97,1996,1997,Coventry,Chelsea,Loss,Away,1996-08-24,0,1,2,5,6,4,4,5,6,-3,-2,0,0,0,16.0,11.0,5.0,1
5135,5135,1996-97,1996,1997,Coventry,Liverpool,Loss,Home,1996-09-04,0,1,1,2,5,4,5,6,7,-3,-4,-4,-2,1,16.0,3.0,13.0,2
5136,5136,1996-97,1996,1997,Coventry,Middlesbrough,Loss,Away,1996-09-07,0,0,1,1,2,4,4,5,5,-4,-3,-4,-3,0,16.0,12.0,4.0,2
5137,5137,1996-97,1996,1997,Coventry,Leeds,Win,Home,1996-09-14,3,0,0,1,1,3,6,6,7,-3,-6,-5,-6,1,16.0,13.0,3.0,2
5138,5138,1996-97,1996,1997,Coventry,Sunderland,Loss,Away,1996-09-21,0,3,3,3,4,1,1,2,5,2,2,1,-1,0,16.0,21.0,-5.0,2
5139,5139,1996-97,1996,1997,Coventry,Blackburn,Draw,Home,1996-09-28,1,3,3,3,3,1,1,1,2,2,2,2,1,1,16.0,7.0,9.0,2
5140,5140,1996-97,1996,1997,Coventry,Southampton,Draw,Home,1996-10-13,1,1,4,4,4,3,3,3,4,-2,1,1,0,1,16.0,17.0,-1.0,3
5141,5141,1996-97,1996,1997,Coventry,Arsenal,Draw,Away,1996-10-19,1,2,2,5,5,6,9,12,13,-4,-7,-7,-8,0,16.0,5.0,11.0,3
5142,5142,1996-97,1996,1997,Coventry,Sheffield Weds,Draw,Home,1996-10-26,1,2,3,3,6,1,1,2,2,1,2,1,4,1,16.0,15.0,1.0,3
5143,5143,1996-97,1996,1997,Coventry,Everton,Draw,Away,1996-11-04,1,2,3,4,4,6,9,10,10,-4,-6,-6,-6,0,16.0,6.0,10.0,4
5144,5144,1996-97,1996,1997,Coventry,Wimbledon,Draw,Away,1996-11-16,1,2,3,4,5,2,5,8,11,0,-2,-4,-6,0,16.0,14.0,2.0,4
5145,5145,1996-97,1996,1997,Coventry,Aston Villa,Loss,Home,1996-11-23,0,2,3,4,5,3,3,6,6,-1,0,-2,-1,1,16.0,4.0,12.0,4
5146,5146,1996-97,1996,1997,Coventry,Derby,Loss,Away,1996-11-30,0,1,2,3,4,4,7,7,8,-3,-5,-4,-4,0,16.0,21.0,-5.0,4
5147,5147,1996-97,1996,1997,Coventry,Tottenham,Loss,Home,1996-12-07,0,0,1,2,3,0,3,6,6,0,-2,-4,-3,1,16.0,8.0,8.0,5
5148,5148,1996-97,1996,1997,Coventry,Newcastle,Win,Home,1996-12-17,3,0,0,1,2,1,2,3,6,-1,-2,-2,-4,1,16.0,2.0,14.0,5
5149,5149,1996-97,1996,1997,Coventry,Leicester,Win,Away,1996-12-21,3,3,3,3,4,4,4,4,7,-1,-1,-1,-3,0,16.0,21.0,-5.0,5
5150,5150,1996-97,1996,1997,Coventry,Leeds,Win,Away,1996-12-26,3,6,6,6,6,2,3,6,9,4,3,0,-3,0,16.0,13.0,3.0,5
5151,5151,1996-97,1996,1997,Coventry,Middlesbrough,Win,Home,1996-12-28,3,6,9,9,9,3,4,4,4,3,5,5,5,1,16.0,12.0,4.0,5
5152,5152,1996-97,1996,1997,Coventry,Sunderland,Draw,Home,1997-01-01,1,6,9,12,12,3,3,6,6,3,6,6,6,1,16.0,21.0,-5.0,6
5153,5153,1996-97,1996,1997,Coventry,Blackburn,Loss,Away,1997-01-11,0,4,7,10,13,4,7,7,8,0,0,3,5,0,16.0,7.0,9.0,6
5154,5154,1996-97,1996,1997,Coventry,Man United,Loss,Home,1997-01-18,0,1,4,7,10,4,7,10,13,-3,-3,-3,-3,1,16.0,1.0,15.0,6
5155,5155,1996-97,1996,1997,Coventry,Nott'm Forest,Win,Away,1997-01-29,3,0,1,4,7,6,9,10,10,-6,-8,-6,-3,0,16.0,9.0,7.0,6
5156,5156,1996-97,1996,1997,Coventry,Sheffield Weds,Draw,Away,1997-02-01,1,3,3,4,7,3,6,7,8,0,-3,-3,-1,0,16.0,15.0,1.0,7
5157,5157,1996-97,1996,1997,Coventry,Aston Villa,Loss,Away,1997-02-19,0,4,4,4,5,3,3,4,5,1,1,0,0,0,16.0,4.0,12.0,7
5158,5158,1996-97,1996,1997,Coventry,Everton,Draw,Home,1997-02-22,1,1,4,4,4,3,3,3,3,-2,1,1,1,1,16.0,6.0,10.0,7
5159,5159,1996-97,1996,1997,Coventry,Man United,Loss,Away,1997-03-01,0,1,2,5,5,4,7,10,13,-3,-5,-5,-8,0,16.0,1.0,15.0,8
5160,5160,1996-97,1996,1997,Coventry,Wimbledon,Draw,Home,1997-03-03,1,1,1,2,5,1,4,5,5,0,-3,-3,0,1,16.0,14.0,2.0,8
5161,5161,1996-97,1996,1997,Coventry,Leicester,Draw,Home,1997-03-08,1,1,2,2,3,6,9,9,10,-5,-7,-7,-7,1,16.0,21.0,-5.0,8
5162,5162,1996-97,1996,1997,Coventry,Newcastle,Loss,Away,1997-03-15,0,2,2,3,3,0,3,6,9,2,-1,-3,-6,0,16.0,2.0,14.0,8
5163,5163,1996-97,1996,1997,Coventry,West Ham,Loss,Home,1997-03-22,0,1,2,2,3,2,5,5,8,-1,-3,-3,-5,1,16.0,10.0,6.0,8
5164,5164,1996-97,1996,1997,Coventry,Liverpool,Win,Away,1997-04-06,3,0,1,2,2,4,7,7,8,-4,-6,-5,-6,0,16.0,3.0,13.0,9
5165,5165,1996-97,1996,1997,Coventry,Chelsea,Win,Home,1997-04-09,3,3,3,4,5,0,3,6,6,3,0,-2,-1,1,16.0,11.0,5.0,9
5166,5166,1996-97,1996,1997,Coventry,Southampton,Draw,Away,1997-04-19,1,6,6,6,7,4,7,8,8,2,-1,-2,-1,0,16.0,17.0,-1.0,9
5167,5167,1996-97,1996,1997,Coventry,Arsenal,Draw,Home,1997-04-21,1,4,7,7,7,4,7,7,10,0,0,0,-3,1,16.0,5.0,11.0,9
5168,5168,1996-97,1996,1997,Coventry,Derby,Loss,Home,1997-05-03,0,2,5,8,8,1,4,5,8,1,1,3,0,1,16.0,21.0,-5.0,10
5169,5169,1996-97,1996,1997,Coventry,Tottenham,Win,Away,1997-05-11,3,1,2,5,8,3,4,4,4,-2,-2,1,4,0,16.0,8.0,8.0,10
5170,5170,1997-98,1997,1998,Coventry,Chelsea,Win,Home,1997-08-09,3,3,4,5,8,4,7,10,10,-1,-3,-5,-2,1,17.0,6.0,11.0,1
5171,5171,1997-98,1997,1998,Coventry,Arsenal,Loss,Away,1997-08-11,0,6,6,7,8,4,4,5,6,2,2,2,2,0,17.0,3.0,14.0,1
5172,5172,1997-98,1997,1998,Coventry,Bolton,Draw,Home,1997-08-23,1,3,6,6,7,3,3,3,6,0,3,3,1,1,17.0,21.0,-4.0,1
5173,5173,1997-98,1997,1998,Coventry,West Ham,Draw,Home,1997-08-27,1,1,4,7,7,3,6,6,7,-2,-2,1,0,1,17.0,14.0,3.0,1
5174,5174,1997-98,1997,1998,Coventry,Man United,Loss,Away,1997-08-30,0,2,2,5,8,4,7,10,13,-2,-5,-5,-5,0,17.0,1.0,16.0,1
5175,5175,1997-98,1997,1998,Coventry,Southampton,Win,Home,1997-09-13,3,1,2,2,5,3,3,3,3,-2,-1,-1,2,1,17.0,16.0,1.0,2
5176,5176,1997-98,1997,1998,Coventry,Sheffield Weds,Draw,Away,1997-09-20,1,3,4,5,5,3,3,4,4,0,1,1,1,0,17.0,7.0,10.0,2
5177,5177,1997-98,1997,1998,Coventry,Crystal Palace,Draw,Home,1997-09-24,1,4,4,5,6,3,3,3,6,1,1,2,0,1,17.0,21.0,-4.0,2
5178,5178,1997-98,1997,1998,Coventry,Blackburn,Draw,Away,1997-09-28,1,2,5,5,6,2,2,5,8,0,3,0,-2,0,17.0,13.0,4.0,2
5179,5179,1997-98,1997,1998,Coventry,Leeds,Draw,Home,1997-10-04,1,2,3,6,6,6,6,9,9,-4,-3,-3,-3,1,17.0,11.0,6.0,3
5180,5180,1997-98,1997,1998,Coventry,Barnsley,Loss,Away,1997-10-20,0,2,3,4,7,0,0,0,0,2,3,4,7,0,17.0,21.0,-4.0,3
5181,5181,1997-98,1997,1998,Coventry,Everton,Draw,Home,1997-10-25,1,1,2,3,4,3,4,4,7,-2,-2,-1,-3,1,17.0,15.0,2.0,3
5182,5182,1997-98,1997,1998,Coventry,Wimbledon,Win,Away,1997-11-01,3,1,2,3,4,4,7,7,8,-3,-5,-4,-4,0,17.0,8.0,9.0,4
5183,5183,1997-98,1997,1998,Coventry,Newcastle,Draw,Home,1997-11-08,1,4,4,5,6,2,2,5,5,2,2,0,1,1,17.0,2.0,15.0,4
5184,5184,1997-98,1997,1998,Coventry,Derby,Loss,Away,1997-11-22,0,4,5,5,6,3,3,4,5,1,2,1,1,0,17.0,12.0,5.0,4
5185,5185,1997-98,1997,1998,Coventry,Leicester,Loss,Home,1997-11-29,0,1,4,5,5,1,2,5,5,0,2,0,0,1,17.0,9.0,8.0,4
5186,5186,1997-98,1997,1998,Coventry,Aston Villa,Loss,Away,1997-12-06,0,0,1,4,5,3,4,4,5,-3,-3,0,0,0,17.0,5.0,12.0,5
5187,5187,1997-98,1997,1998,Coventry,Tottenham,Win,Home,1997-12-13,3,0,0,1,4,3,3,3,3,-3,-3,-2,1,1,17.0,10.0,7.0,5
5188,5188,1997-98,1997,1998,Coventry,Liverpool,Loss,Away,1997-12-20,0,3,3,3,4,3,6,6,9,0,-3,-3,-5,0,17.0,4.0,13.0,5
5189,5189,1997-98,1997,1998,Coventry,West Ham,Loss,Away,1997-12-26,0,3,3,3,3,3,3,6,9,0,0,-3,-6,0,17.0,14.0,3.0,5
5190,5190,1997-98,1997,1998,Coventry,Man United,Win,Home,1997-12-28,3,0,3,3,3,6,9,12,15,-6,-6,-9,-12,1,17.0,1.0,16.0,5
5191,5191,1997-98,1997,1998,Coventry,Chelsea,Loss,Away,1998-01-10,0,3,3,6,6,1,4,5,8,2,-1,1,-2,0,17.0,6.0,11.0,6
5192,5192,1997-98,1997,1998,Coventry,Arsenal,Draw,Home,1998-01-17,1,3,3,3,6,4,7,7,10,-1,-4,-4,-4,1,17.0,3.0,14.0,6
5193,5193,1997-98,1997,1998,Coventry,Bolton,Win,Away,1998-01-31,3,1,4,4,4,1,1,2,2,0,3,2,2,0,17.0,21.0,-4.0,6
5194,5194,1997-98,1997,1998,Coventry,Sheffield Weds,Win,Home,1998-02-07,3,4,4,7,7,4,7,8,9,0,-3,-1,-2,1,17.0,7.0,10.0,7
5195,5195,1997-98,1997,1998,Coventry,Southampton,Win,Away,1998-02-18,3,6,7,7,10,3,6,7,10,3,1,0,0,0,17.0,16.0,1.0,7
5196,5196,1997-98,1997,1998,Coventry,Barnsley,Win,Home,1998-02-21,3,6,9,10,10,1,4,4,7,5,5,6,3,1,17.0,21.0,-4.0,7
5197,5197,1997-98,1997,1998,Coventry,Crystal Palace,Win,Away,1998-02-28,3,6,9,12,13,0,0,0,0,6,9,12,13,0,17.0,21.0,-4.0,7
5198,5198,1997-98,1997,1998,Coventry,Newcastle,Draw,Away,1998-03-14,1,6,9,12,15,2,2,5,5,4,7,7,10,0,17.0,2.0,15.0,8
5199,5199,1997-98,1997,1998,Coventry,Derby,Win,Home,1998-03-28,3,4,7,10,13,3,3,6,6,1,4,4,7,1,17.0,12.0,5.0,8
5200,5200,1997-98,1997,1998,Coventry,Leicester,Draw,Away,1998-04-04,1,4,7,10,13,0,0,3,4,4,7,7,9,0,17.0,9.0,8.0,9
5201,5201,1997-98,1997,1998,Coventry,Aston Villa,Loss,Home,1998-04-11,0,4,5,8,11,6,9,9,12,-2,-4,-1,-1,1,17.0,5.0,12.0,9
5202,5202,1997-98,1997,1998,Coventry,Tottenham,Draw,Away,1998-04-13,1,1,4,5,8,1,4,5,5,0,0,0,3,0,17.0,10.0,7.0,9
5203,5203,1997-98,1997,1998,Coventry,Liverpool,Draw,Home,1998-04-19,1,1,2,5,6,4,7,8,11,-3,-5,-3,-5,1,17.0,4.0,13.0,9
5204,5204,1997-98,1997,1998,Coventry,Leeds,Draw,Away,1998-04-25,1,2,2,3,6,3,6,9,9,-1,-4,-6,-3,0,17.0,11.0,6.0,9
5205,5205,1997-98,1997,1998,Coventry,Wimbledon,Draw,Home,1998-04-29,1,2,3,3,4,1,2,5,6,1,1,-2,-2,1,17.0,8.0,9.0,9
5206,5206,1997-98,1997,1998,Coventry,Blackburn,Win,Home,1998-05-02,3,2,3,4,4,4,4,4,4,-2,-1,0,0,1,17.0,13.0,4.0,10
5207,5207,1997-98,1997,1998,Coventry,Everton,Draw,Away,1998-05-10,1,4,5,6,7,0,1,2,5,4,4,4,2,0,17.0,15.0,2.0,10
5208,5208,1998-99,1998,1999,Coventry,Chelsea,Win,Home,1998-08-15,3,4,5,6,7,3,3,6,9,1,2,0,-2,1,11.0,4.0,7.0,1
5209,5209,1998-99,1998,1999,Coventry,Nott'm Forest,Loss,Away,1998-08-22,0,4,7,8,9,0,1,2,3,4,6,6,6,0,11.0,21.0,-10.0,1
5210,5210,1998-99,1998,1999,Coventry,West Ham,Draw,Home,1998-08-29,1,3,4,7,8,4,7,8,8,-1,-3,-1,0,1,11.0,8.0,3.0,1
5211,5211,1998-99,1998,1999,Coventry,Liverpool,Loss,Away,1998-09-09,0,1,4,5,8,4,7,7,10,-3,-3,-2,-2,0,11.0,3.0,8.0,2
5212,5212,1998-99,1998,1999,Coventry,Man United,Loss,Away,1998-09-12,0,1,1,4,5,4,5,8,11,-3,-4,-4,-6,0,11.0,2.0,9.0,2
5213,5213,1998-99,1998,1999,Coventry,Newcastle,Loss,Home,1998-09-19,0,0,1,1,4,3,3,4,5,-3,-2,-3,-1,1,11.0,13.0,-2.0,2
5214,5214,1998-99,1998,1999,Coventry,Charlton,Draw,Away,1998-09-26,1,0,0,1,1,1,1,2,5,-1,-1,-1,-4,0,11.0,21.0,-10.0,2
5215,5215,1998-99,1998,1999,Coventry,Aston Villa,Loss,Home,1998-10-03,0,1,1,1,2,4,7,10,13,-3,-6,-9,-11,1,11.0,7.0,4.0,3
5216,5216,1998-99,1998,1999,Coventry,Sheffield Weds,Win,Home,1998-10-18,3,1,1,1,1,3,3,6,6,-2,-2,-5,-5,1,11.0,16.0,-5.0,3
5217,5217,1998-99,1998,1999,Coventry,Southampton,Loss,Away,1998-10-24,0,3,4,4,4,1,1,2,2,2,3,2,2,0,11.0,12.0,-1.0,3
5218,5218,1998-99,1998,1999,Coventry,Arsenal,Loss,Home,1998-10-31,0,3,3,4,4,4,7,7,10,-1,-4,-3,-6,1,11.0,1.0,10.0,3
5219,5219,1998-99,1998,1999,Coventry,Blackburn,Win,Away,1998-11-07,3,0,3,3,4,1,1,4,5,-1,2,-1,-1,0,11.0,6.0,5.0,4
5220,5220,1998-99,1998,1999,Coventry,Everton,Win,Home,1998-11-15,3,3,3,6,6,0,1,2,5,3,2,4,1,1,11.0,17.0,-6.0,4
5221,5221,1998-99,1998,1999,Coventry,Middlesbrough,Loss,Away,1998-11-21,0,6,6,6,9,2,3,4,7,4,3,2,2,0,11.0,21.0,-10.0,4
5222,5222,1998-99,1998,1999,Coventry,Leicester,Draw,Home,1998-11-28,1,3,6,6,6,0,1,4,5,3,5,2,1,1,11.0,10.0,1.0,4
5223,5223,1998-99,1998,1999,Coventry,Wimbledon,Loss,Away,1998-12-05,0,1,4,7,7,3,3,6,7,-2,1,1,0,0,11.0,15.0,-4.0,5
5224,5224,1998-99,1998,1999,Coventry,Leeds,Loss,Away,1998-12-14,0,1,1,4,7,3,6,9,12,-2,-5,-5,-5,0,11.0,5.0,6.0,5
5225,5225,1998-99,1998,1999,Coventry,Derby,Draw,Home,1998-12-19,1,0,1,1,4,2,5,5,6,-2,-4,-4,-2,1,11.0,9.0,2.0,5
5226,5226,1998-99,1998,1999,Coventry,Tottenham,Draw,Home,1998-12-26,1,1,1,2,2,1,4,4,7,0,-3,-2,-5,1,11.0,14.0,-3.0,5
5227,5227,1998-99,1998,1999,Coventry,West Ham,Loss,Away,1998-12-28,0,2,2,2,3,3,3,3,6,-1,-1,-1,-3,0,11.0,8.0,3.0,5
5228,5228,1998-99,1998,1999,Coventry,Nott'm Forest,Win,Home,1999-01-09,3,1,2,2,2,1,2,2,2,0,0,0,0,1,11.0,21.0,-10.0,6
5229,5229,1998-99,1998,1999,Coventry,Chelsea,Loss,Away,1999-01-16,0,3,4,5,5,4,7,10,11,-1,-3,-5,-6,0,11.0,4.0,7.0,6
5230,5230,1998-99,1998,1999,Coventry,Liverpool,Win,Home,1999-01-30,3,3,3,4,5,4,7,10,13,-1,-4,-6,-8,1,11.0,3.0,8.0,6
5231,5231,1998-99,1998,1999,Coventry,Tottenham,Draw,Away,1999-02-06,1,3,6,6,7,2,3,6,7,1,3,0,0,0,11.0,14.0,-3.0,7
5232,5232,1998-99,1998,1999,Coventry,Newcastle,Loss,Away,1999-02-17,0,4,4,7,7,6,7,7,7,-2,-3,0,0,0,11.0,13.0,-2.0,7
5233,5233,1998-99,1998,1999,Coventry,Man United,Loss,Home,1999-02-20,0,1,4,4,7,4,7,10,13,-3,-3,-6,-6,1,11.0,2.0,9.0,7
5234,5234,1998-99,1998,1999,Coventry,Aston Villa,Win,Away,1999-02-27,3,0,1,4,4,1,1,1,4,-1,0,3,0,0,11.0,7.0,4.0,7
5235,5235,1998-99,1998,1999,Coventry,Charlton,Win,Home,1999-03-06,3,3,3,4,7,4,7,10,10,-1,-4,-6,-3,1,11.0,21.0,-10.0,8
5236,5236,1998-99,1998,1999,Coventry,Blackburn,Draw,Home,1999-03-13,1,6,6,6,7,0,0,1,4,6,6,5,3,1,11.0,6.0,5.0,8
5237,5237,1998-99,1998,1999,Coventry,Arsenal,Loss,Away,1999-03-20,0,4,7,7,7,6,7,10,11,-2,0,-3,-4,0,11.0,1.0,10.0,8
5238,5238,1998-99,1998,1999,Coventry,Sheffield Weds,Win,Away,1999-04-03,3,1,4,7,7,0,0,0,3,1,4,7,4,0,11.0,16.0,-5.0,9
5239,5239,1998-99,1998,1999,Coventry,Southampton,Win,Home,1999-04-05,3,3,4,7,10,4,4,7,7,-1,0,0,3,1,11.0,12.0,-1.0,9
5240,5240,1998-99,1998,1999,Coventry,Everton,Loss,Away,1999-04-11,0,6,6,7,10,0,0,0,3,6,6,7,7,0,11.0,17.0,-6.0,9
5241,5241,1998-99,1998,1999,Coventry,Middlesbrough,Loss,Home,1999-04-17,0,3,6,6,7,4,7,8,11,-1,-1,-2,-4,1,11.0,21.0,-10.0,9
5242,5242,1998-99,1998,1999,Coventry,Leicester,Loss,Away,1999-04-24,0,0,3,6,6,4,5,6,9,-4,-2,0,-3,0,11.0,10.0,1.0,9
5243,5243,1998-99,1998,1999,Coventry,Wimbledon,Win,Home,1999-05-01,3,0,0,3,6,1,1,1,2,-1,-1,2,4,1,11.0,15.0,-4.0,10
5244,5244,1998-99,1998,1999,Coventry,Derby,Draw,Away,1999-05-08,1,3,3,3,6,3,4,4,7,0,-1,-1,-1,0,11.0,9.0,2.0,10
5245,5245,1998-99,1998,1999,Coventry,Leeds,Draw,Home,1999-05-16,1,4,4,4,4,3,6,7,8,1,-2,-3,-4,1,11.0,5.0,6.0,10
5246,5246,1999-00,1999,2000,Coventry,Southampton,Loss,Home,1999-08-07,0,2,5,5,5,6,9,10,11,-4,-4,-5,-6,1,15.0,17.0,-2.0,1
5247,5247,1999-00,1999,2000,Coventry,Leicester,Loss,Away,1999-08-11,0,1,2,5,5,0,3,3,3,1,-1,2,2,0,15.0,10.0,5.0,1
5248,5248,1999-00,1999,2000,Coventry,Wimbledon,Draw,Away,1999-08-14,1,0,1,2,5,3,3,3,3,-3,-2,-1,2,0,15.0,16.0,-1.0,1
5249,5249,1999-00,1999,2000,Coventry,Derby,Win,Home,1999-08-21,3,1,1,2,3,0,1,1,2,1,0,1,1,1,15.0,8.0,7.0,1
5250,5250,1999-00,1999,2000,Coventry,Man United,Loss,Home,1999-08-25,0,4,4,4,5,6,9,10,13,-2,-5,-6,-8,1,15.0,1.0,14.0,1
5251,5251,1999-00,1999,2000,Coventry,Sunderland,Draw,Away,1999-08-29,1,3,4,4,4,3,4,7,7,0,0,-3,-3,0,15.0,21.0,-6.0,1
5252,5252,1999-00,1999,2000,Coventry,Leeds,Loss,Home,1999-09-11,0,1,4,5,5,3,6,6,9,-2,-2,-1,-4,1,15.0,4.0,11.0,2
5253,5253,1999-00,1999,2000,Coventry,Tottenham,Loss,Away,1999-09-19,0,1,1,4,5,1,4,7,10,0,-3,-3,-5,0,15.0,11.0,4.0,2
5254,5254,1999-00,1999,2000,Coventry,West Ham,Win,Home,1999-09-25,3,0,1,1,4,3,6,9,10,-3,-5,-8,-6,1,15.0,5.0,10.0,2
5255,5255,1999-00,1999,2000,Coventry,Everton,Draw,Away,1999-10-02,1,3,3,4,4,6,9,9,12,-3,-6,-5,-8,0,15.0,14.0,1.0,3
5256,5256,1999-00,1999,2000,Coventry,Newcastle,Win,Home,1999-10-16,3,4,4,4,5,3,6,6,6,1,-2,-2,-1,1,15.0,13.0,2.0,3
5257,5257,1999-00,1999,2000,Coventry,Sheffield Weds,Draw,Away,1999-10-23,1,4,7,7,7,3,3,3,3,1,4,4,4,0,15.0,12.0,3.0,3
5258,5258,1999-00,1999,2000,Coventry,Watford,Win,Home,1999-10-31,3,4,5,8,8,0,0,0,3,4,5,8,5,1,15.0,21.0,-6.0,3
5259,5259,1999-00,1999,2000,Coventry,Bradford,Draw,Away,1999-11-06,1,4,7,8,11,3,3,3,6,1,4,5,5,0,15.0,21.0,-6.0,4
5260,5260,1999-00,1999,2000,Coventry,Aston Villa,Win,Home,1999-11-22,3,4,5,8,9,0,1,1,2,4,4,7,7,1,15.0,6.0,9.0,4
5261,5261,1999-00,1999,2000,Coventry,Leicester,Loss,Home,1999-11-27,0,4,7,8,11,3,6,6,9,1,1,2,2,1,15.0,10.0,5.0,4
5262,5262,1999-00,1999,2000,Coventry,Southampton,Draw,Away,1999-12-04,1,3,4,7,8,0,3,4,5,3,1,3,3,0,15.0,17.0,-2.0,5
5263,5263,1999-00,1999,2000,Coventry,Liverpool,Loss,Away,1999-12-18,0,1,4,5,8,3,6,9,12,-2,-2,-4,-4,0,15.0,7.0,8.0,5
5264,5264,1999-00,1999,2000,Coventry,Arsenal,Win,Home,1999-12-26,3,1,1,4,5,4,7,10,10,-3,-6,-6,-5,1,15.0,2.0,13.0,5
5265,5265,1999-00,1999,2000,Coventry,Chelsea,Draw,Home,2000-01-04,1,3,4,4,7,6,6,6,9,-3,-2,-2,-2,1,15.0,3.0,12.0,6
5266,5266,1999-00,1999,2000,Coventry,Wimbledon,Win,Home,2000-01-15,3,4,4,5,5,3,4,5,8,1,0,0,-3,1,15.0,16.0,-1.0,6
5267,5267,1999-00,1999,2000,Coventry,Derby,Draw,Away,2000-01-22,1,4,7,7,8,6,7,7,10,-2,0,0,-2,0,15.0,8.0,7.0,6
5268,5268,1999-00,1999,2000,Coventry,Man United,Loss,Away,2000-02-05,0,4,5,8,8,6,7,8,11,-2,-2,0,-3,0,15.0,1.0,14.0,7
5269,5269,1999-00,1999,2000,Coventry,Sunderland,Win,Home,2000-02-12,3,1,4,5,8,1,1,1,2,0,3,4,6,1,15.0,21.0,-6.0,7
5270,5270,1999-00,1999,2000,Coventry,Middlesbrough,Loss,Away,2000-02-19,0,3,4,7,8,0,0,1,1,3,4,6,7,0,15.0,9.0,6.0,7
5271,5271,1999-00,1999,2000,Coventry,Tottenham,Loss,Home,2000-02-26,0,3,3,4,7,0,0,1,1,3,3,3,6,1,15.0,11.0,4.0,7
5272,5272,1999-00,1999,2000,Coventry,Leeds,Loss,Away,2000-03-05,0,0,3,3,4,1,4,4,7,-1,-1,-1,-3,0,15.0,4.0,11.0,8
5273,5273,1999-00,1999,2000,Coventry,Aston Villa,Loss,Away,2000-03-11,0,0,0,3,3,2,5,8,9,-2,-5,-5,-6,0,15.0,6.0,9.0,8
5274,5274,1999-00,1999,2000,Coventry,Everton,Win,Home,2000-03-15,3,0,0,0,3,2,5,8,11,-2,-5,-8,-8,1,15.0,14.0,1.0,8
5275,5275,1999-00,1999,2000,Coventry,Bradford,Win,Home,2000-03-18,3,3,3,3,3,1,2,2,5,2,1,1,-2,1,15.0,21.0,-6.0,8
5276,5276,1999-00,1999,2000,Coventry,Arsenal,Loss,Away,2000-03-26,0,6,6,6,6,3,4,7,7,3,2,-1,-1,0,15.0,2.0,13.0,8
5277,5277,1999-00,1999,2000,Coventry,Liverpool,Loss,Home,2000-04-01,0,3,6,6,6,6,7,8,9,-3,-1,-2,-3,1,15.0,7.0,8.0,9
5278,5278,1999-00,1999,2000,Coventry,Chelsea,Loss,Away,2000-04-12,0,0,3,6,6,4,5,6,9,-4,-2,0,-3,0,15.0,3.0,12.0,9
5279,5279,1999-00,1999,2000,Coventry,Middlesbrough,Win,Home,2000-04-15,3,0,0,3,6,3,6,7,10,-3,-6,-4,-4,1,15.0,9.0,6.0,9
5280,5280,1999-00,1999,2000,Coventry,West Ham,Loss,Away,2000-04-22,0,3,3,3,6,6,6,9,10,-3,-3,-6,-4,0,15.0,5.0,10.0,9
5281,5281,1999-00,1999,2000,Coventry,Newcastle,Loss,Away,2000-04-29,0,3,3,3,3,1,1,4,4,2,2,-1,-1,0,15.0,13.0,2.0,9
5282,5282,1999-00,1999,2000,Coventry,Sheffield Weds,Win,Home,2000-05-06,3,0,3,3,3,0,3,6,6,0,0,-3,-3,1,15.0,12.0,3.0,10
5283,5283,1999-00,1999,2000,Coventry,Watford,Loss,Away,2000-05-14,0,3,3,6,6,1,1,1,1,2,2,5,5,0,15.0,21.0,-6.0,10
5284,5284,2000-01,2000,2001,Coventry,Middlesbrough,Loss,Home,2000-08-19,0,3,3,3,6,4,5,8,9,-1,-2,-5,-3,1,14.0,12.0,2.0,1
5285,5285,2000-01,2000,2001,Coventry,Southampton,Win,Away,2000-08-23,3,0,3,3,3,4,5,5,5,-4,-2,-2,-2,0,14.0,15.0,-1.0,1
5286,5286,2000-01,2000,2001,Coventry,Man City,Win,Away,2000-08-26,3,3,3,6,6,3,4,7,10,0,-1,-1,-4,0,14.0,21.0,-7.0,1
5287,5287,2000-01,2000,2001,Coventry,Newcastle,Loss,Home,2000-09-06,0,6,6,6,9,6,6,9,10,0,0,-3,-1,1,14.0,11.0,3.0,2
5288,5288,2000-01,2000,2001,Coventry,Leeds,Draw,Home,2000-09-09,1,3,6,6,6,3,6,7,8,0,0,-1,-2,1,14.0,3.0,11.0,2
5289,5289,2000-01,2000,2001,Coventry,Arsenal,Loss,Away,2000-09-16,0,1,4,7,7,2,5,8,8,-1,-1,-1,-1,0,14.0,2.0,12.0,2
5290,5290,2000-01,2000,2001,Coventry,West Ham,Loss,Home,2000-09-23,0,1,1,4,7,1,2,3,3,0,-1,1,4,1,14.0,9.0,5.0,2
5291,5291,2000-01,2000,2001,Coventry,Charlton,Draw,Away,2000-09-30,1,0,1,1,4,6,7,8,8,-6,-6,-7,-4,0,14.0,21.0,-7.0,2
5292,5292,2000-01,2000,2001,Coventry,Tottenham,Win,Home,2000-10-14,3,1,1,2,2,1,1,4,7,0,0,-2,-5,1,14.0,10.0,4.0,3
5293,5293,2000-01,2000,2001,Coventry,Chelsea,Loss,Away,2000-10-21,0,4,4,4,5,3,4,4,5,1,0,0,0,0,14.0,5.0,9.0,3
5294,5294,2000-01,2000,2001,Coventry,Sunderland,Loss,Away,2000-10-28,0,3,4,4,4,4,5,6,9,-1,-1,-2,-5,0,14.0,7.0,7.0,3
5295,5295,2000-01,2000,2001,Coventry,Man United,Loss,Home,2000-11-04,0,0,3,4,4,6,9,9,10,-6,-6,-5,-6,1,14.0,1.0,13.0,4
5296,5296,2000-01,2000,2001,Coventry,Liverpool,Loss,Away,2000-11-12,0,0,0,3,4,3,6,9,9,-3,-6,-6,-5,0,14.0,4.0,10.0,4
5297,5297,2000-01,2000,2001,Coventry,Ipswich,Loss,Home,2000-11-20,0,0,0,0,3,3,6,9,10,-3,-6,-9,-7,1,14.0,21.0,-7.0,4
5298,5298,2000-01,2000,2001,Coventry,Aston Villa,Draw,Home,2000-11-25,1,0,0,0,0,3,6,9,10,-3,-6,-9,-10,1,14.0,6.0,8.0,4
5299,5299,2000-01,2000,2001,Coventry,Bradford,Loss,Away,2000-12-02,0,1,1,1,1,1,1,1,2,0,0,0,-1,0,14.0,17.0,-3.0,5
5300,5300,2000-01,2000,2001,Coventry,Leicester,Win,Home,2000-12-10,3,1,1,1,1,3,6,7,10,-2,-5,-6,-9,1,14.0,8.0,6.0,5
5301,5301,2000-01,2000,2001,Coventry,Derby,Loss,Away,2000-12-16,0,3,4,4,4,3,3,6,7,0,1,-2,-3,0,14.0,16.0,-2.0,5
5302,5302,2000-01,2000,2001,Coventry,Southampton,Draw,Home,2000-12-22,1,3,3,4,4,3,3,3,6,0,0,1,-2,1,14.0,15.0,-1.0,5
5303,5303,2000-01,2000,2001,Coventry,Everton,Win,Away,2000-12-26,3,1,4,4,5,1,1,1,4,0,3,3,1,0,14.0,13.0,1.0,5
5304,5304,2000-01,2000,2001,Coventry,Middlesbrough,Draw,Away,2000-12-30,1,4,4,7,7,4,7,7,7,0,-3,0,0,0,14.0,12.0,2.0,5
5305,5305,2000-01,2000,2001,Coventry,Man City,Draw,Home,2001-01-01,1,4,5,5,8,1,1,2,5,3,4,3,3,1,14.0,21.0,-7.0,6
5306,5306,2000-01,2000,2001,Coventry,Newcastle,Loss,Away,2001-01-13,0,2,5,6,6,1,4,4,7,1,1,2,-1,0,14.0,11.0,3.0,6
5307,5307,2000-01,2000,2001,Coventry,Everton,Loss,Home,2001-01-20,0,1,2,5,6,1,1,1,2,0,1,4,4,1,14.0,13.0,1.0,6
5308,5308,2000-01,2000,2001,Coventry,Leeds,Loss,Away,2001-01-31,0,0,1,2,5,3,6,7,7,-3,-5,-5,-2,0,14.0,3.0,11.0,6
5309,5309,2000-01,2000,2001,Coventry,Arsenal,Loss,Home,2001-02-03,0,0,0,1,2,4,5,5,6,-4,-5,-4,-4,1,14.0,2.0,12.0,7
5310,5310,2000-01,2000,2001,Coventry,West Ham,Draw,Away,2001-02-12,1,0,0,0,1,1,2,2,2,-1,-2,-2,-1,0,14.0,9.0,5.0,7
5311,5311,2000-01,2000,2001,Coventry,Charlton,Draw,Home,2001-02-24,1,1,1,1,1,4,7,8,9,-3,-6,-7,-8,1,14.0,21.0,-7.0,7
5312,5312,2000-01,2000,2001,Coventry,Chelsea,Draw,Home,2001-03-03,1,2,2,2,2,1,4,7,8,1,-2,-5,-6,1,14.0,5.0,9.0,8
5313,5313,2000-01,2000,2001,Coventry,Tottenham,Loss,Away,2001-03-17,0,2,3,3,3,0,3,4,5,2,0,-1,-2,0,14.0,10.0,4.0,8
5314,5314,2000-01,2000,2001,Coventry,Derby,Win,Home,2001-03-31,3,1,2,3,3,4,7,8,11,-3,-5,-5,-8,1,14.0,16.0,-2.0,8
5315,5315,2000-01,2000,2001,Coventry,Leicester,Win,Away,2001-04-07,3,3,4,5,6,0,0,3,6,3,4,2,0,0,14.0,8.0,6.0,9
5316,5316,2000-01,2000,2001,Coventry,Man United,Loss,Away,2001-04-14,0,6,6,7,8,3,6,7,10,3,0,0,-2,0,14.0,1.0,13.0,9
5317,5317,2000-01,2000,2001,Coventry,Sunderland,Win,Home,2001-04-16,3,3,6,6,7,1,1,4,5,2,5,2,2,1,14.0,7.0,7.0,9
5318,5318,2000-01,2000,2001,Coventry,Ipswich,Loss,Away,2001-04-21,0,3,6,9,9,6,7,10,13,-3,-1,-1,-4,0,14.0,21.0,-7.0,9
5319,5319,2000-01,2000,2001,Coventry,Liverpool,Loss,Home,2001-04-28,0,3,3,6,9,6,6,7,10,-3,-3,-1,-1,1,14.0,4.0,10.0,9
5320,5320,2000-01,2000,2001,Coventry,Aston Villa,Loss,Away,2001-05-05,0,0,3,3,6,2,3,6,7,-2,0,-3,-1,0,14.0,6.0,8.0,10
5321,5321,2000-01,2000,2001,Coventry,Bradford,Draw,Home,2001-05-19,1,0,0,3,3,1,1,1,4,-1,-1,2,-1,1,14.0,17.0,-3.0,10
5322,5322,1994-95,1994,1995,Crystal Palace,Liverpool,Loss,Home,1994-08-20,0,0,0,0,0,0,3,3,6,0,-3,-3,-6,1,21.0,8.0,13.0,1
5323,5323,1994-95,1994,1995,Crystal Palace,Norwich,Draw,Away,1994-08-24,1,0,0,0,0,1,4,4,5,-1,-4,-4,-5,0,21.0,12.0,9.0,1
5324,5324,1994-95,1994,1995,Crystal Palace,Aston Villa,Draw,Away,1994-08-27,1,1,1,1,1,2,5,5,5,-1,-4,-4,-4,0,21.0,10.0,11.0,1
5325,5325,1994-95,1994,1995,Crystal Palace,Leeds,Loss,Home,1994-08-30,0,2,2,2,2,3,4,7,8,-1,-2,-5,-6,1,21.0,5.0,16.0,1
5326,5326,1994-95,1994,1995,Crystal Palace,Man City,Draw,Away,1994-09-10,1,1,2,2,2,3,6,6,7,-2,-4,-4,-5,0,21.0,16.0,5.0,2
5327,5327,1994-95,1994,1995,Crystal Palace,Wimbledon,Draw,Home,1994-09-17,1,1,2,3,3,3,3,4,5,-2,-1,-1,-2,1,21.0,6.0,15.0,2
5328,5328,1994-95,1994,1995,Crystal Palace,Chelsea,Loss,Home,1994-09-24,0,2,2,3,4,0,3,6,9,2,-1,-3,-5,1,21.0,14.0,7.0,2
5329,5329,1994-95,1994,1995,Crystal Palace,Arsenal,Win,Away,1994-10-01,3,1,2,2,3,3,4,5,5,-2,-2,-3,-2,0,21.0,4.0,17.0,3
5330,5330,1994-95,1994,1995,Crystal Palace,West Ham,Loss,Away,1994-10-08,0,3,4,5,5,3,6,7,7,0,-2,-2,-2,0,21.0,13.0,8.0,3
5331,5331,1994-95,1994,1995,Crystal Palace,Newcastle,Loss,Home,1994-10-15,0,3,3,4,5,4,5,8,11,-1,-2,-4,-6,1,21.0,3.0,18.0,3
5332,5332,1994-95,1994,1995,Crystal Palace,Everton,Win,Home,1994-10-22,3,0,3,3,4,0,0,1,2,0,3,2,2,1,21.0,17.0,4.0,3
5333,5333,1994-95,1994,1995,Crystal Palace,Leicester,Win,Away,1994-10-29,3,3,3,6,6,3,3,4,5,0,0,2,1,0,21.0,21.0,0.0,3
5334,5334,1994-95,1994,1995,Crystal Palace,Coventry,Win,Away,1994-11-02,3,6,6,6,9,3,6,9,10,3,0,-3,-1,0,21.0,11.0,10.0,4
5335,5335,1994-95,1994,1995,Crystal Palace,Ipswich,Win,Home,1994-11-05,3,6,9,9,9,3,3,3,3,3,6,6,6,1,21.0,19.0,2.0,4
5336,5336,1994-95,1994,1995,Crystal Palace,Man United,Loss,Away,1994-11-19,0,6,9,12,12,6,9,12,15,0,0,0,-3,0,21.0,1.0,20.0,4
5337,5337,1994-95,1994,1995,Crystal Palace,Southampton,Draw,Home,1994-11-26,1,3,6,9,12,4,5,5,5,-1,1,4,7,1,21.0,18.0,3.0,4
5338,5338,1994-95,1994,1995,Crystal Palace,Sheffield Weds,Loss,Away,1994-12-03,0,1,4,7,10,4,5,5,6,-3,-1,2,4,0,21.0,7.0,14.0,5
5339,5339,1994-95,1994,1995,Crystal Palace,Liverpool,Draw,Away,1994-12-11,1,1,1,4,7,2,2,5,8,-1,-1,-1,-1,0,21.0,8.0,13.0,5
5340,5340,1994-95,1994,1995,Crystal Palace,Norwich,Loss,Home,1994-12-17,0,1,2,2,5,3,6,6,7,-2,-4,-4,-2,1,21.0,12.0,9.0,5
5341,5341,1994-95,1994,1995,Crystal Palace,QPR,Draw,Home,1994-12-26,1,1,1,2,2,3,6,6,9,-2,-5,-4,-7,1,21.0,9.0,12.0,5
5342,5342,1994-95,1994,1995,Crystal Palace,Tottenham,Draw,Away,1994-12-27,1,1,2,2,3,4,7,10,11,-3,-5,-8,-8,0,21.0,15.0,6.0,5
5343,5343,1994-95,1994,1995,Crystal Palace,Blackburn,Loss,Home,1994-12-31,0,2,2,3,3,4,7,10,13,-2,-5,-7,-10,1,21.0,2.0,19.0,5
5344,5344,1994-95,1994,1995,Crystal Palace,Nott'm Forest,Loss,Away,1995-01-02,0,1,2,2,3,3,4,7,10,-2,-2,-5,-7,0,21.0,21.0,0.0,6
5345,5345,1994-95,1994,1995,Crystal Palace,Leicester,Win,Home,1995-01-14,3,0,1,2,2,0,1,1,2,0,0,1,0,1,21.0,21.0,0.0,6
5346,5346,1994-95,1994,1995,Crystal Palace,Everton,Loss,Away,1995-01-21,0,3,3,4,5,1,4,4,5,2,-1,0,0,0,21.0,17.0,4.0,6
5347,5347,1994-95,1994,1995,Crystal Palace,Man United,Draw,Home,1995-01-25,1,3,3,3,4,4,7,8,9,-1,-4,-5,-5,1,21.0,1.0,20.0,6
5348,5348,1994-95,1994,1995,Crystal Palace,Ipswich,Win,Away,1995-02-04,3,1,4,4,4,1,4,7,7,0,0,-3,-3,0,21.0,19.0,2.0,7
5349,5349,1994-95,1994,1995,Crystal Palace,Coventry,Loss,Home,1995-02-11,0,4,4,7,7,2,2,3,3,2,2,4,4,1,21.0,11.0,10.0,7
5350,5350,1994-95,1994,1995,Crystal Palace,Arsenal,Loss,Home,1995-02-25,0,3,4,4,7,4,4,5,8,-1,0,-1,-1,1,21.0,4.0,17.0,7
5351,5351,1994-95,1994,1995,Crystal Palace,Chelsea,Draw,Away,1995-03-05,1,0,3,4,4,4,5,5,6,-4,-2,-1,-2,0,21.0,14.0,7.0,8
5352,5352,1994-95,1994,1995,Crystal Palace,Sheffield Weds,Win,Home,1995-03-14,3,1,1,4,5,1,4,4,4,0,-3,0,1,1,21.0,7.0,14.0,8
5353,5353,1994-95,1994,1995,Crystal Palace,Wimbledon,Loss,Away,1995-03-18,0,4,4,4,7,3,3,6,6,1,1,-2,1,0,21.0,6.0,15.0,8
5354,5354,1994-95,1994,1995,Crystal Palace,Man City,Win,Home,1995-04-01,3,3,4,4,4,3,4,4,5,0,0,0,-1,1,21.0,16.0,5.0,9
5355,5355,1994-95,1994,1995,Crystal Palace,Aston Villa,Draw,Home,1995-04-04,1,3,6,7,7,3,4,4,4,0,2,3,3,1,21.0,10.0,11.0,9
5356,5356,1994-95,1994,1995,Crystal Palace,Tottenham,Draw,Home,1995-04-14,1,4,4,7,8,3,4,7,8,1,0,0,0,1,21.0,15.0,6.0,9
5357,5357,1994-95,1994,1995,Crystal Palace,QPR,Win,Away,1995-04-17,3,2,5,5,8,3,6,6,9,-1,-1,-1,-1,0,21.0,9.0,12.0,9
5358,5358,1994-95,1994,1995,Crystal Palace,Blackburn,Loss,Away,1995-04-19,0,4,5,8,8,1,4,7,10,3,1,1,-2,0,21.0,2.0,19.0,9
5359,5359,1994-95,1994,1995,Crystal Palace,Nott'm Forest,Loss,Home,1995-04-29,0,3,4,5,8,6,7,10,13,-3,-3,-5,-5,1,21.0,21.0,0.0,9
5360,5360,1994-95,1994,1995,Crystal Palace,Southampton,Loss,Away,1995-05-03,0,0,3,4,5,4,7,10,10,-4,-4,-6,-5,0,21.0,18.0,3.0,10
5361,5361,1994-95,1994,1995,Crystal Palace,West Ham,Win,Home,1995-05-06,3,0,0,3,4,4,5,8,9,-4,-5,-5,-5,1,21.0,13.0,8.0,10
5362,5362,1994-95,1994,1995,Crystal Palace,Leeds,Loss,Away,1995-05-09,0,3,3,3,6,6,9,10,13,-3,-6,-7,-7,0,21.0,5.0,16.0,10
5363,5363,1994-95,1994,1995,Crystal Palace,Newcastle,Loss,Away,1995-05-14,0,3,3,3,3,1,2,2,2,2,1,1,1,0,21.0,3.0,18.0,10
5364,5364,1997-98,1997,1998,Crystal Palace,Everton,Win,Away,1997-08-09,3,0,3,3,3,0,1,2,5,0,2,1,-2,0,21.0,15.0,6.0,1
5365,5365,1997-98,1997,1998,Crystal Palace,Barnsley,Loss,Home,1997-08-12,0,3,3,6,6,0,0,0,0,3,3,6,6,1,21.0,21.0,0.0,1
5366,5366,1997-98,1997,1998,Crystal Palace,Leeds,Win,Away,1997-08-23,3,3,3,3,6,4,5,6,7,-1,-2,-3,-1,0,21.0,11.0,10.0,1
5367,5367,1997-98,1997,1998,Crystal Palace,Southampton,Loss,Away,1997-08-27,0,3,6,6,6,0,0,0,3,3,6,6,3,0,21.0,16.0,5.0,1
5368,5368,1997-98,1997,1998,Crystal Palace,Blackburn,Loss,Home,1997-08-30,0,3,3,6,6,4,7,10,10,-1,-4,-4,-4,1,21.0,13.0,8.0,1
5369,5369,1997-98,1997,1998,Crystal Palace,Chelsea,Loss,Home,1997-09-13,0,0,3,3,6,6,9,9,12,-6,-6,-6,-6,1,21.0,6.0,15.0,2
5370,5370,1997-98,1997,1998,Crystal Palace,Wimbledon,Win,Away,1997-09-20,3,0,0,3,3,3,3,4,5,-3,-3,-1,-2,0,21.0,8.0,13.0,2
5371,5371,1997-98,1997,1998,Crystal Palace,Coventry,Draw,Away,1997-09-24,1,3,3,3,6,4,4,5,6,-1,-1,-2,0,0,21.0,17.0,4.0,2
5372,5372,1997-98,1997,1998,Crystal Palace,Bolton,Draw,Home,1997-09-27,1,4,4,4,4,2,2,3,3,2,2,1,1,1,21.0,21.0,0.0,2
5373,5373,1997-98,1997,1998,Crystal Palace,Man United,Loss,Away,1997-10-04,0,2,5,5,5,1,2,5,8,1,3,0,-3,0,21.0,1.0,20.0,3
5374,5374,1997-98,1997,1998,Crystal Palace,Arsenal,Draw,Home,1997-10-18,1,1,2,5,5,4,7,10,13,-3,-5,-5,-8,1,21.0,3.0,18.0,3
5375,5375,1997-98,1997,1998,Crystal Palace,Sheffield Weds,Win,Away,1997-10-25,3,1,2,3,6,3,4,4,5,-2,-2,-1,1,0,21.0,7.0,14.0,3
5376,5376,1997-98,1997,1998,Crystal Palace,Aston Villa,Draw,Home,1997-11-08,1,4,4,5,6,1,1,4,5,3,3,1,1,1,21.0,5.0,16.0,4
5377,5377,1997-98,1997,1998,Crystal Palace,Tottenham,Win,Away,1997-11-24,3,4,5,5,6,0,0,3,3,4,5,2,3,0,21.0,10.0,11.0,4
5378,5378,1997-98,1997,1998,Crystal Palace,Newcastle,Loss,Home,1997-11-29,0,4,7,8,8,4,5,6,6,0,2,2,2,1,21.0,2.0,19.0,4
5379,5379,1997-98,1997,1998,Crystal Palace,West Ham,Loss,Away,1997-12-03,0,3,4,7,8,3,3,3,6,0,1,4,2,0,21.0,14.0,7.0,5
5380,5380,1997-98,1997,1998,Crystal Palace,Leicester,Draw,Away,1997-12-06,1,0,3,4,7,4,4,5,8,-4,-1,-1,-1,0,21.0,9.0,12.0,5
5381,5381,1997-98,1997,1998,Crystal Palace,Liverpool,Loss,Home,1997-12-13,0,1,1,4,5,3,3,6,7,-2,-2,-2,-2,1,21.0,4.0,17.0,5
5382,5382,1997-98,1997,1998,Crystal Palace,Derby,Draw,Away,1997-12-20,1,1,1,1,4,2,5,5,8,-1,-4,-4,-4,0,21.0,12.0,9.0,5
5383,5383,1997-98,1997,1998,Crystal Palace,Southampton,Draw,Home,1997-12-26,1,1,2,2,2,4,4,4,4,-3,-2,-2,-2,1,21.0,16.0,5.0,5
5384,5384,1997-98,1997,1998,Crystal Palace,Blackburn,Draw,Away,1997-12-28,1,2,2,3,3,4,7,10,10,-2,-5,-7,-7,0,21.0,13.0,8.0,5
5385,5385,1997-98,1997,1998,Crystal Palace,Everton,Loss,Home,1998-01-10,0,2,3,3,4,3,6,7,8,-1,-3,-4,-4,1,21.0,15.0,6.0,6
5386,5386,1997-98,1997,1998,Crystal Palace,Barnsley,Loss,Away,1998-01-17,0,1,2,3,3,3,4,4,5,-2,-2,-1,-2,0,21.0,21.0,0.0,6
5387,5387,1997-98,1997,1998,Crystal Palace,Leeds,Loss,Home,1998-01-31,0,0,1,2,3,0,1,1,4,0,0,1,-1,1,21.0,11.0,10.0,6
5388,5388,1997-98,1997,1998,Crystal Palace,Wimbledon,Loss,Home,1998-02-09,0,0,0,1,2,2,2,2,3,-2,-2,-1,-1,1,21.0,8.0,13.0,7
5389,5389,1997-98,1997,1998,Crystal Palace,Arsenal,Loss,Away,1998-02-21,0,0,0,0,1,6,7,10,11,-6,-7,-10,-10,0,21.0,3.0,18.0,7
5390,5390,1997-98,1997,1998,Crystal Palace,Coventry,Loss,Home,1998-02-28,0,0,0,0,0,6,9,12,13,-6,-9,-12,-13,1,21.0,17.0,4.0,7
5391,5391,1997-98,1997,1998,Crystal Palace,Chelsea,Loss,Away,1998-03-11,0,0,0,0,0,0,0,0,3,0,0,0,-3,0,21.0,6.0,15.0,8
5392,5392,1997-98,1997,1998,Crystal Palace,Aston Villa,Loss,Away,1998-03-14,0,0,0,0,0,3,6,6,6,-3,-6,-6,-6,0,21.0,5.0,16.0,8
5393,5393,1997-98,1997,1998,Crystal Palace,Newcastle,Win,Away,1998-03-18,3,0,0,0,0,2,3,3,6,-2,-3,-3,-6,0,21.0,2.0,19.0,8
5394,5394,1997-98,1997,1998,Crystal Palace,Tottenham,Loss,Home,1998-03-28,0,3,3,3,3,1,4,4,5,2,-1,-1,-2,1,21.0,10.0,11.0,8
5395,5395,1997-98,1997,1998,Crystal Palace,Leicester,Loss,Home,1998-04-11,0,3,3,3,3,1,1,1,4,2,2,2,-1,1,21.0,9.0,12.0,9
5396,5396,1997-98,1997,1998,Crystal Palace,Liverpool,Loss,Away,1998-04-13,0,0,3,3,3,4,5,8,8,-4,-2,-5,-5,0,21.0,4.0,17.0,9
5397,5397,1997-98,1997,1998,Crystal Palace,Derby,Win,Home,1998-04-18,3,0,0,3,3,4,4,4,4,-4,-4,-1,-1,1,21.0,12.0,9.0,9
5398,5398,1997-98,1997,1998,Crystal Palace,Man United,Loss,Home,1998-04-27,0,3,3,3,6,2,5,8,8,1,-2,-5,-2,1,21.0,1.0,20.0,9
5399,5399,1997-98,1997,1998,Crystal Palace,Bolton,Loss,Away,1998-05-02,0,3,3,3,3,3,3,6,7,0,0,-3,-4,0,21.0,21.0,0.0,10
5400,5400,1997-98,1997,1998,Crystal Palace,West Ham,Draw,Home,1998-05-05,1,0,3,3,3,0,3,4,5,0,0,-1,-2,1,21.0,14.0,7.0,10
5401,5401,1997-98,1997,1998,Crystal Palace,Sheffield Weds,Win,Home,1998-05-10,3,1,1,4,4,3,3,4,4,-2,-2,0,0,1,21.0,7.0,14.0,10
5402,5402,2004-05,2004,2005,Crystal Palace,Norwich,Draw,Away,2004-08-14,1,4,4,4,7,1,1,1,1,3,3,3,6,0,21.0,21.0,0.0,1
5403,5403,2004-05,2004,2005,Crystal Palace,Everton,Loss,Home,2004-08-21,0,4,5,5,5,0,0,0,0,4,5,5,5,1,21.0,17.0,4.0,1
5404,5404,2004-05,2004,2005,Crystal Palace,Chelsea,Loss,Home,2004-08-24,0,1,4,5,5,6,9,10,13,-5,-5,-5,-8,1,21.0,2.0,19.0,1
5405,5405,2004-05,2004,2005,Crystal Palace,Middlesbrough,Loss,Away,2004-08-28,0,0,1,4,5,3,4,4,7,-3,-3,0,-2,0,21.0,11.0,10.0,1
5406,5406,2004-05,2004,2005,Crystal Palace,Portsmouth,Loss,Away,2004-09-11,0,0,0,1,4,3,4,7,7,-3,-4,-6,-3,0,21.0,13.0,8.0,2
5407,5407,2004-05,2004,2005,Crystal Palace,Man City,Loss,Home,2004-09-18,0,0,0,0,1,3,3,3,4,-3,-3,-3,-3,1,21.0,16.0,5.0,2
5408,5408,2004-05,2004,2005,Crystal Palace,Aston Villa,Draw,Away,2004-09-25,1,0,0,0,0,2,5,5,6,-2,-5,-5,-6,0,21.0,6.0,15.0,2
5409,5409,2004-05,2004,2005,Crystal Palace,Fulham,Win,Home,2004-10-04,3,1,1,1,1,4,4,4,4,-3,-3,-3,-3,1,21.0,9.0,12.0,3
5410,5410,2004-05,2004,2005,Crystal Palace,Bolton,Loss,Away,2004-10-16,0,4,4,4,4,1,2,3,6,3,2,1,-2,0,21.0,8.0,13.0,3
5411,5411,2004-05,2004,2005,Crystal Palace,West Brom,Win,Home,2004-10-23,3,3,4,4,4,4,4,5,5,-1,0,-1,-1,1,21.0,21.0,0.0,3
5412,5412,2004-05,2004,2005,Crystal Palace,Birmingham,Win,Away,2004-10-30,3,3,6,7,7,2,3,4,5,1,3,3,2,0,21.0,10.0,11.0,3
5413,5413,2004-05,2004,2005,Crystal Palace,Arsenal,Draw,Home,2004-11-06,1,6,6,9,10,1,4,7,10,5,2,2,0,1,21.0,1.0,20.0,4
5414,5414,2004-05,2004,2005,Crystal Palace,Liverpool,Loss,Away,2004-11-13,0,4,7,7,10,1,4,7,7,3,3,0,3,0,21.0,4.0,17.0,4
5415,5415,2004-05,2004,2005,Crystal Palace,Newcastle,Loss,Home,2004-11-20,0,1,4,7,7,0,0,3,4,1,4,4,3,1,21.0,5.0,16.0,4
5416,5416,2004-05,2004,2005,Crystal Palace,Southampton,Draw,Away,2004-11-27,1,0,1,4,7,3,4,5,6,-3,-3,-1,1,0,21.0,12.0,9.0,4
5417,5417,2004-05,2004,2005,Crystal Palace,Charlton,Loss,Home,2004-12-05,0,1,1,2,5,0,3,6,6,1,-2,-4,-1,1,21.0,7.0,14.0,5
5418,5418,2004-05,2004,2005,Crystal Palace,Blackburn,Draw,Home,2004-12-11,1,1,1,1,2,3,4,5,6,-2,-3,-4,-4,1,21.0,15.0,6.0,5
5419,5419,2004-05,2004,2005,Crystal Palace,Man United,Loss,Away,2004-12-18,0,1,2,2,2,4,7,10,13,-3,-5,-8,-11,0,21.0,3.0,18.0,5
5420,5420,2004-05,2004,2005,Crystal Palace,Portsmouth,Loss,Home,2004-12-26,0,1,1,2,2,1,2,5,8,0,-1,-3,-6,1,21.0,13.0,8.0,5
5421,5421,2004-05,2004,2005,Crystal Palace,Tottenham,Draw,Away,2004-12-28,1,0,1,1,2,6,9,12,15,-6,-8,-11,-13,0,21.0,14.0,7.0,5
5422,5422,2004-05,2004,2005,Crystal Palace,Fulham,Loss,Away,2005-01-01,0,1,1,2,2,0,0,1,4,1,1,1,-2,0,21.0,9.0,12.0,6
5423,5423,2004-05,2004,2005,Crystal Palace,Aston Villa,Win,Home,2005-01-03,3,1,1,1,2,3,3,3,3,-2,-2,-2,-1,1,21.0,6.0,15.0,6
5424,5424,2004-05,2004,2005,Crystal Palace,Man City,Loss,Away,2005-01-15,0,3,4,4,4,4,5,5,8,-1,-1,-1,-4,0,21.0,16.0,5.0,6
5425,5425,2004-05,2004,2005,Crystal Palace,Tottenham,Win,Home,2005-01-22,3,3,3,4,4,1,4,5,8,2,-1,-1,-4,1,21.0,14.0,7.0,6
5426,5426,2004-05,2004,2005,Crystal Palace,West Brom,Draw,Away,2005-02-01,1,3,6,6,7,3,4,5,6,0,2,1,1,0,21.0,21.0,0.0,7
5427,5427,2004-05,2004,2005,Crystal Palace,Bolton,Loss,Home,2005-02-05,0,4,4,7,7,6,9,12,13,-2,-5,-5,-6,1,21.0,8.0,13.0,7
5428,5428,2004-05,2004,2005,Crystal Palace,Arsenal,Loss,Away,2005-02-14,0,1,4,4,7,3,6,6,7,-2,-2,-2,0,0,21.0,1.0,20.0,7
5429,5429,2004-05,2004,2005,Crystal Palace,Birmingham,Win,Home,2005-02-26,3,0,1,4,4,3,6,6,6,-3,-5,-2,-2,1,21.0,10.0,11.0,7
5430,5430,2004-05,2004,2005,Crystal Palace,Man United,Draw,Home,2005-03-05,1,3,3,4,7,6,9,12,15,-3,-6,-8,-8,1,21.0,3.0,18.0,8
5431,5431,2004-05,2004,2005,Crystal Palace,Chelsea,Loss,Away,2005-03-19,0,4,4,4,5,6,9,10,13,-2,-5,-6,-8,0,21.0,2.0,19.0,8
5432,5432,2004-05,2004,2005,Crystal Palace,Middlesbrough,Loss,Home,2005-04-02,0,1,4,4,4,0,1,2,5,1,3,2,-1,1,21.0,11.0,10.0,9
5433,5433,2004-05,2004,2005,Crystal Palace,Everton,Loss,Away,2005-04-10,0,0,1,4,4,0,0,3,3,0,1,1,1,0,21.0,17.0,4.0,9
5434,5434,2004-05,2004,2005,Crystal Palace,Norwich,Draw,Home,2005-04-16,1,0,0,1,4,3,3,3,3,-3,-3,-2,1,1,21.0,21.0,0.0,9
5435,5435,2004-05,2004,2005,Crystal Palace,Blackburn,Loss,Away,2005-04-20,0,1,1,1,2,4,4,5,8,-3,-3,-4,-6,0,21.0,15.0,6.0,9
5436,5436,2004-05,2004,2005,Crystal Palace,Liverpool,Win,Home,2005-04-23,3,1,1,1,1,4,4,7,10,-3,-3,-6,-9,1,21.0,4.0,17.0,9
5437,5437,2004-05,2004,2005,Crystal Palace,Newcastle,Draw,Away,2005-04-30,1,3,4,4,4,1,1,1,1,2,3,3,3,0,21.0,5.0,16.0,9
5438,5438,2004-05,2004,2005,Crystal Palace,Southampton,Draw,Home,2005-05-07,1,4,4,5,5,3,4,4,4,1,0,1,1,1,21.0,12.0,9.0,10
5439,5439,2004-05,2004,2005,Crystal Palace,Charlton,Draw,Away,2005-05-15,1,2,5,5,6,0,0,1,1,2,5,4,5,0,21.0,7.0,14.0,10
5440,5440,2013-14,2013,2014,Crystal Palace,Tottenham,Loss,Home,2013-08-18,0,2,3,6,6,6,7,10,11,-4,-4,-4,-5,1,21.0,5.0,16.0,1
5441,5441,2013-14,2013,2014,Crystal Palace,Stoke,Loss,Away,2013-08-24,0,1,2,3,6,1,1,2,5,0,1,1,1,0,21.0,13.0,8.0,1
5442,5442,2013-14,2013,2014,Crystal Palace,Sunderland,Win,Home,2013-08-31,3,0,1,2,3,1,1,2,3,-1,0,0,0,1,21.0,17.0,4.0,1
5443,5443,2013-14,2013,2014,Crystal Palace,Man United,Loss,Away,2013-09-14,0,3,3,4,5,1,4,5,8,2,-1,-1,-3,0,21.0,1.0,20.0,2
5444,5444,2013-14,2013,2014,Crystal Palace,Swansea,Loss,Home,2013-09-22,0,3,3,3,4,4,4,4,4,-1,-1,-1,0,1,21.0,9.0,12.0,2
5445,5445,2013-14,2013,2014,Crystal Palace,Southampton,Loss,Away,2013-09-28,0,0,3,3,3,4,4,5,8,-4,-1,-2,-5,0,21.0,14.0,7.0,2
5446,5446,2013-14,2013,2014,Crystal Palace,Liverpool,Loss,Away,2013-10-05,0,0,0,3,3,3,4,7,10,-3,-4,-4,-7,0,21.0,7.0,14.0,3
5447,5447,2013-14,2013,2014,Crystal Palace,Fulham,Loss,Home,2013-10-21,0,0,0,0,3,3,3,4,4,-3,-3,-4,-1,1,21.0,12.0,9.0,3
5448,5448,2013-14,2013,2014,Crystal Palace,Arsenal,Loss,Home,2013-10-26,0,0,0,0,0,4,7,10,13,-4,-7,-10,-13,1,21.0,4.0,17.0,3
5449,5449,2013-14,2013,2014,Crystal Palace,West Brom,Loss,Away,2013-11-02,0,0,0,0,0,1,2,5,8,-1,-2,-5,-8,0,21.0,8.0,13.0,4
5450,5450,2013-14,2013,2014,Crystal Palace,Everton,Draw,Home,2013-11-09,1,0,0,0,0,4,7,7,10,-4,-7,-7,-10,1,21.0,6.0,15.0,4
5451,5451,2013-14,2013,2014,Crystal Palace,Hull,Win,Away,2013-11-23,3,1,1,1,1,3,3,3,4,-2,-2,-2,-3,0,21.0,21.0,0.0,4
5452,5452,2013-14,2013,2014,Crystal Palace,Norwich,Loss,Away,2013-11-30,0,4,4,4,4,3,3,4,4,1,1,0,0,0,21.0,11.0,10.0,4
5453,5453,2013-14,2013,2014,Crystal Palace,West Ham,Win,Home,2013-12-03,3,3,4,4,4,3,3,4,5,0,1,0,-1,1,21.0,10.0,11.0,5
5454,5454,2013-14,2013,2014,Crystal Palace,Cardiff,Win,Home,2013-12-07,3,3,6,7,7,1,2,2,5,2,4,5,2,1,21.0,21.0,0.0,5
5455,5455,2013-14,2013,2014,Crystal Palace,Chelsea,Loss,Away,2013-12-14,0,6,6,9,10,3,6,9,10,3,0,0,0,0,21.0,3.0,18.0,5
5456,5456,2013-14,2013,2014,Crystal Palace,Newcastle,Loss,Home,2013-12-21,0,3,6,6,9,4,4,7,10,-1,2,-1,-1,1,21.0,16.0,5.0,5
5457,5457,2013-14,2013,2014,Crystal Palace,Aston Villa,Win,Away,2013-12-26,3,0,3,6,6,0,0,3,4,0,3,3,2,0,21.0,15.0,6.0,5
5458,5458,2013-14,2013,2014,Crystal Palace,Man City,Loss,Away,2013-12-28,0,3,3,6,9,6,9,10,13,-3,-6,-4,-4,0,21.0,2.0,19.0,5
5459,5459,2013-14,2013,2014,Crystal Palace,Norwich,Draw,Home,2014-01-01,1,3,3,3,6,0,1,2,5,3,2,1,1,1,21.0,11.0,10.0,6
5460,5460,2013-14,2013,2014,Crystal Palace,Tottenham,Loss,Away,2014-01-11,0,1,4,4,4,6,7,10,10,-5,-3,-6,-6,0,21.0,5.0,16.0,6
5461,5461,2013-14,2013,2014,Crystal Palace,Stoke,Win,Home,2014-01-18,3,1,1,4,4,1,1,1,4,0,0,3,0,1,21.0,13.0,8.0,6
5462,5462,2013-14,2013,2014,Crystal Palace,Hull,Win,Home,2014-01-28,3,3,4,4,7,0,0,3,3,3,4,1,4,1,21.0,21.0,0.0,6
5463,5463,2013-14,2013,2014,Crystal Palace,Arsenal,Loss,Away,2014-02-02,0,6,6,7,7,4,7,10,13,2,-1,-3,-6,0,21.0,4.0,17.0,7
5464,5464,2013-14,2013,2014,Crystal Palace,West Brom,Win,Home,2014-02-08,3,3,6,6,7,1,2,2,5,2,4,4,2,1,21.0,8.0,13.0,7
5465,5465,2013-14,2013,2014,Crystal Palace,Man United,Loss,Home,2014-02-22,0,3,6,9,9,2,2,5,5,1,4,4,4,1,21.0,1.0,20.0,7
5466,5466,2013-14,2013,2014,Crystal Palace,Swansea,Draw,Away,2014-03-02,1,3,3,6,9,1,4,4,7,2,-1,2,2,0,21.0,9.0,12.0,8
5467,5467,2013-14,2013,2014,Crystal Palace,Southampton,Loss,Home,2014-03-08,0,1,4,4,7,0,3,4,7,1,1,0,0,1,21.0,14.0,7.0,8
5468,5468,2013-14,2013,2014,Crystal Palace,Sunderland,Draw,Away,2014-03-15,1,1,1,4,4,0,3,6,7,1,-2,-2,-3,0,21.0,17.0,4.0,8
5469,5469,2013-14,2013,2014,Crystal Palace,Newcastle,Loss,Away,2014-03-22,0,1,2,2,5,3,6,6,6,-2,-4,-4,-1,0,21.0,16.0,5.0,8
5470,5470,2013-14,2013,2014,Crystal Palace,Chelsea,Win,Home,2014-03-29,3,1,1,2,2,3,6,9,12,-2,-5,-7,-10,1,21.0,3.0,18.0,8
5471,5471,2013-14,2013,2014,Crystal Palace,Cardiff,Win,Away,2014-04-05,3,3,4,4,5,1,1,4,4,2,3,0,1,0,21.0,21.0,0.0,9
5472,5472,2013-14,2013,2014,Crystal Palace,Aston Villa,Win,Home,2014-04-12,3,6,6,7,7,0,0,3,6,6,6,4,1,1,21.0,15.0,6.0,9
5473,5473,2013-14,2013,2014,Crystal Palace,Everton,Win,Away,2014-04-16,3,6,9,9,10,6,9,12,15,0,0,-3,-5,0,21.0,6.0,15.0,9
5474,5474,2013-14,2013,2014,Crystal Palace,West Ham,Win,Away,2014-04-19,3,6,9,12,12,0,3,6,6,6,6,6,6,0,21.0,10.0,11.0,9
5475,5475,2013-14,2013,2014,Crystal Palace,Man City,Loss,Home,2014-04-27,0,6,9,12,15,4,4,7,8,2,5,5,7,1,21.0,2.0,19.0,9
5476,5476,2013-14,2013,2014,Crystal Palace,Liverpool,Draw,Home,2014-05-05,1,3,6,9,12,3,6,9,12,0,0,0,0,1,21.0,7.0,14.0,10
5477,5477,2013-14,2013,2014,Crystal Palace,Fulham,Draw,Away,2014-05-11,1,1,4,7,10,1,1,4,7,0,3,3,3,0,21.0,12.0,9.0,10
5478,5478,2014-15,2014,2015,Crystal Palace,Arsenal,Loss,Away,2014-08-16,0,2,2,5,8,6,9,12,15,-4,-7,-7,-7,0,11.0,4.0,7.0,1
5479,5479,2014-15,2014,2015,Crystal Palace,West Ham,Loss,Home,2014-08-23,0,1,2,2,5,0,3,3,3,1,-1,-1,2,1,11.0,13.0,-2.0,1
5480,5480,2014-15,2014,2015,Crystal Palace,Newcastle,Draw,Away,2014-08-30,1,0,1,2,2,1,1,4,4,-1,0,-2,-2,0,11.0,10.0,1.0,1
5481,5481,2014-15,2014,2015,Crystal Palace,Burnley,Draw,Home,2014-09-13,1,1,1,2,3,1,1,4,4,0,0,-2,-1,1,11.0,21.0,-10.0,2
5482,5482,2014-15,2014,2015,Crystal Palace,Everton,Win,Away,2014-09-21,3,2,2,2,3,3,4,5,8,-1,-2,-3,-5,0,11.0,5.0,6.0,2
5483,5483,2014-15,2014,2015,Crystal Palace,Leicester,Win,Home,2014-09-27,3,4,5,5,5,6,7,7,8,-2,-2,-2,-3,1,11.0,21.0,-10.0,2
5484,5484,2014-15,2014,2015,Crystal Palace,Hull,Loss,Away,2014-10-04,0,6,7,8,8,1,2,2,3,5,5,6,5,0,11.0,16.0,-5.0,3
5485,5485,2014-15,2014,2015,Crystal Palace,Chelsea,Loss,Home,2014-10-18,0,3,6,7,8,6,7,10,13,-3,-1,-3,-5,1,11.0,3.0,8.0,3
5486,5486,2014-15,2014,2015,Crystal Palace,West Brom,Draw,Away,2014-10-25,1,0,3,6,7,1,4,7,7,-1,-1,-1,0,0,11.0,17.0,-6.0,3
5487,5487,2014-15,2014,2015,Crystal Palace,Sunderland,Loss,Home,2014-11-03,0,1,1,4,7,0,3,4,5,1,-2,0,2,1,11.0,14.0,-3.0,4
5488,5488,2014-15,2014,2015,Crystal Palace,Man United,Loss,Away,2014-11-08,0,1,1,1,4,1,2,5,8,0,-1,-4,-4,0,11.0,7.0,4.0,4
5489,5489,2014-15,2014,2015,Crystal Palace,Liverpool,Win,Home,2014-11-23,3,0,1,1,1,0,1,4,7,0,0,-3,-6,1,11.0,2.0,9.0,4
5490,5490,2014-15,2014,2015,Crystal Palace,Swansea,Draw,Away,2014-11-29,1,3,3,4,4,3,4,7,7,0,-1,-3,-3,0,11.0,12.0,-1.0,4
5491,5491,2014-15,2014,2015,Crystal Palace,Aston Villa,Loss,Home,2014-12-02,0,4,4,4,5,2,3,3,3,2,1,1,2,1,11.0,15.0,-4.0,5
5492,5492,2014-15,2014,2015,Crystal Palace,Tottenham,Draw,Away,2014-12-06,1,1,4,4,4,3,6,6,9,-2,-2,-2,-5,0,11.0,6.0,5.0,5
5493,5493,2014-15,2014,2015,Crystal Palace,Stoke,Draw,Home,2014-12-13,1,1,2,5,5,3,3,3,6,-2,-1,2,-1,1,11.0,9.0,2.0,5
5494,5494,2014-15,2014,2015,Crystal Palace,Man City,Loss,Away,2014-12-20,0,2,2,3,6,6,9,12,15,-4,-7,-9,-9,0,11.0,1.0,10.0,5
5495,5495,2014-15,2014,2015,Crystal Palace,Southampton,Loss,Home,2014-12-26,0,1,2,2,3,3,3,3,3,-2,-1,-1,0,1,11.0,8.0,3.0,5
5496,5496,2014-15,2014,2015,Crystal Palace,QPR,Draw,Away,2014-12-28,1,0,1,2,2,3,3,6,6,-3,-2,-4,-4,0,11.0,21.0,-10.0,5
5497,5497,2014-15,2014,2015,Crystal Palace,Aston Villa,Draw,Away,2015-01-01,1,1,1,2,3,1,2,2,5,0,-1,0,-2,0,11.0,15.0,-4.0,6
5498,5498,2014-15,2014,2015,Crystal Palace,Tottenham,Win,Home,2015-01-10,3,2,2,2,3,4,7,10,13,-2,-5,-8,-10,1,11.0,6.0,5.0,6
5499,5499,2014-15,2014,2015,Crystal Palace,Burnley,Win,Away,2015-01-17,3,4,5,5,5,4,5,5,5,0,0,0,0,0,11.0,21.0,-10.0,6
5500,5500,2014-15,2014,2015,Crystal Palace,Everton,Loss,Home,2015-01-31,0,6,7,8,8,2,2,2,2,4,5,6,6,1,11.0,5.0,6.0,6
5501,5501,2014-15,2014,2015,Crystal Palace,Leicester,Win,Away,2015-02-07,3,3,6,7,8,0,3,4,7,3,3,3,1,0,11.0,21.0,-10.0,7
5502,5502,2014-15,2014,2015,Crystal Palace,Newcastle,Draw,Home,2015-02-11,1,3,6,9,10,4,4,4,5,-1,2,5,5,1,11.0,10.0,1.0,7
5503,5503,2014-15,2014,2015,Crystal Palace,Arsenal,Loss,Home,2015-02-21,0,4,4,7,10,3,6,9,12,1,-2,-2,-2,1,11.0,4.0,7.0,7
5504,5504,2014-15,2014,2015,Crystal Palace,West Ham,Win,Away,2015-02-28,3,1,4,4,7,2,3,3,6,-1,1,1,1,0,11.0,13.0,-2.0,7
5505,5505,2014-15,2014,2015,Crystal Palace,Southampton,Loss,Away,2015-03-03,0,3,4,7,7,0,1,4,4,3,3,3,3,0,11.0,8.0,3.0,8
5506,5506,2014-15,2014,2015,Crystal Palace,QPR,Win,Home,2015-03-14,3,3,3,4,7,0,0,3,3,3,3,1,4,1,11.0,21.0,-10.0,8
5507,5507,2014-15,2014,2015,Crystal Palace,Stoke,Win,Away,2015-03-21,3,3,6,6,7,3,6,9,9,0,0,-3,-2,0,11.0,9.0,2.0,8
5508,5508,2014-15,2014,2015,Crystal Palace,Man City,Win,Home,2015-04-06,3,6,6,9,9,3,6,6,9,3,0,3,0,1,11.0,1.0,10.0,9
5509,5509,2014-15,2014,2015,Crystal Palace,Sunderland,Win,Away,2015-04-11,3,6,9,9,12,3,3,4,4,3,6,5,8,0,11.0,14.0,-3.0,9
5510,5510,2014-15,2014,2015,Crystal Palace,West Brom,Loss,Home,2015-04-18,0,6,9,12,12,0,0,3,3,6,9,9,9,1,11.0,17.0,-6.0,9
5511,5511,2014-15,2014,2015,Crystal Palace,Hull,Loss,Home,2015-04-25,0,3,6,9,12,0,0,1,2,3,6,8,10,1,11.0,16.0,-5.0,9
5512,5512,2014-15,2014,2015,Crystal Palace,Chelsea,Loss,Away,2015-05-03,0,0,3,6,9,4,7,10,13,-4,-4,-4,-4,0,11.0,3.0,8.0,10
5513,5513,2014-15,2014,2015,Crystal Palace,Man United,Loss,Home,2015-05-09,0,0,0,3,6,0,0,3,6,0,0,0,0,1,11.0,7.0,4.0,10
5514,5514,2014-15,2014,2015,Crystal Palace,Liverpool,Win,Away,2015-05-16,3,0,0,0,3,4,4,5,8,-4,-4,-5,-5,0,11.0,2.0,9.0,10
5515,5515,2014-15,2014,2015,Crystal Palace,Swansea,Win,Home,2015-05-24,3,3,3,3,3,3,6,9,9,0,-3,-6,-6,1,11.0,12.0,-1.0,10
5516,5516,2015-16,2015,2016,Crystal Palace,Norwich,Win,Away,2015-08-08,3,6,6,6,6,1,1,1,1,5,5,5,5,0,10.0,21.0,-11.0,1
5517,5517,2015-16,2015,2016,Crystal Palace,Arsenal,Loss,Home,2015-08-16,0,6,9,9,9,3,4,5,5,3,5,4,4,1,10.0,3.0,7.0,1
5518,5518,2015-16,2015,2016,Crystal Palace,Aston Villa,Win,Home,2015-08-22,3,3,6,9,9,3,3,3,6,0,3,6,3,1,10.0,17.0,-7.0,1
5519,5519,2015-16,2015,2016,Crystal Palace,Chelsea,Win,Away,2015-08-29,3,3,6,9,12,3,4,7,7,0,2,2,5,0,10.0,1.0,9.0,1
5520,5520,2015-16,2015,2016,Crystal Palace,Man City,Loss,Home,2015-09-12,0,6,6,9,12,6,9,12,15,0,-3,-3,-3,1,10.0,2.0,8.0,2
5521,5521,2015-16,2015,2016,Crystal Palace,Tottenham,Loss,Away,2015-09-20,0,3,6,6,9,4,5,6,6,-1,1,0,3,0,10.0,5.0,5.0,2
5522,5522,2015-16,2015,2016,Crystal Palace,Watford,Win,Away,2015-09-27,3,0,3,6,6,6,6,7,8,-6,-3,-1,-2,0,10.0,21.0,-11.0,2
5523,5523,2015-16,2015,2016,Crystal Palace,West Brom,Win,Home,2015-10-03,3,3,3,6,9,3,4,7,7,0,-1,-1,2,1,10.0,13.0,-3.0,3
5524,5524,2015-16,2015,2016,Crystal Palace,West Ham,Loss,Home,2015-10-17,0,6,6,6,9,2,5,8,11,4,1,-2,-2,1,10.0,12.0,-2.0,3
5525,5525,2015-16,2015,2016,Crystal Palace,Leicester,Loss,Away,2015-10-24,0,3,6,6,6,4,4,5,8,-1,2,1,-2,0,10.0,14.0,-4.0,3
5526,5526,2015-16,2015,2016,Crystal Palace,Man United,Draw,Home,2015-10-31,1,0,3,6,6,4,4,7,10,-4,-1,-1,-4,1,10.0,4.0,6.0,3
5527,5527,2015-16,2015,2016,Crystal Palace,Liverpool,Win,Away,2015-11-08,3,1,1,4,7,4,5,6,9,-3,-4,-2,-2,0,10.0,6.0,4.0,4
5528,5528,2015-16,2015,2016,Crystal Palace,Sunderland,Loss,Home,2015-11-23,0,4,4,4,7,0,3,3,4,4,1,1,3,1,10.0,16.0,-6.0,4
5529,5529,2015-16,2015,2016,Crystal Palace,Newcastle,Win,Home,2015-11-28,3,3,4,4,4,3,4,4,7,0,0,0,-3,1,10.0,15.0,-5.0,4
5530,5530,2015-16,2015,2016,Crystal Palace,Everton,Draw,Away,2015-12-07,1,3,6,7,7,4,5,8,8,-1,1,-1,-1,0,10.0,11.0,-1.0,5
5531,5531,2015-16,2015,2016,Crystal Palace,Southampton,Win,Home,2015-12-12,3,4,4,7,8,1,1,4,7,3,3,3,1,1,10.0,7.0,3.0,5
5532,5532,2015-16,2015,2016,Crystal Palace,Stoke,Win,Away,2015-12-19,3,4,7,7,10,4,4,7,10,0,3,0,0,0,10.0,9.0,1.0,5
5533,5533,2015-16,2015,2016,Crystal Palace,Bournemouth,Draw,Away,2015-12-26,1,6,7,10,10,6,9,10,11,0,-2,0,-1,0,10.0,21.0,-11.0,5
5534,5534,2015-16,2015,2016,Crystal Palace,Swansea,Draw,Home,2015-12-28,1,4,7,8,11,4,4,4,4,0,3,4,7,1,10.0,8.0,2.0,5
5535,5535,2015-16,2015,2016,Crystal Palace,Chelsea,Loss,Home,2016-01-03,0,2,5,8,9,2,5,5,5,0,0,3,4,1,10.0,1.0,9.0,6
5536,5536,2015-16,2015,2016,Crystal Palace,Aston Villa,Loss,Away,2016-01-12,0,1,2,5,8,0,1,2,2,1,1,3,6,0,10.0,17.0,-7.0,6
5537,5537,2015-16,2015,2016,Crystal Palace,Man City,Loss,Away,2016-01-16,0,0,1,2,5,4,5,8,8,-4,-4,-6,-3,0,10.0,2.0,8.0,6
5538,5538,2015-16,2015,2016,Crystal Palace,Tottenham,Loss,Home,2016-01-23,0,0,0,1,2,3,4,7,10,-3,-4,-6,-8,1,10.0,5.0,5.0,6
5539,5539,2015-16,2015,2016,Crystal Palace,Bournemouth,Loss,Home,2016-02-02,0,0,0,0,1,4,4,5,5,-4,-4,-5,-4,1,10.0,21.0,-11.0,7
5540,5540,2015-16,2015,2016,Crystal Palace,Swansea,Draw,Away,2016-02-06,1,0,0,0,0,4,7,7,7,-4,-7,-7,-7,0,10.0,8.0,2.0,7
5541,5541,2015-16,2015,2016,Crystal Palace,Watford,Loss,Home,2016-02-13,0,1,1,1,1,1,4,4,4,0,-3,-3,-3,1,10.0,21.0,-11.0,7
5542,5542,2015-16,2015,2016,Crystal Palace,West Brom,Loss,Away,2016-02-27,0,1,1,1,1,3,4,5,5,-2,-3,-4,-4,0,10.0,13.0,-3.0,7
5543,5543,2015-16,2015,2016,Crystal Palace,Sunderland,Draw,Away,2016-03-01,1,0,1,1,1,3,4,4,5,-3,-3,-3,-4,0,10.0,16.0,-6.0,8
5544,5544,2015-16,2015,2016,Crystal Palace,Liverpool,Loss,Home,2016-03-06,0,1,1,2,2,6,7,7,10,-5,-6,-5,-8,1,10.0,6.0,4.0,8
5545,5545,2015-16,2015,2016,Crystal Palace,Leicester,Loss,Home,2016-03-19,0,1,1,1,2,6,7,10,10,-5,-6,-9,-8,1,10.0,14.0,-4.0,8
5546,5546,2015-16,2015,2016,Crystal Palace,West Ham,Draw,Away,2016-04-02,1,0,1,1,1,4,7,10,11,-4,-6,-9,-10,0,10.0,12.0,-2.0,9
5547,5547,2015-16,2015,2016,Crystal Palace,Norwich,Win,Home,2016-04-09,3,1,1,2,2,6,7,7,7,-5,-6,-5,-5,1,10.0,21.0,-11.0,9
5548,5548,2015-16,2015,2016,Crystal Palace,Everton,Draw,Home,2016-04-13,1,4,4,4,5,1,1,1,4,3,3,3,1,1,10.0,11.0,-1.0,9
5549,5549,2015-16,2015,2016,Crystal Palace,Arsenal,Draw,Away,2016-04-17,1,4,5,5,5,4,7,8,8,0,-2,-3,-3,0,10.0,3.0,7.0,9
5550,5550,2015-16,2015,2016,Crystal Palace,Man United,Loss,Away,2016-04-20,0,2,5,6,6,3,6,9,9,-1,-1,-3,-3,0,10.0,4.0,6.0,9
5551,5551,2015-16,2015,2016,Crystal Palace,Newcastle,Loss,Away,2016-04-30,0,1,2,5,6,2,5,5,5,-1,-3,0,1,0,10.0,15.0,-5.0,9
5552,5552,2015-16,2015,2016,Crystal Palace,Stoke,Win,Home,2016-05-07,3,0,1,2,5,1,1,1,2,-1,0,1,3,1,10.0,9.0,1.0,10
5553,5553,2015-16,2015,2016,Crystal Palace,Southampton,Loss,Away,2016-05-15,0,3,3,4,5,6,9,10,13,-3,-6,-6,-8,0,10.0,7.0,3.0,10
5554,5554,2016-17,2016,2017,Crystal Palace,West Brom,Loss,Home,2016-08-13,0,3,3,3,4,2,2,3,3,1,1,0,1,1,15.0,14.0,1.0,1
5555,5555,2016-17,2016,2017,Crystal Palace,Tottenham,Loss,Away,2016-08-20,0,0,3,3,3,1,1,2,3,-1,2,1,0,0,15.0,3.0,12.0,1
5556,5556,2016-17,2016,2017,Crystal Palace,Bournemouth,Draw,Home,2016-08-27,1,0,0,3,3,0,0,1,1,0,0,2,2,1,15.0,16.0,-1.0,1
5557,5557,2016-17,2016,2017,Crystal Palace,Middlesbrough,Win,Away,2016-09-10,3,1,1,1,4,4,5,5,6,-3,-4,-4,-2,0,15.0,21.0,-6.0,2
5558,5558,2016-17,2016,2017,Crystal Palace,Stoke,Win,Home,2016-09-18,3,4,4,4,4,0,0,1,4,4,4,3,0,1,15.0,9.0,6.0,2
5559,5559,2016-17,2016,2017,Crystal Palace,Sunderland,Win,Away,2016-09-24,3,6,7,7,7,0,1,1,1,6,6,6,6,0,15.0,17.0,-2.0,2
5560,5560,2016-17,2016,2017,Crystal Palace,Everton,Draw,Away,2016-09-30,1,6,9,10,10,3,6,9,12,3,3,1,-2,0,15.0,11.0,4.0,2
5561,5561,2016-17,2016,2017,Crystal Palace,West Ham,Loss,Home,2016-10-15,0,4,7,10,11,1,1,1,1,3,6,9,10,1,15.0,7.0,8.0,3
5562,5562,2016-17,2016,2017,Crystal Palace,Leicester,Loss,Away,2016-10-22,0,1,4,7,10,1,1,4,4,0,3,3,6,0,15.0,1.0,14.0,3
5563,5563,2016-17,2016,2017,Crystal Palace,Liverpool,Loss,Home,2016-10-29,0,0,1,4,7,4,7,10,13,-4,-6,-6,-6,1,15.0,8.0,7.0,3
5564,5564,2016-17,2016,2017,Crystal Palace,Burnley,Loss,Away,2016-11-05,0,0,0,1,4,4,4,4,7,-4,-4,-3,-3,0,15.0,21.0,-6.0,4
5565,5565,2016-17,2016,2017,Crystal Palace,Man City,Loss,Home,2016-11-19,0,0,0,0,1,4,5,6,6,-4,-5,-6,-5,1,15.0,4.0,11.0,4
5566,5566,2016-17,2016,2017,Crystal Palace,Swansea,Loss,Away,2016-11-26,0,0,0,0,0,1,1,2,2,-1,-1,-2,-2,0,15.0,12.0,3.0,4
5567,5567,2016-17,2016,2017,Crystal Palace,Southampton,Win,Home,2016-12-03,3,0,0,0,0,4,4,4,5,-4,-4,-4,-5,1,15.0,6.0,9.0,5
5568,5568,2016-17,2016,2017,Crystal Palace,Hull,Draw,Away,2016-12-10,1,3,3,3,3,1,1,4,4,2,2,-1,-1,0,15.0,21.0,-6.0,5
5569,5569,2016-17,2016,2017,Crystal Palace,Man United,Loss,Home,2016-12-14,0,4,4,4,4,4,5,6,9,0,-1,-2,-5,1,15.0,5.0,10.0,5
5570,5570,2016-17,2016,2017,Crystal Palace,Chelsea,Loss,Home,2016-12-17,0,1,4,4,4,6,9,12,15,-5,-5,-8,-11,1,15.0,10.0,5.0,5
5571,5571,2016-17,2016,2017,Crystal Palace,Watford,Draw,Away,2016-12-26,1,0,1,4,4,0,3,3,3,0,-2,1,1,0,15.0,13.0,2.0,5
5572,5572,2016-17,2016,2017,Crystal Palace,Arsenal,Loss,Away,2017-01-01,0,1,1,2,5,3,3,6,9,-2,-2,-4,-4,0,15.0,2.0,13.0,6
5573,5573,2016-17,2016,2017,Crystal Palace,Swansea,Loss,Home,2017-01-03,0,1,1,1,2,0,0,0,3,1,1,1,-1,1,15.0,12.0,3.0,6
5574,5574,2016-17,2016,2017,Crystal Palace,West Ham,Loss,Away,2017-01-14,0,0,1,1,1,0,3,6,9,0,-2,-5,-8,0,15.0,7.0,8.0,6
5575,5575,2016-17,2016,2017,Crystal Palace,Everton,Loss,Home,2017-01-21,0,0,0,1,1,6,7,10,10,-6,-7,-9,-9,1,15.0,11.0,4.0,6
5576,5576,2016-17,2016,2017,Crystal Palace,Bournemouth,Win,Away,2017-01-31,3,0,0,0,1,1,2,5,5,-1,-2,-5,-4,0,15.0,16.0,-1.0,6
5577,5577,2016-17,2016,2017,Crystal Palace,Sunderland,Loss,Home,2017-02-04,0,3,3,3,3,1,1,2,2,2,2,1,1,1,15.0,17.0,-2.0,7
5578,5578,2016-17,2016,2017,Crystal Palace,Stoke,Loss,Away,2017-02-11,0,3,3,3,3,1,2,5,8,2,1,-2,-5,0,15.0,9.0,6.0,7
5579,5579,2016-17,2016,2017,Crystal Palace,Middlesbrough,Win,Home,2017-02-25,3,0,3,3,3,1,2,2,3,-1,1,1,0,1,15.0,21.0,-6.0,7
5580,5580,2016-17,2016,2017,Crystal Palace,West Brom,Win,Away,2017-03-04,3,3,3,6,6,4,7,8,11,-1,-4,-2,-5,0,15.0,14.0,1.0,8
5581,5581,2016-17,2016,2017,Crystal Palace,Watford,Win,Home,2017-03-18,3,6,6,6,9,1,1,4,7,5,5,2,2,1,15.0,13.0,2.0,8
5582,5582,2016-17,2016,2017,Crystal Palace,Chelsea,Win,Away,2017-04-01,3,6,9,9,9,6,9,10,13,0,0,-1,-4,0,15.0,10.0,5.0,9
5583,5583,2016-17,2016,2017,Crystal Palace,Southampton,Loss,Away,2017-04-05,0,6,9,12,12,1,4,7,7,5,5,5,5,0,15.0,6.0,9.0,9
5584,5584,2016-17,2016,2017,Crystal Palace,Arsenal,Win,Home,2017-04-10,3,3,6,9,12,4,4,4,7,-1,2,5,5,1,15.0,2.0,13.0,9
5585,5585,2016-17,2016,2017,Crystal Palace,Leicester,Draw,Home,2017-04-15,1,3,6,9,12,3,6,9,12,0,0,0,0,1,15.0,1.0,14.0,9
5586,5586,2016-17,2016,2017,Crystal Palace,Liverpool,Win,Away,2017-04-23,3,4,4,7,10,6,7,10,11,-2,-3,-3,-1,0,15.0,8.0,7.0,9
5587,5587,2016-17,2016,2017,Crystal Palace,Tottenham,Loss,Home,2017-04-26,0,4,7,7,10,6,9,12,15,-2,-2,-5,-5,1,15.0,3.0,12.0,9
5588,5588,2016-17,2016,2017,Crystal Palace,Burnley,Loss,Home,2017-04-29,0,3,4,7,7,0,1,4,4,3,3,3,3,1,15.0,21.0,-6.0,9
5589,5589,2016-17,2016,2017,Crystal Palace,Man City,Loss,Away,2017-05-06,0,0,3,4,7,2,5,8,8,-2,-2,-4,-1,0,15.0,4.0,11.0,10
5590,5590,2016-17,2016,2017,Crystal Palace,Hull,Win,Home,2017-05-14,3,0,0,3,4,1,4,4,4,-1,-4,-1,0,1,15.0,21.0,-6.0,10
5591,5591,2016-17,2016,2017,Crystal Palace,Man United,Loss,Away,2017-05-21,0,3,3,3,6,1,1,2,3,2,2,1,3,0,15.0,5.0,10.0,10
5592,5592,2017-18,2017,2018,Crystal Palace,Huddersfield,Loss,Home,2017-08-12,0,3,3,3,3,0,0,0,0,3,3,3,3,1,14.0,21.0,-7.0,1
5593,5593,2017-18,2017,2018,Crystal Palace,Liverpool,Loss,Away,2017-08-19,0,0,3,3,3,4,7,8,11,-4,-4,-5,-8,0,14.0,4.0,10.0,1
5594,5594,2017-18,2017,2018,Crystal Palace,Swansea,Loss,Home,2017-08-26,0,0,0,3,3,1,4,7,10,-1,-4,-4,-7,1,14.0,15.0,-1.0,1
5595,5595,2017-18,2017,2018,Crystal Palace,Burnley,Loss,Away,2017-09-10,0,0,0,0,3,1,4,4,4,-1,-4,-4,-1,0,14.0,16.0,-2.0,2
5596,5596,2017-18,2017,2018,Crystal Palace,Southampton,Loss,Home,2017-09-16,0,0,0,0,0,1,4,5,5,-1,-4,-5,-5,1,14.0,8.0,6.0,2
5597,5597,2017-18,2017,2018,Crystal Palace,Man City,Loss,Away,2017-09-23,0,0,0,0,0,6,9,10,13,-6,-9,-10,-13,0,14.0,3.0,11.0,2
5598,5598,2017-18,2017,2018,Crystal Palace,Man United,Loss,Away,2017-09-30,0,0,0,0,0,6,7,10,13,-6,-7,-10,-13,0,14.0,6.0,8.0,2
5599,5599,2017-18,2017,2018,Crystal Palace,Chelsea,Win,Home,2017-10-14,3,0,0,0,0,3,4,7,10,-3,-4,-7,-10,1,14.0,1.0,13.0,3
5600,5600,2017-18,2017,2018,Crystal Palace,Newcastle,Loss,Away,2017-10-21,0,3,3,3,3,2,2,5,8,1,1,-2,-5,0,14.0,21.0,-7.0,3
5601,5601,2017-18,2017,2018,Crystal Palace,West Ham,Draw,Home,2017-10-28,1,3,3,3,3,1,4,4,5,2,-1,-1,-2,1,14.0,11.0,3.0,3
5602,5602,2017-18,2017,2018,Crystal Palace,Tottenham,Loss,Away,2017-11-05,0,1,4,4,4,3,6,9,12,-2,-2,-5,-8,0,14.0,2.0,12.0,4
5603,5603,2017-18,2017,2018,Crystal Palace,Everton,Draw,Home,2017-11-18,1,1,1,4,4,3,3,4,4,-2,-2,0,0,1,14.0,7.0,7.0,4
5604,5604,2017-18,2017,2018,Crystal Palace,Stoke,Win,Home,2017-11-25,3,1,2,2,5,2,5,5,5,-1,-3,-3,0,1,14.0,13.0,1.0,4
5605,5605,2017-18,2017,2018,Crystal Palace,Brighton,Draw,Away,2017-11-28,1,4,4,5,5,1,4,5,8,3,0,0,-3,0,14.0,21.0,-7.0,4
5606,5606,2017-18,2017,2018,Crystal Palace,West Brom,Draw,Away,2017-12-02,1,4,5,5,6,2,2,2,2,2,3,3,4,0,14.0,10.0,4.0,5
5607,5607,2017-18,2017,2018,Crystal Palace,Bournemouth,Draw,Home,2017-12-09,1,2,5,6,6,1,2,5,8,1,3,1,-2,1,14.0,9.0,5.0,5
5608,5608,2017-18,2017,2018,Crystal Palace,Watford,Win,Home,2017-12-12,3,2,3,6,7,1,1,4,7,1,2,2,0,1,14.0,17.0,-3.0,5
5609,5609,2017-18,2017,2018,Crystal Palace,Leicester,Win,Away,2017-12-16,3,4,5,6,9,6,9,12,13,-2,-4,-6,-4,0,14.0,12.0,2.0,5
5610,5610,2017-18,2017,2018,Crystal Palace,Swansea,Draw,Away,2017-12-23,1,6,7,8,9,0,3,3,3,6,4,5,6,0,14.0,15.0,-1.0,5
5611,5611,2017-18,2017,2018,Crystal Palace,Arsenal,Loss,Home,2017-12-28,0,4,7,8,9,4,5,6,6,0,2,2,3,1,14.0,5.0,9.0,5
5612,5612,2017-18,2017,2018,Crystal Palace,Man City,Draw,Home,2017-12-31,1,1,4,7,8,6,9,12,15,-5,-5,-5,-7,1,14.0,3.0,11.0,5
5613,5613,2017-18,2017,2018,Crystal Palace,Southampton,Win,Away,2018-01-02,3,1,2,5,8,1,2,2,2,0,0,3,6,0,14.0,8.0,6.0,6
5614,5614,2017-18,2017,2018,Crystal Palace,Burnley,Win,Home,2018-01-13,3,4,4,5,8,1,2,2,3,3,2,3,5,1,14.0,16.0,-2.0,6
5615,5615,2017-18,2017,2018,Crystal Palace,Arsenal,Loss,Away,2018-01-20,0,6,7,7,8,1,2,5,6,5,5,2,2,0,14.0,5.0,9.0,6
5616,5616,2017-18,2017,2018,Crystal Palace,West Ham,Draw,Away,2018-01-30,1,3,6,7,7,4,5,8,9,-1,1,-1,-2,0,14.0,11.0,3.0,6
5617,5617,2017-18,2017,2018,Crystal Palace,Newcastle,Draw,Home,2018-02-04,1,1,4,7,8,1,2,5,6,0,2,2,2,1,14.0,21.0,-7.0,7
5618,5618,2017-18,2017,2018,Crystal Palace,Everton,Loss,Away,2018-02-10,0,2,2,5,8,3,4,4,4,-1,-2,1,4,0,14.0,7.0,7.0,7
5619,5619,2017-18,2017,2018,Crystal Palace,Tottenham,Loss,Home,2018-02-25,0,1,2,2,5,4,7,8,11,-3,-5,-6,-6,1,14.0,2.0,12.0,7
5620,5620,2017-18,2017,2018,Crystal Palace,Man United,Loss,Home,2018-03-05,0,0,1,2,2,3,6,6,9,-3,-5,-4,-7,1,14.0,6.0,8.0,8
5621,5621,2017-18,2017,2018,Crystal Palace,Chelsea,Loss,Away,2018-03-10,0,0,0,1,2,0,3,3,3,0,-3,-2,-1,0,14.0,1.0,13.0,8
5622,5622,2017-18,2017,2018,Crystal Palace,Huddersfield,Win,Away,2018-03-17,3,0,0,0,1,1,4,7,7,-1,-4,-7,-6,0,14.0,21.0,-7.0,8
5623,5623,2017-18,2017,2018,Crystal Palace,Liverpool,Loss,Home,2018-03-31,0,3,3,3,3,3,6,9,12,0,-3,-6,-9,1,14.0,4.0,10.0,8
5624,5624,2017-18,2017,2018,Crystal Palace,Bournemouth,Draw,Away,2018-04-07,1,3,3,3,3,4,4,5,6,-1,-1,-2,-3,0,14.0,9.0,5.0,9
5625,5625,2017-18,2017,2018,Crystal Palace,Brighton,Win,Home,2018-04-14,3,1,4,4,4,1,1,4,7,0,3,0,-3,1,14.0,21.0,-7.0,9
5626,5626,2017-18,2017,2018,Crystal Palace,Watford,Draw,Away,2018-04-21,1,4,4,7,7,0,1,1,1,4,3,6,6,0,14.0,17.0,-3.0,9
5627,5627,2017-18,2017,2018,Crystal Palace,Leicester,Win,Home,2018-04-28,3,4,5,5,8,1,1,4,7,3,4,1,1,1,14.0,12.0,2.0,9
5628,5628,2017-18,2017,2018,Crystal Palace,Stoke,Win,Away,2018-05-05,3,4,7,8,8,2,3,3,3,2,4,5,5,0,14.0,13.0,1.0,10
5629,5629,2017-18,2017,2018,Crystal Palace,West Brom,Win,Home,2018-05-13,3,6,7,10,11,6,7,10,11,0,0,0,0,1,14.0,10.0,4.0,10
5630,5630,1996-97,1996,1997,Derby,Leeds,Draw,Home,1996-08-17,1,0,0,0,0,1,1,1,1,-1,-1,-1,-1,1,21.0,13.0,8.0,1
5631,5631,1996-97,1996,1997,Derby,Tottenham,Draw,Away,1996-08-21,1,1,1,1,1,4,7,8,9,-3,-6,-7,-8,0,21.0,8.0,13.0,1
5632,5632,1996-97,1996,1997,Derby,Aston Villa,Loss,Away,1996-08-24,0,2,2,2,2,3,3,3,4,-1,-1,-1,-2,0,21.0,4.0,17.0,1
5633,5633,1996-97,1996,1997,Derby,Man United,Draw,Home,1996-09-04,1,1,2,2,2,2,5,8,11,-1,-3,-6,-9,1,21.0,1.0,20.0,2
5634,5634,1996-97,1996,1997,Derby,Blackburn,Win,Away,1996-09-09,3,1,2,3,3,1,1,1,4,0,1,2,-1,0,21.0,7.0,14.0,2
5635,5635,1996-97,1996,1997,Derby,Sunderland,Win,Home,1996-09-14,3,4,4,5,6,1,2,5,6,3,2,0,0,1,21.0,21.0,0.0,2
5636,5636,1996-97,1996,1997,Derby,Sheffield Weds,Draw,Away,1996-09-21,1,6,7,7,8,0,3,6,9,6,4,1,-1,0,21.0,15.0,6.0,2
5637,5637,1996-97,1996,1997,Derby,Wimbledon,Loss,Home,1996-09-28,0,4,7,8,8,6,9,12,12,-2,-2,-4,-4,1,21.0,14.0,7.0,2
5638,5638,1996-97,1996,1997,Derby,Newcastle,Loss,Home,1996-10-12,0,1,4,7,8,6,9,12,15,-5,-5,-5,-7,1,21.0,2.0,19.0,3
5639,5639,1996-97,1996,1997,Derby,Nott'm Forest,Draw,Away,1996-10-19,1,0,1,4,7,1,1,1,2,-1,0,3,5,0,21.0,9.0,12.0,3
5640,5640,1996-97,1996,1997,Derby,Liverpool,Loss,Away,1996-10-27,0,1,1,2,5,3,6,9,12,-2,-5,-7,-7,0,21.0,3.0,18.0,3
5641,5641,1996-97,1996,1997,Derby,Leicester,Win,Home,1996-11-02,3,1,1,1,2,3,3,6,9,-2,-2,-5,-7,1,21.0,21.0,0.0,4
5642,5642,1996-97,1996,1997,Derby,Middlesbrough,Win,Home,1996-11-17,3,3,4,4,4,1,1,2,2,2,3,2,2,1,21.0,12.0,9.0,4
5643,5643,1996-97,1996,1997,Derby,West Ham,Draw,Away,1996-11-23,1,6,6,7,7,1,4,7,7,5,2,0,0,0,21.0,10.0,11.0,4
5644,5644,1996-97,1996,1997,Derby,Coventry,Win,Home,1996-11-30,3,4,7,7,8,1,2,3,4,3,5,4,4,1,21.0,16.0,5.0,4
5645,5645,1996-97,1996,1997,Derby,Arsenal,Draw,Away,1996-12-07,1,4,7,10,10,6,9,9,10,-2,-2,1,0,0,21.0,5.0,16.0,5
5646,5646,1996-97,1996,1997,Derby,Everton,Loss,Home,1996-12-16,0,4,5,8,11,1,4,5,8,3,1,3,3,1,21.0,6.0,15.0,5
5647,5647,1996-97,1996,1997,Derby,Southampton,Loss,Away,1996-12-21,0,1,4,5,8,0,0,0,0,1,4,5,8,0,21.0,17.0,4.0,5
5648,5648,1996-97,1996,1997,Derby,Sunderland,Loss,Away,1996-12-26,0,0,1,4,5,3,3,6,7,-3,-2,-2,-2,0,21.0,21.0,0.0,5
5649,5649,1996-97,1996,1997,Derby,Blackburn,Draw,Home,1996-12-28,1,0,0,1,4,3,4,7,8,-3,-4,-6,-4,1,21.0,7.0,14.0,5
5650,5650,1996-97,1996,1997,Derby,Wimbledon,Draw,Away,1997-01-11,1,1,1,1,2,3,6,9,12,-2,-5,-8,-10,0,21.0,14.0,7.0,6
5651,5651,1996-97,1996,1997,Derby,Chelsea,Loss,Away,1997-01-18,0,2,2,2,2,3,4,7,10,-1,-2,-5,-8,0,21.0,11.0,10.0,6
5652,5652,1996-97,1996,1997,Derby,Leeds,Draw,Away,1997-01-29,1,1,2,2,2,6,6,6,6,-5,-4,-4,-4,0,21.0,13.0,8.0,6
5653,5653,1996-97,1996,1997,Derby,Liverpool,Loss,Home,1997-02-01,0,1,2,3,3,4,4,7,8,-3,-2,-4,-5,1,21.0,3.0,18.0,7
5654,5654,1996-97,1996,1997,Derby,West Ham,Win,Home,1997-02-15,3,1,1,2,3,0,0,1,1,1,1,1,2,1,21.0,10.0,11.0,7
5655,5655,1996-97,1996,1997,Derby,Sheffield Weds,Draw,Home,1997-02-19,1,3,4,4,5,4,4,7,8,-1,0,-3,-3,1,21.0,15.0,6.0,7
5656,5656,1996-97,1996,1997,Derby,Leicester,Loss,Away,1997-02-22,0,4,4,5,5,1,4,4,5,3,0,1,0,0,21.0,21.0,0.0,7
5657,5657,1996-97,1996,1997,Derby,Chelsea,Win,Home,1997-03-01,3,1,4,4,5,4,7,7,10,-3,-3,-3,-5,1,21.0,11.0,10.0,8
5658,5658,1996-97,1996,1997,Derby,Middlesbrough,Loss,Away,1997-03-05,0,3,4,7,7,0,1,4,4,3,3,3,3,0,21.0,12.0,9.0,8
5659,5659,1996-97,1996,1997,Derby,Everton,Loss,Away,1997-03-15,0,3,3,4,7,1,1,2,5,2,2,2,2,0,21.0,6.0,15.0,8
5660,5660,1996-97,1996,1997,Derby,Tottenham,Win,Home,1997-03-22,3,0,3,3,4,4,7,7,7,-4,-4,-4,-3,1,21.0,8.0,13.0,8
5661,5661,1996-97,1996,1997,Derby,Man United,Win,Away,1997-04-05,3,3,3,6,6,6,6,9,10,-3,-3,-3,-4,0,21.0,1.0,20.0,9
5662,5662,1996-97,1996,1997,Derby,Southampton,Draw,Home,1997-04-09,1,6,6,6,9,4,4,4,5,2,2,2,4,1,21.0,17.0,4.0,9
5663,5663,1996-97,1996,1997,Derby,Aston Villa,Win,Home,1997-04-12,3,4,7,7,7,6,9,10,10,-2,-2,-3,-3,1,21.0,4.0,17.0,9
5664,5664,1996-97,1996,1997,Derby,Newcastle,Loss,Away,1997-04-19,0,4,7,10,10,4,5,6,9,0,2,4,1,0,21.0,2.0,19.0,9
5665,5665,1996-97,1996,1997,Derby,Nott'm Forest,Draw,Home,1997-04-23,1,3,4,7,10,1,2,3,4,2,2,4,6,1,21.0,9.0,12.0,9
5666,5666,1996-97,1996,1997,Derby,Coventry,Win,Away,1997-05-03,3,1,4,5,8,2,5,8,8,-1,-1,-3,0,0,21.0,16.0,5.0,10
5667,5667,1996-97,1996,1997,Derby,Arsenal,Loss,Home,1997-05-11,0,4,4,7,8,1,2,5,8,3,2,2,0,1,21.0,5.0,16.0,10
5668,5668,1997-98,1997,1998,Derby,Blackburn,Loss,Away,1997-08-09,0,3,4,4,7,1,1,4,5,2,3,0,2,0,12.0,13.0,-1.0,1
5669,5669,1997-98,1997,1998,Derby,Tottenham,Loss,Away,1997-08-23,0,0,3,4,4,0,0,0,3,0,3,4,1,0,12.0,10.0,2.0,1
5670,5670,1997-98,1997,1998,Derby,Barnsley,Win,Home,1997-08-30,3,0,0,3,4,3,6,6,6,-3,-6,-3,-2,1,12.0,21.0,-9.0,1
5671,5671,1997-98,1997,1998,Derby,Everton,Win,Home,1997-09-13,3,3,3,3,6,1,4,4,4,2,-1,-1,2,1,12.0,15.0,-3.0,2
5672,5672,1997-98,1997,1998,Derby,Aston Villa,Loss,Away,1997-09-20,0,6,6,6,6,6,6,6,6,0,0,0,0,0,12.0,5.0,7.0,2
5673,5673,1997-98,1997,1998,Derby,Sheffield Weds,Win,Away,1997-09-24,3,3,6,6,6,1,4,4,5,2,2,2,1,0,12.0,7.0,5.0,2
5674,5674,1997-98,1997,1998,Derby,Southampton,Win,Home,1997-09-27,3,3,6,9,9,1,1,1,4,2,5,8,5,1,12.0,16.0,-4.0,2
5675,5675,1997-98,1997,1998,Derby,Leicester,Win,Away,1997-10-06,3,6,6,9,12,4,7,10,10,2,-1,-1,2,0,12.0,9.0,3.0,3
5676,5676,1997-98,1997,1998,Derby,Man United,Draw,Home,1997-10-18,1,6,9,9,12,3,4,5,8,3,5,4,4,1,12.0,1.0,11.0,3
5677,5677,1997-98,1997,1998,Derby,Wimbledon,Draw,Home,1997-10-22,1,4,7,10,10,3,4,7,7,1,3,3,3,1,12.0,8.0,4.0,3
5678,5678,1997-98,1997,1998,Derby,Liverpool,Loss,Away,1997-10-25,0,2,5,8,11,3,3,6,7,-1,2,2,4,0,12.0,4.0,8.0,3
5679,5679,1997-98,1997,1998,Derby,Arsenal,Win,Home,1997-11-01,3,1,2,5,8,2,5,6,9,-1,-3,-1,-1,1,12.0,3.0,9.0,4
5680,5680,1997-98,1997,1998,Derby,Leeds,Loss,Away,1997-11-08,0,3,4,5,8,3,6,7,10,0,-2,-2,-2,0,12.0,11.0,1.0,4
5681,5681,1997-98,1997,1998,Derby,Coventry,Win,Home,1997-11-22,3,3,3,4,5,4,5,5,6,-1,-2,-1,-1,1,12.0,17.0,-5.0,4
5682,5682,1997-98,1997,1998,Derby,Chelsea,Loss,Away,1997-11-29,0,3,6,6,7,3,6,9,9,0,0,-3,-2,0,12.0,6.0,6.0,4
5683,5683,1997-98,1997,1998,Derby,West Ham,Win,Home,1997-12-06,3,3,3,6,6,6,6,6,6,-3,-3,0,0,1,12.0,14.0,-2.0,5
5684,5684,1997-98,1997,1998,Derby,Bolton,Draw,Away,1997-12-14,1,3,6,6,9,3,6,7,7,0,0,-1,2,0,12.0,21.0,-9.0,5
5685,5685,1997-98,1997,1998,Derby,Newcastle,Draw,Away,1997-12-17,1,4,4,7,7,1,1,4,7,3,3,3,0,0,12.0,2.0,10.0,5
5686,5686,1997-98,1997,1998,Derby,Crystal Palace,Draw,Home,1997-12-20,1,2,5,5,8,1,1,1,4,1,4,4,4,1,12.0,21.0,-9.0,5
5687,5687,1997-98,1997,1998,Derby,Newcastle,Win,Home,1997-12-26,3,2,3,6,6,1,2,2,2,1,1,4,4,1,12.0,2.0,10.0,5
5688,5688,1997-98,1997,1998,Derby,Barnsley,Loss,Away,1997-12-28,0,4,5,6,9,1,2,2,2,3,3,4,7,0,12.0,21.0,-9.0,5
5689,5689,1997-98,1997,1998,Derby,Blackburn,Win,Home,1998-01-11,3,3,4,5,6,2,5,8,11,1,-1,-3,-5,1,12.0,13.0,-1.0,6
5690,5690,1997-98,1997,1998,Derby,Wimbledon,Draw,Away,1998-01-17,1,3,6,7,8,0,1,2,5,3,5,5,3,0,12.0,8.0,4.0,6
5691,5691,1997-98,1997,1998,Derby,Tottenham,Win,Home,1998-01-31,3,4,4,7,8,3,4,4,7,1,0,3,1,1,12.0,10.0,2.0,6
5692,5692,1997-98,1997,1998,Derby,Aston Villa,Loss,Home,1998-02-07,0,4,7,7,10,0,1,2,5,4,6,5,5,1,12.0,5.0,7.0,7
5693,5693,1997-98,1997,1998,Derby,Everton,Win,Away,1998-02-14,3,3,4,7,7,2,5,8,11,1,-1,-1,-4,0,12.0,15.0,-3.0,7
5694,5694,1997-98,1997,1998,Derby,Man United,Loss,Away,1998-02-21,0,3,6,7,10,4,4,4,7,-1,2,3,3,0,12.0,1.0,11.0,7
5695,5695,1997-98,1997,1998,Derby,Sheffield Weds,Win,Home,1998-02-28,3,3,3,6,7,4,4,5,8,-1,-1,1,-1,1,12.0,7.0,5.0,7
5696,5696,1997-98,1997,1998,Derby,Leeds,Loss,Home,1998-03-15,0,3,6,6,9,6,6,7,7,-3,0,-1,2,1,12.0,11.0,1.0,8
5697,5697,1997-98,1997,1998,Derby,Coventry,Loss,Away,1998-03-28,0,3,3,6,6,4,7,10,13,-1,-4,-4,-7,0,12.0,17.0,-5.0,8
5698,5698,1997-98,1997,1998,Derby,Chelsea,Loss,Home,1998-04-05,0,0,3,3,6,3,3,3,3,-3,0,0,3,1,12.0,6.0,6.0,9
5699,5699,1997-98,1997,1998,Derby,West Ham,Draw,Away,1998-04-11,1,0,0,3,3,3,6,7,8,-3,-6,-4,-5,0,12.0,14.0,-2.0,9
5700,5700,1997-98,1997,1998,Derby,Bolton,Win,Home,1998-04-13,3,1,1,1,4,4,4,7,10,-3,-3,-6,-6,1,12.0,21.0,-9.0,9
5701,5701,1997-98,1997,1998,Derby,Crystal Palace,Loss,Away,1998-04-18,0,4,4,4,4,0,0,3,3,4,4,1,1,0,12.0,21.0,-9.0,9
5702,5702,1997-98,1997,1998,Derby,Leicester,Loss,Home,1998-04-26,0,3,4,4,4,2,5,6,6,1,-1,-2,-2,1,12.0,9.0,3.0,9
5703,5703,1997-98,1997,1998,Derby,Arsenal,Loss,Away,1998-04-29,0,0,3,4,4,6,9,12,15,-6,-6,-8,-11,0,12.0,3.0,9.0,9
5704,5704,1997-98,1997,1998,Derby,Southampton,Win,Away,1998-05-02,3,0,0,3,4,3,4,4,4,-3,-4,-1,0,0,12.0,16.0,-4.0,10
5705,5705,1997-98,1997,1998,Derby,Liverpool,Win,Home,1998-05-10,3,3,3,3,6,6,6,7,10,-3,-3,-4,-4,1,12.0,4.0,8.0,10
5706,5706,1998-99,1998,1999,Derby,Blackburn,Draw,Away,1998-08-15,1,6,6,6,6,3,6,7,7,3,0,-1,-1,0,9.0,6.0,3.0,1
5707,5707,1998-99,1998,1999,Derby,Wimbledon,Draw,Home,1998-08-22,1,4,7,7,7,4,4,5,6,0,3,2,1,1,9.0,15.0,-6.0,1
5708,5708,1998-99,1998,1999,Derby,Middlesbrough,Draw,Away,1998-08-29,1,2,5,8,8,1,2,3,4,1,3,5,4,0,9.0,21.0,-12.0,1
5709,5709,1998-99,1998,1999,Derby,Sheffield Weds,Win,Home,1998-09-09,3,2,3,6,9,3,3,3,3,-1,0,3,6,1,9.0,16.0,-7.0,2
5710,5710,1998-99,1998,1999,Derby,Charlton,Win,Away,1998-09-12,3,4,5,6,9,1,4,5,5,3,1,1,4,0,9.0,21.0,-12.0,2
5711,5711,1998-99,1998,1999,Derby,Leicester,Win,Home,1998-09-19,3,6,7,8,9,1,1,4,5,5,6,4,4,1,9.0,10.0,-1.0,2
5712,5712,1998-99,1998,1999,Derby,Aston Villa,Loss,Away,1998-09-26,0,6,9,10,11,4,7,10,13,2,2,0,-2,0,9.0,7.0,2.0,2
5713,5713,1998-99,1998,1999,Derby,Tottenham,Loss,Home,1998-10-03,0,3,6,9,10,2,2,5,8,1,4,4,2,1,9.0,14.0,-5.0,3
5714,5714,1998-99,1998,1999,Derby,Newcastle,Loss,Away,1998-10-17,0,0,3,6,9,3,6,9,9,-3,-3,-3,0,0,9.0,13.0,-4.0,3
5715,5715,1998-99,1998,1999,Derby,Man United,Draw,Home,1998-10-24,1,0,0,3,6,6,9,9,12,-6,-9,-6,-6,1,9.0,2.0,7.0,3
5716,5716,1998-99,1998,1999,Derby,Leeds,Draw,Home,1998-10-31,1,1,1,1,4,2,2,3,4,-1,-1,-2,0,1,9.0,5.0,4.0,3
5717,5717,1998-99,1998,1999,Derby,Liverpool,Win,Away,1998-11-07,3,2,2,2,2,3,4,5,5,-1,-2,-3,-3,0,9.0,3.0,6.0,4
5718,5718,1998-99,1998,1999,Derby,Nott'm Forest,Draw,Away,1998-11-16,1,4,5,5,5,1,1,2,2,3,4,3,3,0,9.0,21.0,-12.0,4
5719,5719,1998-99,1998,1999,Derby,West Ham,Loss,Home,1998-11-22,0,4,5,6,6,4,7,7,8,0,-2,-1,-2,1,9.0,8.0,1.0,4
5720,5720,1998-99,1998,1999,Derby,Southampton,Win,Away,1998-11-28,3,1,4,5,6,3,4,5,8,-2,0,0,-2,0,9.0,12.0,-3.0,4
5721,5721,1998-99,1998,1999,Derby,Arsenal,Draw,Home,1998-12-05,1,3,4,7,8,1,2,5,8,2,2,2,0,1,9.0,1.0,8.0,5
5722,5722,1998-99,1998,1999,Derby,Chelsea,Draw,Home,1998-12-12,1,4,4,5,8,4,5,8,11,0,-1,-3,-3,1,9.0,4.0,5.0,5
5723,5723,1998-99,1998,1999,Derby,Coventry,Draw,Away,1998-12-19,1,2,5,5,6,0,1,1,4,2,4,4,2,0,9.0,11.0,-2.0,5
5724,5724,1998-99,1998,1999,Derby,Everton,Draw,Away,1998-12-26,1,2,3,6,6,3,4,7,10,-1,-1,-1,-4,0,9.0,17.0,-8.0,5
5725,5725,1998-99,1998,1999,Derby,Middlesbrough,Win,Home,1998-12-28,3,2,3,4,7,3,6,7,8,-1,-3,-3,-1,1,9.0,21.0,-12.0,5
5726,5726,1998-99,1998,1999,Derby,Wimbledon,Loss,Away,1999-01-09,0,4,5,6,7,4,4,7,10,0,1,-1,-3,0,9.0,15.0,-6.0,6
5727,5727,1998-99,1998,1999,Derby,Blackburn,Win,Home,1999-01-16,3,3,4,5,6,4,7,8,9,-1,-3,-3,-3,1,9.0,6.0,3.0,6
5728,5728,1998-99,1998,1999,Derby,Sheffield Weds,Win,Away,1999-01-30,3,3,6,7,8,4,4,4,4,-1,2,3,4,0,9.0,16.0,-7.0,6
5729,5729,1998-99,1998,1999,Derby,Man United,Loss,Away,1999-02-02,0,6,6,9,10,6,9,10,13,0,-3,-1,-3,0,9.0,2.0,7.0,7
5730,5730,1998-99,1998,1999,Derby,Everton,Win,Home,1999-02-07,3,3,6,6,9,0,1,1,2,3,5,5,7,1,9.0,17.0,-8.0,7
5731,5731,1998-99,1998,1999,Derby,Charlton,Loss,Home,1999-02-20,0,3,6,9,9,6,6,7,7,-3,0,2,2,1,9.0,21.0,-12.0,7
5732,5732,1998-99,1998,1999,Derby,Tottenham,Draw,Away,1999-02-27,1,3,3,6,9,2,3,4,5,1,0,2,4,0,9.0,14.0,-5.0,7
5733,5733,1998-99,1998,1999,Derby,Aston Villa,Win,Home,1999-03-10,3,1,4,4,7,1,1,1,1,0,3,3,6,1,9.0,7.0,2.0,8
5734,5734,1998-99,1998,1999,Derby,Liverpool,Win,Home,1999-03-13,3,4,4,7,7,1,1,4,4,3,3,3,3,1,9.0,3.0,6.0,8
5735,5735,1998-99,1998,1999,Derby,Leeds,Loss,Away,1999-03-20,0,6,7,7,10,6,9,12,15,0,-2,-5,-5,0,9.0,5.0,4.0,8
5736,5736,1998-99,1998,1999,Derby,Newcastle,Loss,Home,1999-04-03,0,3,6,7,7,0,3,4,4,3,3,3,3,1,9.0,13.0,-4.0,9
5737,5737,1998-99,1998,1999,Derby,Nott'm Forest,Win,Home,1999-04-10,3,0,3,6,7,1,1,4,4,-1,2,2,3,1,9.0,21.0,-12.0,9
5738,5738,1998-99,1998,1999,Derby,West Ham,Loss,Away,1999-04-17,0,3,3,6,9,1,2,5,8,2,1,1,1,0,9.0,8.0,1.0,9
5739,5739,1998-99,1998,1999,Derby,Southampton,Draw,Home,1999-04-24,1,3,3,3,6,1,1,2,5,2,2,1,1,1,9.0,12.0,-3.0,9
5740,5740,1998-99,1998,1999,Derby,Arsenal,Loss,Away,1999-05-02,0,1,4,4,4,6,9,10,13,-5,-5,-6,-9,0,9.0,1.0,8.0,10
5741,5741,1998-99,1998,1999,Derby,Leicester,Win,Away,1999-05-05,3,1,1,4,4,3,6,7,8,-2,-5,-3,-4,0,9.0,10.0,-1.0,10
5742,5742,1998-99,1998,1999,Derby,Coventry,Draw,Home,1999-05-08,1,3,4,4,7,3,3,3,6,0,1,1,1,1,9.0,11.0,-2.0,10
5743,5743,1998-99,1998,1999,Derby,Chelsea,Loss,Away,1999-05-16,0,4,4,5,5,4,7,8,9,0,-3,-3,-4,0,9.0,4.0,5.0,10
5744,5744,1999-00,1999,2000,Derby,Leeds,Draw,Away,1999-08-07,1,1,4,4,5,4,4,7,8,-3,0,-3,-3,0,8.0,4.0,4.0,1
5745,5745,1999-00,1999,2000,Derby,Arsenal,Loss,Home,1999-08-10,0,1,2,5,5,6,6,9,12,-5,-4,-4,-7,1,8.0,2.0,6.0,1
5746,5746,1999-00,1999,2000,Derby,Middlesbrough,Loss,Home,1999-08-14,0,1,1,2,5,3,3,3,4,-2,-2,-1,1,1,8.0,9.0,-1.0,1
5747,5747,1999-00,1999,2000,Derby,Coventry,Loss,Away,1999-08-21,0,0,1,1,2,1,1,2,3,-1,0,-1,-1,0,8.0,15.0,-7.0,1
5748,5748,1999-00,1999,2000,Derby,Sheffield Weds,Win,Away,1999-08-25,3,0,0,1,1,1,1,1,4,-1,-1,0,-3,0,8.0,12.0,-4.0,1
5749,5749,1999-00,1999,2000,Derby,Everton,Win,Home,1999-08-28,3,3,3,3,4,6,6,6,7,-3,-3,-3,-3,1,8.0,14.0,-6.0,1
5750,5750,1999-00,1999,2000,Derby,Wimbledon,Draw,Away,1999-09-11,1,6,6,6,6,0,1,2,2,6,5,4,4,0,8.0,16.0,-8.0,2
5751,5751,1999-00,1999,2000,Derby,Sunderland,Loss,Home,1999-09-18,0,4,7,7,7,4,7,7,8,0,0,0,-1,1,8.0,21.0,-13.0,2
5752,5752,1999-00,1999,2000,Derby,Bradford,Loss,Home,1999-09-25,0,1,4,7,7,1,1,1,1,0,3,6,6,1,8.0,21.0,-13.0,2
5753,5753,1999-00,1999,2000,Derby,Southampton,Draw,Away,1999-10-04,1,0,1,4,7,1,1,4,4,-1,0,0,3,0,8.0,17.0,-9.0,3
5754,5754,1999-00,1999,2000,Derby,Tottenham,Loss,Home,1999-10-16,0,1,1,2,5,1,4,5,5,0,-3,-3,0,1,8.0,11.0,-3.0,3
5755,5755,1999-00,1999,2000,Derby,Newcastle,Loss,Away,1999-10-25,0,1,1,1,2,3,3,6,6,-2,-2,-5,-4,0,8.0,13.0,-5.0,3
5756,5756,1999-00,1999,2000,Derby,Chelsea,Win,Home,1999-10-30,3,0,1,1,1,0,3,6,6,0,-2,-5,-5,1,8.0,3.0,5.0,3
5757,5757,1999-00,1999,2000,Derby,Liverpool,Loss,Away,1999-11-06,0,3,3,4,4,6,7,10,11,-3,-4,-6,-7,0,8.0,7.0,1.0,4
5758,5758,1999-00,1999,2000,Derby,Man United,Loss,Home,1999-11-20,0,3,3,3,4,6,6,9,9,-3,-3,-6,-5,1,8.0,1.0,7.0,4
5759,5759,1999-00,1999,2000,Derby,Arsenal,Loss,Away,1999-11-28,0,0,3,3,3,3,4,7,10,-3,-1,-4,-7,0,8.0,2.0,6.0,4
5760,5760,1999-00,1999,2000,Derby,Leeds,Loss,Home,1999-12-05,0,0,0,3,3,6,6,9,10,-6,-6,-6,-7,1,8.0,4.0,4.0,5
5761,5761,1999-00,1999,2000,Derby,Leicester,Win,Away,1999-12-18,3,0,0,0,3,3,6,6,9,-3,-6,-6,-6,0,8.0,10.0,-2.0,5
5762,5762,1999-00,1999,2000,Derby,Aston Villa,Loss,Home,1999-12-26,0,3,3,3,3,3,4,4,4,0,-1,-1,-1,1,8.0,6.0,2.0,5
5763,5763,1999-00,1999,2000,Derby,West Ham,Draw,Away,1999-12-28,1,3,3,3,3,1,2,5,8,2,1,-2,-5,0,8.0,5.0,3.0,5
5764,5764,1999-00,1999,2000,Derby,Watford,Win,Home,2000-01-03,3,1,4,4,4,3,3,3,3,-2,1,1,1,1,8.0,21.0,-13.0,6
5765,5765,1999-00,1999,2000,Derby,Middlesbrough,Win,Away,2000-01-15,3,4,4,7,7,3,4,5,5,1,0,2,2,0,8.0,9.0,-1.0,6
5766,5766,1999-00,1999,2000,Derby,Coventry,Draw,Home,2000-01-22,1,6,7,7,10,4,7,7,8,2,0,0,2,1,8.0,15.0,-7.0,6
5767,5767,1999-00,1999,2000,Derby,Sheffield Weds,Draw,Home,2000-02-05,1,4,7,8,8,3,6,7,7,1,1,1,1,1,8.0,12.0,-4.0,7
5768,5768,1999-00,1999,2000,Derby,Everton,Loss,Away,2000-02-12,0,2,5,8,9,3,4,5,6,-1,1,3,3,0,8.0,14.0,-6.0,7
5769,5769,1999-00,1999,2000,Derby,Sunderland,Draw,Away,2000-02-26,1,1,2,5,8,1,1,1,1,0,1,4,7,0,8.0,21.0,-13.0,7
5770,5770,1999-00,1999,2000,Derby,Wimbledon,Win,Home,2000-03-04,3,1,2,3,6,1,1,4,4,0,1,-1,2,1,8.0,16.0,-8.0,8
5771,5771,1999-00,1999,2000,Derby,Man United,Loss,Away,2000-03-11,0,4,4,5,6,2,5,5,8,2,-1,0,-2,0,8.0,1.0,7.0,8
5772,5772,1999-00,1999,2000,Derby,Liverpool,Loss,Home,2000-03-18,0,3,4,4,5,2,3,6,9,1,1,-2,-4,1,8.0,7.0,1.0,8
5773,5773,1999-00,1999,2000,Derby,Aston Villa,Loss,Away,2000-03-25,0,0,3,4,4,1,4,5,6,-1,-1,-1,-2,0,8.0,6.0,2.0,8
5774,5774,1999-00,1999,2000,Derby,Leicester,Win,Home,2000-04-02,3,0,0,3,4,3,3,6,7,-3,-3,-3,-3,1,8.0,10.0,-2.0,9
5775,5775,1999-00,1999,2000,Derby,Watford,Draw,Away,2000-04-08,1,3,3,3,6,1,4,4,4,2,-1,-1,2,0,8.0,21.0,-13.0,9
5776,5776,1999-00,1999,2000,Derby,West Ham,Loss,Home,2000-04-15,0,4,4,4,4,3,6,7,7,1,-2,-3,-3,1,8.0,5.0,3.0,9
5777,5777,1999-00,1999,2000,Derby,Bradford,Draw,Away,2000-04-21,1,1,4,4,4,0,0,0,0,1,4,4,4,0,8.0,21.0,-13.0,9
5778,5778,1999-00,1999,2000,Derby,Southampton,Win,Home,2000-04-24,3,1,2,5,5,3,6,6,7,-2,-4,-1,-2,1,8.0,17.0,-9.0,9
5779,5779,1999-00,1999,2000,Derby,Tottenham,Draw,Away,2000-04-29,1,4,4,5,8,6,6,6,6,-2,-2,-1,2,0,8.0,11.0,-3.0,9
5780,5780,1999-00,1999,2000,Derby,Newcastle,Draw,Home,2000-05-06,1,4,5,5,6,4,5,5,5,0,0,0,1,1,8.0,13.0,-5.0,10
5781,5781,1999-00,1999,2000,Derby,Chelsea,Loss,Away,2000-05-14,0,2,5,6,6,3,3,4,4,-1,2,2,2,0,8.0,3.0,5.0,10
5782,5782,2000-01,2000,2001,Derby,Southampton,Draw,Home,2000-08-19,1,1,2,5,6,4,4,4,4,-3,-2,1,2,1,16.0,15.0,1.0,1
5783,5783,2000-01,2000,2001,Derby,Newcastle,Loss,Away,2000-08-23,0,1,2,3,6,3,4,5,8,-2,-2,-2,-2,0,16.0,11.0,5.0,1
5784,5784,2000-01,2000,2001,Derby,Everton,Draw,Away,2000-08-26,1,1,1,2,3,3,3,4,4,-2,-2,-2,-1,0,16.0,13.0,3.0,1
5785,5785,2000-01,2000,2001,Derby,Middlesbrough,Draw,Home,2000-09-06,1,1,2,2,3,1,4,7,8,0,-2,-5,-5,1,16.0,12.0,4.0,2
5786,5786,2000-01,2000,2001,Derby,Charlton,Draw,Home,2000-09-10,1,2,2,3,3,1,1,4,4,1,1,-1,-1,1,16.0,21.0,-5.0,2
5787,5787,2000-01,2000,2001,Derby,Sunderland,Loss,Away,2000-09-16,0,2,3,3,4,1,1,1,4,1,2,2,0,0,16.0,7.0,9.0,2
5788,5788,2000-01,2000,2001,Derby,Leeds,Draw,Home,2000-09-23,1,1,2,3,3,1,1,4,7,0,1,-1,-4,1,16.0,3.0,13.0,2
5789,5789,2000-01,2000,2001,Derby,Aston Villa,Loss,Away,2000-09-30,0,1,2,3,4,4,7,7,8,-3,-5,-4,-4,0,16.0,6.0,10.0,2
5790,5790,2000-01,2000,2001,Derby,Liverpool,Loss,Home,2000-10-15,0,1,1,2,3,1,2,5,8,0,-1,-3,-5,1,16.0,4.0,12.0,3
5791,5791,2000-01,2000,2001,Derby,Tottenham,Loss,Away,2000-10-21,0,0,1,1,2,0,1,1,4,0,0,0,-2,0,16.0,10.0,6.0,3
5792,5792,2000-01,2000,2001,Derby,Leicester,Loss,Away,2000-10-28,0,0,0,1,1,0,1,2,5,0,-1,-1,-4,0,16.0,8.0,8.0,3
5793,5793,2000-01,2000,2001,Derby,West Ham,Draw,Home,2000-11-06,1,0,0,0,1,3,4,5,8,-3,-4,-5,-7,1,16.0,9.0,7.0,4
5794,5794,2000-01,2000,2001,Derby,Arsenal,Draw,Away,2000-11-11,1,1,1,1,1,6,9,12,15,-5,-8,-11,-14,0,16.0,2.0,14.0,4
5795,5795,2000-01,2000,2001,Derby,Bradford,Win,Home,2000-11-18,3,2,2,2,2,0,1,1,1,2,1,1,1,1,16.0,17.0,-1.0,4
5796,5796,2000-01,2000,2001,Derby,Man United,Loss,Home,2000-11-25,0,4,5,5,5,6,9,12,15,-2,-4,-7,-10,1,16.0,1.0,15.0,4
5797,5797,2000-01,2000,2001,Derby,Ipswich,Win,Away,2000-12-02,3,3,4,5,5,6,9,9,12,-3,-5,-4,-7,0,16.0,21.0,-5.0,5
5798,5798,2000-01,2000,2001,Derby,Chelsea,Loss,Away,2000-12-09,0,3,6,7,8,3,3,4,4,0,3,3,4,0,16.0,5.0,11.0,5
5799,5799,2000-01,2000,2001,Derby,Coventry,Win,Home,2000-12-16,3,3,3,6,7,3,4,4,4,0,-1,2,3,1,16.0,14.0,2.0,5
5800,5800,2000-01,2000,2001,Derby,Newcastle,Win,Home,2000-12-23,3,3,6,6,9,3,4,7,7,0,2,-1,2,1,16.0,11.0,5.0,5
5801,5801,2000-01,2000,2001,Derby,Man City,Draw,Away,2000-12-26,1,6,6,9,9,1,4,4,4,5,2,5,5,0,16.0,21.0,-5.0,5
5802,5802,2000-01,2000,2001,Derby,Southampton,Loss,Away,2000-12-30,0,4,7,7,10,4,4,7,7,0,3,0,3,0,16.0,15.0,1.0,5
5803,5803,2000-01,2000,2001,Derby,Everton,Win,Home,2001-01-01,3,1,4,7,7,0,1,1,1,1,3,6,6,1,16.0,13.0,3.0,6
5804,5804,2000-01,2000,2001,Derby,Middlesbrough,Loss,Away,2001-01-13,0,3,4,7,10,2,5,6,9,1,-1,1,1,0,16.0,12.0,4.0,6
5805,5805,2000-01,2000,2001,Derby,Man City,Draw,Home,2001-01-20,1,3,3,4,7,1,1,2,2,2,2,2,5,1,16.0,21.0,-5.0,6
5806,5806,2000-01,2000,2001,Derby,Charlton,Loss,Away,2001-01-30,0,1,4,4,5,2,5,8,8,-1,-1,-4,-3,0,16.0,21.0,-5.0,6
5807,5807,2000-01,2000,2001,Derby,Sunderland,Win,Home,2001-02-03,3,1,1,4,4,1,4,7,8,0,-3,-3,-4,1,16.0,7.0,9.0,7
5808,5808,2000-01,2000,2001,Derby,Leeds,Draw,Away,2001-02-10,1,3,4,4,7,4,7,10,10,-1,-3,-6,-3,0,16.0,3.0,13.0,7
5809,5809,2000-01,2000,2001,Derby,Aston Villa,Win,Home,2001-02-24,3,4,4,5,5,4,4,4,4,0,0,1,1,1,16.0,6.0,10.0,7
5810,5810,2000-01,2000,2001,Derby,Tottenham,Win,Home,2001-03-03,3,4,7,7,8,3,4,5,6,1,3,2,2,1,16.0,10.0,6.0,8
5811,5811,2000-01,2000,2001,Derby,Liverpool,Draw,Away,2001-03-18,1,6,7,10,10,1,4,5,6,5,3,5,4,0,16.0,4.0,12.0,8
5812,5812,2000-01,2000,2001,Derby,Coventry,Loss,Away,2001-03-31,0,4,7,8,11,1,2,3,3,3,5,5,8,0,16.0,14.0,2.0,8
5813,5813,2000-01,2000,2001,Derby,Chelsea,Loss,Home,2001-04-07,0,1,4,7,8,3,6,7,8,-2,-2,0,0,1,16.0,5.0,11.0,9
5814,5814,2000-01,2000,2001,Derby,West Ham,Loss,Away,2001-04-14,0,0,1,4,7,1,1,1,1,-1,0,3,6,0,16.0,9.0,7.0,9
5815,5815,2000-01,2000,2001,Derby,Leicester,Win,Home,2001-04-16,3,0,0,1,4,0,0,0,0,0,0,1,4,1,16.0,8.0,8.0,9
5816,5816,2000-01,2000,2001,Derby,Bradford,Loss,Away,2001-04-21,0,3,3,3,4,3,4,5,5,0,-1,-2,-1,0,16.0,17.0,-1.0,9
5817,5817,2000-01,2000,2001,Derby,Arsenal,Loss,Home,2001-04-28,0,3,3,3,3,3,6,9,10,0,-3,-6,-7,1,16.0,2.0,14.0,9
5818,5818,2000-01,2000,2001,Derby,Man United,Win,Away,2001-05-05,3,0,3,3,3,4,7,10,10,-4,-4,-7,-7,0,16.0,1.0,15.0,10
5819,5819,2000-01,2000,2001,Derby,Ipswich,Draw,Home,2001-05-19,1,3,3,6,6,3,6,9,12,0,-3,-3,-6,1,16.0,21.0,-5.0,10
5820,5820,2001-02,2001,2002,Derby,Blackburn,Win,Home,2001-08-18,3,4,4,4,7,2,2,3,3,2,2,1,4,1,17.0,21.0,-4.0,1
5821,5821,2001-02,2001,2002,Derby,Ipswich,Loss,Away,2001-08-21,0,4,7,7,7,1,4,4,7,3,3,3,0,0,17.0,5.0,12.0,1
5822,5822,2001-02,2001,2002,Derby,Fulham,Draw,Away,2001-08-25,1,3,4,7,7,3,3,3,3,0,1,4,4,0,17.0,21.0,-4.0,1
5823,5823,2001-02,2001,2002,Derby,West Ham,Draw,Home,2001-09-08,1,1,4,5,8,1,1,4,4,0,3,1,4,1,17.0,15.0,2.0,2
5824,5824,2001-02,2001,2002,Derby,Leicester,Loss,Home,2001-09-15,0,2,2,5,6,1,1,1,4,1,1,4,2,1,17.0,13.0,4.0,2
5825,5825,2001-02,2001,2002,Derby,Leeds,Loss,Away,2001-09-23,0,1,2,2,5,4,5,8,11,-3,-3,-6,-6,0,17.0,4.0,13.0,2
5826,5826,2001-02,2001,2002,Derby,Arsenal,Loss,Home,2001-09-29,0,0,1,2,2,4,5,8,8,-4,-4,-6,-6,1,17.0,2.0,15.0,2
5827,5827,2001-02,2001,2002,Derby,Tottenham,Loss,Away,2001-10-15,0,0,0,1,2,0,3,3,6,0,-3,-2,-4,0,17.0,12.0,5.0,3
5828,5828,2001-02,2001,2002,Derby,Charlton,Draw,Home,2001-10-20,1,0,0,0,1,4,5,5,6,-4,-5,-5,-5,1,17.0,9.0,8.0,3
5829,5829,2001-02,2001,2002,Derby,Chelsea,Draw,Home,2001-10-28,1,1,1,1,1,1,4,5,6,0,-3,-4,-5,1,17.0,6.0,11.0,3
5830,5830,2001-02,2001,2002,Derby,Middlesbrough,Loss,Away,2001-11-03,0,2,2,2,2,3,4,4,5,-1,-2,-2,-3,0,17.0,14.0,3.0,4
5831,5831,2001-02,2001,2002,Derby,Southampton,Win,Home,2001-11-17,3,1,2,2,2,0,1,1,1,1,1,1,1,1,17.0,10.0,7.0,4
5832,5832,2001-02,2001,2002,Derby,Newcastle,Loss,Away,2001-11-24,0,3,4,5,5,3,6,6,9,0,-2,-1,-4,0,17.0,11.0,6.0,4
5833,5833,2001-02,2001,2002,Derby,Liverpool,Loss,Home,2001-12-01,0,3,3,4,5,4,7,10,13,-1,-4,-6,-8,1,17.0,3.0,14.0,5
5834,5834,2001-02,2001,2002,Derby,Bolton,Win,Home,2001-12-08,3,0,3,3,4,1,4,5,5,-1,-1,-2,-1,1,17.0,21.0,-4.0,5
5835,5835,2001-02,2001,2002,Derby,Man United,Loss,Away,2001-12-12,0,3,3,6,6,0,0,3,3,3,3,3,3,0,17.0,1.0,16.0,5
5836,5836,2001-02,2001,2002,Derby,Everton,Loss,Away,2001-12-15,0,3,3,3,6,3,4,5,6,0,-1,-2,0,0,17.0,16.0,1.0,5
5837,5837,2001-02,2001,2002,Derby,Aston Villa,Win,Home,2001-12-22,3,0,3,3,3,3,4,4,5,-3,-1,-1,-2,1,17.0,8.0,9.0,5
5838,5838,2001-02,2001,2002,Derby,West Ham,Loss,Away,2001-12-26,0,3,3,6,6,2,5,6,6,1,-2,0,0,0,17.0,15.0,2.0,5
5839,5839,2001-02,2001,2002,Derby,Blackburn,Win,Away,2001-12-29,3,3,3,3,6,3,3,3,3,0,0,0,3,0,17.0,21.0,-4.0,5
5840,5840,2001-02,2001,2002,Derby,Fulham,Loss,Home,2002-01-02,0,3,6,6,6,1,1,2,5,2,5,4,1,1,17.0,21.0,-4.0,6
5841,5841,2001-02,2001,2002,Derby,Aston Villa,Loss,Away,2002-01-12,0,3,3,6,6,2,2,2,5,1,1,4,1,0,17.0,8.0,9.0,6
5842,5842,2001-02,2001,2002,Derby,Ipswich,Loss,Home,2002-01-19,0,0,3,3,6,3,6,9,12,-3,-3,-6,-6,1,17.0,5.0,12.0,6
5843,5843,2001-02,2001,2002,Derby,Charlton,Loss,Away,2002-01-29,0,0,0,3,3,0,3,6,7,0,-3,-3,-4,0,17.0,9.0,8.0,6
5844,5844,2001-02,2001,2002,Derby,Tottenham,Win,Home,2002-02-02,3,0,0,0,3,1,1,4,5,-1,-1,-4,-2,1,17.0,12.0,5.0,7
5845,5845,2001-02,2001,2002,Derby,Sunderland,Loss,Home,2002-02-09,0,3,3,3,3,0,1,1,2,3,2,2,1,1,17.0,7.0,10.0,7
5846,5846,2001-02,2001,2002,Derby,Leicester,Win,Away,2002-02-23,3,3,3,3,3,0,0,0,1,3,3,3,2,0,17.0,13.0,4.0,7
5847,5847,2001-02,2001,2002,Derby,Man United,Draw,Home,2002-03-03,1,3,6,6,6,6,9,12,12,-3,-3,-6,-6,1,17.0,1.0,16.0,8
5848,5848,2001-02,2001,2002,Derby,Arsenal,Loss,Away,2002-03-05,0,4,4,7,7,6,9,10,13,-2,-5,-3,-6,0,17.0,2.0,15.0,8
5849,5849,2001-02,2001,2002,Derby,Bolton,Win,Away,2002-03-16,3,1,4,4,7,1,2,5,5,0,2,-1,2,0,17.0,21.0,-4.0,8
5850,5850,2001-02,2001,2002,Derby,Everton,Loss,Home,2002-03-23,0,3,4,7,7,3,4,5,5,0,0,2,2,1,17.0,16.0,1.0,8
5851,5851,2001-02,2001,2002,Derby,Chelsea,Loss,Away,2002-03-30,0,3,3,4,7,3,6,9,9,0,-3,-5,-2,0,17.0,6.0,11.0,8
5852,5852,2001-02,2001,2002,Derby,Middlesbrough,Loss,Home,2002-04-01,0,0,3,3,4,4,4,5,8,-4,-1,-2,-4,1,17.0,14.0,3.0,9
5853,5853,2001-02,2001,2002,Derby,Southampton,Loss,Away,2002-04-06,0,0,0,3,3,1,2,3,4,-1,-2,0,-1,0,17.0,10.0,7.0,9
5854,5854,2001-02,2001,2002,Derby,Newcastle,Loss,Home,2002-04-13,0,0,0,0,3,2,5,6,6,-2,-5,-6,-3,1,17.0,11.0,6.0,9
5855,5855,2001-02,2001,2002,Derby,Liverpool,Loss,Away,2002-04-20,0,0,0,0,0,6,9,12,15,-6,-9,-12,-15,0,17.0,3.0,14.0,9
5856,5856,2001-02,2001,2002,Derby,Leeds,Loss,Home,2002-04-27,0,0,0,0,0,3,6,6,6,-3,-6,-6,-6,1,17.0,4.0,13.0,9
5857,5857,2001-02,2001,2002,Derby,Sunderland,Draw,Away,2002-05-11,1,0,0,0,0,1,1,1,4,-1,-1,-1,-4,0,17.0,7.0,10.0,10
5858,5858,2007-08,2007,2008,Derby,Portsmouth,Draw,Home,2007-08-11,1,1,1,1,1,1,4,5,8,0,-3,-4,-7,1,21.0,9.0,12.0,1
5859,5859,2007-08,2007,2008,Derby,Man City,Loss,Away,2007-08-15,0,2,2,2,2,3,3,3,4,-1,-1,-1,-2,0,21.0,14.0,7.0,1
5860,5860,2007-08,2007,2008,Derby,Tottenham,Loss,Away,2007-08-18,0,1,2,2,2,0,3,4,7,1,-1,-2,-5,0,21.0,5.0,16.0,1
5861,5861,2007-08,2007,2008,Derby,Birmingham,Loss,Home,2007-08-25,0,0,1,2,2,1,1,1,2,-1,0,1,0,1,21.0,21.0,0.0,1
5862,5862,2007-08,2007,2008,Derby,Liverpool,Loss,Away,2007-09-01,0,0,0,1,2,4,7,8,8,-4,-7,-7,-6,0,21.0,3.0,18.0,2
5863,5863,2007-08,2007,2008,Derby,Newcastle,Win,Home,2007-09-17,3,0,0,0,1,4,5,8,9,-4,-5,-8,-8,1,21.0,13.0,8.0,2
5864,5864,2007-08,2007,2008,Derby,Arsenal,Loss,Away,2007-09-22,0,3,3,3,3,6,9,10,13,-3,-6,-7,-10,0,21.0,4.0,17.0,2
5865,5865,2007-08,2007,2008,Derby,Bolton,Draw,Home,2007-09-29,1,3,3,3,3,1,1,4,4,2,2,-1,-1,1,21.0,7.0,14.0,2
5866,5866,2007-08,2007,2008,Derby,Reading,Loss,Away,2007-10-07,0,1,4,4,4,3,3,3,3,-2,1,1,1,0,21.0,8.0,13.0,3
5867,5867,2007-08,2007,2008,Derby,Fulham,Draw,Away,2007-10-20,1,1,1,4,4,1,2,3,4,0,-1,1,0,0,21.0,16.0,5.0,3
5868,5868,2007-08,2007,2008,Derby,Everton,Loss,Home,2007-10-28,0,1,2,2,5,0,3,3,3,1,-1,-1,2,1,21.0,6.0,15.0,3
5869,5869,2007-08,2007,2008,Derby,Aston Villa,Loss,Away,2007-11-03,0,1,1,2,2,1,4,5,8,0,-3,-3,-6,0,21.0,11.0,10.0,4
5870,5870,2007-08,2007,2008,Derby,West Ham,Loss,Home,2007-11-10,0,0,1,1,2,2,5,5,5,-2,-4,-4,-3,1,21.0,15.0,6.0,4
5871,5871,2007-08,2007,2008,Derby,Chelsea,Loss,Home,2007-11-24,0,0,0,1,1,4,7,10,13,-4,-7,-9,-12,1,21.0,2.0,19.0,4
5872,5872,2007-08,2007,2008,Derby,Sunderland,Loss,Away,2007-12-01,0,0,0,0,1,1,1,2,2,-1,-1,-2,-1,0,21.0,21.0,0.0,5
5873,5873,2007-08,2007,2008,Derby,Man United,Loss,Away,2007-12-08,0,0,0,0,0,3,6,7,10,-3,-6,-7,-10,0,21.0,1.0,20.0,5
5874,5874,2007-08,2007,2008,Derby,Middlesbrough,Loss,Home,2007-12-15,0,0,0,0,0,4,4,5,6,-4,-4,-5,-6,1,21.0,12.0,9.0,5
5875,5875,2007-08,2007,2008,Derby,Newcastle,Draw,Away,2007-12-23,1,0,0,0,0,6,7,7,7,-6,-7,-7,-7,0,21.0,13.0,8.0,5
5876,5876,2007-08,2007,2008,Derby,Liverpool,Loss,Home,2007-12-26,0,1,1,1,1,3,3,6,9,-2,-2,-5,-8,1,21.0,3.0,18.0,5
5877,5877,2007-08,2007,2008,Derby,Blackburn,Loss,Home,2007-12-30,0,1,1,1,1,1,1,1,4,0,0,0,-3,1,21.0,10.0,11.0,5
5878,5878,2007-08,2007,2008,Derby,Bolton,Loss,Away,2008-01-02,0,0,1,1,1,0,3,3,6,0,-2,-2,-5,0,21.0,7.0,14.0,6
5879,5879,2007-08,2007,2008,Derby,Wigan,Loss,Home,2008-01-12,0,0,0,1,1,1,4,5,8,-1,-4,-4,-7,1,21.0,17.0,4.0,6
5880,5880,2007-08,2007,2008,Derby,Portsmouth,Loss,Away,2008-01-19,0,0,0,0,1,3,3,4,4,-3,-3,-4,-3,0,21.0,9.0,12.0,6
5881,5881,2007-08,2007,2008,Derby,Man City,Draw,Home,2008-01-30,1,0,0,0,0,1,4,5,6,-1,-4,-5,-6,1,21.0,14.0,7.0,6
5882,5882,2007-08,2007,2008,Derby,Birmingham,Draw,Away,2008-02-02,1,1,1,1,1,0,1,1,2,1,0,0,-1,0,21.0,21.0,0.0,7
5883,5883,2007-08,2007,2008,Derby,Tottenham,Loss,Home,2008-02-09,0,2,2,2,2,2,5,5,5,0,-3,-3,-3,1,21.0,5.0,16.0,7
5884,5884,2007-08,2007,2008,Derby,Wigan,Loss,Away,2008-02-23,0,1,2,2,2,3,3,3,6,-2,-1,-1,-4,0,21.0,17.0,4.0,7
5885,5885,2007-08,2007,2008,Derby,Sunderland,Draw,Home,2008-03-01,1,0,1,2,2,3,3,6,6,-3,-2,-4,-4,1,21.0,21.0,0.0,8
5886,5886,2007-08,2007,2008,Derby,Chelsea,Loss,Away,2008-03-12,0,1,1,2,3,4,5,8,11,-3,-4,-6,-8,0,21.0,2.0,19.0,8
5887,5887,2007-08,2007,2008,Derby,Man United,Loss,Home,2008-03-15,0,1,1,1,2,6,6,7,10,-5,-5,-6,-8,1,21.0,1.0,20.0,8
5888,5888,2007-08,2007,2008,Derby,Middlesbrough,Loss,Away,2008-03-22,0,0,1,1,1,2,2,2,5,-2,-1,-1,-4,0,21.0,12.0,9.0,8
5889,5889,2007-08,2007,2008,Derby,Fulham,Draw,Home,2008-03-29,1,0,0,1,1,3,4,4,4,-3,-4,-3,-3,1,21.0,16.0,5.0,8
5890,5890,2007-08,2007,2008,Derby,Everton,Loss,Away,2008-04-06,0,1,1,1,2,1,1,4,7,0,0,-3,-5,0,21.0,6.0,15.0,9
5891,5891,2007-08,2007,2008,Derby,Aston Villa,Loss,Home,2008-04-12,0,1,1,1,1,3,3,3,4,-2,-2,-2,-3,1,21.0,11.0,10.0,9
5892,5892,2007-08,2007,2008,Derby,West Ham,Loss,Away,2008-04-19,0,0,1,1,1,0,0,1,4,0,1,0,-3,0,21.0,15.0,6.0,9
5893,5893,2007-08,2007,2008,Derby,Arsenal,Loss,Home,2008-04-28,0,0,0,1,1,3,4,7,7,-3,-4,-6,-6,1,21.0,4.0,17.0,9
5894,5894,2007-08,2007,2008,Derby,Blackburn,Loss,Away,2008-05-03,0,0,0,0,1,4,4,5,6,-4,-4,-5,-5,0,21.0,10.0,11.0,10
5895,5895,2007-08,2007,2008,Derby,Reading,Loss,Home,2008-05-11,0,0,0,0,0,1,1,1,1,-1,-1,-1,-1,1,21.0,8.0,13.0,10
5896,5896,1993-94,1993,1994,Everton,Southampton,Win,Away,1993-08-14,3,0,0,0,0,0,0,0,0,0,0,0,0,0,13.0,18.0,-5.0,1
5897,5897,1993-94,1993,1994,Everton,Man City,Win,Home,1993-08-17,3,3,3,3,3,1,1,1,1,2,2,2,2,1,13.0,9.0,4.0,1
5898,5898,1993-94,1993,1994,Everton,Sheffield United,Win,Home,1993-08-21,3,6,6,6,6,3,3,3,3,3,3,3,3,1,13.0,14.0,-1.0,1
5899,5899,1993-94,1993,1994,Everton,Newcastle,Loss,Away,1993-08-25,0,6,9,9,9,1,1,1,1,5,8,8,8,0,13.0,21.0,-8.0,1
5900,5900,1993-94,1993,1994,Everton,Arsenal,Loss,Away,1993-08-28,0,3,6,9,9,6,9,9,9,-3,-3,0,0,0,13.0,10.0,3.0,1
5901,5901,1993-94,1993,1994,Everton,Aston Villa,Loss,Home,1993-08-31,0,0,3,6,9,3,4,5,8,-3,-1,1,1,1,13.0,2.0,11.0,1
5902,5902,1993-94,1993,1994,Everton,Oldham,Win,Away,1993-09-11,3,0,0,3,6,1,2,2,5,-1,-2,1,1,0,13.0,19.0,-6.0,2
5903,5903,1993-94,1993,1994,Everton,Liverpool,Win,Home,1993-09-18,3,3,3,3,6,0,3,3,6,3,0,0,0,1,13.0,6.0,7.0,2
5904,5904,1993-94,1993,1994,Everton,Norwich,Loss,Home,1993-09-25,0,6,6,6,6,1,2,3,6,5,4,3,0,1,13.0,3.0,10.0,2
5905,5905,1993-94,1993,1994,Everton,Tottenham,Loss,Away,1993-10-03,0,3,6,6,6,4,5,6,6,-1,1,0,0,0,13.0,8.0,5.0,3
5906,5906,1993-94,1993,1994,Everton,Swindon,Draw,Away,1993-10-16,1,0,3,6,6,0,1,2,2,0,2,4,4,0,13.0,21.0,-8.0,3
5907,5907,1993-94,1993,1994,Everton,Man United,Loss,Home,1993-10-23,0,1,1,4,7,6,9,12,12,-5,-8,-8,-5,1,13.0,1.0,12.0,3
5908,5908,1993-94,1993,1994,Everton,Ipswich,Win,Away,1993-10-30,3,1,1,1,4,4,4,5,5,-3,-3,-4,-1,0,13.0,16.0,-3.0,3
5909,5909,1993-94,1993,1994,Everton,Coventry,Loss,Away,1993-11-06,0,3,4,4,4,1,2,2,2,2,2,2,2,0,13.0,15.0,-2.0,4
5910,5910,1993-94,1993,1994,Everton,QPR,Loss,Home,1993-11-20,0,3,3,4,4,3,6,9,12,0,-3,-5,-8,1,13.0,5.0,8.0,4
5911,5911,1993-94,1993,1994,Everton,Leeds,Draw,Home,1993-11-23,1,0,3,3,4,4,5,6,7,-4,-2,-3,-3,1,13.0,17.0,-4.0,4
5912,5912,1993-94,1993,1994,Everton,Wimbledon,Draw,Away,1993-11-27,1,1,1,4,4,1,4,4,4,0,-3,0,0,0,13.0,12.0,1.0,4
5913,5913,1993-94,1993,1994,Everton,Southampton,Win,Home,1993-12-04,3,2,2,2,5,3,3,6,6,-1,-1,-4,-1,1,13.0,18.0,-5.0,5
5914,5914,1993-94,1993,1994,Everton,Man City,Loss,Away,1993-12-08,0,4,5,5,5,0,1,2,2,4,4,3,3,0,13.0,9.0,4.0,5
5915,5915,1993-94,1993,1994,Everton,Sheffield United,Draw,Away,1993-12-11,1,3,4,5,5,1,4,4,4,2,0,1,1,0,13.0,14.0,-1.0,5
5916,5916,1993-94,1993,1994,Everton,Newcastle,Loss,Home,1993-12-18,0,1,4,5,6,4,4,7,10,-3,0,-2,-4,1,13.0,21.0,-8.0,5
5917,5917,1993-94,1993,1994,Everton,Sheffield Weds,Loss,Home,1993-12-27,0,1,1,4,5,3,4,7,10,-2,-3,-3,-5,1,13.0,7.0,6.0,5
5918,5918,1993-94,1993,1994,Everton,Blackburn,Loss,Away,1993-12-29,0,0,1,1,4,4,7,10,10,-4,-6,-9,-6,0,13.0,4.0,9.0,5
5919,5919,1993-94,1993,1994,Everton,West Ham,Loss,Home,1994-01-01,0,0,0,1,1,1,1,4,4,-1,-1,-3,-3,1,13.0,21.0,-8.0,6
5920,5920,1993-94,1993,1994,Everton,Chelsea,Loss,Away,1994-01-03,0,0,0,0,1,6,6,7,7,-6,-6,-7,-6,0,13.0,11.0,2.0,6
5921,5921,1993-94,1993,1994,Everton,Swindon,Win,Home,1994-01-15,3,0,0,0,0,1,2,2,5,-1,-2,-2,-5,1,13.0,21.0,-8.0,6
5922,5922,1993-94,1993,1994,Everton,Man United,Loss,Away,1994-01-22,0,3,3,3,3,4,5,8,9,-1,-2,-5,-6,0,13.0,1.0,12.0,6
5923,5923,1993-94,1993,1994,Everton,Chelsea,Win,Home,1994-02-05,3,3,3,3,3,2,5,8,11,1,-2,-5,-8,1,13.0,11.0,2.0,7
5924,5924,1993-94,1993,1994,Everton,Ipswich,Draw,Home,1994-02-12,1,3,6,6,6,0,1,2,2,3,5,4,4,1,13.0,16.0,-3.0,7
5925,5925,1993-94,1993,1994,Everton,Arsenal,Draw,Home,1994-02-19,1,4,4,7,7,2,3,4,7,2,1,3,0,1,13.0,10.0,3.0,7
5926,5926,1993-94,1993,1994,Everton,Oldham,Win,Home,1994-03-05,3,2,5,5,8,4,7,8,8,-2,-2,-3,0,1,13.0,19.0,-6.0,8
5927,5927,1993-94,1993,1994,Everton,Liverpool,Loss,Away,1994-03-13,0,4,5,8,8,3,3,3,4,1,2,5,4,0,13.0,6.0,7.0,8
5928,5928,1993-94,1993,1994,Everton,Norwich,Loss,Away,1994-03-21,0,3,4,5,8,0,1,2,3,3,3,3,5,0,13.0,3.0,10.0,8
5929,5929,1993-94,1993,1994,Everton,Tottenham,Loss,Home,1994-03-26,0,0,3,4,5,2,3,3,3,-2,0,1,2,1,13.0,8.0,5.0,8
5930,5930,1993-94,1993,1994,Everton,Aston Villa,Draw,Away,1994-03-30,1,0,0,3,4,0,0,3,4,0,0,0,0,0,13.0,2.0,11.0,8
5931,5931,1993-94,1993,1994,Everton,Sheffield Weds,Loss,Away,1994-04-02,0,1,1,1,4,3,3,4,4,-2,-2,-3,0,0,13.0,7.0,6.0,9
5932,5932,1993-94,1993,1994,Everton,Blackburn,Loss,Home,1994-04-04,0,1,1,1,1,3,6,9,12,-2,-5,-8,-11,1,13.0,4.0,9.0,9
5933,5933,1993-94,1993,1994,Everton,West Ham,Win,Away,1994-04-09,3,0,1,1,1,6,6,6,6,-6,-5,-5,-5,0,13.0,21.0,-8.0,9
5934,5934,1993-94,1993,1994,Everton,QPR,Loss,Away,1994-04-16,0,3,3,4,4,1,1,1,4,2,2,3,0,0,13.0,5.0,8.0,9
5935,5935,1993-94,1993,1994,Everton,Coventry,Draw,Home,1994-04-23,1,3,3,3,4,4,7,7,10,-1,-4,-4,-6,1,13.0,15.0,-2.0,9
5936,5936,1993-94,1993,1994,Everton,Leeds,Loss,Away,1994-04-30,0,1,4,4,4,1,4,7,8,0,0,-3,-4,0,13.0,17.0,-4.0,9
5937,5937,1993-94,1993,1994,Everton,Wimbledon,Win,Home,1994-05-07,3,1,1,4,4,6,9,10,13,-5,-8,-6,-9,1,13.0,12.0,1.0,10
5938,5938,1994-95,1994,1995,Everton,Aston Villa,Draw,Home,1994-08-20,1,3,4,4,7,3,3,3,6,0,1,1,1,1,17.0,10.0,7.0,1
5939,5939,1994-95,1994,1995,Everton,Tottenham,Loss,Away,1994-08-24,0,4,4,5,5,3,6,6,9,1,-2,-1,-4,0,17.0,15.0,2.0,1
5940,5940,1994-95,1994,1995,Everton,Man City,Loss,Away,1994-08-27,0,1,4,4,5,3,4,5,5,-2,0,-1,0,0,17.0,16.0,1.0,1
5941,5941,1994-95,1994,1995,Everton,Nott'm Forest,Loss,Home,1994-08-30,0,0,1,4,4,4,7,7,7,-4,-6,-3,-3,1,17.0,21.0,-4.0,1
5942,5942,1994-95,1994,1995,Everton,Blackburn,Loss,Away,1994-09-10,0,0,0,1,4,4,7,8,9,-4,-7,-7,-5,0,17.0,2.0,15.0,2
5943,5943,1994-95,1994,1995,Everton,QPR,Draw,Home,1994-09-17,1,0,0,0,1,2,2,5,5,-2,-2,-5,-4,1,17.0,9.0,8.0,2
5944,5944,1994-95,1994,1995,Everton,Leicester,Draw,Home,1994-09-24,1,1,1,1,1,3,4,4,4,-2,-3,-3,-3,1,17.0,21.0,-4.0,2
5945,5945,1994-95,1994,1995,Everton,Man United,Loss,Away,1994-10-01,0,2,2,2,2,3,3,6,9,-1,-1,-4,-7,0,17.0,1.0,16.0,3
5946,5946,1994-95,1994,1995,Everton,Southampton,Loss,Away,1994-10-08,0,1,2,2,2,6,7,10,10,-5,-5,-8,-8,0,17.0,18.0,-1.0,3
5947,5947,1994-95,1994,1995,Everton,Coventry,Loss,Home,1994-10-15,0,0,1,2,2,4,4,7,8,-4,-3,-5,-6,1,17.0,11.0,6.0,3
5948,5948,1994-95,1994,1995,Everton,Crystal Palace,Loss,Away,1994-10-22,0,0,0,1,2,0,3,3,4,0,-3,-2,-2,0,17.0,21.0,-4.0,3
5949,5949,1994-95,1994,1995,Everton,Arsenal,Draw,Home,1994-10-29,1,0,0,0,1,6,9,9,12,-6,-9,-9,-11,1,17.0,4.0,13.0,3
5950,5950,1994-95,1994,1995,Everton,West Ham,Win,Home,1994-11-01,3,1,1,1,1,3,3,6,9,-2,-2,-5,-8,1,17.0,13.0,4.0,4
5951,5951,1994-95,1994,1995,Everton,Norwich,Draw,Away,1994-11-05,1,4,4,4,4,1,4,5,8,3,0,-1,-4,0,17.0,12.0,5.0,4
5952,5952,1994-95,1994,1995,Everton,Liverpool,Win,Home,1994-11-21,3,4,5,5,5,6,6,9,12,-2,-1,-4,-7,1,17.0,8.0,9.0,4
5953,5953,1994-95,1994,1995,Everton,Chelsea,Win,Away,1994-11-26,3,4,7,8,8,4,4,5,6,0,3,3,2,0,17.0,14.0,3.0,4
5954,5954,1994-95,1994,1995,Everton,Leeds,Win,Home,1994-12-04,3,6,7,10,11,3,6,6,9,3,1,4,2,1,17.0,5.0,12.0,5
5955,5955,1994-95,1994,1995,Everton,Aston Villa,Draw,Away,1994-12-10,1,6,9,10,13,2,5,5,5,4,4,5,8,0,17.0,10.0,7.0,5
5956,5956,1994-95,1994,1995,Everton,Tottenham,Draw,Home,1994-12-17,1,4,7,10,11,6,7,8,8,-2,0,2,3,1,17.0,15.0,2.0,5
5957,5957,1994-95,1994,1995,Everton,Sheffield Weds,Loss,Home,1994-12-26,0,2,5,8,11,0,3,4,7,2,2,4,4,1,17.0,7.0,10.0,5
5958,5958,1994-95,1994,1995,Everton,Ipswich,Win,Home,1994-12-31,3,1,2,5,8,1,2,2,2,0,0,3,6,1,17.0,19.0,-2.0,5
5959,5959,1994-95,1994,1995,Everton,Wimbledon,Loss,Away,1995-01-02,0,3,4,5,8,4,7,8,11,-1,-3,-3,-3,0,17.0,6.0,11.0,6
5960,5960,1994-95,1994,1995,Everton,Arsenal,Draw,Away,1995-01-14,1,3,3,4,5,0,3,4,4,3,0,0,1,0,17.0,4.0,13.0,6
5961,5961,1994-95,1994,1995,Everton,Crystal Palace,Win,Home,1995-01-21,3,1,4,4,5,3,3,4,5,-2,1,0,0,1,17.0,21.0,-4.0,6
5962,5962,1994-95,1994,1995,Everton,Liverpool,Draw,Away,1995-01-24,1,4,4,7,7,3,6,9,12,1,-2,-2,-5,0,17.0,8.0,9.0,6
5963,5963,1994-95,1994,1995,Everton,Newcastle,Loss,Away,1995-02-01,0,4,5,5,8,4,5,6,6,0,0,-1,2,0,17.0,3.0,14.0,7
5964,5964,1994-95,1994,1995,Everton,Norwich,Win,Home,1995-02-04,3,1,4,5,5,1,1,4,4,0,3,1,1,1,17.0,12.0,5.0,7
5965,5965,1994-95,1994,1995,Everton,West Ham,Draw,Away,1995-02-13,1,3,4,7,8,3,3,3,6,0,1,4,2,0,17.0,13.0,4.0,7
5966,5966,1994-95,1994,1995,Everton,Leeds,Loss,Away,1995-02-22,0,4,4,5,8,2,5,6,7,2,-1,-1,1,0,17.0,5.0,12.0,7
5967,5967,1994-95,1994,1995,Everton,Man United,Win,Home,1995-02-25,3,1,4,4,5,6,9,10,13,-5,-5,-6,-8,1,17.0,1.0,16.0,7
5968,5968,1994-95,1994,1995,Everton,Leicester,Draw,Away,1995-03-04,1,3,4,7,7,1,2,2,5,2,2,5,2,0,17.0,21.0,-4.0,8
5969,5969,1994-95,1994,1995,Everton,Nott'm Forest,Loss,Away,1995-03-08,0,4,4,5,8,2,2,2,3,2,2,3,5,0,17.0,21.0,-4.0,8
5970,5970,1994-95,1994,1995,Everton,Man City,Draw,Home,1995-03-15,1,1,4,4,5,1,2,5,5,0,2,-1,0,1,17.0,16.0,1.0,8
5971,5971,1994-95,1994,1995,Everton,QPR,Win,Away,1995-03-18,3,1,2,5,5,6,9,10,11,-5,-7,-5,-6,0,17.0,9.0,8.0,8
5972,5972,1994-95,1994,1995,Everton,Blackburn,Loss,Home,1995-04-01,0,4,4,5,8,4,7,10,11,0,-3,-5,-3,1,17.0,2.0,15.0,9
5973,5973,1994-95,1994,1995,Everton,Newcastle,Win,Home,1995-04-14,3,3,4,4,5,4,4,7,10,-1,0,-3,-5,1,17.0,3.0,14.0,9
5974,5974,1994-95,1994,1995,Everton,Sheffield Weds,Draw,Away,1995-04-17,1,3,6,7,7,3,3,3,3,0,3,4,4,0,17.0,7.0,10.0,9
5975,5975,1994-95,1994,1995,Everton,Wimbledon,Draw,Home,1995-04-29,1,4,4,7,8,0,1,4,7,4,3,3,1,1,17.0,6.0,11.0,9
5976,5976,1994-95,1994,1995,Everton,Chelsea,Draw,Home,1995-05-03,1,2,5,5,8,4,7,7,8,-2,-2,-2,0,1,17.0,14.0,3.0,10
5977,5977,1994-95,1994,1995,Everton,Southampton,Draw,Home,1995-05-06,1,2,3,6,6,4,7,10,13,-2,-4,-4,-7,1,17.0,18.0,-1.0,10
5978,5978,1994-95,1994,1995,Everton,Ipswich,Win,Away,1995-05-09,3,2,3,4,7,3,4,4,4,-1,-1,0,3,0,17.0,19.0,-2.0,10
5979,5979,1994-95,1994,1995,Everton,Coventry,Draw,Away,1995-05-14,1,4,5,6,7,3,3,3,6,1,2,3,1,0,17.0,11.0,6.0,10
5980,5980,1995-96,1995,1996,Everton,Chelsea,Draw,Away,1995-08-19,1,4,5,6,7,4,5,8,9,0,0,-2,-2,0,15.0,11.0,4.0,1
5981,5981,1995-96,1995,1996,Everton,Arsenal,Loss,Home,1995-08-23,0,2,5,6,7,1,2,3,6,1,3,3,1,1,15.0,12.0,3.0,1
5982,5982,1995-96,1995,1996,Everton,Southampton,Win,Home,1995-08-26,3,1,2,5,6,1,1,2,5,0,1,3,1,1,15.0,10.0,5.0,1
5983,5983,1995-96,1995,1996,Everton,Man City,Win,Away,1995-08-30,3,3,4,5,8,0,1,1,1,3,3,4,7,0,15.0,17.0,-2.0,1
5984,5984,1995-96,1995,1996,Everton,Man United,Loss,Home,1995-09-09,0,6,6,7,8,6,9,9,10,0,-3,-2,-2,1,15.0,2.0,13.0,2
5985,5985,1995-96,1995,1996,Everton,Nott'm Forest,Loss,Away,1995-09-17,0,3,6,6,7,2,3,4,7,1,3,2,0,0,15.0,3.0,12.0,2
5986,5986,1995-96,1995,1996,Everton,West Ham,Loss,Away,1995-09-23,0,0,3,6,6,0,1,2,2,0,2,4,4,0,15.0,14.0,1.0,2
5987,5987,1995-96,1995,1996,Everton,Newcastle,Loss,Home,1995-10-01,0,0,0,3,6,6,6,9,12,-6,-6,-6,-6,1,15.0,6.0,9.0,3
5988,5988,1995-96,1995,1996,Everton,Bolton,Draw,Away,1995-10-14,1,0,0,0,3,0,0,1,1,0,0,-1,2,0,15.0,21.0,-6.0,3
5989,5989,1995-96,1995,1996,Everton,Tottenham,Draw,Home,1995-10-22,1,1,1,1,1,3,6,9,12,-2,-5,-8,-11,1,15.0,7.0,8.0,3
5990,5990,1995-96,1995,1996,Everton,Aston Villa,Loss,Away,1995-10-28,0,2,2,2,2,0,3,4,7,2,-1,-2,-5,0,15.0,18.0,-3.0,3
5991,5991,1995-96,1995,1996,Everton,Blackburn,Win,Home,1995-11-05,3,1,2,2,2,4,7,7,10,-3,-5,-5,-8,1,15.0,1.0,14.0,4
5992,5992,1995-96,1995,1996,Everton,Liverpool,Win,Away,1995-11-18,3,3,4,5,5,3,6,7,8,0,-2,-2,-3,0,15.0,4.0,11.0,4
5993,5993,1995-96,1995,1996,Everton,QPR,Win,Home,1995-11-22,3,6,6,7,8,1,2,2,2,5,4,5,6,1,15.0,8.0,7.0,4
5994,5994,1995-96,1995,1996,Everton,Sheffield Weds,Draw,Home,1995-11-25,1,6,9,9,10,1,2,2,5,5,7,7,5,1,15.0,13.0,2.0,4
5995,5995,1995-96,1995,1996,Everton,Tottenham,Draw,Away,1995-12-02,1,4,7,10,10,4,7,10,11,0,0,0,-1,0,15.0,7.0,8.0,5
5996,5996,1995-96,1995,1996,Everton,West Ham,Win,Home,1995-12-11,3,2,5,8,11,3,4,7,7,-1,1,1,4,1,15.0,14.0,1.0,5
5997,5997,1995-96,1995,1996,Everton,Newcastle,Loss,Away,1995-12-16,0,4,5,8,11,1,4,5,8,3,1,3,3,0,15.0,6.0,9.0,5
5998,5998,1995-96,1995,1996,Everton,Coventry,Loss,Away,1995-12-23,0,3,4,5,8,3,3,4,4,0,1,1,4,0,15.0,16.0,-1.0,5
5999,5999,1995-96,1995,1996,Everton,Middlesbrough,Win,Home,1995-12-26,3,0,3,4,5,3,6,7,10,-3,-3,-3,-5,1,15.0,21.0,-6.0,5
6000,6000,1995-96,1995,1996,Everton,Leeds,Win,Home,1995-12-30,3,3,3,6,7,6,6,7,7,-3,-3,-1,0,1,15.0,5.0,10.0,5
6001,6001,1995-96,1995,1996,Everton,Wimbledon,Win,Away,1996-01-01,3,6,6,6,9,6,7,7,8,0,-1,-1,1,0,15.0,9.0,6.0,6
6002,6002,1995-96,1995,1996,Everton,Chelsea,Draw,Home,1996-01-13,1,6,9,9,9,4,4,7,8,2,5,2,1,1,15.0,11.0,4.0,6
6003,6003,1995-96,1995,1996,Everton,Arsenal,Win,Away,1996-01-20,3,4,7,10,10,3,3,6,6,1,4,4,4,0,15.0,12.0,3.0,6
6004,6004,1995-96,1995,1996,Everton,Southampton,Draw,Away,1996-02-03,1,4,7,10,13,4,4,5,6,0,3,5,7,0,15.0,10.0,5.0,7
6005,6005,1995-96,1995,1996,Everton,Man City,Win,Home,1996-02-10,3,4,5,8,11,4,5,5,8,0,0,3,3,1,15.0,17.0,-2.0,7
6006,6006,1995-96,1995,1996,Everton,Man United,Loss,Away,1996-02-21,0,4,7,8,11,6,9,10,10,-2,-2,-2,1,0,15.0,2.0,13.0,7
6007,6007,1995-96,1995,1996,Everton,Nott'm Forest,Win,Home,1996-02-24,3,3,4,7,8,0,3,3,6,3,1,4,2,1,15.0,3.0,12.0,7
6008,6008,1995-96,1995,1996,Everton,Middlesbrough,Win,Away,1996-03-02,3,3,6,7,10,1,1,1,1,2,5,6,9,0,15.0,21.0,-6.0,8
6009,6009,1995-96,1995,1996,Everton,Coventry,Draw,Home,1996-03-09,1,6,6,9,10,2,5,6,6,4,1,3,4,1,15.0,16.0,-1.0,8
6010,6010,1995-96,1995,1996,Everton,Leeds,Draw,Away,1996-03-17,1,4,7,7,10,3,3,3,3,1,4,4,7,0,15.0,5.0,10.0,8
6011,6011,1995-96,1995,1996,Everton,Wimbledon,Loss,Home,1996-03-23,0,2,5,8,8,1,2,3,3,1,3,5,5,1,15.0,9.0,6.0,8
6012,6012,1995-96,1995,1996,Everton,Blackburn,Win,Away,1996-03-30,3,1,2,5,8,6,7,7,7,-5,-5,-2,1,0,15.0,1.0,14.0,8
6013,6013,1995-96,1995,1996,Everton,Bolton,Win,Home,1996-04-06,3,3,4,5,8,4,4,7,10,-1,0,-2,-2,1,15.0,21.0,-6.0,9
6014,6014,1995-96,1995,1996,Everton,QPR,Loss,Away,1996-04-08,0,6,6,7,8,3,4,5,5,3,2,2,3,0,15.0,8.0,7.0,9
6015,6015,1995-96,1995,1996,Everton,Liverpool,Draw,Home,1996-04-16,1,3,6,6,7,3,6,6,9,0,0,0,-2,1,15.0,4.0,11.0,9
6016,6016,1995-96,1995,1996,Everton,Sheffield Weds,Win,Away,1996-04-27,3,1,4,7,7,1,4,4,4,0,0,3,3,0,15.0,13.0,2.0,9
6017,6017,1995-96,1995,1996,Everton,Aston Villa,Win,Home,1996-05-04,3,4,4,7,10,1,1,4,7,3,3,3,3,1,15.0,18.0,-3.0,10
6018,6018,1996-97,1996,1997,Everton,Newcastle,Win,Home,1996-08-17,3,6,7,7,10,2,5,8,11,4,2,-1,-1,1,6.0,2.0,4.0,1
6019,6019,1996-97,1996,1997,Everton,Man United,Draw,Away,1996-08-21,1,6,9,10,10,6,9,12,12,0,0,-2,-2,0,6.0,1.0,5.0,1
6020,6020,1996-97,1996,1997,Everton,Tottenham,Draw,Away,1996-08-24,1,4,7,10,11,4,5,8,9,0,2,2,2,0,6.0,8.0,-2.0,1
6021,6021,1996-97,1996,1997,Everton,Aston Villa,Loss,Home,1996-09-04,0,2,5,8,11,6,6,6,6,-4,-1,2,5,1,6.0,4.0,2.0,2
6022,6022,1996-97,1996,1997,Everton,Wimbledon,Loss,Away,1996-09-07,0,1,2,5,8,3,3,3,4,-2,-1,2,4,0,6.0,14.0,-8.0,2
6023,6023,1996-97,1996,1997,Everton,Middlesbrough,Loss,Home,1996-09-14,0,0,1,2,5,6,7,7,8,-6,-6,-5,-3,1,6.0,12.0,-6.0,2
6024,6024,1996-97,1996,1997,Everton,Blackburn,Draw,Away,1996-09-21,1,0,0,1,2,0,0,1,1,0,0,0,1,0,6.0,7.0,-1.0,2
6025,6025,1996-97,1996,1997,Everton,Sheffield Weds,Win,Home,1996-09-28,3,1,1,1,2,1,1,4,7,0,0,-3,-5,1,6.0,15.0,-9.0,2
6026,6026,1996-97,1996,1997,Everton,West Ham,Win,Home,1996-10-12,3,4,4,4,4,3,3,4,4,1,1,0,0,1,6.0,10.0,-4.0,3
6027,6027,1996-97,1996,1997,Everton,Nott'm Forest,Win,Away,1996-10-28,3,6,7,7,7,1,2,2,2,5,5,5,5,0,6.0,9.0,-3.0,3
6028,6028,1996-97,1996,1997,Everton,Coventry,Draw,Home,1996-11-04,1,6,9,10,10,2,3,4,4,4,6,6,6,1,6.0,16.0,-10.0,4
6029,6029,1996-97,1996,1997,Everton,Southampton,Win,Home,1996-11-16,3,4,7,10,11,4,7,8,11,0,0,2,0,1,6.0,17.0,-11.0,4
6030,6030,1996-97,1996,1997,Everton,Liverpool,Draw,Away,1996-11-20,1,4,7,10,13,3,6,6,9,1,1,4,4,0,6.0,3.0,3.0,4
6031,6031,1996-97,1996,1997,Everton,Leicester,Win,Away,1996-11-23,3,4,5,8,11,3,6,6,6,1,-1,2,5,0,6.0,21.0,-15.0,4
6032,6032,1996-97,1996,1997,Everton,Sunderland,Loss,Home,1996-11-30,0,4,7,8,11,1,1,4,4,3,6,4,7,1,6.0,21.0,-15.0,4
6033,6033,1996-97,1996,1997,Everton,Chelsea,Draw,Away,1996-12-07,1,3,4,7,8,1,2,5,8,2,2,2,0,0,6.0,11.0,-5.0,5
6034,6034,1996-97,1996,1997,Everton,Derby,Win,Away,1996-12-16,3,1,4,5,8,4,5,8,11,-3,-1,-3,-3,0,6.0,21.0,-15.0,5
6035,6035,1996-97,1996,1997,Everton,Leeds,Draw,Home,1996-12-21,1,4,4,7,8,2,5,8,8,2,-1,-1,0,1,6.0,13.0,-7.0,5
6036,6036,1996-97,1996,1997,Everton,Middlesbrough,Loss,Away,1996-12-26,0,4,5,5,8,1,1,1,2,3,4,4,6,0,6.0,12.0,-6.0,5
6037,6037,1996-97,1996,1997,Everton,Wimbledon,Loss,Home,1996-12-28,0,1,4,5,5,3,6,9,10,-2,-2,-4,-5,1,6.0,14.0,-8.0,5
6038,6038,1996-97,1996,1997,Everton,Blackburn,Loss,Home,1997-01-01,0,0,1,4,5,4,4,5,8,-4,-3,-1,-3,1,6.0,7.0,-1.0,6
6039,6039,1996-97,1996,1997,Everton,Sheffield Weds,Loss,Away,1997-01-11,0,0,0,1,4,2,3,4,7,-2,-3,-3,-3,0,6.0,15.0,-9.0,6
6040,6040,1996-97,1996,1997,Everton,Arsenal,Loss,Away,1997-01-19,0,0,0,0,1,3,4,5,5,-3,-4,-5,-4,0,6.0,5.0,1.0,6
6041,6041,1996-97,1996,1997,Everton,Newcastle,Loss,Away,1997-01-29,0,0,0,0,0,2,5,8,8,-2,-5,-8,-8,0,6.0,2.0,4.0,6
6042,6042,1996-97,1996,1997,Everton,Nott'm Forest,Win,Home,1997-02-01,3,0,0,0,0,3,6,9,10,-3,-6,-9,-10,1,6.0,9.0,-3.0,7
6043,6043,1996-97,1996,1997,Everton,Coventry,Draw,Away,1997-02-22,1,3,3,3,3,1,4,4,4,2,-1,-1,-1,0,6.0,16.0,-10.0,7
6044,6044,1996-97,1996,1997,Everton,Arsenal,Loss,Home,1997-03-01,0,4,4,4,4,0,1,2,5,4,3,2,-1,1,6.0,5.0,1.0,8
6045,6045,1996-97,1996,1997,Everton,Southampton,Draw,Away,1997-03-05,1,1,4,4,4,4,4,4,5,-3,0,0,-1,0,6.0,17.0,-11.0,8
6046,6046,1996-97,1996,1997,Everton,Leeds,Loss,Away,1997-03-08,0,1,2,5,5,6,6,7,8,-5,-4,-2,-3,0,6.0,13.0,-7.0,8
6047,6047,1996-97,1996,1997,Everton,Derby,Win,Home,1997-03-15,3,1,1,2,5,3,3,4,7,-2,-2,-2,-2,1,6.0,21.0,-15.0,8
6048,6048,1996-97,1996,1997,Everton,Man United,Loss,Home,1997-03-22,0,3,4,4,5,3,6,7,10,0,-2,-3,-5,1,6.0,1.0,5.0,8
6049,6049,1996-97,1996,1997,Everton,Aston Villa,Loss,Away,1997-04-05,0,3,3,4,4,4,4,7,8,-1,-1,-3,-4,0,6.0,4.0,2.0,9
6050,6050,1996-97,1996,1997,Everton,Leicester,Draw,Home,1997-04-09,1,0,3,3,4,2,2,3,6,-2,1,0,-2,1,6.0,21.0,-15.0,9
6051,6051,1996-97,1996,1997,Everton,Tottenham,Win,Home,1997-04-12,3,1,1,4,4,3,3,4,7,-2,-2,0,-3,1,6.0,8.0,-2.0,9
6052,6052,1996-97,1996,1997,Everton,Liverpool,Draw,Home,1997-04-16,1,4,4,4,7,3,6,7,10,1,-2,-3,-3,1,6.0,3.0,3.0,9
6053,6053,1996-97,1996,1997,Everton,West Ham,Draw,Away,1997-04-19,1,4,5,5,5,1,4,5,6,3,1,0,-1,0,6.0,10.0,-4.0,9
6054,6054,1996-97,1996,1997,Everton,Sunderland,Loss,Away,1997-05-03,0,2,5,6,6,3,3,4,5,-1,2,2,1,0,6.0,21.0,-15.0,10
6055,6055,1996-97,1996,1997,Everton,Chelsea,Loss,Home,1997-05-11,0,1,2,5,6,4,7,7,7,-3,-5,-2,-1,1,6.0,11.0,-5.0,10
6056,6056,1997-98,1997,1998,Everton,Crystal Palace,Loss,Home,1997-08-09,0,0,1,2,5,0,3,3,3,0,-2,-1,2,1,15.0,21.0,-6.0,1
6057,6057,1997-98,1997,1998,Everton,West Ham,Win,Home,1997-08-23,3,0,0,1,2,6,6,7,10,-6,-6,-6,-8,1,15.0,14.0,1.0,1
6058,6058,1997-98,1997,1998,Everton,Man United,Loss,Home,1997-08-27,0,3,3,3,4,4,7,10,11,-1,-4,-7,-7,1,15.0,1.0,14.0,1
6059,6059,1997-98,1997,1998,Everton,Bolton,Draw,Away,1997-09-01,1,3,3,3,3,1,4,4,4,2,-1,-1,-1,0,15.0,21.0,-6.0,2
6060,6060,1997-98,1997,1998,Everton,Derby,Loss,Away,1997-09-13,0,1,4,4,4,3,3,3,6,-2,1,1,-2,0,15.0,12.0,3.0,2
6061,6061,1997-98,1997,1998,Everton,Barnsley,Win,Home,1997-09-20,3,1,1,4,4,0,3,3,6,1,-2,1,-2,1,15.0,21.0,-6.0,2
6062,6062,1997-98,1997,1998,Everton,Newcastle,Loss,Away,1997-09-24,0,3,4,4,7,3,6,9,12,0,-2,-5,-5,0,15.0,2.0,13.0,2
6063,6063,1997-98,1997,1998,Everton,Arsenal,Draw,Home,1997-09-27,1,3,3,4,4,6,9,10,11,-3,-6,-6,-7,1,15.0,3.0,12.0,2
6064,6064,1997-98,1997,1998,Everton,Sheffield Weds,Loss,Away,1997-10-04,0,1,4,4,5,1,2,2,5,0,2,2,0,0,15.0,7.0,8.0,3
6065,6065,1997-98,1997,1998,Everton,Liverpool,Win,Home,1997-10-18,3,1,1,4,4,3,6,7,10,-2,-5,-3,-6,1,15.0,4.0,11.0,3
6066,6066,1997-98,1997,1998,Everton,Coventry,Draw,Away,1997-10-25,1,3,4,4,7,1,2,3,4,2,2,1,3,0,15.0,17.0,-2.0,3
6067,6067,1997-98,1997,1998,Everton,Southampton,Loss,Home,1997-11-02,0,4,4,5,5,3,6,6,6,1,-2,-1,-1,1,15.0,16.0,-1.0,4
6068,6068,1997-98,1997,1998,Everton,Blackburn,Loss,Away,1997-11-08,0,1,4,4,5,2,5,8,9,-1,-1,-4,-4,0,15.0,13.0,2.0,4
6069,6069,1997-98,1997,1998,Everton,Aston Villa,Loss,Away,1997-11-22,0,0,1,4,4,1,2,2,5,-1,-1,2,-1,0,15.0,5.0,10.0,4
6070,6070,1997-98,1997,1998,Everton,Chelsea,Loss,Away,1997-11-26,0,0,0,1,4,3,6,6,9,-3,-6,-5,-5,0,15.0,6.0,9.0,4
6071,6071,1997-98,1997,1998,Everton,Tottenham,Loss,Home,1997-11-29,0,0,0,0,1,0,0,0,3,0,0,0,-2,1,15.0,10.0,5.0,4
6072,6072,1997-98,1997,1998,Everton,Leeds,Draw,Away,1997-12-06,1,0,0,0,0,6,9,12,12,-6,-9,-12,-12,0,15.0,11.0,4.0,5
6073,6073,1997-98,1997,1998,Everton,Wimbledon,Draw,Home,1997-12-13,1,1,1,1,1,3,3,6,6,-2,-2,-5,-5,1,15.0,8.0,7.0,5
6074,6074,1997-98,1997,1998,Everton,Leicester,Win,Away,1997-12-20,3,2,2,2,2,1,4,5,5,1,-2,-3,-3,0,15.0,9.0,6.0,5
6075,6075,1997-98,1997,1998,Everton,Man United,Loss,Away,1997-12-26,0,4,5,5,5,6,9,12,15,-2,-4,-7,-10,0,15.0,1.0,14.0,5
6076,6076,1997-98,1997,1998,Everton,Bolton,Win,Home,1997-12-28,3,3,4,5,5,1,2,2,5,2,2,3,0,1,15.0,21.0,-6.0,5
6077,6077,1997-98,1997,1998,Everton,Crystal Palace,Win,Away,1998-01-10,3,3,6,7,8,2,3,3,4,1,3,4,4,0,15.0,21.0,-6.0,6
6078,6078,1997-98,1997,1998,Everton,Chelsea,Win,Home,1998-01-18,3,6,6,9,10,3,4,7,8,3,2,2,2,1,15.0,6.0,9.0,6
6079,6079,1997-98,1997,1998,Everton,West Ham,Draw,Away,1998-01-31,1,6,9,9,12,3,6,9,9,3,3,0,3,0,15.0,14.0,1.0,6
6080,6080,1997-98,1997,1998,Everton,Barnsley,Draw,Away,1998-02-07,1,4,7,10,10,3,3,6,7,1,4,4,3,0,15.0,21.0,-6.0,7
6081,6081,1997-98,1997,1998,Everton,Derby,Loss,Home,1998-02-14,0,2,5,8,11,3,4,7,7,-1,1,1,4,1,15.0,12.0,3.0,7
6082,6082,1997-98,1997,1998,Everton,Liverpool,Draw,Away,1998-02-23,1,1,2,5,8,1,2,5,6,0,0,0,2,0,15.0,4.0,11.0,7
6083,6083,1997-98,1997,1998,Everton,Newcastle,Draw,Home,1998-02-28,1,1,2,3,6,1,4,4,7,0,-2,-1,-1,1,15.0,2.0,13.0,7
6084,6084,1997-98,1997,1998,Everton,Southampton,Loss,Away,1998-03-07,0,2,2,3,4,6,6,9,9,-4,-4,-6,-5,0,15.0,16.0,-1.0,8
6085,6085,1997-98,1997,1998,Everton,Blackburn,Win,Home,1998-03-14,3,1,2,2,3,3,3,3,4,-2,-1,-1,-1,1,15.0,13.0,2.0,8
6086,6086,1997-98,1997,1998,Everton,Aston Villa,Loss,Home,1998-03-28,0,3,4,5,5,3,6,9,9,0,-2,-4,-4,1,15.0,5.0,10.0,8
6087,6087,1997-98,1997,1998,Everton,Tottenham,Draw,Away,1998-04-04,1,3,3,4,5,4,4,7,7,-1,-1,-3,-2,0,15.0,10.0,5.0,9
6088,6088,1997-98,1997,1998,Everton,Leeds,Win,Home,1998-04-11,3,1,4,4,5,6,6,9,12,-5,-2,-5,-7,1,15.0,11.0,4.0,9
6089,6089,1997-98,1997,1998,Everton,Wimbledon,Draw,Away,1998-04-13,1,4,4,7,7,4,5,5,8,0,-1,2,-1,0,15.0,8.0,7.0,9
6090,6090,1997-98,1997,1998,Everton,Leicester,Draw,Home,1998-04-18,1,4,5,5,8,4,5,5,5,0,0,0,3,1,15.0,9.0,6.0,9
6091,6091,1997-98,1997,1998,Everton,Sheffield Weds,Loss,Home,1998-04-25,0,2,5,6,6,1,1,4,4,1,4,2,2,1,15.0,7.0,8.0,9
6092,6092,1997-98,1997,1998,Everton,Arsenal,Loss,Away,1998-05-03,0,1,2,5,6,6,9,12,15,-5,-7,-7,-9,0,15.0,3.0,12.0,10
6093,6093,1997-98,1997,1998,Everton,Coventry,Draw,Home,1998-05-10,1,0,1,2,5,4,5,6,7,-4,-4,-4,-2,1,15.0,17.0,-2.0,10
6094,6094,1998-99,1998,1999,Everton,Aston Villa,Draw,Home,1998-08-15,1,1,1,2,3,6,6,9,12,-5,-5,-7,-9,1,17.0,7.0,10.0,1
6095,6095,1998-99,1998,1999,Everton,Leicester,Loss,Away,1998-08-22,0,2,2,2,3,1,4,5,8,1,-2,-3,-5,0,17.0,10.0,7.0,1
6096,6096,1998-99,1998,1999,Everton,Tottenham,Loss,Home,1998-08-29,0,1,2,2,2,0,1,4,7,1,1,-2,-5,1,17.0,14.0,3.0,1
6097,6097,1998-99,1998,1999,Everton,Nott'm Forest,Win,Away,1998-09-08,3,0,1,2,2,6,6,6,7,-6,-5,-4,-5,0,17.0,21.0,-4.0,2
6098,6098,1998-99,1998,1999,Everton,Leeds,Draw,Home,1998-09-12,1,3,3,4,5,4,7,8,9,-1,-4,-4,-4,1,17.0,5.0,12.0,2
6099,6099,1998-99,1998,1999,Everton,Middlesbrough,Draw,Away,1998-09-19,1,4,4,4,5,6,7,7,8,-2,-3,-3,-3,0,17.0,21.0,-4.0,2
6100,6100,1998-99,1998,1999,Everton,Blackburn,Draw,Home,1998-09-26,1,2,5,5,5,0,0,3,3,2,5,2,2,1,17.0,6.0,11.0,2
6101,6101,1998-99,1998,1999,Everton,Wimbledon,Win,Away,1998-10-03,3,2,3,6,6,4,4,7,8,-2,-1,-1,-2,0,17.0,15.0,2.0,3
6102,6102,1998-99,1998,1999,Everton,Liverpool,Draw,Home,1998-10-17,1,4,5,6,9,1,2,2,5,3,3,4,4,1,17.0,3.0,14.0,3
6103,6103,1998-99,1998,1999,Everton,Sheffield Weds,Draw,Away,1998-10-24,1,4,5,6,7,0,3,3,6,4,2,3,1,0,17.0,16.0,1.0,3
6104,6104,1998-99,1998,1999,Everton,Man United,Loss,Home,1998-10-31,0,2,5,6,7,4,7,10,10,-2,-2,-4,-3,1,17.0,2.0,15.0,3
6105,6105,1998-99,1998,1999,Everton,Arsenal,Loss,Away,1998-11-08,0,1,2,5,6,6,7,10,10,-5,-5,-5,-4,0,17.0,1.0,16.0,4
6106,6106,1998-99,1998,1999,Everton,Coventry,Loss,Away,1998-11-15,0,0,1,2,5,3,3,6,6,-3,-2,-4,-1,0,17.0,11.0,6.0,4
6107,6107,1998-99,1998,1999,Everton,Newcastle,Win,Home,1998-11-23,3,0,0,1,2,2,2,2,5,-2,-2,-1,-3,1,17.0,13.0,4.0,4
6108,6108,1998-99,1998,1999,Everton,Charlton,Win,Away,1998-11-28,3,3,3,3,4,1,2,3,6,2,1,0,-2,0,17.0,21.0,-4.0,4
6109,6109,1998-99,1998,1999,Everton,Chelsea,Draw,Home,1998-12-05,1,6,6,6,6,4,7,8,9,2,-1,-2,-3,1,17.0,4.0,13.0,5
6110,6110,1998-99,1998,1999,Everton,Southampton,Win,Home,1998-12-12,3,4,7,7,7,0,3,3,4,4,4,4,3,1,17.0,12.0,5.0,5
6111,6111,1998-99,1998,1999,Everton,West Ham,Loss,Away,1998-12-19,0,4,7,10,10,0,3,6,9,4,4,4,1,0,17.0,8.0,9.0,5
6112,6112,1998-99,1998,1999,Everton,Derby,Draw,Home,1998-12-26,1,3,4,7,10,2,3,6,6,1,1,1,4,1,17.0,9.0,8.0,5
6113,6113,1998-99,1998,1999,Everton,Tottenham,Loss,Away,1998-12-28,0,1,4,5,8,1,2,5,5,0,2,0,3,0,17.0,14.0,3.0,5
6114,6114,1998-99,1998,1999,Everton,Leicester,Draw,Home,1999-01-09,1,1,1,4,5,4,4,7,10,-3,-3,-3,-5,1,17.0,10.0,7.0,6
6115,6115,1998-99,1998,1999,Everton,Aston Villa,Loss,Away,1999-01-18,0,1,2,2,5,4,4,7,10,-3,-2,-5,-5,0,17.0,7.0,10.0,6
6116,6116,1998-99,1998,1999,Everton,Nott'm Forest,Loss,Home,1999-01-30,0,1,1,2,2,0,1,1,2,1,0,1,0,1,17.0,21.0,-4.0,6
6117,6117,1998-99,1998,1999,Everton,Derby,Loss,Away,1999-02-07,0,0,1,1,2,3,6,6,9,-3,-5,-5,-7,0,17.0,9.0,8.0,7
6118,6118,1998-99,1998,1999,Everton,Middlesbrough,Win,Home,1999-02-17,3,0,0,1,1,1,1,2,2,-1,-1,-1,-1,1,17.0,21.0,-4.0,7
6119,6119,1998-99,1998,1999,Everton,Leeds,Loss,Away,1999-02-20,0,3,3,3,4,3,3,6,6,0,0,-3,-2,0,17.0,5.0,12.0,7
6120,6120,1998-99,1998,1999,Everton,Wimbledon,Draw,Home,1999-02-27,1,3,3,3,3,1,2,3,6,2,1,0,-3,1,17.0,15.0,2.0,7
6121,6121,1998-99,1998,1999,Everton,Blackburn,Win,Away,1999-03-10,3,1,4,4,4,0,1,4,5,1,3,0,-1,0,17.0,6.0,11.0,8
6122,6122,1998-99,1998,1999,Everton,Arsenal,Loss,Home,1999-03-13,0,4,4,7,7,4,7,8,11,0,-3,-1,-4,1,17.0,1.0,16.0,8
6123,6123,1998-99,1998,1999,Everton,Man United,Loss,Away,1999-03-21,0,3,4,4,7,6,9,10,13,-3,-5,-6,-6,0,17.0,2.0,15.0,8
6124,6124,1998-99,1998,1999,Everton,Liverpool,Loss,Away,1999-04-03,0,0,3,4,4,0,1,1,4,0,2,3,0,0,17.0,3.0,14.0,9
6125,6125,1998-99,1998,1999,Everton,Sheffield Weds,Loss,Home,1999-04-05,0,0,0,3,4,0,0,0,0,0,0,3,4,1,17.0,16.0,1.0,9
6126,6126,1998-99,1998,1999,Everton,Coventry,Win,Home,1999-04-11,3,0,0,0,3,6,6,7,10,-6,-6,-7,-7,1,17.0,11.0,6.0,9
6127,6127,1998-99,1998,1999,Everton,Newcastle,Win,Away,1999-04-17,3,3,3,3,3,4,4,4,7,-1,-1,-1,-4,0,17.0,13.0,4.0,9
6128,6128,1998-99,1998,1999,Everton,Charlton,Win,Home,1999-04-24,3,6,6,6,6,1,1,4,4,5,5,2,2,1,17.0,21.0,-4.0,9
6129,6129,1998-99,1998,1999,Everton,Chelsea,Loss,Away,1999-05-01,0,6,9,9,9,2,3,6,9,4,6,3,0,0,17.0,4.0,13.0,10
6130,6130,1998-99,1998,1999,Everton,West Ham,Win,Home,1999-05-08,3,3,6,9,9,3,6,7,7,0,0,2,2,1,17.0,8.0,9.0,10
6131,6131,1998-99,1998,1999,Everton,Southampton,Loss,Away,1999-05-16,0,3,6,9,12,6,7,8,8,-3,-1,1,4,0,17.0,12.0,5.0,10
6132,6132,1999-00,1999,2000,Everton,Man United,Draw,Home,1999-08-08,1,3,3,6,9,4,7,8,11,-1,-4,-2,-2,1,14.0,1.0,13.0,1
6133,6133,1999-00,1999,2000,Everton,Aston Villa,Loss,Away,1999-08-11,0,1,4,4,7,3,3,3,6,-2,1,1,1,0,14.0,6.0,8.0,1
6134,6134,1999-00,1999,2000,Everton,Tottenham,Loss,Away,1999-08-14,0,1,1,4,4,3,3,4,4,-2,-2,0,0,0,14.0,11.0,3.0,1
6135,6135,1999-00,1999,2000,Everton,Southampton,Win,Home,1999-08-21,3,0,1,1,4,3,6,9,12,-3,-5,-8,-8,1,14.0,17.0,-3.0,1
6136,6136,1999-00,1999,2000,Everton,Wimbledon,Win,Home,1999-08-25,3,3,3,4,4,2,2,5,5,1,1,-1,-1,1,14.0,16.0,-2.0,1
6137,6137,1999-00,1999,2000,Everton,Derby,Loss,Away,1999-08-28,0,6,6,6,7,3,3,3,4,3,3,3,3,0,14.0,8.0,6.0,1
6138,6138,1999-00,1999,2000,Everton,Sheffield Weds,Win,Away,1999-09-11,3,3,6,6,6,0,0,1,1,3,6,5,5,0,14.0,12.0,2.0,2
6139,6139,1999-00,1999,2000,Everton,West Ham,Win,Home,1999-09-19,3,3,6,9,9,6,9,10,13,-3,-3,-1,-4,1,14.0,5.0,9.0,2
6140,6140,1999-00,1999,2000,Everton,Liverpool,Win,Away,1999-09-27,3,6,6,9,12,1,4,7,7,5,2,2,5,0,14.0,7.0,7.0,2
6141,6141,1999-00,1999,2000,Everton,Coventry,Draw,Home,1999-10-02,1,6,9,9,12,3,3,4,4,3,6,5,8,1,14.0,15.0,-1.0,3
6142,6142,1999-00,1999,2000,Everton,Arsenal,Loss,Away,1999-10-16,0,4,7,10,10,3,6,9,9,1,1,1,1,0,14.0,2.0,12.0,3
6143,6143,1999-00,1999,2000,Everton,Leeds,Draw,Home,1999-10-24,1,1,4,7,10,6,9,12,15,-5,-5,-5,-5,1,14.0,4.0,10.0,3
6144,6144,1999-00,1999,2000,Everton,Middlesbrough,Loss,Away,1999-10-30,0,1,2,5,8,6,6,6,6,-5,-4,-1,2,0,14.0,9.0,5.0,3
6145,6145,1999-00,1999,2000,Everton,Newcastle,Draw,Away,1999-11-07,1,1,1,2,5,4,4,7,7,-3,-3,-5,-2,0,14.0,13.0,1.0,4
6146,6146,1999-00,1999,2000,Everton,Chelsea,Draw,Home,1999-11-20,1,1,2,2,3,1,1,1,4,0,1,1,-1,1,14.0,3.0,11.0,4
6147,6147,1999-00,1999,2000,Everton,Aston Villa,Draw,Home,1999-11-27,1,2,2,3,3,0,0,1,1,2,2,2,2,1,14.0,6.0,8.0,4
6148,6148,1999-00,1999,2000,Everton,Man United,Loss,Away,1999-12-04,0,2,3,3,4,6,9,9,12,-4,-6,-6,-8,0,14.0,1.0,13.0,5
6149,6149,1999-00,1999,2000,Everton,Watford,Win,Away,1999-12-18,3,1,2,3,3,0,1,2,2,1,1,1,1,0,14.0,21.0,-7.0,5
6150,6150,1999-00,1999,2000,Everton,Sunderland,Win,Home,1999-12-26,3,3,4,5,6,6,9,9,10,-3,-5,-4,-4,1,14.0,21.0,-7.0,5
6151,6151,1999-00,1999,2000,Everton,Bradford,Draw,Away,1999-12-28,1,6,6,7,8,3,4,4,4,3,2,3,4,0,14.0,21.0,-7.0,5
6152,6152,1999-00,1999,2000,Everton,Leicester,Draw,Home,2000-01-03,1,4,7,7,8,0,0,0,3,4,7,7,5,1,14.0,10.0,4.0,6
6153,6153,1999-00,1999,2000,Everton,Tottenham,Draw,Home,2000-01-15,1,2,5,8,8,3,4,7,7,-1,1,1,1,1,14.0,11.0,3.0,6
6154,6154,1999-00,1999,2000,Everton,Southampton,Loss,Away,2000-01-22,0,2,3,6,9,3,3,3,3,-1,0,3,6,0,14.0,17.0,-3.0,6
6155,6155,1999-00,1999,2000,Everton,Wimbledon,Win,Away,2000-02-06,3,1,2,3,6,3,6,6,7,-2,-4,-3,-1,0,14.0,16.0,-2.0,7
6156,6156,1999-00,1999,2000,Everton,Derby,Win,Home,2000-02-12,3,3,4,5,6,2,5,8,9,1,-1,-3,-3,1,14.0,8.0,6.0,7
6157,6157,1999-00,1999,2000,Everton,West Ham,Win,Away,2000-02-26,3,6,6,7,8,3,6,7,8,3,0,0,0,0,14.0,5.0,9.0,7
6158,6158,1999-00,1999,2000,Everton,Sheffield Weds,Draw,Home,2000-03-04,1,6,9,9,10,0,1,1,4,6,8,8,6,1,14.0,12.0,2.0,8
6159,6159,1999-00,1999,2000,Everton,Chelsea,Draw,Away,2000-03-11,1,4,7,10,10,6,9,12,13,-2,-2,-2,-3,0,14.0,3.0,11.0,8
6160,6160,1999-00,1999,2000,Everton,Coventry,Loss,Away,2000-03-15,0,2,5,8,11,0,0,0,3,2,5,8,8,0,14.0,15.0,-1.0,8
6161,6161,1999-00,1999,2000,Everton,Newcastle,Loss,Home,2000-03-19,0,1,2,5,8,3,6,9,10,-2,-4,-4,-2,1,14.0,13.0,1.0,8
6162,6162,1999-00,1999,2000,Everton,Sunderland,Loss,Away,2000-03-25,0,0,1,2,5,2,2,3,3,-2,-1,-1,2,0,14.0,21.0,-7.0,8
6163,6163,1999-00,1999,2000,Everton,Watford,Win,Home,2000-04-01,3,0,0,1,2,4,4,4,4,-4,-4,-3,-2,1,14.0,21.0,-7.0,9
6164,6164,1999-00,1999,2000,Everton,Leicester,Draw,Away,2000-04-08,1,3,3,3,4,3,3,3,6,0,0,0,-2,0,14.0,10.0,4.0,9
6165,6165,1999-00,1999,2000,Everton,Bradford,Win,Home,2000-04-15,3,4,4,4,4,0,0,0,0,4,4,4,4,1,14.0,21.0,-7.0,9
6166,6166,1999-00,1999,2000,Everton,Liverpool,Draw,Home,2000-04-21,1,4,7,7,7,6,9,12,15,-2,-2,-5,-8,1,14.0,7.0,7.0,9
6167,6167,1999-00,1999,2000,Everton,Arsenal,Loss,Home,2000-04-29,0,4,5,8,8,6,9,12,15,-2,-4,-4,-7,1,14.0,2.0,12.0,9
6168,6168,1999-00,1999,2000,Everton,Leeds,Draw,Away,2000-05-08,1,1,4,5,8,6,7,7,7,-5,-3,-2,1,0,14.0,4.0,10.0,10
6169,6169,1999-00,1999,2000,Everton,Middlesbrough,Loss,Home,2000-05-14,0,1,2,5,6,2,5,6,6,-1,-3,-1,0,1,14.0,9.0,5.0,10
6170,6170,2000-01,2000,2001,Everton,Leeds,Loss,Away,2000-08-19,0,1,1,2,5,2,5,8,9,-1,-4,-6,-4,0,13.0,3.0,10.0,1
6171,6171,2000-01,2000,2001,Everton,Charlton,Win,Home,2000-08-23,3,0,1,1,2,3,6,7,7,-3,-5,-6,-5,1,13.0,21.0,-8.0,1
6172,6172,2000-01,2000,2001,Everton,Derby,Draw,Home,2000-08-26,1,3,3,4,4,1,1,2,3,2,2,2,1,1,13.0,16.0,-3.0,1
6173,6173,2000-01,2000,2001,Everton,Tottenham,Loss,Away,2000-09-05,0,4,4,4,5,1,4,7,7,3,0,-3,-2,0,13.0,10.0,3.0,2
6174,6174,2000-01,2000,2001,Everton,Middlesbrough,Win,Away,2000-09-09,3,1,4,4,4,1,2,5,8,0,2,-1,-4,0,13.0,12.0,1.0,2
6175,6175,2000-01,2000,2001,Everton,Man United,Loss,Home,2000-09-16,0,3,4,7,7,6,7,8,11,-3,-3,-1,-4,1,13.0,1.0,12.0,2
6176,6176,2000-01,2000,2001,Everton,Leicester,Draw,Away,2000-09-24,1,3,3,4,7,6,9,10,13,-3,-6,-6,-6,0,13.0,8.0,5.0,2
6177,6177,2000-01,2000,2001,Everton,Ipswich,Loss,Home,2000-09-30,0,1,4,4,5,4,4,4,7,-3,0,0,-2,1,13.0,21.0,-8.0,2
6178,6178,2000-01,2000,2001,Everton,Southampton,Draw,Home,2000-10-14,1,1,1,4,4,3,6,6,7,-2,-5,-2,-3,1,13.0,15.0,-2.0,3
6179,6179,2000-01,2000,2001,Everton,Newcastle,Win,Away,2000-10-21,3,1,2,2,5,6,6,6,7,-5,-4,-4,-2,0,13.0,11.0,2.0,3
6180,6180,2000-01,2000,2001,Everton,Liverpool,Loss,Away,2000-10-29,0,4,4,5,5,6,6,7,8,-2,-2,-2,-3,0,13.0,4.0,9.0,3
6181,6181,2000-01,2000,2001,Everton,Aston Villa,Loss,Home,2000-11-05,0,3,4,4,5,4,4,7,8,-1,0,-3,-3,1,13.0,6.0,7.0,4
6182,6182,2000-01,2000,2001,Everton,Bradford,Win,Away,2000-11-11,3,0,3,4,4,1,1,1,2,-1,2,3,2,0,13.0,17.0,-4.0,4
6183,6183,2000-01,2000,2001,Everton,Arsenal,Win,Home,2000-11-18,3,3,3,6,7,4,7,10,13,-1,-4,-4,-6,1,13.0,2.0,11.0,4
6184,6184,2000-01,2000,2001,Everton,Chelsea,Win,Home,2000-11-25,3,6,6,6,9,1,1,4,7,5,5,2,2,1,13.0,5.0,8.0,4
6185,6185,2000-01,2000,2001,Everton,Sunderland,Loss,Away,2000-12-04,0,6,9,9,9,6,7,7,10,0,2,2,-1,0,13.0,7.0,6.0,5
6186,6186,2000-01,2000,2001,Everton,Man City,Loss,Away,2000-12-09,0,3,6,9,9,0,0,0,0,3,6,9,9,0,13.0,21.0,-8.0,5
6187,6187,2000-01,2000,2001,Everton,West Ham,Draw,Home,2000-12-16,1,0,3,6,9,4,7,10,13,-4,-4,-4,-4,1,13.0,9.0,4.0,5
6188,6188,2000-01,2000,2001,Everton,Charlton,Loss,Away,2000-12-23,0,1,1,4,7,1,1,1,4,0,0,3,3,0,13.0,21.0,-8.0,5
6189,6189,2000-01,2000,2001,Everton,Coventry,Loss,Home,2000-12-26,0,1,1,1,4,1,4,4,5,0,-3,-3,-1,1,13.0,14.0,-1.0,5
6190,6190,2000-01,2000,2001,Everton,Derby,Loss,Away,2001-01-01,0,0,1,1,1,1,4,7,7,-1,-3,-6,-6,0,13.0,16.0,-3.0,6
6191,6191,2000-01,2000,2001,Everton,Tottenham,Draw,Home,2001-01-13,1,0,0,1,1,3,3,4,5,-3,-3,-3,-4,1,13.0,10.0,3.0,6
6192,6192,2000-01,2000,2001,Everton,Coventry,Win,Away,2001-01-20,3,1,1,1,2,1,2,5,6,0,-1,-4,-4,0,13.0,14.0,-1.0,6
6193,6193,2000-01,2000,2001,Everton,Middlesbrough,Draw,Home,2001-01-31,1,4,4,4,4,4,5,6,9,0,-1,-2,-5,1,13.0,12.0,1.0,6
6194,6194,2000-01,2000,2001,Everton,Man United,Loss,Away,2001-02-03,0,4,5,5,5,6,9,12,13,-2,-4,-7,-8,0,13.0,1.0,12.0,7
6195,6195,2000-01,2000,2001,Everton,Leeds,Draw,Home,2001-02-07,1,1,4,5,5,6,9,9,12,-5,-5,-4,-7,1,13.0,3.0,10.0,7
6196,6196,2000-01,2000,2001,Everton,Leicester,Win,Home,2001-02-10,3,1,2,5,6,3,4,4,4,-2,-2,1,2,1,13.0,8.0,5.0,7
6197,6197,2000-01,2000,2001,Everton,Ipswich,Loss,Away,2001-02-24,0,4,4,5,8,0,0,3,3,4,4,2,5,0,13.0,21.0,-8.0,7
6198,6198,2000-01,2000,2001,Everton,Newcastle,Draw,Home,2001-03-03,1,3,4,4,5,0,0,3,6,3,4,1,-1,1,13.0,11.0,2.0,8
6199,6199,2000-01,2000,2001,Everton,Southampton,Loss,Away,2001-03-17,0,1,4,5,5,6,9,12,13,-5,-5,-7,-8,0,13.0,15.0,-2.0,8
6200,6200,2000-01,2000,2001,Everton,West Ham,Win,Away,2001-03-31,3,1,1,4,5,0,0,3,4,1,1,1,1,0,13.0,9.0,4.0,8
6201,6201,2000-01,2000,2001,Everton,Man City,Win,Home,2001-04-08,3,3,4,4,7,1,1,4,4,2,3,0,3,1,13.0,21.0,-8.0,9
6202,6202,2000-01,2000,2001,Everton,Aston Villa,Loss,Away,2001-04-14,0,6,6,7,7,4,7,8,11,2,-1,-1,-4,0,13.0,6.0,7.0,9
6203,6203,2000-01,2000,2001,Everton,Liverpool,Loss,Home,2001-04-16,0,3,6,6,7,1,4,5,5,2,2,1,2,1,13.0,4.0,9.0,9
6204,6204,2000-01,2000,2001,Everton,Arsenal,Loss,Away,2001-04-21,0,0,3,6,6,3,6,7,10,-3,-3,-1,-4,0,13.0,2.0,11.0,9
6205,6205,2000-01,2000,2001,Everton,Bradford,Win,Home,2001-04-28,3,0,0,3,6,6,6,7,8,-6,-6,-4,-2,1,13.0,17.0,-4.0,9
6206,6206,2000-01,2000,2001,Everton,Chelsea,Loss,Away,2001-05-05,0,3,3,3,6,0,3,6,9,3,0,-3,-3,0,13.0,5.0,8.0,10
6207,6207,2000-01,2000,2001,Everton,Sunderland,Draw,Home,2001-05-19,1,3,3,3,3,6,7,7,7,-3,-4,-4,-4,1,13.0,7.0,6.0,10
6208,6208,2001-02,2001,2002,Everton,Charlton,Win,Away,2001-08-18,3,1,4,4,4,0,3,6,7,1,1,-2,-3,0,16.0,9.0,7.0,1
6209,6209,2001-02,2001,2002,Everton,Tottenham,Draw,Home,2001-08-20,1,4,4,7,7,4,4,5,5,0,0,2,2,1,16.0,12.0,4.0,1
6210,6210,2001-02,2001,2002,Everton,Middlesbrough,Win,Home,2001-08-25,3,4,5,5,8,0,3,4,4,4,2,1,4,1,16.0,14.0,2.0,1
6211,6211,2001-02,2001,2002,Everton,Man United,Loss,Away,2001-09-08,0,4,7,8,8,2,5,5,5,2,2,3,3,0,16.0,1.0,15.0,2
6212,6212,2001-02,2001,2002,Everton,Liverpool,Loss,Home,2001-09-15,0,3,4,7,8,0,3,6,7,3,1,1,1,1,16.0,3.0,13.0,2
6213,6213,2001-02,2001,2002,Everton,Blackburn,Loss,Away,2001-09-22,0,0,3,4,7,2,2,5,6,-2,1,-1,1,0,16.0,21.0,-5.0,2
6214,6214,2001-02,2001,2002,Everton,West Ham,Win,Home,2001-09-29,3,0,0,3,4,3,4,5,5,-3,-4,-2,-1,1,16.0,15.0,1.0,2
6215,6215,2001-02,2001,2002,Everton,Ipswich,Draw,Away,2001-10-13,1,3,3,3,6,0,1,2,2,3,2,1,4,0,16.0,5.0,11.0,3
6216,6216,2001-02,2001,2002,Everton,Aston Villa,Win,Home,2001-10-20,3,4,4,4,4,6,9,10,13,-2,-5,-6,-9,1,16.0,8.0,8.0,3
6217,6217,2001-02,2001,2002,Everton,Newcastle,Loss,Home,2001-10-27,0,4,7,7,7,3,3,6,6,1,4,1,1,1,16.0,11.0,5.0,3
6218,6218,2001-02,2001,2002,Everton,Bolton,Draw,Away,2001-11-03,1,3,4,7,7,3,3,3,4,0,1,4,3,0,16.0,21.0,-5.0,4
6219,6219,2001-02,2001,2002,Everton,Chelsea,Draw,Home,2001-11-18,1,1,4,5,8,4,4,5,8,-3,0,0,0,1,16.0,6.0,10.0,4
6220,6220,2001-02,2001,2002,Everton,Leicester,Draw,Away,2001-11-24,1,2,2,5,6,3,4,4,4,-1,-2,1,2,0,16.0,13.0,3.0,4
6221,6221,2001-02,2001,2002,Everton,Southampton,Win,Home,2001-12-02,3,2,3,3,6,3,3,3,4,-1,0,0,2,1,16.0,10.0,6.0,5
6222,6222,2001-02,2001,2002,Everton,Fulham,Loss,Away,2001-12-08,0,4,5,6,6,2,5,8,11,2,0,-2,-5,0,16.0,21.0,-5.0,5
6223,6223,2001-02,2001,2002,Everton,Derby,Win,Home,2001-12-15,3,3,4,5,6,3,3,3,6,0,1,2,0,1,16.0,17.0,-1.0,5
6224,6224,2001-02,2001,2002,Everton,Leeds,Loss,Away,2001-12-19,0,3,6,7,8,4,5,6,6,-1,1,1,2,0,16.0,4.0,12.0,5
6225,6225,2001-02,2001,2002,Everton,Sunderland,Loss,Away,2001-12-22,0,3,3,6,7,1,4,4,7,2,-1,2,0,0,16.0,7.0,9.0,5
6226,6226,2001-02,2001,2002,Everton,Man United,Loss,Home,2001-12-26,0,0,3,3,6,6,9,9,9,-6,-6,-6,-3,1,16.0,1.0,15.0,5
6227,6227,2001-02,2001,2002,Everton,Charlton,Loss,Home,2001-12-29,0,0,0,3,3,1,2,5,8,-1,-2,-2,-5,1,16.0,9.0,7.0,5
6228,6228,2001-02,2001,2002,Everton,Middlesbrough,Loss,Away,2002-01-01,0,0,0,0,3,0,0,0,3,0,0,0,0,0,16.0,14.0,2.0,6
6229,6229,2001-02,2001,2002,Everton,Sunderland,Win,Home,2002-01-12,3,0,0,0,0,1,4,7,7,-1,-4,-7,-7,1,16.0,7.0,9.0,6
6230,6230,2001-02,2001,2002,Everton,Tottenham,Draw,Away,2002-01-19,1,3,3,3,3,3,4,4,4,0,-1,-1,-1,0,16.0,12.0,4.0,6
6231,6231,2001-02,2001,2002,Everton,Aston Villa,Draw,Away,2002-01-30,1,4,4,4,4,6,7,8,8,-2,-3,-4,-4,0,16.0,8.0,8.0,6
6232,6232,2001-02,2001,2002,Everton,Ipswich,Loss,Home,2002-02-02,0,2,5,5,5,6,9,9,12,-4,-4,-4,-7,1,16.0,5.0,11.0,7
6233,6233,2001-02,2001,2002,Everton,Arsenal,Loss,Home,2002-02-10,0,1,2,5,5,4,7,8,9,-3,-5,-3,-4,1,16.0,2.0,14.0,7
6234,6234,2001-02,2001,2002,Everton,Liverpool,Draw,Away,2002-02-23,1,0,1,2,5,6,9,12,13,-6,-8,-10,-8,0,16.0,3.0,13.0,7
6235,6235,2001-02,2001,2002,Everton,Leeds,Draw,Home,2002-03-03,1,1,1,2,3,2,2,2,3,-1,-1,0,0,1,16.0,4.0,12.0,8
6236,6236,2001-02,2001,2002,Everton,West Ham,Loss,Away,2002-03-06,0,2,2,2,3,3,3,6,6,-1,-1,-4,-3,0,16.0,15.0,1.0,8
6237,6237,2001-02,2001,2002,Everton,Fulham,Win,Home,2002-03-16,3,1,2,2,2,0,0,0,3,1,2,2,-1,1,16.0,21.0,-5.0,8
6238,6238,2001-02,2001,2002,Everton,Derby,Win,Away,2002-03-23,3,3,4,5,5,3,4,7,7,0,0,-2,-2,0,16.0,17.0,-1.0,8
6239,6239,2001-02,2001,2002,Everton,Newcastle,Loss,Away,2002-03-29,0,6,6,7,8,1,1,4,7,5,5,3,1,0,16.0,11.0,5.0,8
6240,6240,2001-02,2001,2002,Everton,Bolton,Win,Home,2002-04-01,3,3,6,6,7,6,6,6,7,-3,0,0,0,1,16.0,21.0,-5.0,9
6241,6241,2001-02,2001,2002,Everton,Chelsea,Loss,Away,2002-04-06,0,3,6,9,9,4,4,7,10,-1,2,2,-1,0,16.0,6.0,10.0,9
6242,6242,2001-02,2001,2002,Everton,Leicester,Draw,Home,2002-04-13,1,3,3,6,9,0,3,3,4,3,0,3,5,1,16.0,13.0,3.0,9
6243,6243,2001-02,2001,2002,Everton,Southampton,Win,Away,2002-04-20,3,1,4,4,7,4,4,5,6,-3,0,-1,1,0,16.0,10.0,6.0,9
6244,6244,2001-02,2001,2002,Everton,Blackburn,Loss,Home,2002-04-28,0,4,4,7,7,4,5,8,8,0,-1,-1,-1,1,16.0,21.0,-5.0,9
6245,6245,2001-02,2001,2002,Everton,Arsenal,Loss,Away,2002-05-11,0,3,4,4,7,6,9,12,15,-3,-5,-8,-8,0,16.0,2.0,14.0,10
6246,6246,2002-03,2002,2003,Everton,Tottenham,Draw,Home,2002-08-17,1,0,3,4,4,3,4,5,5,-3,-1,-1,-1,1,15.0,9.0,6.0,1
6247,6247,2002-03,2002,2003,Everton,Sunderland,Win,Away,2002-08-24,3,1,1,4,5,2,3,3,3,-1,-2,1,2,0,15.0,17.0,-2.0,1
6248,6248,2002-03,2002,2003,Everton,Birmingham,Draw,Home,2002-08-28,1,4,4,4,7,0,0,0,0,4,4,4,7,1,15.0,21.0,-6.0,1
6249,6249,2002-03,2002,2003,Everton,Man City,Loss,Away,2002-08-31,0,4,5,5,5,3,3,3,3,1,2,2,2,0,15.0,21.0,-6.0,1
6250,6250,2002-03,2002,2003,Everton,Southampton,Loss,Away,2002-09-11,0,1,4,5,5,1,1,2,5,0,3,3,0,0,15.0,11.0,4.0,2
6251,6251,2002-03,2002,2003,Everton,Middlesbrough,Win,Home,2002-09-14,3,0,1,4,5,3,6,7,8,-3,-5,-3,-3,1,15.0,12.0,3.0,2
6252,6252,2002-03,2002,2003,Everton,Aston Villa,Loss,Away,2002-09-22,0,3,3,4,7,3,3,6,6,0,0,-2,1,0,15.0,8.0,7.0,2
6253,6253,2002-03,2002,2003,Everton,Fulham,Win,Home,2002-09-28,3,3,3,3,4,4,7,7,8,-1,-4,-4,-4,1,15.0,13.0,2.0,2
6254,6254,2002-03,2002,2003,Everton,Man United,Loss,Away,2002-10-07,0,3,6,6,6,6,6,6,9,-3,0,0,-3,0,15.0,3.0,12.0,3
6255,6255,2002-03,2002,2003,Everton,Arsenal,Win,Home,2002-10-19,3,3,3,6,6,6,9,12,15,-3,-6,-6,-9,1,15.0,1.0,14.0,3
6256,6256,2002-03,2002,2003,Everton,West Ham,Win,Away,2002-10-27,3,3,6,6,9,6,6,9,10,-3,0,-3,-1,0,15.0,7.0,8.0,3
6257,6257,2002-03,2002,2003,Everton,Leeds,Win,Away,2002-11-03,3,6,6,9,9,1,2,2,2,5,4,7,7,0,15.0,5.0,10.0,4
6258,6258,2002-03,2002,2003,Everton,Charlton,Win,Home,2002-11-09,3,6,9,9,12,1,4,4,4,5,5,5,8,1,15.0,14.0,1.0,4
6259,6259,2002-03,2002,2003,Everton,Blackburn,Win,Away,2002-11-17,3,6,9,12,12,2,5,8,8,4,4,4,4,0,15.0,10.0,5.0,4
6260,6260,2002-03,2002,2003,Everton,West Brom,Win,Home,2002-11-23,3,6,9,12,15,2,2,2,3,4,7,10,12,1,15.0,21.0,-6.0,4
6261,6261,2002-03,2002,2003,Everton,Newcastle,Loss,Away,2002-12-01,0,6,9,12,15,3,3,6,9,3,6,6,6,0,15.0,4.0,11.0,5
6262,6262,2002-03,2002,2003,Everton,Chelsea,Loss,Home,2002-12-07,0,3,6,9,12,4,7,10,11,-1,-1,-1,1,1,15.0,6.0,9.0,5
6263,6263,2002-03,2002,2003,Everton,Blackburn,Win,Home,2002-12-14,3,0,3,6,9,4,4,4,5,-4,-1,2,4,1,15.0,10.0,5.0,5
6264,6264,2002-03,2002,2003,Everton,Liverpool,Draw,Away,2002-12-22,1,3,3,6,9,0,0,0,1,3,3,6,8,0,15.0,2.0,13.0,5
6265,6265,2002-03,2002,2003,Everton,Birmingham,Draw,Away,2002-12-26,1,4,4,4,7,4,4,5,8,0,0,-1,-1,0,15.0,21.0,-6.0,5
6266,6266,2002-03,2002,2003,Everton,Bolton,Draw,Home,2002-12-28,1,2,5,5,5,4,4,5,5,-2,1,0,0,1,15.0,16.0,-1.0,5
6267,6267,2002-03,2002,2003,Everton,Man City,Draw,Home,2003-01-01,1,2,3,6,6,6,6,7,10,-4,-3,-1,-4,1,15.0,21.0,-6.0,6
6268,6268,2002-03,2002,2003,Everton,Tottenham,Loss,Away,2003-01-12,0,2,3,4,7,0,1,4,5,2,2,0,2,0,15.0,9.0,6.0,6
6269,6269,2002-03,2002,2003,Everton,Sunderland,Win,Home,2003-01-18,3,1,2,3,4,1,1,1,2,0,1,2,2,1,15.0,17.0,-2.0,6
6270,6270,2002-03,2002,2003,Everton,Bolton,Win,Away,2003-01-28,3,3,4,5,6,1,2,2,3,2,2,3,3,0,15.0,16.0,-1.0,6
6271,6271,2002-03,2002,2003,Everton,Leeds,Win,Home,2003-02-01,3,6,6,7,8,1,1,4,7,5,5,3,1,1,15.0,5.0,10.0,7
6272,6272,2002-03,2002,2003,Everton,Charlton,Loss,Away,2003-02-08,0,6,9,9,10,6,9,10,10,0,0,-1,0,0,15.0,14.0,1.0,7
6273,6273,2002-03,2002,2003,Everton,Southampton,Win,Home,2003-02-22,3,3,6,9,9,0,3,3,4,3,3,6,5,1,15.0,11.0,4.0,7
6274,6274,2002-03,2002,2003,Everton,Middlesbrough,Draw,Away,2003-03-01,1,3,6,9,12,4,4,4,5,-1,2,5,7,0,15.0,12.0,3.0,8
6275,6275,2002-03,2002,2003,Everton,West Ham,Draw,Home,2003-03-15,1,4,4,7,10,6,6,6,9,-2,-2,1,1,1,15.0,7.0,8.0,8
6276,6276,2002-03,2002,2003,Everton,Arsenal,Loss,Away,2003-03-23,0,2,5,5,8,3,6,7,10,-1,-1,-2,-2,0,15.0,1.0,14.0,8
6277,6277,2002-03,2002,2003,Everton,Newcastle,Win,Home,2003-04-06,3,1,2,5,5,6,6,9,12,-5,-4,-4,-7,1,15.0,4.0,11.0,9
6278,6278,2002-03,2002,2003,Everton,West Brom,Win,Away,2003-04-12,3,3,4,5,8,0,0,0,0,3,4,5,8,0,15.0,21.0,-6.0,9
6279,6279,2002-03,2002,2003,Everton,Liverpool,Loss,Home,2003-04-19,0,6,6,7,8,3,6,9,12,3,0,-2,-4,1,15.0,2.0,13.0,9
6280,6280,2002-03,2002,2003,Everton,Chelsea,Loss,Away,2003-04-21,0,3,6,6,7,3,6,9,12,0,0,-3,-5,0,15.0,6.0,9.0,9
6281,6281,2002-03,2002,2003,Everton,Aston Villa,Win,Home,2003-04-26,3,0,3,6,6,4,5,6,7,-4,-2,0,-1,1,15.0,8.0,7.0,9
6282,6282,2002-03,2002,2003,Everton,Fulham,Loss,Away,2003-05-03,0,3,3,6,9,1,4,4,4,2,-1,2,5,0,15.0,13.0,2.0,10
6283,6283,2002-03,2002,2003,Everton,Man United,Loss,Home,2003-05-11,0,3,3,3,6,6,9,10,13,-3,-6,-7,-7,1,15.0,3.0,12.0,10
6284,6284,2003-04,2003,2004,Everton,Arsenal,Loss,Away,2003-08-16,0,0,3,3,3,6,6,7,10,-6,-3,-4,-7,0,7.0,2.0,5.0,1
6285,6285,2003-04,2003,2004,Everton,Fulham,Win,Home,2003-08-23,3,0,0,3,3,6,9,10,10,-6,-9,-7,-7,1,7.0,14.0,-7.0,1
6286,6286,2003-04,2003,2004,Everton,Charlton,Draw,Away,2003-08-26,1,3,3,3,6,3,3,3,6,0,0,0,0,0,7.0,12.0,-5.0,1
6287,6287,2003-04,2003,2004,Everton,Liverpool,Loss,Home,2003-08-30,0,4,4,4,4,2,2,2,2,2,2,2,2,1,7.0,5.0,2.0,1
6288,6288,2003-04,2003,2004,Everton,Newcastle,Draw,Home,2003-09-13,1,1,4,4,4,0,1,2,5,1,3,2,-1,1,7.0,3.0,4.0,2
6289,6289,2003-04,2003,2004,Everton,Middlesbrough,Loss,Away,2003-09-21,0,1,2,5,5,0,1,1,1,1,1,4,4,0,7.0,11.0,-4.0,2
6290,6290,2003-04,2003,2004,Everton,Leeds,Win,Home,2003-09-28,3,1,1,2,5,0,3,4,4,1,-2,-2,1,1,7.0,15.0,-8.0,2
6291,6291,2003-04,2003,2004,Everton,Tottenham,Loss,Away,2003-10-04,0,3,4,4,5,1,1,1,2,2,3,3,3,0,7.0,10.0,-3.0,3
6292,6292,2003-04,2003,2004,Everton,Southampton,Draw,Home,2003-10-19,1,3,3,4,4,0,3,6,9,3,0,-2,-5,1,7.0,8.0,-1.0,3
6293,6293,2003-04,2003,2004,Everton,Aston Villa,Draw,Away,2003-10-25,1,1,4,4,5,2,2,5,5,-1,2,-1,0,0,7.0,16.0,-9.0,3
6294,6294,2003-04,2003,2004,Everton,Chelsea,Loss,Home,2003-11-01,0,2,2,5,5,3,4,7,10,-1,-2,-2,-5,1,7.0,4.0,3.0,4
6295,6295,2003-04,2003,2004,Everton,Blackburn,Loss,Away,2003-11-10,0,1,2,2,5,0,0,0,0,1,2,2,5,0,7.0,6.0,1.0,4
6296,6296,2003-04,2003,2004,Everton,Wolves,Win,Home,2003-11-22,3,0,1,2,2,1,4,5,8,-1,-3,-3,-6,1,7.0,21.0,-14.0,4
6297,6297,2003-04,2003,2004,Everton,Bolton,Loss,Away,2003-11-29,0,3,3,4,5,4,7,7,7,-1,-4,-3,-2,0,7.0,17.0,-10.0,4
6298,6298,2003-04,2003,2004,Everton,Man City,Draw,Home,2003-12-07,1,3,3,3,4,0,0,3,3,3,3,0,1,1,7.0,9.0,-2.0,5
6299,6299,2003-04,2003,2004,Everton,Portsmouth,Win,Away,2003-12-13,3,1,4,4,4,1,1,4,4,0,3,0,0,0,7.0,21.0,-14.0,5
6300,6300,2003-04,2003,2004,Everton,Leicester,Win,Home,2003-12-20,3,4,4,7,7,1,4,5,8,3,0,2,-1,1,7.0,21.0,-14.0,5
6301,6301,2003-04,2003,2004,Everton,Man United,Loss,Away,2003-12-26,0,6,7,7,10,6,9,9,12,0,-2,-2,-2,0,7.0,1.0,6.0,5
6302,6302,2003-04,2003,2004,Everton,Birmingham,Win,Home,2003-12-28,3,3,6,7,7,6,6,6,6,-3,0,1,1,1,7.0,13.0,-6.0,5
6303,6303,2003-04,2003,2004,Everton,Arsenal,Draw,Home,2004-01-07,1,3,6,9,10,6,7,10,11,-3,-1,-1,-1,1,7.0,2.0,5.0,6
6304,6304,2003-04,2003,2004,Everton,Fulham,Loss,Away,2004-01-10,0,4,4,7,10,0,3,3,3,4,1,4,7,0,7.0,14.0,-7.0,6
6305,6305,2003-04,2003,2004,Everton,Charlton,Loss,Home,2004-01-17,0,1,4,4,7,4,7,10,11,-3,-3,-6,-4,1,7.0,12.0,-5.0,6
6306,6306,2003-04,2003,2004,Everton,Liverpool,Draw,Away,2004-01-31,1,0,1,4,4,1,4,7,8,-1,-3,-3,-4,0,7.0,5.0,2.0,6
6307,6307,2003-04,2003,2004,Everton,Man United,Loss,Home,2004-02-07,0,1,1,2,5,3,4,7,10,-2,-3,-5,-5,1,7.0,1.0,6.0,7
6308,6308,2003-04,2003,2004,Everton,Birmingham,Loss,Away,2004-02-11,0,1,1,1,2,2,3,6,6,-1,-2,-5,-4,0,7.0,13.0,-6.0,7
6309,6309,2003-04,2003,2004,Everton,Southampton,Draw,Away,2004-02-21,1,0,1,1,1,1,1,4,4,-1,0,-3,-3,0,7.0,8.0,-1.0,7
6310,6310,2003-04,2003,2004,Everton,Aston Villa,Win,Home,2004-02-28,3,1,1,2,2,4,7,10,10,-3,-6,-8,-8,1,7.0,16.0,-9.0,7
6311,6311,2003-04,2003,2004,Everton,Portsmouth,Win,Home,2004-03-13,3,4,4,4,5,1,1,2,2,3,3,2,3,1,7.0,21.0,-14.0,8
6312,6312,2003-04,2003,2004,Everton,Leicester,Draw,Away,2004-03-20,1,6,7,7,7,4,5,6,6,2,2,1,1,0,7.0,21.0,-14.0,8
6313,6313,2003-04,2003,2004,Everton,Middlesbrough,Draw,Home,2004-03-27,1,4,7,8,8,3,6,6,6,1,1,2,2,1,7.0,11.0,-4.0,8
6314,6314,2003-04,2003,2004,Everton,Newcastle,Loss,Away,2004-04-03,0,2,5,8,9,3,3,4,7,-1,2,4,2,0,7.0,3.0,4.0,9
6315,6315,2003-04,2003,2004,Everton,Tottenham,Win,Home,2004-04-09,3,1,2,5,8,0,0,3,3,1,2,2,5,1,7.0,10.0,-3.0,9
6316,6316,2003-04,2003,2004,Everton,Leeds,Draw,Away,2004-04-13,1,3,4,5,8,6,6,9,9,-3,-2,-4,-1,0,7.0,15.0,-8.0,9
6317,6317,2003-04,2003,2004,Everton,Chelsea,Draw,Away,2004-04-17,1,4,4,5,6,1,4,7,10,3,0,-2,-4,0,7.0,4.0,3.0,9
6318,6318,2003-04,2003,2004,Everton,Blackburn,Loss,Home,2004-04-24,0,2,5,5,6,6,6,6,6,-4,-1,-1,0,1,7.0,6.0,1.0,9
6319,6319,2003-04,2003,2004,Everton,Wolves,Loss,Away,2004-05-01,0,1,2,5,5,4,4,5,5,-3,-2,0,0,0,7.0,21.0,-14.0,10
6320,6320,2003-04,2003,2004,Everton,Bolton,Loss,Home,2004-05-08,0,0,1,2,5,6,9,12,13,-6,-8,-10,-8,1,7.0,17.0,-10.0,10
6321,6321,2003-04,2003,2004,Everton,Man City,Loss,Away,2004-05-15,0,0,0,1,2,3,4,4,5,-3,-4,-3,-3,0,7.0,9.0,-2.0,10
6322,6322,2004-05,2004,2005,Everton,Arsenal,Loss,Home,2004-08-15,0,0,0,0,1,6,7,8,9,-6,-7,-8,-8,1,17.0,1.0,16.0,1
6323,6323,2004-05,2004,2005,Everton,Crystal Palace,Win,Away,2004-08-21,3,0,0,0,0,4,5,5,5,-4,-5,-5,-5,0,17.0,21.0,-4.0,1
6324,6324,2004-05,2004,2005,Everton,West Brom,Win,Home,2004-08-28,3,3,3,3,3,2,3,4,5,1,0,-1,-2,1,17.0,21.0,-4.0,1
6325,6325,2004-05,2004,2005,Everton,Man United,Draw,Away,2004-08-30,1,6,6,6,6,4,4,7,8,2,2,-1,-2,0,17.0,3.0,14.0,1
6326,6326,2004-05,2004,2005,Everton,Man City,Win,Away,2004-09-11,3,4,7,7,7,3,3,4,7,1,4,3,0,0,17.0,16.0,1.0,2
6327,6327,2004-05,2004,2005,Everton,Middlesbrough,Win,Home,2004-09-19,3,4,7,10,10,6,9,9,10,-2,-2,1,0,1,17.0,11.0,6.0,2
6328,6328,2004-05,2004,2005,Everton,Portsmouth,Win,Away,2004-09-26,3,6,7,10,13,3,6,6,7,3,1,4,6,0,17.0,13.0,4.0,2
6329,6329,2004-05,2004,2005,Everton,Tottenham,Loss,Home,2004-10-02,0,6,9,10,13,1,2,5,6,5,7,5,7,1,17.0,14.0,3.0,3
6330,6330,2004-05,2004,2005,Everton,Southampton,Win,Home,2004-10-16,3,3,6,9,10,1,1,2,2,2,5,7,8,1,17.0,12.0,5.0,3
6331,6331,2004-05,2004,2005,Everton,Norwich,Win,Away,2004-10-23,3,3,6,9,12,2,2,3,4,1,4,6,8,0,17.0,21.0,-4.0,3
6332,6332,2004-05,2004,2005,Everton,Aston Villa,Draw,Home,2004-10-30,1,6,6,9,12,3,4,5,6,3,2,4,6,1,17.0,6.0,11.0,3
6333,6333,2004-05,2004,2005,Everton,Chelsea,Loss,Away,2004-11-06,0,4,7,7,10,6,6,9,12,-2,1,-2,-2,0,17.0,2.0,15.0,4
6334,6334,2004-05,2004,2005,Everton,Birmingham,Win,Away,2004-11-13,3,1,4,7,7,3,4,5,6,-2,0,2,1,0,17.0,10.0,7.0,4
6335,6335,2004-05,2004,2005,Everton,Fulham,Win,Home,2004-11-20,3,3,4,7,10,3,6,6,6,0,-2,1,4,1,17.0,9.0,8.0,4
6336,6336,2004-05,2004,2005,Everton,Newcastle,Draw,Away,2004-11-28,1,6,6,7,10,3,3,3,6,3,3,4,4,0,17.0,5.0,12.0,4
6337,6337,2004-05,2004,2005,Everton,Bolton,Win,Home,2004-12-04,3,4,7,7,8,1,1,2,5,3,6,5,3,1,17.0,8.0,9.0,5
6338,6338,2004-05,2004,2005,Everton,Liverpool,Win,Home,2004-12-11,3,4,7,10,10,4,4,7,7,0,3,3,3,1,17.0,4.0,13.0,5
6339,6339,2004-05,2004,2005,Everton,Blackburn,Draw,Away,2004-12-18,1,6,7,10,13,1,4,5,6,5,3,5,7,0,17.0,15.0,2.0,5
6340,6340,2004-05,2004,2005,Everton,Man City,Win,Home,2004-12-26,3,4,7,8,11,3,3,6,9,1,4,2,2,1,17.0,16.0,1.0,5
6341,6341,2004-05,2004,2005,Everton,Charlton,Loss,Away,2004-12-28,0,4,7,10,11,4,7,10,10,0,0,0,1,0,17.0,7.0,10.0,5
6342,6342,2004-05,2004,2005,Everton,Tottenham,Loss,Away,2005-01-01,0,3,4,7,10,4,7,10,13,-1,-3,-3,-3,0,17.0,14.0,3.0,6
6343,6343,2004-05,2004,2005,Everton,Portsmouth,Win,Home,2005-01-04,3,0,3,4,7,1,4,4,5,-1,-1,0,2,1,17.0,13.0,4.0,6
6344,6344,2004-05,2004,2005,Everton,Middlesbrough,Draw,Away,2005-01-16,1,3,3,6,7,0,3,3,6,3,0,3,1,0,17.0,11.0,6.0,6
6345,6345,2004-05,2004,2005,Everton,Charlton,Loss,Home,2005-01-22,0,4,4,4,7,3,3,6,7,1,1,-2,0,1,17.0,7.0,10.0,6
6346,6346,2004-05,2004,2005,Everton,Norwich,Win,Home,2005-02-02,3,1,4,4,4,1,1,2,2,0,3,2,2,1,17.0,21.0,-4.0,7
6347,6347,2004-05,2004,2005,Everton,Southampton,Draw,Away,2005-02-06,1,3,4,7,7,3,3,4,4,0,1,3,3,0,17.0,12.0,5.0,7
6348,6348,2004-05,2004,2005,Everton,Chelsea,Loss,Home,2005-02-12,0,4,4,5,8,4,7,10,13,0,-3,-5,-5,1,17.0,2.0,15.0,7
6349,6349,2004-05,2004,2005,Everton,Aston Villa,Win,Away,2005-02-26,3,1,4,4,5,3,4,4,7,-2,0,0,-2,0,17.0,6.0,11.0,7
6350,6350,2004-05,2004,2005,Everton,Blackburn,Loss,Home,2005-03-06,0,3,4,7,7,3,3,3,6,0,1,4,1,1,17.0,15.0,2.0,8
6351,6351,2004-05,2004,2005,Everton,Liverpool,Loss,Away,2005-03-20,0,3,3,4,7,1,1,4,7,2,2,0,0,0,17.0,4.0,13.0,8
6352,6352,2004-05,2004,2005,Everton,West Brom,Loss,Away,2005-04-03,0,0,3,3,4,3,6,7,7,-3,-3,-4,-3,0,17.0,21.0,-4.0,9
6353,6353,2004-05,2004,2005,Everton,Crystal Palace,Win,Home,2005-04-10,3,0,0,3,3,0,1,4,4,0,-1,-1,-1,1,17.0,21.0,-4.0,9
6354,6354,2004-05,2004,2005,Everton,Man United,Win,Home,2005-04-20,3,3,3,3,6,1,4,5,8,2,-1,-2,-2,1,17.0,3.0,14.0,9
6355,6355,2004-05,2004,2005,Everton,Birmingham,Draw,Home,2005-04-23,1,6,6,6,6,1,2,3,6,5,4,3,0,1,17.0,10.0,7.0,9
6356,6356,2004-05,2004,2005,Everton,Fulham,Loss,Away,2005-04-30,0,4,7,7,7,1,2,2,5,3,5,5,2,0,17.0,9.0,8.0,9
6357,6357,2004-05,2004,2005,Everton,Newcastle,Win,Home,2005-05-07,3,1,4,7,7,4,5,5,5,-3,-1,2,2,1,17.0,5.0,12.0,10
6358,6358,2004-05,2004,2005,Everton,Arsenal,Loss,Away,2005-05-11,0,3,4,7,10,6,9,10,13,-3,-5,-3,-3,0,17.0,1.0,16.0,10
6359,6359,2004-05,2004,2005,Everton,Bolton,Loss,Away,2005-05-15,0,3,3,4,7,1,2,3,6,2,1,1,1,0,17.0,8.0,9.0,10
6360,6360,2005-06,2005,2006,Everton,Man United,Loss,Home,2005-08-13,0,0,3,3,4,3,4,7,10,-3,-1,-4,-6,1,4.0,3.0,1.0,1
6361,6361,2005-06,2005,2006,Everton,Bolton,Win,Away,2005-08-21,3,0,0,3,3,4,5,5,6,-4,-5,-2,-3,0,4.0,6.0,-2.0,1
6362,6362,2005-06,2005,2006,Everton,Fulham,Loss,Away,2005-08-27,0,3,3,3,6,0,1,4,7,3,2,-1,-1,0,4.0,13.0,-9.0,1
6363,6363,2005-06,2005,2006,Everton,Portsmouth,Loss,Home,2005-09-10,0,3,3,3,3,1,1,1,1,2,2,2,2,1,4.0,16.0,-12.0,2
6364,6364,2005-06,2005,2006,Everton,Arsenal,Loss,Away,2005-09-19,0,0,3,3,3,3,3,6,6,-3,0,-3,-3,0,4.0,2.0,2.0,2
6365,6365,2005-06,2005,2006,Everton,Wigan,Loss,Home,2005-09-24,0,0,0,3,3,4,7,7,7,-4,-7,-4,-4,1,4.0,21.0,-17.0,2
6366,6366,2005-06,2005,2006,Everton,Man City,Loss,Away,2005-10-02,0,0,0,0,3,0,1,4,7,0,-1,-4,-4,0,4.0,8.0,-4.0,3
6367,6367,2005-06,2005,2006,Everton,Tottenham,Loss,Away,2005-10-15,0,0,0,0,0,6,7,8,8,-6,-7,-8,-8,0,4.0,9.0,-5.0,3
6368,6368,2005-06,2005,2006,Everton,Chelsea,Draw,Home,2005-10-23,1,0,0,0,0,6,9,12,15,-6,-9,-12,-15,1,4.0,1.0,3.0,3
6369,6369,2005-06,2005,2006,Everton,Birmingham,Win,Away,2005-10-29,3,1,1,1,1,0,0,1,2,1,1,0,-1,0,4.0,12.0,-8.0,3
6370,6370,2005-06,2005,2006,Everton,Middlesbrough,Win,Home,2005-11-06,3,4,4,4,4,3,4,7,7,1,0,-3,-3,1,4.0,7.0,-3.0,4
6371,6371,2005-06,2005,2006,Everton,West Brom,Loss,Away,2005-11-19,0,6,7,7,7,0,0,3,3,6,7,4,4,0,4.0,17.0,-13.0,4
6372,6372,2005-06,2005,2006,Everton,Newcastle,Win,Home,2005-11-27,3,3,6,7,7,3,6,9,9,0,0,-2,-2,1,4.0,14.0,-10.0,4
6373,6373,2005-06,2005,2006,Everton,Blackburn,Win,Away,2005-12-03,3,3,6,9,10,1,4,4,7,2,2,5,3,0,4.0,15.0,-11.0,5
6374,6374,2005-06,2005,2006,Everton,Man United,Draw,Away,2005-12-11,1,6,6,9,12,6,9,12,12,0,-3,-3,0,0,4.0,3.0,1.0,5
6375,6375,2005-06,2005,2006,Everton,West Ham,Loss,Home,2005-12-14,0,4,7,7,10,3,3,4,7,1,4,3,3,1,4.0,21.0,-17.0,5
6376,6376,2005-06,2005,2006,Everton,Bolton,Loss,Home,2005-12-17,0,1,4,7,7,4,4,7,10,-3,0,0,-3,1,4.0,6.0,-2.0,5
6377,6377,2005-06,2005,2006,Everton,Aston Villa,Loss,Away,2005-12-26,0,0,1,4,7,1,2,5,8,-1,-1,-1,-1,0,4.0,10.0,-6.0,5
6378,6378,2005-06,2005,2006,Everton,Liverpool,Loss,Home,2005-12-28,0,0,0,1,4,6,9,12,15,-6,-9,-11,-11,1,4.0,5.0,-1.0,5
6379,6379,2005-06,2005,2006,Everton,Sunderland,Win,Away,2005-12-31,3,0,0,0,1,1,1,1,1,-1,-1,-1,0,0,4.0,21.0,-17.0,5
6380,6380,2005-06,2005,2006,Everton,Charlton,Win,Home,2006-01-02,3,3,3,3,3,3,3,6,6,0,0,-3,-3,1,4.0,11.0,-7.0,6
6381,6381,2005-06,2005,2006,Everton,Portsmouth,Win,Away,2006-01-14,3,6,6,6,6,3,3,4,7,3,3,2,-1,0,4.0,16.0,-12.0,6
6382,6382,2005-06,2005,2006,Everton,Arsenal,Win,Home,2006-01-21,3,6,9,9,9,4,5,8,11,2,4,1,-2,1,4.0,2.0,2.0,6
6383,6383,2005-06,2005,2006,Everton,Wigan,Draw,Away,2006-01-31,1,6,9,12,12,3,3,3,6,3,6,9,6,0,4.0,21.0,-17.0,6
6384,6384,2005-06,2005,2006,Everton,Man City,Win,Home,2006-02-04,3,4,7,10,13,3,6,6,7,1,1,4,6,1,4.0,8.0,-4.0,7
6385,6385,2005-06,2005,2006,Everton,Blackburn,Win,Home,2006-02-11,3,4,7,10,13,3,6,7,10,1,1,3,3,1,4.0,15.0,-11.0,7
6386,6386,2005-06,2005,2006,Everton,Newcastle,Loss,Away,2006-02-25,0,6,7,10,13,4,7,7,7,2,0,3,6,0,4.0,14.0,-10.0,7
6387,6387,2005-06,2005,2006,Everton,West Ham,Draw,Away,2006-03-04,1,3,6,7,10,6,9,12,15,-3,-3,-5,-5,0,4.0,21.0,-17.0,8
6388,6388,2005-06,2005,2006,Everton,Fulham,Win,Home,2006-03-11,3,1,4,7,8,0,3,3,6,1,1,4,2,1,4.0,13.0,-9.0,8
6389,6389,2005-06,2005,2006,Everton,Aston Villa,Win,Home,2006-03-18,3,4,4,7,10,3,4,4,7,1,0,3,3,1,4.0,10.0,-6.0,8
6390,6390,2005-06,2005,2006,Everton,Liverpool,Loss,Away,2006-03-25,0,6,7,7,10,6,6,7,10,0,1,0,0,0,4.0,5.0,-1.0,8
6391,6391,2005-06,2005,2006,Everton,Sunderland,Draw,Home,2006-04-01,1,3,6,7,7,0,0,0,0,3,6,7,7,1,4.0,21.0,-17.0,9
6392,6392,2005-06,2005,2006,Everton,Charlton,Draw,Away,2006-04-08,1,1,4,7,8,4,4,7,8,-3,0,0,0,0,4.0,11.0,-7.0,9
6393,6393,2005-06,2005,2006,Everton,Tottenham,Loss,Home,2006-04-15,0,2,2,5,8,3,6,9,9,-1,-4,-4,-1,1,4.0,9.0,-5.0,9
6394,6394,2005-06,2005,2006,Everton,Chelsea,Loss,Away,2006-04-17,0,1,2,2,5,6,7,10,10,-5,-5,-8,-5,0,4.0,1.0,3.0,9
6395,6395,2005-06,2005,2006,Everton,Birmingham,Draw,Home,2006-04-22,1,0,1,2,2,3,4,7,8,-3,-3,-5,-6,1,4.0,12.0,-8.0,9
6396,6396,2005-06,2005,2006,Everton,Middlesbrough,Win,Away,2006-04-29,3,1,1,2,3,3,3,6,9,-2,-2,-4,-6,0,4.0,7.0,-3.0,9
6397,6397,2005-06,2005,2006,Everton,West Brom,Draw,Home,2006-05-07,1,4,4,4,5,0,1,1,2,4,3,3,3,1,4.0,17.0,-13.0,10
6398,6398,2006-07,2006,2007,Everton,Watford,Win,Home,2006-08-19,3,4,5,5,5,4,4,4,4,0,1,1,1,1,11.0,21.0,-10.0,1
6399,6399,2006-07,2006,2007,Everton,Blackburn,Draw,Away,2006-08-23,1,4,7,8,8,3,6,9,9,1,1,-1,-1,0,11.0,6.0,5.0,1
6400,6400,2006-07,2006,2007,Everton,Tottenham,Win,Away,2006-08-26,3,4,5,8,9,3,3,6,7,1,2,2,2,0,11.0,5.0,6.0,1
6401,6401,2006-07,2006,2007,Everton,Liverpool,Win,Home,2006-09-09,3,4,7,8,11,4,7,10,13,0,0,-2,-2,1,11.0,3.0,8.0,2
6402,6402,2006-07,2006,2007,Everton,Wigan,Draw,Home,2006-09-16,1,6,7,10,11,3,3,3,3,3,4,7,8,1,11.0,10.0,1.0,2
6403,6403,2006-07,2006,2007,Everton,Newcastle,Draw,Away,2006-09-24,1,4,7,8,11,3,3,3,6,1,4,5,5,0,11.0,7.0,4.0,2
6404,6404,2006-07,2006,2007,Everton,Man City,Draw,Home,2006-09-30,1,2,5,8,9,3,3,6,7,-1,2,2,2,1,11.0,15.0,-4.0,2
6405,6405,2006-07,2006,2007,Everton,Middlesbrough,Loss,Away,2006-10-14,0,2,3,6,9,0,1,2,2,2,2,4,7,0,11.0,14.0,-3.0,3
6406,6406,2006-07,2006,2007,Everton,Sheffield United,Win,Home,2006-10-21,3,1,2,3,6,4,4,4,5,-3,-2,-1,1,1,11.0,21.0,-10.0,3
6407,6407,2006-07,2006,2007,Everton,Arsenal,Draw,Away,2006-10-28,1,3,4,5,6,6,9,12,15,-3,-5,-7,-9,0,11.0,4.0,7.0,3
6408,6408,2006-07,2006,2007,Everton,Fulham,Loss,Away,2006-11-04,0,4,4,5,6,1,4,5,5,3,0,0,1,0,11.0,12.0,-1.0,4
6409,6409,2006-07,2006,2007,Everton,Aston Villa,Loss,Home,2006-11-11,0,1,4,4,5,3,4,5,6,-2,0,-1,-1,1,11.0,16.0,-5.0,4
6410,6410,2006-07,2006,2007,Everton,Bolton,Win,Home,2006-11-18,3,0,1,4,4,1,1,4,7,-1,0,0,-3,1,11.0,8.0,3.0,4
6411,6411,2006-07,2006,2007,Everton,Charlton,Draw,Away,2006-11-25,1,3,3,4,7,0,3,4,5,3,0,0,2,0,11.0,13.0,-2.0,4
6412,6412,2006-07,2006,2007,Everton,Man United,Loss,Away,2006-11-29,0,4,4,4,5,4,7,10,13,0,-3,-6,-8,0,11.0,2.0,9.0,4
6413,6413,2006-07,2006,2007,Everton,West Ham,Win,Home,2006-12-03,3,1,4,4,4,3,3,6,9,-2,1,-2,-5,1,11.0,9.0,2.0,5
6414,6414,2006-07,2006,2007,Everton,Portsmouth,Loss,Away,2006-12-09,0,3,4,7,7,2,2,5,6,1,2,2,1,0,11.0,17.0,-6.0,5
6415,6415,2006-07,2006,2007,Everton,Chelsea,Loss,Home,2006-12-17,0,3,3,4,7,4,7,8,11,-1,-4,-4,-4,1,11.0,1.0,10.0,5
6416,6416,2006-07,2006,2007,Everton,Reading,Win,Away,2006-12-23,3,0,3,3,4,1,1,4,7,-1,2,-1,-3,0,11.0,21.0,-10.0,5
6417,6417,2006-07,2006,2007,Everton,Middlesbrough,Draw,Home,2006-12-26,1,3,3,6,6,3,4,4,4,0,-1,2,2,1,11.0,14.0,-3.0,5
6418,6418,2006-07,2006,2007,Everton,Newcastle,Win,Home,2006-12-30,3,4,4,4,7,3,6,6,9,1,-2,-2,-2,1,11.0,7.0,4.0,5
6419,6419,2006-07,2006,2007,Everton,Man City,Loss,Away,2007-01-01,0,4,7,7,7,6,6,6,6,-2,1,1,1,0,11.0,15.0,-4.0,6
6420,6420,2006-07,2006,2007,Everton,Reading,Draw,Home,2007-01-14,1,3,4,7,7,3,4,4,4,0,0,3,3,1,11.0,21.0,-10.0,6
6421,6421,2006-07,2006,2007,Everton,Wigan,Win,Away,2007-01-21,3,1,4,5,8,0,0,0,0,1,4,5,8,0,11.0,10.0,1.0,6
6422,6422,2006-07,2006,2007,Everton,Liverpool,Draw,Away,2007-02-03,1,4,4,7,8,6,9,12,15,-2,-5,-5,-7,0,11.0,3.0,8.0,7
6423,6423,2006-07,2006,2007,Everton,Blackburn,Win,Home,2007-02-10,3,4,5,5,8,3,3,6,6,1,2,-1,2,1,11.0,6.0,5.0,7
6424,6424,2006-07,2006,2007,Everton,Tottenham,Loss,Home,2007-02-21,0,4,7,8,8,0,1,1,2,4,6,7,6,1,11.0,5.0,6.0,7
6425,6425,2006-07,2006,2007,Everton,Watford,Win,Away,2007-02-24,3,3,4,7,8,4,4,4,7,-1,0,3,1,0,11.0,21.0,-10.0,7
6426,6426,2006-07,2006,2007,Everton,Sheffield United,Draw,Away,2007-03-03,1,3,6,7,10,3,3,6,6,0,3,1,4,0,11.0,21.0,-10.0,8
6427,6427,2006-07,2006,2007,Everton,Arsenal,Win,Home,2007-03-18,3,4,4,7,8,6,9,10,13,-2,-5,-3,-5,1,11.0,4.0,7.0,8
6428,6428,2006-07,2006,2007,Everton,Aston Villa,Draw,Away,2007-04-02,1,4,7,7,10,1,2,2,5,3,5,5,5,0,11.0,16.0,-5.0,9
6429,6429,2006-07,2006,2007,Everton,Fulham,Win,Home,2007-04-06,3,4,5,8,8,2,3,3,3,2,2,5,5,1,11.0,12.0,-1.0,9
6430,6430,2006-07,2006,2007,Everton,Bolton,Draw,Away,2007-04-09,1,4,7,8,11,6,6,6,6,-2,1,2,5,0,11.0,8.0,3.0,9
6431,6431,2006-07,2006,2007,Everton,Charlton,Win,Home,2007-04-15,3,4,5,8,9,2,5,8,9,2,0,0,0,1,11.0,13.0,-2.0,9
6432,6432,2006-07,2006,2007,Everton,West Ham,Loss,Away,2007-04-21,0,4,7,8,11,0,3,6,9,4,4,2,2,0,11.0,9.0,2.0,9
6433,6433,2006-07,2006,2007,Everton,Man United,Loss,Home,2007-04-28,0,3,4,7,8,4,4,7,10,-1,0,0,-2,1,11.0,2.0,9.0,9
6434,6434,2006-07,2006,2007,Everton,Portsmouth,Win,Home,2007-05-05,3,0,3,4,7,4,7,7,10,-4,-4,-3,-3,1,11.0,17.0,-6.0,10
6435,6435,2006-07,2006,2007,Everton,Chelsea,Draw,Away,2007-05-13,1,3,3,6,7,2,3,4,7,1,0,2,0,0,11.0,1.0,10.0,10
6436,6436,2007-08,2007,2008,Everton,Wigan,Win,Home,2007-08-11,3,4,4,4,7,3,3,3,4,1,1,1,3,1,6.0,17.0,-11.0,1
6437,6437,2007-08,2007,2008,Everton,Tottenham,Win,Away,2007-08-14,3,4,7,7,7,3,4,7,10,1,3,0,-3,0,6.0,5.0,1.0,1
6438,6438,2007-08,2007,2008,Everton,Reading,Loss,Away,2007-08-18,0,6,7,10,10,1,2,2,5,5,5,8,5,0,6.0,8.0,-2.0,1
6439,6439,2007-08,2007,2008,Everton,Blackburn,Draw,Home,2007-08-25,1,3,6,7,10,4,5,6,9,-1,1,1,1,1,6.0,10.0,-4.0,1
6440,6440,2007-08,2007,2008,Everton,Bolton,Win,Away,2007-09-01,3,1,4,7,8,3,3,3,4,-2,1,4,4,0,6.0,7.0,-1.0,2
6441,6441,2007-08,2007,2008,Everton,Man United,Loss,Home,2007-09-15,0,4,4,7,10,6,6,7,8,-2,-2,0,2,1,6.0,1.0,5.0,2
6442,6442,2007-08,2007,2008,Everton,Aston Villa,Loss,Away,2007-09-23,0,3,4,4,7,3,6,7,7,0,-2,-3,0,0,6.0,11.0,-5.0,2
6443,6443,2007-08,2007,2008,Everton,Middlesbrough,Win,Home,2007-09-30,3,0,3,4,4,1,4,5,8,-1,-1,-1,-4,1,6.0,12.0,-6.0,2
6444,6444,2007-08,2007,2008,Everton,Newcastle,Loss,Away,2007-10-07,0,3,3,6,7,3,3,6,7,0,0,0,0,0,6.0,13.0,-7.0,3
6445,6445,2007-08,2007,2008,Everton,Liverpool,Loss,Home,2007-10-20,0,3,3,3,6,4,5,6,9,-1,-2,-3,-3,1,6.0,3.0,3.0,3
6446,6446,2007-08,2007,2008,Everton,Derby,Win,Away,2007-10-28,3,0,3,3,3,1,2,2,5,-1,1,1,-2,0,6.0,21.0,-15.0,3
6447,6447,2007-08,2007,2008,Everton,Birmingham,Win,Home,2007-11-03,3,3,3,6,6,3,3,3,4,0,0,3,2,1,6.0,21.0,-15.0,4
6448,6448,2007-08,2007,2008,Everton,Chelsea,Draw,Away,2007-11-11,1,6,6,6,9,6,9,12,13,0,-3,-6,-4,0,6.0,2.0,4.0,4
6449,6449,2007-08,2007,2008,Everton,Sunderland,Win,Home,2007-11-24,3,4,7,7,7,1,2,2,2,3,5,5,5,1,6.0,21.0,-15.0,4
6450,6450,2007-08,2007,2008,Everton,Portsmouth,Draw,Away,2007-12-01,1,4,7,10,10,4,7,8,11,0,0,2,-1,0,6.0,9.0,-3.0,5
6451,6451,2007-08,2007,2008,Everton,Fulham,Win,Home,2007-12-08,3,4,5,8,11,1,1,4,5,3,4,4,6,1,6.0,16.0,-10.0,5
6452,6452,2007-08,2007,2008,Everton,West Ham,Win,Away,2007-12-15,3,4,7,8,11,3,4,7,8,1,3,1,3,0,6.0,15.0,-9.0,5
6453,6453,2007-08,2007,2008,Everton,Man United,Loss,Away,2007-12-23,0,6,7,10,11,6,9,9,12,0,-2,1,-1,0,6.0,1.0,5.0,5
6454,6454,2007-08,2007,2008,Everton,Bolton,Win,Home,2007-12-26,3,3,6,7,10,3,6,6,9,0,0,1,1,1,6.0,7.0,-1.0,5
6455,6455,2007-08,2007,2008,Everton,Arsenal,Loss,Home,2007-12-29,0,3,6,9,10,4,7,7,8,-1,-1,2,2,1,6.0,4.0,2.0,5
6456,6456,2007-08,2007,2008,Everton,Middlesbrough,Win,Away,2008-01-01,3,3,3,6,9,3,3,6,9,0,0,0,0,0,6.0,12.0,-6.0,6
6457,6457,2007-08,2007,2008,Everton,Man City,Win,Home,2008-01-12,3,3,6,6,9,4,5,6,9,-1,1,0,0,1,6.0,14.0,-8.0,6
6458,6458,2007-08,2007,2008,Everton,Wigan,Win,Away,2008-01-20,3,6,6,9,9,4,4,7,8,2,2,2,1,0,6.0,17.0,-11.0,6
6459,6459,2007-08,2007,2008,Everton,Tottenham,Draw,Home,2008-01-30,1,6,9,9,12,3,3,6,9,3,6,3,3,1,6.0,5.0,1.0,6
6460,6460,2007-08,2007,2008,Everton,Blackburn,Draw,Away,2008-02-02,1,4,7,10,10,2,5,8,11,2,2,2,-1,0,6.0,10.0,-4.0,7
6461,6461,2007-08,2007,2008,Everton,Reading,Win,Home,2008-02-09,3,2,5,8,11,0,0,0,0,2,5,8,11,1,6.0,8.0,-2.0,7
6462,6462,2007-08,2007,2008,Everton,Man City,Win,Away,2008-02-25,3,4,5,8,11,3,4,5,5,1,1,3,6,0,6.0,14.0,-8.0,7
6463,6463,2007-08,2007,2008,Everton,Portsmouth,Win,Home,2008-03-02,3,6,7,8,11,6,7,7,10,0,0,1,1,1,6.0,9.0,-3.0,8
6464,6464,2007-08,2007,2008,Everton,Sunderland,Win,Away,2008-03-09,3,6,9,10,11,1,4,4,7,5,5,6,4,0,6.0,21.0,-15.0,8
6465,6465,2007-08,2007,2008,Everton,Fulham,Loss,Away,2008-03-16,0,6,9,12,13,1,1,1,4,5,8,11,9,0,6.0,16.0,-10.0,8
6466,6466,2007-08,2007,2008,Everton,West Ham,Draw,Home,2008-03-22,1,3,6,9,12,3,3,3,6,0,3,6,6,1,6.0,15.0,-9.0,8
6467,6467,2007-08,2007,2008,Everton,Liverpool,Loss,Away,2008-03-30,0,1,4,7,10,3,6,9,12,-2,-2,-2,-2,0,6.0,3.0,3.0,8
6468,6468,2007-08,2007,2008,Everton,Derby,Win,Home,2008-04-06,3,1,1,4,7,1,1,1,2,0,0,3,5,1,6.0,21.0,-15.0,9
6469,6469,2007-08,2007,2008,Everton,Birmingham,Draw,Away,2008-04-12,1,3,4,4,7,3,3,4,4,0,1,0,3,0,6.0,21.0,-15.0,9
6470,6470,2007-08,2007,2008,Everton,Chelsea,Loss,Home,2008-04-17,0,4,4,5,5,4,7,10,11,0,-3,-5,-6,1,6.0,2.0,4.0,9
6471,6471,2007-08,2007,2008,Everton,Aston Villa,Draw,Home,2008-04-27,1,1,4,4,5,6,9,9,9,-5,-5,-5,-4,1,6.0,11.0,-5.0,9
6472,6472,2007-08,2007,2008,Everton,Arsenal,Loss,Away,2008-05-04,0,1,2,5,5,6,6,7,10,-5,-4,-2,-5,0,6.0,4.0,2.0,10
6473,6473,2007-08,2007,2008,Everton,Newcastle,Win,Home,2008-05-11,3,1,1,2,5,1,4,5,8,0,-3,-3,-3,1,6.0,13.0,-7.0,10
6474,6474,2008-09,2008,2009,Everton,Blackburn,Loss,Home,2008-08-16,0,3,4,4,5,3,6,7,7,0,-2,-3,-2,1,5.0,7.0,-2.0,1
6475,6475,2008-09,2008,2009,Everton,West Brom,Win,Away,2008-08-23,3,3,3,4,4,1,1,1,2,2,2,3,2,0,5.0,21.0,-16.0,1
6476,6476,2008-09,2008,2009,Everton,Portsmouth,Loss,Home,2008-08-30,0,3,6,6,7,0,0,0,0,3,6,6,7,1,5.0,8.0,-3.0,1
6477,6477,2008-09,2008,2009,Everton,Stoke,Win,Away,2008-09-14,3,3,3,6,6,3,3,3,3,0,0,3,3,0,5.0,21.0,-16.0,2
6478,6478,2008-09,2008,2009,Everton,Hull,Draw,Away,2008-09-21,1,3,6,6,9,3,4,7,7,0,2,-1,2,0,5.0,21.0,-16.0,2
6479,6479,2008-09,2008,2009,Everton,Liverpool,Loss,Home,2008-09-27,0,4,4,7,7,4,5,8,11,0,-1,-1,-4,1,5.0,4.0,1.0,2
6480,6480,2008-09,2008,2009,Everton,Newcastle,Draw,Home,2008-10-05,1,1,4,4,7,0,0,0,3,1,4,4,4,1,5.0,12.0,-7.0,3
6481,6481,2008-09,2008,2009,Everton,Arsenal,Loss,Away,2008-10-18,0,1,2,5,5,1,4,7,10,0,-2,-2,-5,0,5.0,3.0,2.0,3
6482,6482,2008-09,2008,2009,Everton,Man United,Draw,Home,2008-10-25,1,1,1,2,5,6,9,10,10,-5,-8,-8,-5,1,5.0,1.0,4.0,3
6483,6483,2008-09,2008,2009,Everton,Bolton,Win,Away,2008-10-29,3,1,2,2,3,1,4,4,4,0,-2,-2,-1,0,5.0,16.0,-11.0,3
6484,6484,2008-09,2008,2009,Everton,Fulham,Win,Home,2008-11-01,3,4,4,5,5,4,5,5,5,0,-1,0,0,1,5.0,17.0,-12.0,4
6485,6485,2008-09,2008,2009,Everton,West Ham,Win,Away,2008-11-08,3,6,7,7,8,1,1,1,1,5,6,6,7,0,5.0,10.0,-5.0,4
6486,6486,2008-09,2008,2009,Everton,Middlesbrough,Draw,Home,2008-11-16,1,6,9,10,10,4,7,8,8,2,2,2,2,1,5.0,13.0,-8.0,4
6487,6487,2008-09,2008,2009,Everton,Wigan,Loss,Away,2008-11-24,0,4,7,10,11,2,5,5,5,2,2,5,6,0,5.0,14.0,-9.0,4
6488,6488,2008-09,2008,2009,Everton,Tottenham,Win,Away,2008-11-30,3,1,4,7,10,3,6,9,10,-2,-2,-2,0,0,5.0,11.0,-6.0,4
6489,6489,2008-09,2008,2009,Everton,Aston Villa,Loss,Home,2008-12-07,0,3,4,7,10,2,5,5,5,1,-1,2,5,1,5.0,6.0,-1.0,5
6490,6490,2008-09,2008,2009,Everton,Man City,Win,Away,2008-12-13,3,3,3,4,7,1,4,5,5,2,-1,-1,2,0,5.0,9.0,-4.0,5
6491,6491,2008-09,2008,2009,Everton,Chelsea,Draw,Home,2008-12-22,1,3,6,6,7,4,4,5,8,-1,2,1,-1,1,5.0,2.0,3.0,5
6492,6492,2008-09,2008,2009,Everton,Middlesbrough,Win,Away,2008-12-26,3,4,4,7,7,1,1,2,2,3,3,5,5,0,5.0,13.0,-8.0,5
6493,6493,2008-09,2008,2009,Everton,Sunderland,Win,Home,2008-12-28,3,4,7,7,10,4,7,7,7,0,0,0,3,1,5.0,15.0,-10.0,5
6494,6494,2008-09,2008,2009,Everton,Hull,Win,Home,2009-01-10,3,6,7,10,10,0,0,1,4,6,7,9,6,1,5.0,21.0,-16.0,6
6495,6495,2008-09,2008,2009,Everton,Liverpool,Draw,Away,2009-01-19,1,6,9,10,13,4,7,8,9,2,2,2,4,0,5.0,4.0,1.0,6
6496,6496,2008-09,2008,2009,Everton,Arsenal,Draw,Home,2009-01-28,1,4,7,10,11,6,9,10,11,-2,-2,0,0,1,5.0,3.0,2.0,6
6497,6497,2008-09,2008,2009,Everton,Man United,Loss,Away,2009-01-31,0,2,5,8,11,6,9,12,15,-4,-4,-4,-4,0,5.0,1.0,4.0,6
6498,6498,2008-09,2008,2009,Everton,Bolton,Win,Home,2009-02-07,3,1,2,5,8,4,4,4,4,-3,-2,1,4,1,5.0,16.0,-11.0,7
6499,6499,2008-09,2008,2009,Everton,Newcastle,Draw,Away,2009-02-22,1,3,4,5,8,4,4,4,5,-1,0,1,3,0,5.0,12.0,-7.0,7
6500,6500,2008-09,2008,2009,Everton,West Brom,Win,Home,2009-02-28,3,4,4,5,6,0,1,1,4,4,3,4,2,1,5.0,21.0,-16.0,7
6501,6501,2008-09,2008,2009,Everton,Blackburn,Draw,Away,2009-03-04,1,4,7,7,8,3,3,4,5,1,4,3,3,0,5.0,7.0,-2.0,8
6502,6502,2008-09,2008,2009,Everton,Stoke,Win,Home,2009-03-14,3,4,5,8,8,4,5,5,8,0,0,3,0,1,5.0,21.0,-16.0,8
6503,6503,2008-09,2008,2009,Everton,Portsmouth,Loss,Away,2009-03-21,0,4,7,8,11,1,2,5,5,3,5,3,6,0,5.0,8.0,-3.0,8
6504,6504,2008-09,2008,2009,Everton,Wigan,Win,Home,2009-04-05,3,3,4,7,8,6,6,6,7,-3,-2,1,1,1,5.0,14.0,-9.0,9
6505,6505,2008-09,2008,2009,Everton,Aston Villa,Draw,Away,2009-04-12,1,3,6,7,10,0,0,0,1,3,6,7,9,0,5.0,6.0,-1.0,9
6506,6506,2008-09,2008,2009,Everton,Chelsea,Draw,Away,2009-04-22,1,4,4,7,8,6,6,9,12,-2,-2,-2,-4,0,5.0,2.0,3.0,9
6507,6507,2008-09,2008,2009,Everton,Man City,Loss,Home,2009-04-25,0,2,5,5,8,3,3,6,6,-1,2,-1,2,1,5.0,9.0,-4.0,9
6508,6508,2008-09,2008,2009,Everton,Sunderland,Win,Away,2009-05-03,3,1,2,5,5,3,3,3,3,-2,-1,2,2,0,5.0,15.0,-10.0,10
6509,6509,2008-09,2008,2009,Everton,Tottenham,Draw,Home,2009-05-09,1,3,4,5,8,3,6,9,9,0,-2,-4,-1,1,5.0,11.0,-6.0,10
6510,6510,2008-09,2008,2009,Everton,West Ham,Win,Home,2009-05-16,3,4,4,5,6,3,3,4,4,1,1,1,2,1,5.0,10.0,-5.0,10
6511,6511,2008-09,2008,2009,Everton,Fulham,Win,Away,2009-05-24,3,4,7,7,8,6,6,9,10,-2,1,-2,-2,0,5.0,17.0,-12.0,10
6512,6512,2009-10,2009,2010,Everton,Arsenal,Loss,Home,2009-08-15,0,6,7,10,10,4,4,7,10,2,3,3,0,1,5.0,4.0,1.0,1
6513,6513,2009-10,2009,2010,Everton,Burnley,Loss,Away,2009-08-23,0,3,6,7,10,3,3,3,3,0,3,4,7,0,5.0,21.0,-16.0,1
6514,6514,2009-10,2009,2010,Everton,Wigan,Win,Home,2009-08-30,3,0,3,6,7,0,3,6,6,0,0,0,1,1,5.0,11.0,-6.0,1
6515,6515,2009-10,2009,2010,Everton,Fulham,Loss,Away,2009-09-13,0,3,3,6,9,0,3,3,6,3,0,3,3,0,5.0,7.0,-2.0,2
6516,6516,2009-10,2009,2010,Everton,Blackburn,Win,Home,2009-09-20,3,3,3,3,6,4,4,4,5,-1,-1,-1,1,1,5.0,15.0,-10.0,2
6517,6517,2009-10,2009,2010,Everton,Portsmouth,Win,Away,2009-09-26,3,3,6,6,6,0,0,0,0,3,6,6,6,0,5.0,14.0,-9.0,2
6518,6518,2009-10,2009,2010,Everton,Stoke,Draw,Home,2009-10-04,1,6,6,9,9,1,1,4,5,5,5,5,4,1,5.0,12.0,-7.0,3
6519,6519,2009-10,2009,2010,Everton,Wolves,Draw,Home,2009-10-17,1,4,7,7,10,0,3,3,4,4,4,4,6,1,5.0,21.0,-16.0,3
6520,6520,2009-10,2009,2010,Everton,Bolton,Loss,Away,2009-10-25,0,2,5,8,8,1,4,5,8,1,1,3,0,0,5.0,13.0,-8.0,3
6521,6521,2009-10,2009,2010,Everton,Aston Villa,Draw,Home,2009-10-31,1,1,2,5,8,4,5,5,8,-3,-3,0,0,1,5.0,6.0,-1.0,3
6522,6522,2009-10,2009,2010,Everton,West Ham,Win,Away,2009-11-08,3,1,2,3,6,4,5,5,6,-3,-3,-2,0,0,5.0,9.0,-4.0,4
6523,6523,2009-10,2009,2010,Everton,Man United,Loss,Away,2009-11-21,0,4,4,5,6,3,3,6,7,1,1,-1,-1,0,5.0,1.0,4.0,4
6524,6524,2009-10,2009,2010,Everton,Hull,Loss,Away,2009-11-25,0,3,4,4,5,4,4,5,5,-1,0,-1,0,0,5.0,17.0,-12.0,4
6525,6525,2009-10,2009,2010,Everton,Liverpool,Loss,Home,2009-11-29,0,0,3,4,4,2,2,5,5,-2,1,-1,-1,1,5.0,2.0,3.0,4
6526,6526,2009-10,2009,2010,Everton,Tottenham,Draw,Home,2009-12-06,1,0,0,3,4,4,7,7,7,-4,-7,-4,-3,1,5.0,8.0,-3.0,5
6527,6527,2009-10,2009,2010,Everton,Chelsea,Draw,Away,2009-12-12,1,1,1,1,4,3,6,9,12,-2,-5,-8,-8,0,5.0,3.0,2.0,5
6528,6528,2009-10,2009,2010,Everton,Birmingham,Draw,Home,2009-12-20,1,2,2,2,2,6,9,12,15,-4,-7,-10,-13,1,5.0,21.0,-16.0,5
6529,6529,2009-10,2009,2010,Everton,Sunderland,Draw,Away,2009-12-26,1,2,3,3,3,0,1,1,1,2,2,2,2,0,5.0,16.0,-11.0,5
6530,6530,2009-10,2009,2010,Everton,Burnley,Win,Home,2009-12-28,3,2,3,4,4,1,2,3,3,1,1,1,1,1,5.0,21.0,-16.0,5
6531,6531,2009-10,2009,2010,Everton,Arsenal,Draw,Away,2010-01-09,1,4,5,6,7,6,9,10,13,-2,-4,-4,-6,0,5.0,4.0,1.0,6
6532,6532,2009-10,2009,2010,Everton,Man City,Win,Home,2010-01-16,3,4,5,6,7,6,9,12,12,-2,-4,-6,-5,1,5.0,10.0,-5.0,6
6533,6533,2009-10,2009,2010,Everton,Sunderland,Win,Home,2010-01-27,3,4,7,8,9,1,2,2,2,3,5,6,7,1,5.0,16.0,-11.0,6
6534,6534,2009-10,2009,2010,Everton,Wigan,Win,Away,2010-01-30,3,6,7,10,11,3,3,4,4,3,4,6,7,0,5.0,11.0,-6.0,6
6535,6535,2009-10,2009,2010,Everton,Liverpool,Loss,Away,2010-02-06,0,6,9,10,13,4,7,8,11,2,2,2,2,0,5.0,2.0,3.0,7
6536,6536,2009-10,2009,2010,Everton,Chelsea,Win,Home,2010-02-10,3,3,6,9,10,4,7,10,13,-1,-1,-1,-3,1,5.0,3.0,2.0,7
6537,6537,2009-10,2009,2010,Everton,Man United,Win,Home,2010-02-20,3,3,6,9,12,4,7,10,13,-1,-1,-1,-1,1,5.0,1.0,4.0,7
6538,6538,2009-10,2009,2010,Everton,Tottenham,Loss,Away,2010-02-28,0,6,6,9,12,3,4,5,8,3,2,4,4,0,5.0,8.0,-3.0,7
6539,6539,2009-10,2009,2010,Everton,Hull,Win,Home,2010-03-07,3,3,6,6,9,0,3,4,5,3,3,2,4,1,5.0,17.0,-12.0,8
6540,6540,2009-10,2009,2010,Everton,Birmingham,Draw,Away,2010-03-13,1,3,6,9,9,6,6,6,9,-3,0,3,0,0,5.0,21.0,-16.0,8
6541,6541,2009-10,2009,2010,Everton,Bolton,Win,Home,2010-03-20,3,4,4,7,10,3,6,9,9,1,-2,-2,1,1,5.0,13.0,-8.0,8
6542,6542,2009-10,2009,2010,Everton,Man City,Win,Away,2010-03-24,3,4,7,7,10,4,7,8,9,0,0,-1,1,0,5.0,10.0,-5.0,8
6543,6543,2009-10,2009,2010,Everton,Wolves,Draw,Away,2010-03-27,1,6,7,10,10,4,7,7,7,2,0,3,3,0,5.0,21.0,-16.0,8
6544,6544,2009-10,2009,2010,Everton,West Ham,Draw,Home,2010-04-04,1,4,7,8,11,0,0,0,0,4,7,8,11,1,5.0,9.0,-4.0,9
6545,6545,2009-10,2009,2010,Everton,Aston Villa,Draw,Away,2010-04-14,1,2,5,8,9,3,4,5,8,-1,1,3,1,0,5.0,6.0,-1.0,9
6546,6546,2009-10,2009,2010,Everton,Blackburn,Win,Away,2010-04-17,3,2,3,6,9,2,5,8,9,0,-2,-2,0,0,5.0,15.0,-10.0,9
6547,6547,2009-10,2009,2010,Everton,Fulham,Win,Home,2010-04-25,3,4,5,6,9,2,5,5,5,2,0,1,4,1,5.0,7.0,-2.0,9
6548,6548,2009-10,2009,2010,Everton,Stoke,Draw,Away,2010-05-01,1,6,7,8,9,0,1,4,7,6,6,4,2,0,5.0,12.0,-7.0,10
6549,6549,2009-10,2009,2010,Everton,Portsmouth,Win,Home,2010-05-09,3,4,7,8,9,4,4,5,6,0,3,3,3,1,5.0,14.0,-9.0,10
6550,6550,2010-11,2010,2011,Everton,Blackburn,Loss,Away,2010-08-14,0,4,7,10,11,6,7,7,8,-2,0,3,3,0,8.0,10.0,-2.0,1
6551,6551,2010-11,2010,2011,Everton,Wolves,Draw,Home,2010-08-21,1,3,4,7,10,6,6,7,8,-3,-2,0,2,1,8.0,15.0,-7.0,1
6552,6552,2010-11,2010,2011,Everton,Aston Villa,Loss,Away,2010-08-29,0,1,4,5,8,3,3,3,6,-2,1,2,2,0,8.0,6.0,2.0,1
6553,6553,2010-11,2010,2011,Everton,Man United,Draw,Home,2010-09-11,1,1,1,4,5,4,7,10,13,-3,-6,-6,-8,1,8.0,2.0,6.0,2
6554,6554,2010-11,2010,2011,Everton,Newcastle,Loss,Home,2010-09-18,0,1,2,2,5,1,4,4,4,0,-2,-2,1,1,8.0,21.0,-13.0,2
6555,6555,2010-11,2010,2011,Everton,Fulham,Draw,Away,2010-09-25,1,1,1,2,2,4,5,6,7,-3,-4,-4,-5,0,8.0,12.0,-4.0,2
6556,6556,2010-11,2010,2011,Everton,Birmingham,Win,Away,2010-10-02,3,1,2,2,3,1,2,3,6,0,0,-1,-3,0,8.0,9.0,-1.0,3
6557,6557,2010-11,2010,2011,Everton,Liverpool,Win,Home,2010-10-17,3,4,4,5,5,1,1,2,5,3,3,3,0,1,8.0,7.0,1.0,3
6558,6558,2010-11,2010,2011,Everton,Tottenham,Draw,Away,2010-10-23,1,6,7,7,8,6,6,9,10,0,1,-2,-2,0,8.0,4.0,4.0,3
6559,6559,2010-11,2010,2011,Everton,Stoke,Win,Home,2010-10-30,3,4,7,8,8,0,3,6,7,4,4,2,1,1,8.0,11.0,-3.0,3
6560,6560,2010-11,2010,2011,Everton,Blackpool,Draw,Away,2010-11-06,1,4,7,10,11,3,3,6,6,1,4,4,5,0,8.0,21.0,-13.0,4
6561,6561,2010-11,2010,2011,Everton,Bolton,Draw,Home,2010-11-10,1,4,5,8,11,3,4,7,8,1,1,1,3,1,8.0,14.0,-6.0,4
6562,6562,2010-11,2010,2011,Everton,Arsenal,Loss,Home,2010-11-14,0,2,5,6,9,3,6,9,12,-1,-1,-3,-3,1,8.0,3.0,5.0,4
6563,6563,2010-11,2010,2011,Everton,Sunderland,Draw,Away,2010-11-22,1,1,2,5,6,4,7,7,10,-3,-5,-2,-4,0,8.0,13.0,-5.0,4
6564,6564,2010-11,2010,2011,Everton,West Brom,Loss,Home,2010-11-27,0,1,2,3,6,0,1,1,1,1,1,2,5,1,8.0,21.0,-13.0,4
6565,6565,2010-11,2010,2011,Everton,Chelsea,Draw,Away,2010-12-04,1,1,1,2,3,1,1,4,4,0,0,-2,-1,0,8.0,1.0,7.0,5
6566,6566,2010-11,2010,2011,Everton,Wigan,Draw,Home,2010-12-11,1,1,2,2,3,1,1,4,5,0,1,-2,-2,1,8.0,16.0,-8.0,5
6567,6567,2010-11,2010,2011,Everton,Man City,Win,Away,2010-12-20,3,2,2,3,3,6,7,10,11,-4,-5,-7,-8,0,8.0,5.0,3.0,5
6568,6568,2010-11,2010,2011,Everton,West Ham,Draw,Away,2010-12-28,1,4,5,5,6,4,4,4,7,0,1,1,-1,0,8.0,17.0,-9.0,5
6569,6569,2010-11,2010,2011,Everton,Stoke,Loss,Away,2011-01-01,0,4,5,6,6,3,3,4,5,1,2,2,1,0,8.0,11.0,-3.0,6
6570,6570,2010-11,2010,2011,Everton,Tottenham,Win,Home,2011-01-05,3,1,4,5,6,6,9,10,11,-5,-5,-5,-5,1,8.0,4.0,4.0,6
6571,6571,2010-11,2010,2011,Everton,Liverpool,Draw,Away,2011-01-16,1,3,4,7,8,0,3,3,3,3,1,4,5,0,8.0,7.0,1.0,6
6572,6572,2010-11,2010,2011,Everton,West Ham,Draw,Home,2011-01-22,1,4,4,5,8,0,3,4,7,4,1,1,1,1,8.0,17.0,-9.0,6
6573,6573,2010-11,2010,2011,Everton,Arsenal,Loss,Away,2011-02-01,0,2,5,5,6,6,7,10,11,-4,-2,-5,-5,0,8.0,3.0,5.0,7
6574,6574,2010-11,2010,2011,Everton,Blackpool,Win,Home,2011-02-05,3,1,2,5,5,0,0,0,3,1,2,5,2,1,8.0,21.0,-13.0,7
6575,6575,2010-11,2010,2011,Everton,Bolton,Loss,Away,2011-02-13,0,3,4,5,8,3,3,3,4,0,1,2,4,0,8.0,14.0,-6.0,7
6576,6576,2010-11,2010,2011,Everton,Sunderland,Win,Home,2011-02-26,3,3,3,4,5,0,0,3,4,3,3,1,1,1,8.0,13.0,-5.0,7
6577,6577,2010-11,2010,2011,Everton,Newcastle,Win,Away,2011-03-05,3,3,6,6,7,4,5,6,6,-1,1,0,1,0,8.0,21.0,-13.0,8
6578,6578,2010-11,2010,2011,Everton,Birmingham,Draw,Home,2011-03-09,1,6,6,9,9,0,3,6,7,6,3,3,2,1,8.0,9.0,-1.0,8
6579,6579,2010-11,2010,2011,Everton,Fulham,Win,Home,2011-03-19,3,4,7,7,10,4,5,6,9,0,2,1,1,1,8.0,12.0,-4.0,8
6580,6580,2010-11,2010,2011,Everton,Aston Villa,Draw,Home,2011-04-02,1,4,7,10,10,0,3,4,5,4,4,6,5,1,8.0,6.0,2.0,9
6581,6581,2010-11,2010,2011,Everton,Wolves,Win,Away,2011-04-09,3,4,5,8,11,3,4,7,8,1,1,1,3,0,8.0,15.0,-7.0,9
6582,6582,2010-11,2010,2011,Everton,Blackburn,Win,Home,2011-04-16,3,4,7,8,11,2,3,3,3,2,4,5,8,1,8.0,10.0,-2.0,9
6583,6583,2010-11,2010,2011,Everton,Man United,Loss,Away,2011-04-23,0,6,7,10,11,4,7,10,10,2,0,0,1,0,8.0,2.0,6.0,9
6584,6584,2010-11,2010,2011,Everton,Wigan,Draw,Away,2011-04-30,1,3,6,7,10,3,3,4,7,0,3,3,3,0,8.0,16.0,-8.0,9
6585,6585,2010-11,2010,2011,Everton,Man City,Win,Home,2011-05-07,3,1,4,7,8,6,6,9,9,-5,-2,-2,-1,1,8.0,5.0,3.0,10
6586,6586,2010-11,2010,2011,Everton,West Brom,Loss,Away,2011-05-14,0,4,4,7,10,3,4,4,7,1,0,3,3,0,8.0,21.0,-13.0,10
6587,6587,2010-11,2010,2011,Everton,Chelsea,Win,Home,2011-05-22,3,3,4,4,7,1,4,7,10,2,0,-3,-3,1,8.0,1.0,7.0,10
6588,6588,2011-12,2011,2012,Everton,QPR,Loss,Home,2011-08-20,0,3,6,7,7,0,3,3,6,3,3,4,1,1,7.0,21.0,-14.0,1
6589,6589,2011-12,2011,2012,Everton,Blackburn,Win,Away,2011-08-27,3,3,3,6,7,0,3,4,5,3,0,2,2,0,7.0,15.0,-8.0,1
6590,6590,2011-12,2011,2012,Everton,Aston Villa,Draw,Home,2011-09-10,1,3,6,6,9,4,5,8,11,-1,1,-2,-2,1,7.0,9.0,-2.0,2
6591,6591,2011-12,2011,2012,Everton,Wigan,Win,Home,2011-09-17,3,4,4,7,7,3,4,5,8,1,0,2,-1,1,7.0,16.0,-9.0,2
6592,6592,2011-12,2011,2012,Everton,Man City,Loss,Away,2011-09-24,0,4,7,7,10,4,7,10,13,0,0,-3,-3,0,7.0,3.0,4.0,2
6593,6593,2011-12,2011,2012,Everton,Liverpool,Loss,Home,2011-10-01,0,3,4,7,7,3,3,6,9,0,1,1,-2,1,7.0,6.0,1.0,3
6594,6594,2011-12,2011,2012,Everton,Chelsea,Loss,Away,2011-10-15,0,0,3,4,7,6,6,9,12,-6,-3,-5,-5,0,7.0,2.0,5.0,3
6595,6595,2011-12,2011,2012,Everton,Fulham,Win,Away,2011-10-23,3,0,0,3,4,3,4,5,6,-3,-4,-2,-2,0,7.0,8.0,-1.0,3
6596,6596,2011-12,2011,2012,Everton,Man United,Loss,Home,2011-10-29,0,3,3,3,6,1,4,5,8,2,-1,-2,-2,1,7.0,1.0,6.0,3
6597,6597,2011-12,2011,2012,Everton,Newcastle,Loss,Away,2011-11-05,0,3,3,3,3,6,7,10,13,-3,-4,-7,-10,0,7.0,12.0,-5.0,4
6598,6598,2011-12,2011,2012,Everton,Wolves,Win,Home,2011-11-19,3,0,3,3,3,3,4,4,4,-3,-1,-1,-1,1,7.0,17.0,-10.0,4
6599,6599,2011-12,2011,2012,Everton,Bolton,Win,Away,2011-11-26,3,3,3,6,6,3,3,3,6,0,0,3,0,0,7.0,14.0,-7.0,4
6600,6600,2011-12,2011,2012,Everton,Stoke,Loss,Home,2011-12-04,0,6,6,6,9,3,3,3,3,3,3,3,6,1,7.0,13.0,-6.0,5
6601,6601,2011-12,2011,2012,Everton,Arsenal,Loss,Away,2011-12-10,0,3,6,6,6,4,7,10,13,-1,-1,-4,-7,0,7.0,4.0,3.0,5
6602,6602,2011-12,2011,2012,Everton,Norwich,Draw,Home,2011-12-17,1,0,3,6,6,3,6,6,6,-3,-3,0,0,1,7.0,21.0,-14.0,5
6603,6603,2011-12,2011,2012,Everton,Swansea,Win,Home,2011-12-21,3,1,1,4,7,4,4,5,5,-3,-3,-1,2,1,7.0,21.0,-14.0,5
6604,6604,2011-12,2011,2012,Everton,Sunderland,Draw,Away,2011-12-26,1,4,4,4,7,3,6,6,6,1,-2,-2,1,0,7.0,10.0,-3.0,5
6605,6605,2011-12,2011,2012,Everton,West Brom,Win,Away,2012-01-01,3,4,5,5,5,4,7,7,8,0,-2,-2,-3,0,7.0,11.0,-4.0,6
6606,6606,2011-12,2011,2012,Everton,Bolton,Loss,Home,2012-01-04,0,4,7,8,8,1,4,4,4,3,3,4,4,1,7.0,14.0,-7.0,6
6607,6607,2011-12,2011,2012,Everton,Tottenham,Loss,Away,2012-01-11,0,3,4,7,8,4,7,8,11,-1,-3,-1,-3,0,7.0,5.0,2.0,6
6608,6608,2011-12,2011,2012,Everton,Aston Villa,Draw,Away,2012-01-14,1,0,3,4,7,3,4,4,4,-3,-1,0,3,0,7.0,9.0,-2.0,6
6609,6609,2011-12,2011,2012,Everton,Blackburn,Draw,Home,2012-01-21,1,1,1,4,5,3,6,7,7,-2,-5,-3,-2,1,7.0,15.0,-8.0,6
6610,6610,2011-12,2011,2012,Everton,Man City,Win,Home,2012-01-31,3,2,2,2,5,6,9,9,10,-4,-7,-7,-5,1,7.0,3.0,4.0,6
6611,6611,2011-12,2011,2012,Everton,Wigan,Draw,Away,2012-02-04,1,4,5,5,5,0,0,0,1,4,5,5,4,0,7.0,16.0,-9.0,7
6612,6612,2011-12,2011,2012,Everton,Chelsea,Win,Home,2012-02-11,3,4,5,6,6,2,3,6,9,2,2,0,-3,1,7.0,2.0,5.0,7
6613,6613,2011-12,2011,2012,Everton,QPR,Draw,Away,2012-03-03,1,4,7,8,9,0,0,1,4,4,7,7,5,0,7.0,21.0,-14.0,8
6614,6614,2011-12,2011,2012,Everton,Tottenham,Win,Home,2012-03-10,3,4,5,8,9,0,3,4,7,4,2,4,2,1,7.0,5.0,2.0,8
6615,6615,2011-12,2011,2012,Everton,Liverpool,Loss,Away,2012-03-13,0,4,7,8,11,0,0,1,4,4,7,7,7,0,7.0,6.0,1.0,8
6616,6616,2011-12,2011,2012,Everton,Arsenal,Loss,Home,2012-03-21,0,3,4,7,8,6,9,12,15,-3,-5,-5,-7,1,7.0,4.0,3.0,8
6617,6617,2011-12,2011,2012,Everton,Swansea,Win,Away,2012-03-24,3,0,3,4,7,6,9,9,9,-6,-6,-5,-2,0,7.0,21.0,-14.0,8
6618,6618,2011-12,2011,2012,Everton,West Brom,Win,Home,2012-03-31,3,3,3,6,7,1,1,4,7,2,2,2,0,1,7.0,11.0,-4.0,8
6619,6619,2011-12,2011,2012,Everton,Norwich,Draw,Away,2012-04-07,1,6,6,6,9,3,3,4,4,3,3,2,5,0,7.0,21.0,-14.0,9
6620,6620,2011-12,2011,2012,Everton,Sunderland,Win,Home,2012-04-09,3,4,7,7,7,2,5,5,8,2,2,2,-1,1,7.0,10.0,-3.0,9
6621,6621,2011-12,2011,2012,Everton,Man United,Draw,Away,2012-04-22,1,4,7,10,10,3,6,9,12,1,1,1,-2,0,7.0,1.0,6.0,9
6622,6622,2011-12,2011,2012,Everton,Fulham,Win,Home,2012-04-28,3,4,5,8,11,4,7,10,10,0,-2,-2,1,1,7.0,8.0,-1.0,9
6623,6623,2011-12,2011,2012,Everton,Stoke,Draw,Away,2012-05-01,1,4,7,8,11,1,2,5,5,3,5,3,6,0,7.0,13.0,-6.0,10
6624,6624,2011-12,2011,2012,Everton,Wolves,Draw,Away,2012-05-06,1,4,5,8,9,1,2,2,2,3,3,6,7,0,7.0,17.0,-10.0,10
6625,6625,2011-12,2011,2012,Everton,Newcastle,Win,Home,2012-05-13,3,2,5,6,9,3,3,6,9,-1,2,0,0,1,7.0,12.0,-5.0,10
6626,6626,2012-13,2012,2013,Everton,Man United,Win,Home,2012-08-20,3,4,5,8,9,6,6,7,10,-2,-1,1,-1,1,7.0,2.0,5.0,1
6627,6627,2012-13,2012,2013,Everton,Aston Villa,Win,Away,2012-08-25,3,6,7,8,11,0,1,2,2,6,6,6,9,0,7.0,16.0,-9.0,1
6628,6628,2012-13,2012,2013,Everton,West Brom,Loss,Away,2012-09-01,0,6,9,10,11,4,4,5,6,2,5,5,5,0,7.0,10.0,-3.0,2
6629,6629,2012-13,2012,2013,Everton,Newcastle,Draw,Home,2012-09-17,1,3,6,9,10,1,4,4,4,2,2,5,6,1,7.0,5.0,2.0,2
6630,6630,2012-13,2012,2013,Everton,Swansea,Win,Away,2012-09-22,3,1,4,7,10,1,4,7,10,0,0,0,0,0,7.0,11.0,-4.0,2
6631,6631,2012-13,2012,2013,Everton,Southampton,Win,Home,2012-09-29,3,4,4,7,10,3,3,3,3,1,1,4,7,1,7.0,21.0,-14.0,2
6632,6632,2012-13,2012,2013,Everton,Wigan,Draw,Away,2012-10-06,1,6,7,7,10,0,0,1,4,6,7,6,6,0,7.0,15.0,-8.0,3
6633,6633,2012-13,2012,2013,Everton,QPR,Draw,Away,2012-10-21,1,4,7,8,8,0,0,1,1,4,7,7,7,0,7.0,17.0,-10.0,3
6634,6634,2012-13,2012,2013,Everton,Liverpool,Draw,Home,2012-10-28,1,2,5,8,9,4,7,7,8,-2,-2,1,1,1,7.0,8.0,-1.0,3
6635,6635,2012-13,2012,2013,Everton,Fulham,Draw,Away,2012-11-03,1,2,3,6,9,4,5,5,8,-2,-2,1,1,0,7.0,9.0,-2.0,4
6636,6636,2012-13,2012,2013,Everton,Sunderland,Win,Home,2012-11-10,3,2,3,4,7,1,2,2,5,1,1,2,2,1,7.0,13.0,-6.0,4
6637,6637,2012-13,2012,2013,Everton,Reading,Loss,Away,2012-11-17,0,4,5,6,7,2,3,3,4,2,2,3,3,0,7.0,21.0,-14.0,4
6638,6638,2012-13,2012,2013,Everton,Norwich,Draw,Home,2012-11-24,1,3,4,5,6,4,7,8,11,-1,-3,-3,-5,1,7.0,12.0,-5.0,4
6639,6639,2012-13,2012,2013,Everton,Arsenal,Draw,Home,2012-11-28,1,1,4,5,6,4,5,5,8,-3,-1,0,-2,1,7.0,3.0,4.0,4
6640,6640,2012-13,2012,2013,Everton,Man City,Draw,Away,2012-12-01,1,2,2,5,6,4,7,10,11,-2,-5,-5,-5,0,7.0,1.0,6.0,5
6641,6641,2012-13,2012,2013,Everton,Tottenham,Win,Home,2012-12-09,3,2,3,3,6,6,9,9,9,-4,-6,-6,-3,1,7.0,4.0,3.0,5
6642,6642,2012-13,2012,2013,Everton,Stoke,Draw,Away,2012-12-15,1,4,5,6,6,4,7,10,11,0,-2,-4,-5,0,7.0,14.0,-7.0,5
6643,6643,2012-13,2012,2013,Everton,West Ham,Win,Away,2012-12-22,3,4,5,6,7,1,4,4,4,3,1,2,3,0,7.0,21.0,-14.0,5
6644,6644,2012-13,2012,2013,Everton,Wigan,Win,Home,2012-12-26,3,4,7,8,9,0,1,1,1,4,6,7,8,1,7.0,15.0,-8.0,5
6645,6645,2012-13,2012,2013,Everton,Chelsea,Loss,Home,2012-12-30,0,6,7,10,11,6,9,9,10,0,-2,1,1,1,7.0,6.0,1.0,5
6646,6646,2012-13,2012,2013,Everton,Newcastle,Win,Away,2013-01-02,3,3,6,7,10,0,3,3,3,3,3,4,7,0,7.0,5.0,2.0,6
6647,6647,2012-13,2012,2013,Everton,Swansea,Draw,Home,2013-01-12,1,3,6,9,10,4,5,6,6,-1,1,3,4,1,7.0,11.0,-4.0,6
6648,6648,2012-13,2012,2013,Everton,Southampton,Draw,Away,2013-01-21,1,4,4,7,10,4,5,6,7,0,-1,1,3,0,7.0,21.0,-14.0,6
6649,6649,2012-13,2012,2013,Everton,West Brom,Win,Home,2013-01-30,3,2,5,5,8,1,1,1,4,1,4,4,4,1,7.0,10.0,-3.0,6
6650,6650,2012-13,2012,2013,Everton,Aston Villa,Draw,Home,2013-02-02,1,4,5,8,8,1,1,2,2,3,4,6,6,1,7.0,16.0,-9.0,7
6651,6651,2012-13,2012,2013,Everton,Man United,Loss,Away,2013-02-10,0,4,5,6,9,6,7,10,13,-2,-2,-4,-4,0,7.0,2.0,5.0,7
6652,6652,2012-13,2012,2013,Everton,Norwich,Loss,Away,2013-02-23,0,1,4,5,6,2,3,3,4,-1,1,2,2,0,7.0,12.0,-5.0,7
6653,6653,2012-13,2012,2013,Everton,Reading,Win,Home,2013-03-02,3,0,1,4,5,0,3,4,7,0,-2,0,-2,1,7.0,21.0,-14.0,8
6654,6654,2012-13,2012,2013,Everton,Man City,Win,Home,2013-03-16,3,3,3,4,7,6,6,7,8,-3,-3,-3,-1,1,7.0,1.0,6.0,8
6655,6655,2012-13,2012,2013,Everton,Stoke,Win,Home,2013-03-30,3,6,6,6,7,1,1,1,4,5,5,5,3,1,7.0,14.0,-7.0,8
6656,6656,2012-13,2012,2013,Everton,Tottenham,Draw,Away,2013-04-07,1,6,9,9,9,3,3,6,9,3,6,3,0,0,7.0,4.0,3.0,9
6657,6657,2012-13,2012,2013,Everton,QPR,Win,Home,2013-04-13,3,4,7,10,10,1,1,4,7,3,6,6,3,1,7.0,17.0,-10.0,9
6658,6658,2012-13,2012,2013,Everton,Arsenal,Draw,Away,2013-04-16,1,4,7,10,13,6,9,12,12,-2,-2,-2,1,0,7.0,3.0,4.0,9
6659,6659,2012-13,2012,2013,Everton,Sunderland,Loss,Away,2013-04-20,0,4,5,8,11,3,3,4,4,1,2,4,7,0,7.0,13.0,-6.0,9
6660,6660,2012-13,2012,2013,Everton,Fulham,Win,Home,2013-04-27,3,1,4,5,8,0,1,1,4,1,3,4,4,1,7.0,9.0,-2.0,9
6661,6661,2012-13,2012,2013,Everton,Liverpool,Draw,Away,2013-05-05,1,3,4,7,8,4,5,6,9,-1,-1,1,-1,0,7.0,8.0,-1.0,10
6662,6662,2012-13,2012,2013,Everton,West Ham,Win,Home,2013-05-12,3,4,4,5,8,1,4,5,6,3,0,0,2,1,7.0,21.0,-14.0,10
6663,6663,2012-13,2012,2013,Everton,Chelsea,Loss,Away,2013-05-19,0,4,7,7,8,4,7,10,11,0,0,-3,-3,0,7.0,6.0,1.0,10
6664,6664,2013-14,2013,2014,Everton,Norwich,Draw,Away,2013-08-17,1,3,4,7,7,6,6,6,9,-3,-2,1,-2,0,6.0,11.0,-5.0,1
6665,6665,2013-14,2013,2014,Everton,West Brom,Draw,Home,2013-08-24,1,1,4,5,8,1,1,1,1,0,3,4,7,1,6.0,8.0,-2.0,1
6666,6666,2013-14,2013,2014,Everton,Cardiff,Draw,Away,2013-08-31,1,2,2,5,6,3,3,3,3,-1,-1,2,3,0,6.0,21.0,-15.0,1
6667,6667,2013-14,2013,2014,Everton,Chelsea,Win,Home,2013-09-14,3,2,3,3,6,4,7,10,13,-2,-4,-7,-7,1,6.0,3.0,3.0,2
6668,6668,2013-14,2013,2014,Everton,West Ham,Win,Away,2013-09-21,3,4,5,6,6,1,2,5,8,3,3,1,-2,0,6.0,10.0,-4.0,2
6669,6669,2013-14,2013,2014,Everton,Newcastle,Win,Home,2013-09-30,3,6,7,8,9,3,6,7,7,3,1,1,2,1,6.0,16.0,-10.0,2
6670,6670,2013-14,2013,2014,Everton,Man City,Loss,Away,2013-10-05,0,6,9,10,11,3,4,7,7,3,5,3,4,0,6.0,2.0,4.0,3
6671,6671,2013-14,2013,2014,Everton,Hull,Win,Home,2013-10-19,3,3,6,9,10,4,7,8,8,-1,-1,1,2,1,6.0,21.0,-15.0,3
6672,6672,2013-14,2013,2014,Everton,Aston Villa,Win,Away,2013-10-26,3,3,6,9,12,1,4,7,7,2,2,2,5,0,6.0,15.0,-9.0,3
6673,6673,2013-14,2013,2014,Everton,Tottenham,Draw,Home,2013-11-03,1,6,6,9,12,6,6,7,10,0,0,2,2,1,6.0,5.0,1.0,4
6674,6674,2013-14,2013,2014,Everton,Crystal Palace,Draw,Away,2013-11-09,1,4,7,7,10,0,0,0,0,4,7,7,10,0,6.0,21.0,-15.0,4
6675,6675,2013-14,2013,2014,Everton,Liverpool,Draw,Home,2013-11-23,1,2,5,8,8,3,6,7,10,-1,-1,1,-2,1,6.0,7.0,-1.0,4
6676,6676,2013-14,2013,2014,Everton,Stoke,Win,Home,2013-11-30,3,2,3,6,9,4,5,5,6,-2,-2,1,3,1,6.0,13.0,-7.0,4
6677,6677,2013-14,2013,2014,Everton,Man United,Win,Away,2013-12-04,3,4,5,6,9,2,5,8,11,2,0,-2,-2,0,6.0,1.0,5.0,5
6678,6678,2013-14,2013,2014,Everton,Arsenal,Draw,Away,2013-12-08,1,6,7,8,9,6,9,9,12,0,-2,-1,-3,0,6.0,4.0,2.0,5
6679,6679,2013-14,2013,2014,Everton,Fulham,Win,Home,2013-12-14,3,4,7,8,9,3,3,3,3,1,4,5,6,1,6.0,12.0,-6.0,5
6680,6680,2013-14,2013,2014,Everton,Swansea,Win,Away,2013-12-22,3,4,7,10,11,2,5,5,8,2,2,5,3,0,6.0,9.0,-3.0,5
6681,6681,2013-14,2013,2014,Everton,Sunderland,Loss,Home,2013-12-26,0,6,7,10,13,2,2,2,3,4,5,8,10,1,6.0,17.0,-11.0,5
6682,6682,2013-14,2013,2014,Everton,Southampton,Win,Home,2013-12-29,3,3,6,7,10,3,4,5,5,0,2,2,5,1,6.0,14.0,-8.0,5
6683,6683,2013-14,2013,2014,Everton,Stoke,Draw,Away,2014-01-01,1,3,6,9,10,0,3,4,7,3,3,5,3,0,6.0,13.0,-7.0,6
6684,6684,2013-14,2013,2014,Everton,Norwich,Win,Home,2014-01-11,3,4,4,7,10,1,1,2,3,3,3,5,7,1,6.0,11.0,-5.0,6
6685,6685,2013-14,2013,2014,Everton,West Brom,Draw,Away,2014-01-20,1,4,7,7,10,3,4,5,6,1,3,2,4,0,6.0,8.0,-2.0,6
6686,6686,2013-14,2013,2014,Everton,Liverpool,Loss,Away,2014-01-28,0,4,5,8,8,4,7,7,7,0,-2,1,1,0,6.0,7.0,-1.0,6
6687,6687,2013-14,2013,2014,Everton,Aston Villa,Win,Home,2014-02-01,3,1,4,5,8,4,4,7,8,-3,0,-2,0,1,6.0,15.0,-9.0,7
6688,6688,2013-14,2013,2014,Everton,Tottenham,Loss,Away,2014-02-09,0,3,4,7,8,1,4,7,10,2,0,0,-2,0,6.0,5.0,1.0,7
6689,6689,2013-14,2013,2014,Everton,Chelsea,Loss,Away,2014-02-22,0,3,3,4,7,4,7,8,11,-1,-4,-4,-4,0,6.0,3.0,3.0,7
6690,6690,2013-14,2013,2014,Everton,West Ham,Win,Home,2014-03-01,3,0,3,3,4,6,9,12,13,-6,-6,-9,-9,1,6.0,10.0,-4.0,8
6691,6691,2013-14,2013,2014,Everton,Cardiff,Win,Home,2014-03-15,3,3,3,6,6,3,3,4,4,0,0,2,2,1,6.0,21.0,-15.0,8
6692,6692,2013-14,2013,2014,Everton,Swansea,Win,Home,2014-03-22,3,6,6,6,9,1,1,2,5,5,5,4,4,1,6.0,9.0,-3.0,8
6693,6693,2013-14,2013,2014,Everton,Newcastle,Win,Away,2014-03-25,3,6,9,9,9,3,6,9,9,3,3,0,0,0,6.0,16.0,-10.0,8
6694,6694,2013-14,2013,2014,Everton,Fulham,Win,Away,2014-03-30,3,6,9,12,12,3,3,3,4,3,6,9,8,0,6.0,12.0,-6.0,8
6695,6695,2013-14,2013,2014,Everton,Arsenal,Win,Home,2014-04-06,3,6,9,12,15,2,2,5,5,4,7,7,10,1,6.0,4.0,2.0,9
6696,6696,2013-14,2013,2014,Everton,Sunderland,Win,Away,2014-04-12,3,6,9,12,15,0,0,0,1,6,9,12,14,0,6.0,17.0,-11.0,9
6697,6697,2013-14,2013,2014,Everton,Crystal Palace,Loss,Home,2014-04-16,0,6,9,12,15,6,9,9,10,0,0,3,5,1,6.0,21.0,-15.0,9
6698,6698,2013-14,2013,2014,Everton,Man United,Win,Home,2014-04-20,3,3,6,9,12,6,6,9,9,-3,0,0,3,1,6.0,1.0,5.0,9
6699,6699,2013-14,2013,2014,Everton,Southampton,Loss,Away,2014-04-26,0,3,6,9,12,1,1,4,4,2,5,5,8,0,6.0,14.0,-8.0,9
6700,6700,2013-14,2013,2014,Everton,Man City,Loss,Home,2014-05-03,0,3,3,6,9,6,7,7,10,-3,-4,-1,-1,1,6.0,2.0,4.0,10
6701,6701,2013-14,2013,2014,Everton,Hull,Win,Away,2014-05-11,3,0,3,3,6,0,1,1,4,0,2,2,2,0,6.0,21.0,-15.0,10
6702,6702,2014-15,2014,2015,Everton,Leicester,Draw,Away,2014-08-16,1,3,3,6,6,3,4,5,5,0,-1,1,1,0,5.0,21.0,-16.0,1
6703,6703,2014-15,2014,2015,Everton,Arsenal,Draw,Home,2014-08-23,1,4,4,4,7,6,9,12,15,-2,-5,-8,-8,1,5.0,4.0,1.0,1
6704,6704,2014-15,2014,2015,Everton,Chelsea,Loss,Home,2014-08-30,0,2,5,5,5,6,9,10,13,-4,-4,-5,-8,1,5.0,3.0,2.0,1
6705,6705,2014-15,2014,2015,Everton,West Brom,Win,Away,2014-09-13,3,1,2,5,5,1,2,2,2,0,0,3,3,0,5.0,17.0,-12.0,2
6706,6706,2014-15,2014,2015,Everton,Crystal Palace,Loss,Home,2014-09-21,0,3,4,5,8,2,2,2,3,1,2,3,5,1,5.0,11.0,-6.0,2
6707,6707,2014-15,2014,2015,Everton,Liverpool,Draw,Away,2014-09-27,1,3,3,4,5,0,3,3,6,3,0,1,-1,0,5.0,2.0,3.0,2
6708,6708,2014-15,2014,2015,Everton,Man United,Loss,Away,2014-10-05,0,1,4,4,5,3,6,7,8,-2,-2,-3,-3,0,5.0,7.0,-2.0,3
6709,6709,2014-15,2014,2015,Everton,Aston Villa,Win,Home,2014-10-18,3,1,1,4,4,0,0,3,6,1,1,1,-2,1,5.0,15.0,-10.0,3
6710,6710,2014-15,2014,2015,Everton,Burnley,Win,Away,2014-10-26,3,3,4,4,7,1,1,2,3,2,3,2,4,0,5.0,21.0,-16.0,3
6711,6711,2014-15,2014,2015,Everton,Swansea,Draw,Home,2014-11-01,1,6,6,7,7,3,4,5,5,3,2,2,2,1,5.0,12.0,-7.0,4
6712,6712,2014-15,2014,2015,Everton,Sunderland,Draw,Away,2014-11-09,1,4,7,7,8,3,3,6,7,1,4,1,1,0,5.0,14.0,-9.0,4
6713,6713,2014-15,2014,2015,Everton,West Ham,Win,Home,2014-11-22,3,2,5,8,8,2,5,8,11,0,0,0,-3,1,5.0,13.0,-8.0,4
6714,6714,2014-15,2014,2015,Everton,Tottenham,Loss,Away,2014-11-30,0,4,5,8,11,3,6,6,6,1,-1,2,5,0,5.0,6.0,-1.0,4
6715,6715,2014-15,2014,2015,Everton,Hull,Draw,Home,2014-12-03,1,3,4,5,8,0,0,0,1,3,4,5,7,1,5.0,16.0,-11.0,5
6716,6716,2014-15,2014,2015,Everton,Man City,Loss,Away,2014-12-06,0,1,4,5,6,6,9,10,13,-5,-5,-5,-7,0,5.0,1.0,4.0,5
6717,6717,2014-15,2014,2015,Everton,QPR,Win,Home,2014-12-15,3,1,1,4,5,3,6,6,7,-2,-5,-2,-2,1,5.0,21.0,-16.0,5
6718,6718,2014-15,2014,2015,Everton,Southampton,Loss,Away,2014-12-20,0,3,4,4,7,0,0,0,1,3,4,4,6,0,5.0,8.0,-3.0,5
6719,6719,2014-15,2014,2015,Everton,Stoke,Loss,Home,2014-12-26,0,3,3,4,4,1,4,4,4,2,-1,0,0,1,5.0,9.0,-4.0,5
6720,6720,2014-15,2014,2015,Everton,Newcastle,Loss,Away,2014-12-28,0,0,3,3,4,0,0,3,4,0,3,0,0,0,5.0,10.0,-5.0,5
6721,6721,2014-15,2014,2015,Everton,Hull,Loss,Away,2015-01-01,0,0,0,3,3,3,3,3,4,-3,-3,0,-1,0,5.0,16.0,-11.0,6
6722,6722,2014-15,2014,2015,Everton,Man City,Draw,Home,2015-01-10,1,0,0,0,3,4,7,10,13,-4,-7,-10,-10,1,5.0,1.0,4.0,6
6723,6723,2014-15,2014,2015,Everton,West Brom,Draw,Home,2015-01-19,1,1,1,1,1,4,4,4,4,-3,-3,-3,-3,1,5.0,17.0,-12.0,6
6724,6724,2014-15,2014,2015,Everton,Crystal Palace,Win,Away,2015-01-31,3,2,2,2,2,6,7,8,8,-4,-5,-6,-6,0,5.0,11.0,-6.0,6
6725,6725,2014-15,2014,2015,Everton,Liverpool,Draw,Home,2015-02-07,1,4,5,5,5,6,9,10,13,-2,-4,-5,-8,1,5.0,2.0,3.0,7
6726,6726,2014-15,2014,2015,Everton,Chelsea,Loss,Away,2015-02-11,0,4,5,6,6,4,7,10,10,0,-2,-4,-4,0,5.0,3.0,2.0,7
6727,6727,2014-15,2014,2015,Everton,Leicester,Draw,Home,2015-02-22,1,1,4,5,6,0,0,0,3,1,4,5,3,1,5.0,21.0,-16.0,7
6728,6728,2014-15,2014,2015,Everton,Arsenal,Loss,Away,2015-03-01,0,1,2,5,6,6,6,9,12,-5,-4,-4,-6,0,5.0,4.0,1.0,8
6729,6729,2014-15,2014,2015,Everton,Stoke,Loss,Away,2015-03-04,0,1,1,2,5,6,6,7,10,-5,-5,-5,-5,0,5.0,9.0,-4.0,8
6730,6730,2014-15,2014,2015,Everton,Newcastle,Win,Home,2015-03-15,3,0,1,1,2,3,3,4,5,-3,-2,-3,-3,1,5.0,10.0,-5.0,8
6731,6731,2014-15,2014,2015,Everton,QPR,Win,Away,2015-03-22,3,3,3,4,4,0,0,0,3,3,3,4,1,0,5.0,21.0,-16.0,8
6732,6732,2014-15,2014,2015,Everton,Southampton,Win,Home,2015-04-04,3,6,6,6,7,4,7,7,7,2,-1,-1,0,1,5.0,8.0,-3.0,9
6733,6733,2014-15,2014,2015,Everton,Swansea,Draw,Away,2015-04-11,1,6,9,9,9,6,6,6,9,0,3,3,0,0,5.0,12.0,-7.0,9
6734,6734,2014-15,2014,2015,Everton,Burnley,Win,Home,2015-04-18,3,4,7,10,10,1,1,4,4,3,6,6,6,1,5.0,21.0,-16.0,9
6735,6735,2014-15,2014,2015,Everton,Man United,Win,Home,2015-04-26,3,4,7,10,13,3,6,9,12,1,1,1,1,1,5.0,7.0,-2.0,9
6736,6736,2014-15,2014,2015,Everton,Aston Villa,Loss,Away,2015-05-02,0,6,7,10,13,3,4,4,4,3,3,6,9,0,5.0,15.0,-10.0,10
6737,6737,2014-15,2014,2015,Everton,Sunderland,Loss,Home,2015-05-09,0,3,6,7,10,4,4,7,7,-1,2,0,3,1,5.0,14.0,-9.0,10
6738,6738,2014-15,2014,2015,Everton,West Ham,Win,Away,2015-05-16,3,0,3,6,7,3,4,4,5,-3,-1,2,2,0,5.0,13.0,-8.0,10
6739,6739,2014-15,2014,2015,Everton,Tottenham,Loss,Home,2015-05-24,0,3,3,6,9,3,3,4,7,0,0,2,2,1,5.0,6.0,-1.0,10
6740,6740,2015-16,2015,2016,Everton,Watford,Draw,Home,2015-08-08,1,3,3,3,6,4,4,5,5,-1,-1,-2,1,1,11.0,21.0,-10.0,1
6741,6741,2015-16,2015,2016,Everton,Southampton,Win,Away,2015-08-15,3,1,4,4,4,1,4,4,4,0,0,0,0,0,11.0,7.0,4.0,1
6742,6742,2015-16,2015,2016,Everton,Man City,Loss,Home,2015-08-23,0,4,4,7,7,6,9,12,15,-2,-5,-5,-8,1,11.0,2.0,9.0,1
6743,6743,2015-16,2015,2016,Everton,Tottenham,Draw,Away,2015-08-29,1,3,4,4,7,2,2,5,8,1,2,-1,-1,0,11.0,5.0,6.0,1
6744,6744,2015-16,2015,2016,Everton,Chelsea,Win,Home,2015-09-12,3,1,4,5,5,3,3,4,7,-2,1,1,-2,1,11.0,1.0,10.0,2
6745,6745,2015-16,2015,2016,Everton,Swansea,Draw,Away,2015-09-19,1,4,4,7,8,3,4,7,8,1,0,0,0,0,11.0,8.0,3.0,2
6746,6746,2015-16,2015,2016,Everton,West Brom,Win,Away,2015-09-28,3,4,5,5,8,4,7,7,8,0,-2,-2,0,0,11.0,13.0,-2.0,2
6747,6747,2015-16,2015,2016,Everton,Liverpool,Draw,Home,2015-10-04,1,4,7,8,8,4,4,4,5,0,3,4,3,1,11.0,6.0,5.0,3
6748,6748,2015-16,2015,2016,Everton,Man United,Loss,Home,2015-10-17,0,4,5,8,9,3,6,9,9,1,-1,-1,0,1,11.0,4.0,7.0,3
6749,6749,2015-16,2015,2016,Everton,Arsenal,Loss,Away,2015-10-24,0,1,4,5,8,6,9,9,12,-5,-5,-4,-4,0,11.0,3.0,8.0,3
6750,6750,2015-16,2015,2016,Everton,Sunderland,Win,Home,2015-11-01,3,0,1,4,5,3,4,4,4,-3,-3,0,1,1,11.0,16.0,-5.0,4
6751,6751,2015-16,2015,2016,Everton,West Ham,Draw,Away,2015-11-07,1,3,3,4,7,3,6,7,8,0,-3,-3,-1,0,11.0,12.0,-1.0,4
6752,6752,2015-16,2015,2016,Everton,Aston Villa,Win,Home,2015-11-21,3,4,4,4,5,1,1,1,1,3,3,3,4,1,11.0,17.0,-6.0,4
6753,6753,2015-16,2015,2016,Everton,Bournemouth,Draw,Away,2015-11-28,1,4,7,7,7,1,1,1,1,3,6,6,6,0,11.0,21.0,-10.0,4
6754,6754,2015-16,2015,2016,Everton,Crystal Palace,Draw,Home,2015-12-07,1,4,5,8,8,3,6,7,7,1,-1,1,1,1,11.0,10.0,1.0,5
6755,6755,2015-16,2015,2016,Everton,Norwich,Draw,Away,2015-12-12,1,2,5,6,9,1,1,4,4,1,4,2,5,0,11.0,21.0,-10.0,5
6756,6756,2015-16,2015,2016,Everton,Leicester,Loss,Home,2015-12-19,0,2,3,6,7,6,7,10,13,-4,-4,-4,-6,1,11.0,14.0,-3.0,5
6757,6757,2015-16,2015,2016,Everton,Newcastle,Win,Away,2015-12-26,3,1,2,3,6,4,7,7,7,-3,-5,-4,-1,0,11.0,15.0,-4.0,5
6758,6758,2015-16,2015,2016,Everton,Stoke,Loss,Home,2015-12-28,0,3,4,5,6,3,4,7,7,0,0,-2,-1,1,11.0,9.0,2.0,5
6759,6759,2015-16,2015,2016,Everton,Tottenham,Draw,Home,2016-01-03,1,3,3,4,5,6,9,9,10,-3,-6,-5,-5,1,11.0,5.0,6.0,6
6760,6760,2015-16,2015,2016,Everton,Man City,Draw,Away,2016-01-13,1,1,4,4,5,4,7,7,10,-3,-3,-3,-5,0,11.0,2.0,9.0,6
6761,6761,2015-16,2015,2016,Everton,Chelsea,Draw,Away,2016-01-16,1,2,2,5,5,4,5,6,9,-2,-3,-1,-4,0,11.0,1.0,10.0,6
6762,6762,2015-16,2015,2016,Everton,Swansea,Loss,Home,2016-01-24,0,2,3,3,6,3,3,4,7,-1,0,-1,-1,1,11.0,8.0,3.0,6
6763,6763,2015-16,2015,2016,Everton,Newcastle,Win,Home,2016-02-03,3,1,2,3,3,3,4,4,4,-2,-2,-1,-1,1,11.0,15.0,-4.0,7
6764,6764,2015-16,2015,2016,Everton,Stoke,Win,Away,2016-02-06,3,3,4,5,6,0,1,4,4,3,3,1,2,0,11.0,9.0,2.0,7
6765,6765,2015-16,2015,2016,Everton,West Brom,Loss,Home,2016-02-13,0,6,6,7,8,1,2,2,3,5,4,5,5,1,11.0,13.0,-2.0,7
6766,6766,2015-16,2015,2016,Everton,Aston Villa,Win,Away,2016-03-01,3,3,6,6,7,0,3,3,4,3,3,3,3,0,11.0,17.0,-6.0,8
6767,6767,2015-16,2015,2016,Everton,West Ham,Loss,Home,2016-03-05,0,3,6,9,9,6,7,7,10,-3,-1,2,-1,1,11.0,12.0,-1.0,8
6768,6768,2015-16,2015,2016,Everton,Arsenal,Loss,Home,2016-03-19,0,3,3,6,9,1,1,4,7,2,2,2,2,1,11.0,3.0,8.0,8
6769,6769,2015-16,2015,2016,Everton,Man United,Loss,Away,2016-04-03,0,0,3,3,6,3,6,9,9,-3,-3,-6,-3,0,11.0,4.0,7.0,9
6770,6770,2015-16,2015,2016,Everton,Watford,Draw,Away,2016-04-09,1,0,0,3,3,0,0,0,1,0,0,3,2,0,11.0,21.0,-10.0,9
6771,6771,2015-16,2015,2016,Everton,Crystal Palace,Draw,Away,2016-04-13,1,1,1,1,4,4,4,4,5,-3,-3,-3,-1,0,11.0,10.0,1.0,9
6772,6772,2015-16,2015,2016,Everton,Southampton,Draw,Home,2016-04-16,1,2,2,2,2,3,6,9,10,-1,-4,-7,-8,1,11.0,7.0,4.0,9
6773,6773,2015-16,2015,2016,Everton,Liverpool,Loss,Away,2016-04-20,0,2,3,3,3,6,7,7,10,-4,-4,-4,-7,0,11.0,6.0,5.0,9
6774,6774,2015-16,2015,2016,Everton,Bournemouth,Win,Home,2016-04-30,3,1,2,3,3,0,3,3,3,1,-1,0,0,1,11.0,21.0,-10.0,9
6775,6775,2015-16,2015,2016,Everton,Leicester,Loss,Away,2016-05-07,0,3,4,5,6,4,5,8,11,-1,-1,-3,-5,0,11.0,14.0,-3.0,10
6776,6776,2015-16,2015,2016,Everton,Sunderland,Loss,Away,2016-05-11,0,3,3,4,5,4,5,8,8,-1,-2,-4,-3,0,11.0,16.0,-5.0,10
6777,6777,2015-16,2015,2016,Everton,Norwich,Win,Home,2016-05-15,3,0,3,3,4,3,3,3,3,-3,0,0,1,1,11.0,21.0,-10.0,10
6778,6778,2016-17,2016,2017,Everton,Tottenham,Draw,Home,2016-08-13,1,3,3,6,6,0,1,2,5,3,2,4,1,1,11.0,3.0,8.0,1
6779,6779,2016-17,2016,2017,Everton,West Brom,Win,Away,2016-08-20,3,4,4,4,7,4,5,5,6,0,-1,-1,1,0,11.0,14.0,-3.0,1
6780,6780,2016-17,2016,2017,Everton,Stoke,Win,Home,2016-08-27,3,4,7,7,7,1,4,4,5,3,3,3,2,1,11.0,9.0,2.0,1
6781,6781,2016-17,2016,2017,Everton,Sunderland,Win,Away,2016-09-12,3,6,7,10,10,1,1,2,5,5,6,8,5,0,11.0,17.0,-6.0,2
6782,6782,2016-17,2016,2017,Everton,Middlesbrough,Win,Home,2016-09-17,3,6,9,10,13,1,4,5,5,5,5,5,8,1,11.0,21.0,-10.0,2
6783,6783,2016-17,2016,2017,Everton,Bournemouth,Loss,Away,2016-09-24,0,6,9,12,13,3,4,4,4,3,5,8,9,0,11.0,16.0,-5.0,2
6784,6784,2016-17,2016,2017,Everton,Crystal Palace,Draw,Home,2016-09-30,1,3,6,9,12,6,9,10,10,-3,-3,-1,2,1,11.0,15.0,-4.0,2
6785,6785,2016-17,2016,2017,Everton,Man City,Draw,Away,2016-10-15,1,1,4,7,10,3,6,9,12,-2,-2,-2,-2,0,11.0,4.0,7.0,3
6786,6786,2016-17,2016,2017,Everton,Burnley,Loss,Away,2016-10-22,0,2,2,5,8,0,3,3,4,2,-1,2,4,0,11.0,21.0,-10.0,3
6787,6787,2016-17,2016,2017,Everton,West Ham,Win,Home,2016-10-30,3,1,2,2,5,6,7,7,7,-5,-5,-5,-2,1,11.0,7.0,4.0,3
6788,6788,2016-17,2016,2017,Everton,Chelsea,Loss,Away,2016-11-05,0,3,4,5,5,6,9,12,12,-3,-5,-7,-7,0,11.0,10.0,1.0,4
6789,6789,2016-17,2016,2017,Everton,Swansea,Draw,Home,2016-11-19,1,3,3,4,5,0,1,1,1,3,2,3,4,1,11.0,12.0,-1.0,4
6790,6790,2016-17,2016,2017,Everton,Southampton,Loss,Away,2016-11-27,0,1,4,4,5,1,1,2,5,0,3,2,0,0,11.0,6.0,5.0,4
6791,6791,2016-17,2016,2017,Everton,Man United,Draw,Home,2016-12-04,1,1,1,4,4,2,5,6,6,-1,-4,-2,-2,1,11.0,5.0,6.0,5
6792,6792,2016-17,2016,2017,Everton,Watford,Loss,Away,2016-12-10,0,1,2,2,5,0,3,3,6,1,-1,-1,-1,0,11.0,13.0,-2.0,5
6793,6793,2016-17,2016,2017,Everton,Arsenal,Win,Home,2016-12-13,3,1,1,2,2,6,9,10,11,-5,-8,-8,-9,1,11.0,2.0,9.0,5
6794,6794,2016-17,2016,2017,Everton,Liverpool,Loss,Home,2016-12-19,0,3,4,4,5,4,4,7,8,-1,0,-3,-3,1,11.0,8.0,3.0,5
6795,6795,2016-17,2016,2017,Everton,Leicester,Win,Away,2016-12-26,3,3,3,4,4,1,4,4,5,2,-1,0,-1,0,11.0,1.0,10.0,5
6796,6796,2016-17,2016,2017,Everton,Hull,Draw,Away,2016-12-30,1,3,6,6,7,0,0,1,1,3,6,5,6,0,11.0,21.0,-10.0,5
6797,6797,2016-17,2016,2017,Everton,Southampton,Win,Home,2017-01-02,3,4,4,7,7,0,3,4,7,4,1,3,0,1,11.0,6.0,5.0,6
6798,6798,2016-17,2016,2017,Everton,Man City,Win,Home,2017-01-15,3,4,7,7,10,3,6,9,12,1,1,-2,-2,1,11.0,4.0,7.0,6
6799,6799,2016-17,2016,2017,Everton,Crystal Palace,Win,Away,2017-01-21,3,6,7,10,10,0,0,1,1,6,7,9,9,0,11.0,15.0,-4.0,6
6800,6800,2016-17,2016,2017,Everton,Stoke,Draw,Away,2017-02-01,1,6,9,10,13,4,7,7,7,2,2,3,6,0,11.0,9.0,2.0,7
6801,6801,2016-17,2016,2017,Everton,Bournemouth,Win,Home,2017-02-04,3,4,7,10,11,1,1,2,5,3,6,8,6,1,11.0,16.0,-5.0,7
6802,6802,2016-17,2016,2017,Everton,Middlesbrough,Draw,Away,2017-02-11,1,4,7,10,13,1,1,2,3,3,6,8,10,0,11.0,21.0,-10.0,7
6803,6803,2016-17,2016,2017,Everton,Sunderland,Win,Home,2017-02-25,3,4,5,8,11,3,4,4,4,1,1,4,7,1,11.0,17.0,-6.0,7
6804,6804,2016-17,2016,2017,Everton,Tottenham,Loss,Away,2017-03-05,0,4,7,8,11,3,6,7,8,1,1,1,3,0,11.0,3.0,8.0,8
6805,6805,2016-17,2016,2017,Everton,West Brom,Win,Home,2017-03-11,3,3,4,7,8,3,4,7,8,0,0,0,0,1,11.0,14.0,-3.0,8
6806,6806,2016-17,2016,2017,Everton,Hull,Win,Home,2017-03-18,3,3,6,7,10,3,4,4,7,0,2,3,3,1,11.0,21.0,-10.0,8
6807,6807,2016-17,2016,2017,Everton,Liverpool,Loss,Away,2017-04-01,0,6,6,9,10,4,7,7,10,2,-1,2,0,0,11.0,8.0,3.0,9
6808,6808,2016-17,2016,2017,Everton,Man United,Draw,Away,2017-04-04,1,3,6,6,9,4,5,8,11,-1,1,-2,-2,0,11.0,5.0,6.0,9
6809,6809,2016-17,2016,2017,Everton,Leicester,Win,Home,2017-04-09,3,1,4,7,7,6,9,12,15,-5,-5,-5,-8,1,11.0,1.0,10.0,9
6810,6810,2016-17,2016,2017,Everton,Burnley,Win,Home,2017-04-15,3,4,4,7,10,4,4,5,5,0,0,2,5,1,11.0,21.0,-10.0,9
6811,6811,2016-17,2016,2017,Everton,West Ham,Draw,Away,2017-04-22,1,6,7,7,10,4,4,4,4,2,3,3,6,0,11.0,7.0,4.0,9
6812,6812,2016-17,2016,2017,Everton,Chelsea,Loss,Home,2017-04-30,0,4,7,8,8,3,6,9,9,1,1,-1,-1,1,11.0,10.0,1.0,9
6813,6813,2016-17,2016,2017,Everton,Swansea,Loss,Away,2017-05-06,0,1,4,7,8,4,4,4,4,-3,0,3,4,0,11.0,12.0,-1.0,10
6814,6814,2016-17,2016,2017,Everton,Watford,Win,Home,2017-05-12,3,0,1,4,7,0,0,3,3,0,1,1,4,1,11.0,13.0,-2.0,10
6815,6815,2016-17,2016,2017,Everton,Arsenal,Loss,Away,2017-05-21,0,3,3,4,7,6,9,12,12,-3,-6,-8,-5,0,11.0,2.0,9.0,10
6816,6816,2017-18,2017,2018,Everton,Stoke,Win,Home,2017-08-12,3,3,3,3,4,3,4,5,5,0,-1,-2,-1,1,7.0,13.0,-6.0,1
6817,6817,2017-18,2017,2018,Everton,Man City,Draw,Away,2017-08-21,1,3,6,6,6,6,9,12,15,-3,-3,-6,-9,0,7.0,3.0,4.0,1
6818,6818,2017-18,2017,2018,Everton,Chelsea,Loss,Away,2017-08-27,0,4,4,7,7,3,6,9,12,1,-2,-2,-5,0,7.0,1.0,6.0,1
6819,6819,2017-18,2017,2018,Everton,Tottenham,Loss,Home,2017-09-09,0,1,4,4,7,1,4,7,10,0,0,-3,-3,1,7.0,2.0,5.0,2
6820,6820,2017-18,2017,2018,Everton,Man United,Loss,Away,2017-09-17,0,0,1,4,4,4,7,10,13,-4,-6,-6,-9,0,7.0,6.0,1.0,2
6821,6821,2017-18,2017,2018,Everton,Bournemouth,Win,Home,2017-09-23,3,0,0,1,4,3,3,3,3,-3,-3,-2,1,1,7.0,9.0,-2.0,2
6822,6822,2017-18,2017,2018,Everton,Burnley,Loss,Home,2017-10-01,0,3,3,3,4,2,5,6,6,1,-2,-3,-2,1,7.0,16.0,-9.0,3
6823,6823,2017-18,2017,2018,Everton,Brighton,Draw,Away,2017-10-15,1,3,3,3,3,3,3,6,7,0,0,-3,-4,0,7.0,21.0,-14.0,3
6824,6824,2017-18,2017,2018,Everton,Arsenal,Loss,Home,2017-10-22,0,1,4,4,4,3,6,7,10,-2,-2,-3,-6,1,7.0,5.0,2.0,3
6825,6825,2017-18,2017,2018,Everton,Leicester,Loss,Away,2017-10-29,0,1,1,4,4,4,5,5,6,-3,-4,-1,-2,0,7.0,12.0,-5.0,3
6826,6826,2017-18,2017,2018,Everton,Watford,Win,Home,2017-11-05,3,0,1,1,4,0,3,4,7,0,-2,-3,-3,1,7.0,17.0,-10.0,4
6827,6827,2017-18,2017,2018,Everton,Crystal Palace,Draw,Away,2017-11-18,1,3,3,4,4,1,1,4,4,2,2,0,0,0,7.0,14.0,-7.0,4
6828,6828,2017-18,2017,2018,Everton,Southampton,Loss,Away,2017-11-26,0,4,4,4,5,0,1,4,5,4,3,0,0,0,7.0,8.0,-1.0,4
6829,6829,2017-18,2017,2018,Everton,West Ham,Win,Home,2017-11-29,3,1,4,4,4,1,1,2,2,0,3,2,2,1,7.0,11.0,-4.0,4
6830,6830,2017-18,2017,2018,Everton,Huddersfield,Win,Home,2017-12-02,3,3,4,7,7,0,0,3,3,3,4,4,4,1,7.0,21.0,-14.0,5
6831,6831,2017-18,2017,2018,Everton,Liverpool,Draw,Away,2017-12-10,1,6,6,7,10,6,7,10,13,0,-1,-3,-3,0,7.0,4.0,3.0,5
6832,6832,2017-18,2017,2018,Everton,Newcastle,Win,Away,2017-12-13,3,4,7,7,8,0,1,1,1,4,6,6,7,0,7.0,21.0,-14.0,5
6833,6833,2017-18,2017,2018,Everton,Swansea,Win,Home,2017-12-18,3,4,7,10,10,3,3,3,4,1,4,7,6,1,7.0,15.0,-8.0,5
6834,6834,2017-18,2017,2018,Everton,Chelsea,Draw,Home,2017-12-23,1,6,7,10,13,6,6,9,12,0,1,1,1,1,7.0,1.0,6.0,5
6835,6835,2017-18,2017,2018,Everton,West Brom,Draw,Away,2017-12-26,1,4,7,8,11,0,1,1,2,4,6,7,9,0,7.0,10.0,-3.0,5
6836,6836,2017-18,2017,2018,Everton,Bournemouth,Loss,Away,2017-12-30,0,2,5,8,9,1,1,1,2,1,4,7,7,0,7.0,9.0,-2.0,5
6837,6837,2017-18,2017,2018,Everton,Man United,Loss,Home,2018-01-01,0,1,2,5,8,2,3,6,9,-1,-1,-1,-1,1,7.0,6.0,1.0,6
6838,6838,2017-18,2017,2018,Everton,Tottenham,Loss,Away,2018-01-13,0,0,1,2,5,4,7,10,10,-4,-6,-8,-5,0,7.0,2.0,5.0,6
6839,6839,2017-18,2017,2018,Everton,West Brom,Draw,Home,2018-01-20,1,0,0,1,2,3,4,5,5,-3,-4,-4,-3,1,7.0,10.0,-3.0,6
6840,6840,2017-18,2017,2018,Everton,Leicester,Win,Home,2018-01-31,3,1,1,1,2,4,7,7,7,-3,-6,-6,-5,1,7.0,12.0,-5.0,6
6841,6841,2017-18,2017,2018,Everton,Arsenal,Loss,Away,2018-02-03,0,4,4,4,4,3,3,4,5,1,1,0,-1,0,7.0,5.0,2.0,7
6842,6842,2017-18,2017,2018,Everton,Crystal Palace,Win,Home,2018-02-10,3,3,4,4,4,2,2,5,8,1,2,-1,-4,1,7.0,14.0,-7.0,7
6843,6843,2017-18,2017,2018,Everton,Watford,Loss,Away,2018-02-24,0,3,6,7,7,3,4,4,5,0,2,3,2,0,7.0,17.0,-10.0,7
6844,6844,2017-18,2017,2018,Everton,Burnley,Loss,Away,2018-03-03,0,3,3,6,7,1,2,3,3,2,1,3,4,0,7.0,16.0,-9.0,8
6845,6845,2017-18,2017,2018,Everton,Brighton,Win,Home,2018-03-10,3,0,3,3,6,6,7,10,11,-6,-4,-7,-5,1,7.0,21.0,-14.0,8
6846,6846,2017-18,2017,2018,Everton,Stoke,Win,Away,2018-03-17,3,3,3,6,6,1,2,3,3,2,1,3,3,0,7.0,13.0,-6.0,8
6847,6847,2017-18,2017,2018,Everton,Man City,Loss,Home,2018-03-31,0,6,6,6,9,6,9,12,13,0,-3,-6,-4,1,7.0,3.0,4.0,8
6848,6848,2017-18,2017,2018,Everton,Liverpool,Draw,Home,2018-04-07,1,3,6,6,6,6,6,9,12,-3,0,-3,-6,1,7.0,4.0,3.0,9
6849,6849,2017-18,2017,2018,Everton,Swansea,Draw,Away,2018-04-14,1,1,4,7,7,1,2,5,5,0,2,2,2,0,7.0,15.0,-8.0,9
6850,6850,2017-18,2017,2018,Everton,Newcastle,Win,Home,2018-04-23,3,2,2,5,8,6,9,12,12,-4,-7,-7,-4,1,7.0,21.0,-14.0,9
6851,6851,2017-18,2017,2018,Everton,Huddersfield,Win,Away,2018-04-28,3,4,5,5,8,4,4,4,5,0,1,1,3,0,7.0,21.0,-14.0,9
6852,6852,2017-18,2017,2018,Everton,Southampton,Draw,Home,2018-05-05,1,6,7,8,8,4,4,4,4,2,3,4,4,1,7.0,8.0,-1.0,10
6853,6853,2017-18,2017,2018,Everton,West Ham,Loss,Away,2018-05-13,0,4,7,8,9,4,4,4,5,0,3,4,4,0,7.0,11.0,-4.0,10
6854,6854,2001-02,2001,2002,Fulham,Man United,Loss,Away,2001-08-19,0,0,0,0,0,0,0,3,4,0,0,-3,-4,0,21.0,1.0,20.0,1
6855,6855,2001-02,2001,2002,Fulham,Sunderland,Win,Home,2001-08-22,3,0,0,0,0,4,7,10,11,-4,-7,-10,-11,1,21.0,7.0,14.0,1
6856,6856,2001-02,2001,2002,Fulham,Derby,Draw,Home,2001-08-25,1,3,3,3,3,3,4,7,7,0,-1,-4,-4,1,21.0,17.0,4.0,1
6857,6857,2001-02,2001,2002,Fulham,Charlton,Draw,Away,2001-09-09,1,4,4,4,4,3,3,3,6,1,1,1,-2,0,21.0,9.0,12.0,2
6858,6858,2001-02,2001,2002,Fulham,Arsenal,Loss,Home,2001-09-15,0,2,5,5,5,4,4,7,7,-2,1,-2,-2,1,21.0,2.0,19.0,2
6859,6859,2001-02,2001,2002,Fulham,Leicester,Draw,Away,2001-09-22,1,1,2,5,5,3,4,4,4,-2,-2,1,1,0,21.0,13.0,8.0,2
6860,6860,2001-02,2001,2002,Fulham,Chelsea,Draw,Home,2001-09-30,1,1,2,3,6,4,5,8,9,-3,-3,-5,-3,1,21.0,6.0,15.0,2
6861,6861,2001-02,2001,2002,Fulham,Aston Villa,Loss,Away,2001-10-14,0,2,2,3,4,6,7,10,11,-4,-5,-7,-7,0,21.0,8.0,13.0,3
6862,6862,2001-02,2001,2002,Fulham,Ipswich,Draw,Home,2001-10-21,1,1,2,2,3,1,1,2,3,0,1,0,0,1,21.0,5.0,16.0,3
6863,6863,2001-02,2001,2002,Fulham,Southampton,Win,Home,2001-10-27,3,1,2,3,3,1,1,4,4,0,1,-1,-1,1,21.0,10.0,11.0,3
6864,6864,2001-02,2001,2002,Fulham,West Ham,Win,Away,2001-11-03,3,4,4,5,6,6,9,9,9,-2,-5,-4,-3,0,21.0,15.0,6.0,4
6865,6865,2001-02,2001,2002,Fulham,Newcastle,Win,Home,2001-11-17,3,6,7,7,8,6,6,9,9,0,1,-2,-1,1,21.0,11.0,10.0,4
6866,6866,2001-02,2001,2002,Fulham,Bolton,Draw,Away,2001-11-24,1,6,9,10,10,4,4,7,7,2,5,3,3,0,21.0,21.0,0.0,4
6867,6867,2001-02,2001,2002,Fulham,Leeds,Draw,Home,2001-12-02,1,4,7,10,11,1,4,5,6,3,3,5,5,1,21.0,4.0,17.0,5
6868,6868,2001-02,2001,2002,Fulham,Everton,Win,Home,2001-12-08,3,2,5,8,11,4,5,6,6,-2,0,2,5,1,21.0,16.0,5.0,5
6869,6869,2001-02,2001,2002,Fulham,Liverpool,Draw,Away,2001-12-12,1,4,5,8,11,6,9,10,13,-2,-4,-2,-2,0,21.0,3.0,18.0,5
6870,6870,2001-02,2001,2002,Fulham,Tottenham,Loss,Away,2001-12-15,0,4,5,6,9,3,6,7,7,1,-1,-1,2,0,21.0,12.0,9.0,5
6871,6871,2001-02,2001,2002,Fulham,Charlton,Draw,Home,2001-12-26,1,1,4,5,6,1,4,7,8,0,0,-2,-2,1,21.0,9.0,12.0,5
6872,6872,2001-02,2001,2002,Fulham,Man United,Loss,Home,2001-12-30,0,1,2,5,6,6,9,12,12,-5,-7,-7,-6,1,21.0,1.0,20.0,5
6873,6873,2001-02,2001,2002,Fulham,Derby,Win,Away,2002-01-02,3,1,1,2,5,3,6,6,6,-2,-5,-4,-1,0,21.0,17.0,4.0,6
6874,6874,2001-02,2001,2002,Fulham,Middlesbrough,Win,Home,2002-01-12,3,3,4,4,5,3,3,3,3,0,1,1,2,1,21.0,14.0,7.0,6
6875,6875,2001-02,2001,2002,Fulham,Sunderland,Draw,Away,2002-01-19,1,6,6,7,7,1,1,4,7,5,5,3,0,0,21.0,7.0,14.0,6
6876,6876,2001-02,2001,2002,Fulham,Ipswich,Loss,Away,2002-01-30,0,4,7,7,8,6,6,9,12,-2,1,-2,-4,0,21.0,5.0,16.0,6
6877,6877,2001-02,2001,2002,Fulham,Aston Villa,Draw,Home,2002-02-02,1,1,4,7,7,4,7,8,9,-3,-3,-1,-2,1,21.0,8.0,13.0,7
6878,6878,2001-02,2001,2002,Fulham,Blackburn,Win,Home,2002-02-09,3,1,2,5,8,0,0,3,3,1,2,2,5,1,21.0,21.0,0.0,7
6879,6879,2001-02,2001,2002,Fulham,Middlesbrough,Loss,Away,2002-02-19,0,4,4,5,8,2,5,6,6,2,-1,-1,2,0,21.0,14.0,7.0,7
6880,6880,2001-02,2001,2002,Fulham,Arsenal,Loss,Away,2002-02-23,0,3,4,4,5,4,7,10,11,-1,-3,-6,-6,0,21.0,2.0,19.0,7
6881,6881,2001-02,2001,2002,Fulham,Liverpool,Loss,Home,2002-03-02,0,0,3,4,4,4,7,10,13,-4,-4,-6,-9,1,21.0,3.0,18.0,8
6882,6882,2001-02,2001,2002,Fulham,Chelsea,Loss,Away,2002-03-06,0,0,0,3,4,1,4,7,10,-1,-4,-4,-6,0,21.0,6.0,15.0,8
6883,6883,2001-02,2001,2002,Fulham,Everton,Loss,Away,2002-03-16,0,0,0,0,3,1,2,2,2,-1,-2,-2,1,0,21.0,16.0,5.0,8
6884,6884,2001-02,2001,2002,Fulham,Tottenham,Loss,Home,2002-03-24,0,0,0,0,0,0,0,3,6,0,0,-3,-6,1,21.0,12.0,9.0,8
6885,6885,2001-02,2001,2002,Fulham,Southampton,Draw,Away,2002-03-30,1,0,0,0,0,2,3,6,7,-2,-3,-6,-7,0,21.0,10.0,11.0,8
6886,6886,2001-02,2001,2002,Fulham,West Ham,Loss,Home,2002-04-01,0,1,1,1,1,3,6,6,9,-2,-5,-5,-8,1,21.0,15.0,6.0,9
6887,6887,2001-02,2001,2002,Fulham,Newcastle,Draw,Away,2002-04-08,1,1,1,1,1,4,5,5,5,-3,-4,-4,-4,0,21.0,11.0,10.0,9
6888,6888,2001-02,2001,2002,Fulham,Leeds,Win,Away,2002-04-20,3,1,2,2,2,6,6,6,9,-5,-4,-4,-7,0,21.0,4.0,17.0,9
6889,6889,2001-02,2001,2002,Fulham,Bolton,Win,Home,2002-04-23,3,4,4,5,5,4,4,7,10,0,0,-2,-5,1,21.0,21.0,0.0,9
6890,6890,2001-02,2001,2002,Fulham,Leicester,Draw,Home,2002-04-27,1,6,7,7,8,2,2,2,5,4,5,5,3,1,21.0,13.0,8.0,9
6891,6891,2001-02,2001,2002,Fulham,Blackburn,Loss,Away,2002-05-11,0,4,7,8,8,3,4,7,8,1,3,1,0,0,21.0,21.0,0.0,10
6892,6892,2002-03,2002,2003,Fulham,Bolton,Win,Home,2002-08-17,3,1,4,7,8,0,0,1,4,1,4,6,4,1,13.0,16.0,-3.0,1
6893,6893,2002-03,2002,2003,Fulham,Middlesbrough,Draw,Away,2002-08-24,1,3,4,7,10,1,1,1,1,2,3,6,9,0,13.0,12.0,1.0,1
6894,6894,2002-03,2002,2003,Fulham,West Brom,Loss,Away,2002-08-31,0,4,4,5,8,0,0,0,0,4,4,5,8,0,13.0,21.0,-8.0,1
6895,6895,2002-03,2002,2003,Fulham,Tottenham,Win,Home,2002-09-11,3,1,4,4,5,6,9,10,10,-5,-5,-6,-5,1,13.0,9.0,4.0,2
6896,6896,2002-03,2002,2003,Fulham,Sunderland,Win,Away,2002-09-14,3,3,4,7,7,1,4,4,5,2,0,3,2,0,13.0,17.0,-4.0,2
6897,6897,2002-03,2002,2003,Fulham,Chelsea,Draw,Home,2002-09-23,1,6,6,7,10,6,7,8,9,0,-1,-1,1,1,13.0,6.0,7.0,2
6898,6898,2002-03,2002,2003,Fulham,Everton,Loss,Away,2002-09-28,0,4,7,7,8,3,3,3,4,1,4,4,4,0,13.0,15.0,-2.0,2
6899,6899,2002-03,2002,2003,Fulham,Charlton,Win,Home,2002-10-06,3,1,4,7,7,1,1,1,4,0,3,6,3,1,13.0,14.0,-1.0,3
6900,6900,2002-03,2002,2003,Fulham,Man United,Draw,Home,2002-10-19,1,3,4,7,10,6,9,9,9,-3,-5,-2,1,1,13.0,3.0,10.0,3
6901,6901,2002-03,2002,2003,Fulham,West Ham,Loss,Home,2002-10-23,0,4,4,5,8,3,6,7,7,1,-2,-2,1,1,13.0,7.0,6.0,3
6902,6902,2002-03,2002,2003,Fulham,Southampton,Loss,Away,2002-10-27,0,1,4,4,5,6,7,8,8,-5,-3,-4,-3,0,13.0,11.0,2.0,3
6903,6903,2002-03,2002,2003,Fulham,Arsenal,Loss,Home,2002-11-03,0,0,1,4,4,0,3,6,9,0,-2,-2,-5,1,13.0,1.0,12.0,4
6904,6904,2002-03,2002,2003,Fulham,Aston Villa,Loss,Away,2002-11-09,0,0,0,1,4,2,2,3,3,-2,-2,-2,1,0,13.0,8.0,5.0,4
6905,6905,2002-03,2002,2003,Fulham,Birmingham,Draw,Away,2002-11-17,1,0,0,0,1,3,3,4,7,-3,-3,-4,-6,0,13.0,21.0,-8.0,4
6906,6906,2002-03,2002,2003,Fulham,Liverpool,Win,Home,2002-11-23,3,1,1,1,1,1,4,7,10,0,-3,-6,-9,1,13.0,2.0,11.0,4
6907,6907,2002-03,2002,2003,Fulham,Blackburn,Loss,Away,2002-11-30,0,4,4,4,4,0,1,2,5,4,3,2,-1,0,13.0,10.0,3.0,4
6908,6908,2002-03,2002,2003,Fulham,Leeds,Win,Home,2002-12-07,3,3,4,4,4,0,0,3,3,3,4,1,1,1,13.0,5.0,8.0,5
6909,6909,2002-03,2002,2003,Fulham,Birmingham,Loss,Home,2002-12-15,0,3,6,7,7,1,4,5,5,2,2,2,2,1,13.0,21.0,-8.0,5
6910,6910,2002-03,2002,2003,Fulham,Newcastle,Loss,Away,2002-12-21,0,3,3,6,7,4,7,7,10,-1,-4,-1,-3,0,13.0,4.0,9.0,5
6911,6911,2002-03,2002,2003,Fulham,West Ham,Draw,Away,2002-12-26,1,0,3,3,6,1,2,2,2,-1,1,1,4,0,13.0,7.0,6.0,5
6912,6912,2002-03,2002,2003,Fulham,Man City,Loss,Home,2002-12-28,0,1,1,4,4,3,4,7,10,-2,-3,-3,-6,1,13.0,21.0,-8.0,5
6913,6913,2002-03,2002,2003,Fulham,Bolton,Draw,Away,2003-01-11,1,1,1,1,4,1,4,5,5,0,-3,-4,-1,0,13.0,16.0,-3.0,6
6914,6914,2002-03,2002,2003,Fulham,Middlesbrough,Win,Home,2003-01-19,3,1,2,2,2,1,1,4,4,0,1,-2,-2,1,13.0,12.0,1.0,6
6915,6915,2002-03,2002,2003,Fulham,Man City,Loss,Away,2003-01-29,0,4,4,5,5,3,4,7,10,1,0,-2,-5,0,13.0,21.0,-8.0,6
6916,6916,2002-03,2002,2003,Fulham,Arsenal,Loss,Away,2003-02-01,0,3,4,4,5,4,7,10,11,-1,-3,-6,-6,0,13.0,1.0,12.0,7
6917,6917,2002-03,2002,2003,Fulham,Aston Villa,Win,Home,2003-02-08,3,0,3,4,4,6,6,7,10,-6,-3,-3,-6,1,13.0,8.0,5.0,7
6918,6918,2002-03,2002,2003,Fulham,West Brom,Win,Home,2003-02-19,3,3,3,6,7,4,4,5,5,-1,-1,1,2,1,13.0,21.0,-8.0,7
6919,6919,2002-03,2002,2003,Fulham,Tottenham,Draw,Away,2003-02-24,1,6,6,6,9,4,4,7,10,2,2,-1,-1,0,13.0,9.0,4.0,7
6920,6920,2002-03,2002,2003,Fulham,Sunderland,Win,Home,2003-03-01,3,4,7,7,7,0,0,0,0,4,7,7,7,1,13.0,17.0,-4.0,8
6921,6921,2002-03,2002,2003,Fulham,Southampton,Draw,Home,2003-03-15,1,4,7,10,10,3,3,3,6,1,4,7,4,1,13.0,11.0,2.0,8
6922,6922,2002-03,2002,2003,Fulham,Man United,Loss,Away,2003-03-22,0,4,5,8,11,6,7,8,11,-2,-2,0,0,0,13.0,3.0,10.0,8
6923,6923,2002-03,2002,2003,Fulham,Blackburn,Loss,Home,2003-04-07,0,1,4,5,8,3,6,9,12,-2,-2,-4,-4,1,13.0,10.0,3.0,9
6924,6924,2002-03,2002,2003,Fulham,Liverpool,Loss,Away,2003-04-12,0,0,1,4,5,3,6,9,9,-3,-5,-5,-4,0,13.0,2.0,11.0,9
6925,6925,2002-03,2002,2003,Fulham,Newcastle,Win,Home,2003-04-19,3,0,0,1,4,0,3,6,6,0,-3,-5,-2,1,13.0,4.0,9.0,9
6926,6926,2002-03,2002,2003,Fulham,Leeds,Loss,Away,2003-04-22,0,3,3,3,4,1,4,4,4,2,-1,-1,0,0,13.0,5.0,8.0,9
6927,6927,2002-03,2002,2003,Fulham,Chelsea,Draw,Away,2003-04-26,1,3,3,3,3,3,6,9,12,0,-3,-6,-9,0,13.0,6.0,7.0,9
6928,6928,2002-03,2002,2003,Fulham,Everton,Win,Home,2003-05-03,3,1,4,4,4,3,3,6,9,-2,1,-2,-5,1,13.0,15.0,-2.0,10
6929,6929,2002-03,2002,2003,Fulham,Charlton,Win,Away,2003-05-11,3,4,4,7,7,3,3,3,3,1,1,4,4,0,13.0,14.0,-1.0,10
6930,6930,2003-04,2003,2004,Fulham,Middlesbrough,Win,Home,2003-08-16,3,6,7,7,10,0,0,0,3,6,7,7,7,1,14.0,11.0,3.0,1
6931,6931,2003-04,2003,2004,Fulham,Everton,Loss,Away,2003-08-23,0,6,9,10,10,0,0,3,3,6,9,7,7,0,14.0,7.0,7.0,1
6932,6932,2003-04,2003,2004,Fulham,Tottenham,Win,Away,2003-08-30,3,3,6,9,10,4,4,4,4,-1,2,5,6,0,14.0,10.0,4.0,1
6933,6933,2003-04,2003,2004,Fulham,Birmingham,Draw,Away,2003-09-14,1,3,6,9,12,4,7,8,8,-1,-1,1,4,0,14.0,13.0,1.0,2
6934,6934,2003-04,2003,2004,Fulham,Man City,Draw,Home,2003-09-20,1,4,4,7,10,3,6,7,10,1,-2,0,0,1,14.0,9.0,5.0,2
6935,6935,2003-04,2003,2004,Fulham,Blackburn,Win,Away,2003-09-28,3,2,5,5,8,3,4,4,5,-1,1,1,3,0,14.0,6.0,8.0,2
6936,6936,2003-04,2003,2004,Fulham,Leicester,Win,Home,2003-10-04,3,4,5,8,8,0,3,3,4,4,2,5,4,1,14.0,21.0,-7.0,3
6937,6937,2003-04,2003,2004,Fulham,Wolves,Draw,Home,2003-10-18,1,6,7,8,11,4,4,4,5,2,3,4,6,1,14.0,21.0,-7.0,3
6938,6938,2003-04,2003,2004,Fulham,Newcastle,Loss,Home,2003-10-21,0,4,7,8,9,6,6,7,8,-2,1,1,1,1,14.0,3.0,11.0,3
6939,6939,2003-04,2003,2004,Fulham,Man United,Win,Away,2003-10-25,3,1,4,7,8,6,9,10,13,-5,-5,-3,-5,0,14.0,1.0,13.0,3
6940,6940,2003-04,2003,2004,Fulham,Liverpool,Loss,Home,2003-11-02,0,3,4,7,10,3,3,3,6,0,1,4,4,1,14.0,5.0,9.0,4
6941,6941,2003-04,2003,2004,Fulham,Charlton,Loss,Away,2003-11-08,0,3,3,4,7,4,7,10,13,-1,-4,-6,-6,0,14.0,12.0,2.0,4
6942,6942,2003-04,2003,2004,Fulham,Portsmouth,Win,Home,2003-11-24,3,0,3,3,4,3,3,6,6,-3,0,-3,-2,1,14.0,21.0,-7.0,4
6943,6943,2003-04,2003,2004,Fulham,Arsenal,Draw,Away,2003-11-30,1,3,3,6,6,6,9,10,13,-3,-6,-4,-7,0,14.0,2.0,12.0,4
6944,6944,2003-04,2003,2004,Fulham,Bolton,Win,Home,2003-12-06,3,4,4,4,7,6,7,10,10,-2,-3,-6,-3,1,14.0,17.0,-3.0,5
6945,6945,2003-04,2003,2004,Fulham,Leeds,Loss,Away,2003-12-14,0,4,7,7,7,4,4,4,4,0,3,3,3,0,14.0,15.0,-1.0,5
6946,6946,2003-04,2003,2004,Fulham,Chelsea,Loss,Home,2003-12-20,0,3,4,7,7,1,4,7,10,2,0,0,-3,1,14.0,4.0,10.0,5
6947,6947,2003-04,2003,2004,Fulham,Southampton,Win,Home,2003-12-26,3,0,3,4,7,6,9,9,9,-6,-6,-5,-2,1,14.0,8.0,6.0,5
6948,6948,2003-04,2003,2004,Fulham,Aston Villa,Loss,Away,2003-12-28,0,3,3,6,7,4,7,7,10,-1,-4,-1,-3,0,14.0,16.0,-2.0,5
6949,6949,2003-04,2003,2004,Fulham,Middlesbrough,Loss,Away,2004-01-07,0,3,3,3,6,1,2,3,6,2,1,0,0,0,14.0,11.0,3.0,6
6950,6950,2003-04,2003,2004,Fulham,Everton,Win,Home,2004-01-10,3,0,3,3,3,4,4,7,10,-4,-1,-4,-7,1,14.0,7.0,7.0,6
6951,6951,2003-04,2003,2004,Fulham,Newcastle,Loss,Away,2004-01-19,0,3,3,6,6,4,4,5,6,-1,-1,1,0,0,14.0,3.0,11.0,6
6952,6952,2003-04,2003,2004,Fulham,Tottenham,Win,Home,2004-01-31,3,3,3,3,6,6,9,9,9,-3,-6,-6,-3,1,14.0,10.0,4.0,6
6953,6953,2003-04,2003,2004,Fulham,Southampton,Draw,Away,2004-02-07,1,3,6,6,6,3,3,4,4,0,3,2,2,0,14.0,8.0,6.0,7
6954,6954,2003-04,2003,2004,Fulham,Aston Villa,Loss,Home,2004-02-11,0,4,4,7,7,6,6,6,9,-2,-2,1,-2,1,14.0,16.0,-2.0,7
6955,6955,2003-04,2003,2004,Fulham,Wolves,Loss,Away,2004-02-21,0,1,4,4,7,0,1,2,5,1,3,2,2,0,14.0,21.0,-7.0,7
6956,6956,2003-04,2003,2004,Fulham,Man United,Draw,Home,2004-02-28,1,0,1,4,4,1,4,7,7,-1,-3,-3,-3,1,14.0,1.0,13.0,7
6957,6957,2003-04,2003,2004,Fulham,Leeds,Win,Home,2004-03-13,3,1,1,2,5,2,5,5,5,-1,-4,-3,0,1,14.0,15.0,-1.0,8
6958,6958,2003-04,2003,2004,Fulham,Chelsea,Loss,Away,2004-03-20,0,4,4,4,5,6,6,9,12,-2,-2,-5,-7,0,14.0,4.0,10.0,8
6959,6959,2003-04,2003,2004,Fulham,Man City,Draw,Away,2004-03-27,1,3,4,4,4,3,3,6,6,0,1,-2,-2,0,14.0,9.0,5.0,8
6960,6960,2003-04,2003,2004,Fulham,Birmingham,Draw,Home,2004-04-03,1,1,4,5,5,3,3,6,9,-2,1,-1,-4,1,14.0,13.0,1.0,9
6961,6961,2003-04,2003,2004,Fulham,Leicester,Win,Away,2004-04-10,3,2,2,5,6,1,2,5,6,1,0,0,0,0,14.0,21.0,-7.0,9
6962,6962,2003-04,2003,2004,Fulham,Blackburn,Loss,Home,2004-04-12,0,4,5,5,8,0,0,3,3,4,5,2,5,1,14.0,6.0,8.0,9
6963,6963,2003-04,2003,2004,Fulham,Liverpool,Draw,Away,2004-04-17,1,3,4,5,5,0,3,4,7,3,1,1,-2,0,14.0,5.0,9.0,9
6964,6964,2003-04,2003,2004,Fulham,Charlton,Win,Home,2004-04-24,3,1,4,5,6,1,4,5,5,0,0,0,1,1,14.0,12.0,2.0,9
6965,6965,2003-04,2003,2004,Fulham,Portsmouth,Draw,Away,2004-05-01,1,4,4,7,8,6,9,10,13,-2,-5,-3,-5,0,14.0,21.0,-7.0,10
6966,6966,2003-04,2003,2004,Fulham,Arsenal,Loss,Home,2004-05-09,0,4,5,5,8,2,3,6,7,2,2,-1,1,1,14.0,2.0,12.0,10
6967,6967,2003-04,2003,2004,Fulham,Bolton,Win,Away,2004-05-15,3,1,4,5,5,6,9,12,15,-5,-5,-7,-10,0,14.0,17.0,-3.0,10
6968,6968,2004-05,2004,2005,Fulham,Man City,Draw,Away,2004-08-14,1,3,4,7,8,3,6,7,7,0,-2,0,1,0,9.0,16.0,-7.0,1
6969,6969,2004-05,2004,2005,Fulham,Bolton,Win,Home,2004-08-21,3,4,4,5,8,3,6,9,12,1,-2,-4,-4,1,9.0,8.0,1.0,1
6970,6970,2004-05,2004,2005,Fulham,Middlesbrough,Loss,Home,2004-08-25,0,4,7,7,8,1,1,4,4,3,6,3,4,1,9.0,11.0,-2.0,1
6971,6971,2004-05,2004,2005,Fulham,Portsmouth,Loss,Away,2004-08-30,0,3,4,7,7,1,4,4,5,2,0,3,2,0,9.0,13.0,-4.0,1
6972,6972,2004-05,2004,2005,Fulham,Arsenal,Loss,Home,2004-09-11,0,0,3,4,7,6,9,12,15,-6,-6,-8,-8,1,9.0,1.0,8.0,2
6973,6973,2004-05,2004,2005,Fulham,West Brom,Draw,Away,2004-09-18,1,0,0,3,4,0,1,2,3,0,-1,1,1,0,9.0,21.0,-12.0,2
6974,6974,2004-05,2004,2005,Fulham,Southampton,Win,Home,2004-09-25,3,1,1,1,4,1,1,1,4,0,0,0,0,1,9.0,12.0,-3.0,2
6975,6975,2004-05,2004,2005,Fulham,Crystal Palace,Loss,Away,2004-10-04,0,4,4,4,4,1,1,1,1,3,3,3,3,0,9.0,21.0,-12.0,3
6976,6976,2004-05,2004,2005,Fulham,Liverpool,Loss,Home,2004-10-16,0,3,4,4,4,3,3,6,6,0,1,-2,-2,1,9.0,4.0,5.0,3
6977,6977,2004-05,2004,2005,Fulham,Aston Villa,Loss,Away,2004-10-23,0,0,3,4,4,1,2,3,4,-1,1,1,0,0,9.0,6.0,3.0,3
6978,6978,2004-05,2004,2005,Fulham,Tottenham,Win,Home,2004-10-30,3,0,0,3,4,0,3,3,4,0,-3,0,0,1,9.0,14.0,-5.0,3
6979,6979,2004-05,2004,2005,Fulham,Newcastle,Win,Away,2004-11-07,3,3,3,3,6,3,4,5,8,0,-1,-2,-2,0,9.0,5.0,4.0,4
6980,6980,2004-05,2004,2005,Fulham,Chelsea,Loss,Home,2004-11-13,0,6,6,6,6,6,9,9,12,0,-3,-3,-6,1,9.0,2.0,7.0,4
6981,6981,2004-05,2004,2005,Fulham,Everton,Loss,Away,2004-11-20,0,3,6,6,6,3,4,7,10,0,2,-1,-4,0,9.0,17.0,-8.0,4
6982,6982,2004-05,2004,2005,Fulham,Blackburn,Loss,Home,2004-11-27,0,0,3,6,6,2,3,4,4,-2,0,2,2,1,9.0,15.0,-6.0,4
6983,6983,2004-05,2004,2005,Fulham,Norwich,Win,Away,2004-12-04,3,0,0,3,6,4,4,5,6,-4,-4,-2,0,0,9.0,21.0,-12.0,5
6984,6984,2004-05,2004,2005,Fulham,Man United,Draw,Home,2004-12-13,1,3,3,3,6,6,9,12,13,-3,-6,-9,-7,1,9.0,3.0,6.0,5
6985,6985,2004-05,2004,2005,Fulham,Charlton,Loss,Away,2004-12-20,0,4,4,4,4,6,6,6,9,-2,-2,-2,-5,0,9.0,7.0,2.0,5
6986,6986,2004-05,2004,2005,Fulham,Arsenal,Loss,Away,2004-12-26,0,1,4,4,4,4,7,7,8,-3,-3,-3,-4,0,9.0,1.0,8.0,5
6987,6987,2004-05,2004,2005,Fulham,Birmingham,Loss,Home,2004-12-28,0,0,1,4,4,6,9,9,10,-6,-8,-5,-6,1,9.0,10.0,-1.0,5
6988,6988,2004-05,2004,2005,Fulham,Crystal Palace,Win,Home,2005-01-01,3,0,0,1,4,1,1,2,2,-1,-1,-1,2,1,9.0,21.0,-12.0,6
6989,6989,2004-05,2004,2005,Fulham,Southampton,Draw,Away,2005-01-05,1,3,3,3,4,0,1,1,2,3,2,2,2,0,9.0,12.0,-3.0,6
6990,6990,2004-05,2004,2005,Fulham,West Brom,Win,Home,2005-01-16,3,4,4,4,4,2,3,3,3,2,1,1,1,1,9.0,21.0,-12.0,6
6991,6991,2004-05,2004,2005,Fulham,Birmingham,Win,Away,2005-01-22,3,4,7,7,7,0,0,3,6,4,7,4,1,0,9.0,10.0,-1.0,6
6992,6992,2004-05,2004,2005,Fulham,Aston Villa,Draw,Home,2005-02-02,1,6,7,10,10,3,3,6,6,3,4,4,4,1,9.0,6.0,3.0,7
6993,6993,2004-05,2004,2005,Fulham,Liverpool,Loss,Away,2005-02-05,0,4,7,8,11,3,3,6,6,1,4,2,5,0,9.0,4.0,5.0,7
6994,6994,2004-05,2004,2005,Fulham,Tottenham,Loss,Away,2005-02-26,0,1,4,7,8,3,3,3,4,-2,1,4,4,0,9.0,14.0,-5.0,7
6995,6995,2004-05,2004,2005,Fulham,Charlton,Draw,Home,2005-03-05,1,0,1,4,7,2,2,5,8,-2,-1,-1,-1,1,9.0,7.0,2.0,8
6996,6996,2004-05,2004,2005,Fulham,Man United,Loss,Away,2005-03-19,0,1,1,2,5,4,7,10,13,-3,-6,-8,-8,0,9.0,3.0,6.0,8
6997,6997,2004-05,2004,2005,Fulham,Portsmouth,Win,Home,2005-04-03,3,1,1,1,2,1,1,1,1,0,0,0,1,1,9.0,13.0,-4.0,9
6998,6998,2004-05,2004,2005,Fulham,Bolton,Loss,Away,2005-04-09,0,3,4,4,4,3,6,6,7,0,-2,-2,-3,0,9.0,8.0,1.0,9
6999,6999,2004-05,2004,2005,Fulham,Man City,Draw,Home,2005-04-16,1,3,3,4,4,4,4,4,7,-1,-1,0,-3,1,9.0,16.0,-7.0,9
7000,7000,2004-05,2004,2005,Fulham,Middlesbrough,Draw,Away,2005-04-19,1,1,4,4,5,3,3,3,4,-2,1,1,1,0,9.0,11.0,-2.0,9
7001,7001,2004-05,2004,2005,Fulham,Chelsea,Loss,Away,2005-04-23,0,2,2,5,5,2,5,8,11,0,-3,-3,-6,0,9.0,2.0,7.0,9
7002,7002,2004-05,2004,2005,Fulham,Everton,Win,Home,2005-04-30,3,1,2,2,5,4,7,7,7,-3,-5,-5,-2,1,9.0,17.0,-8.0,9
7003,7003,2004-05,2004,2005,Fulham,Newcastle,Loss,Home,2005-05-04,0,3,4,5,5,2,2,2,2,1,2,3,3,1,9.0,5.0,4.0,10
7004,7004,2004-05,2004,2005,Fulham,Blackburn,Win,Away,2005-05-07,3,3,3,4,5,1,2,5,8,2,1,-1,-3,0,9.0,15.0,-6.0,10
7005,7005,2004-05,2004,2005,Fulham,Norwich,Win,Home,2005-05-15,3,3,6,6,7,3,6,9,10,0,0,-3,-3,1,9.0,21.0,-12.0,10
7006,7006,2005-06,2005,2006,Fulham,Birmingham,Draw,Home,2005-08-13,1,6,6,9,9,3,6,7,7,3,0,2,2,1,13.0,12.0,1.0,1
7007,7007,2005-06,2005,2006,Fulham,Blackburn,Loss,Away,2005-08-20,0,4,7,7,10,1,1,1,2,3,6,6,8,0,13.0,15.0,-2.0,1
7008,7008,2005-06,2005,2006,Fulham,Arsenal,Loss,Away,2005-08-24,0,1,4,7,7,3,3,6,9,-2,1,1,-2,0,13.0,2.0,11.0,1
7009,7009,2005-06,2005,2006,Fulham,Everton,Win,Home,2005-08-27,3,0,1,4,7,3,3,3,6,-3,-2,1,1,1,13.0,4.0,9.0,1
7010,7010,2005-06,2005,2006,Fulham,Newcastle,Draw,Away,2005-09-10,1,3,3,4,7,0,1,1,2,3,2,3,5,0,13.0,14.0,-1.0,2
7011,7011,2005-06,2005,2006,Fulham,West Ham,Loss,Home,2005-09-17,0,4,4,4,5,3,4,7,8,1,0,-3,-3,1,13.0,21.0,-8.0,2
7012,7012,2005-06,2005,2006,Fulham,Tottenham,Loss,Away,2005-09-26,0,1,4,4,4,2,2,3,6,-1,2,1,-2,0,13.0,9.0,4.0,2
7013,7013,2005-06,2005,2006,Fulham,Man United,Loss,Home,2005-10-01,0,0,1,4,4,1,2,5,8,-1,-1,-1,-4,1,13.0,3.0,10.0,3
7014,7014,2005-06,2005,2006,Fulham,Charlton,Draw,Away,2005-10-17,1,0,0,1,4,3,3,6,9,-3,-3,-5,-5,0,13.0,11.0,2.0,3
7015,7015,2005-06,2005,2006,Fulham,Liverpool,Win,Home,2005-10-22,3,1,1,1,2,3,4,5,6,-2,-3,-4,-4,1,13.0,5.0,8.0,3
7016,7016,2005-06,2005,2006,Fulham,Wigan,Loss,Away,2005-10-29,0,4,4,4,4,6,9,12,13,-2,-5,-8,-9,0,13.0,21.0,-8.0,3
7017,7017,2005-06,2005,2006,Fulham,Man City,Win,Home,2005-11-05,3,3,4,4,4,3,6,9,9,0,-2,-5,-5,1,13.0,8.0,5.0,4
7018,7018,2005-06,2005,2006,Fulham,Middlesbrough,Loss,Away,2005-11-20,0,3,6,7,7,3,3,4,7,0,3,3,0,0,13.0,7.0,6.0,4
7019,7019,2005-06,2005,2006,Fulham,Bolton,Win,Home,2005-11-27,3,3,3,6,7,6,9,9,9,-3,-6,-3,-2,1,13.0,6.0,7.0,4
7020,7020,2005-06,2005,2006,Fulham,West Brom,Draw,Away,2005-12-03,1,3,6,6,9,4,4,4,4,-1,2,2,5,0,13.0,17.0,-4.0,5
7021,7021,2005-06,2005,2006,Fulham,Birmingham,Loss,Away,2005-12-10,0,4,4,7,7,3,3,3,3,1,1,4,4,0,13.0,12.0,1.0,5
7022,7022,2005-06,2005,2006,Fulham,Blackburn,Win,Home,2005-12-17,3,1,4,4,7,3,3,4,7,-2,1,0,0,1,13.0,15.0,-2.0,5
7023,7023,2005-06,2005,2006,Fulham,Chelsea,Loss,Away,2005-12-26,0,3,4,7,7,6,9,12,15,-3,-5,-5,-8,0,13.0,1.0,12.0,5
7024,7024,2005-06,2005,2006,Fulham,Aston Villa,Draw,Home,2005-12-28,1,3,3,4,7,3,4,5,8,0,-1,-1,-1,1,13.0,10.0,3.0,5
7025,7025,2005-06,2005,2006,Fulham,Portsmouth,Loss,Away,2005-12-31,0,1,4,4,5,1,4,4,4,0,0,0,1,0,13.0,16.0,-3.0,5
7026,7026,2005-06,2005,2006,Fulham,Sunderland,Win,Home,2006-01-02,3,1,1,4,4,1,1,1,1,0,0,3,3,1,13.0,21.0,-8.0,6
7027,7027,2005-06,2005,2006,Fulham,Newcastle,Win,Home,2006-01-14,3,3,4,4,7,1,1,4,7,2,3,0,0,1,13.0,14.0,-1.0,6
7028,7028,2005-06,2005,2006,Fulham,West Ham,Loss,Away,2006-01-23,0,6,6,7,7,3,3,3,4,3,3,4,3,0,13.0,21.0,-8.0,6
7029,7029,2005-06,2005,2006,Fulham,Tottenham,Win,Home,2006-01-31,3,3,6,6,7,1,4,7,7,2,2,-1,0,1,13.0,9.0,4.0,6
7030,7030,2005-06,2005,2006,Fulham,Man United,Loss,Away,2006-02-04,0,3,6,9,9,3,3,4,7,0,3,5,2,0,13.0,3.0,10.0,7
7031,7031,2005-06,2005,2006,Fulham,West Brom,Win,Home,2006-02-11,3,3,3,6,9,4,4,7,7,-1,-1,-1,2,1,13.0,17.0,-4.0,7
7032,7032,2005-06,2005,2006,Fulham,Bolton,Loss,Away,2006-02-26,0,3,6,6,9,2,3,6,7,1,3,0,2,0,13.0,6.0,7.0,7
7033,7033,2005-06,2005,2006,Fulham,Arsenal,Loss,Home,2006-03-04,0,3,3,6,6,0,1,4,4,3,2,2,2,1,13.0,2.0,11.0,8
7034,7034,2005-06,2005,2006,Fulham,Everton,Loss,Away,2006-03-11,0,0,3,3,6,1,4,7,8,-1,-1,-4,-2,0,13.0,4.0,9.0,8
7035,7035,2005-06,2005,2006,Fulham,Liverpool,Loss,Away,2006-03-15,0,0,0,3,3,1,4,7,10,-1,-4,-4,-7,0,13.0,5.0,8.0,8
7036,7036,2005-06,2005,2006,Fulham,Chelsea,Win,Home,2006-03-19,3,0,0,0,3,6,9,9,12,-6,-9,-9,-9,1,13.0,1.0,12.0,8
7037,7037,2005-06,2005,2006,Fulham,Aston Villa,Draw,Away,2006-03-25,1,3,3,3,3,0,3,4,4,3,0,-1,-1,0,13.0,10.0,3.0,8
7038,7038,2005-06,2005,2006,Fulham,Portsmouth,Loss,Home,2006-04-01,0,4,4,4,4,6,6,6,6,-2,-2,-2,-2,1,13.0,16.0,-3.0,9
7039,7039,2005-06,2005,2006,Fulham,Charlton,Win,Home,2006-04-15,3,1,4,4,4,2,5,5,8,-1,-1,-1,-4,1,13.0,11.0,2.0,9
7040,7040,2005-06,2005,2006,Fulham,Wigan,Win,Home,2006-04-24,3,3,4,7,7,3,4,5,5,0,0,2,2,1,13.0,21.0,-8.0,9
7041,7041,2005-06,2005,2006,Fulham,Man City,Win,Away,2006-04-29,3,6,6,7,10,3,3,3,3,3,3,4,7,0,13.0,8.0,5.0,9
7042,7042,2005-06,2005,2006,Fulham,Sunderland,Loss,Away,2006-05-04,0,6,9,9,10,0,0,1,2,6,9,8,8,0,13.0,21.0,-8.0,10
7043,7043,2005-06,2005,2006,Fulham,Middlesbrough,Win,Home,2006-05-07,3,3,6,9,9,2,2,5,5,1,4,4,4,1,13.0,7.0,6.0,10
7044,7044,2006-07,2006,2007,Fulham,Man United,Loss,Away,2006-08-20,0,3,6,9,12,4,4,7,8,-1,2,2,4,0,12.0,2.0,10.0,1
7045,7045,2006-07,2006,2007,Fulham,Bolton,Draw,Home,2006-08-23,1,3,3,6,9,6,7,7,10,-3,-4,-1,-1,1,12.0,8.0,4.0,1
7046,7046,2006-07,2006,2007,Fulham,Sheffield United,Win,Home,2006-08-26,3,1,4,4,7,1,1,2,5,0,3,2,2,1,12.0,21.0,-9.0,1
7047,7047,2006-07,2006,2007,Fulham,Newcastle,Win,Away,2006-09-09,3,4,4,7,7,3,6,7,10,1,-2,0,-3,0,12.0,7.0,5.0,2
7048,7048,2006-07,2006,2007,Fulham,Tottenham,Draw,Away,2006-09-17,1,6,7,7,10,0,3,3,3,6,4,4,7,0,12.0,5.0,7.0,2
7049,7049,2006-07,2006,2007,Fulham,Chelsea,Loss,Home,2006-09-23,0,4,7,8,8,6,9,9,12,-2,-2,-1,-4,1,12.0,1.0,11.0,2
7050,7050,2006-07,2006,2007,Fulham,Watford,Draw,Away,2006-10-02,1,1,4,7,8,2,2,2,3,-1,2,5,5,0,12.0,21.0,-9.0,3
7051,7051,2006-07,2006,2007,Fulham,Charlton,Win,Home,2006-10-16,3,1,2,5,8,0,0,0,3,1,2,5,5,1,12.0,13.0,-1.0,3
7052,7052,2006-07,2006,2007,Fulham,Aston Villa,Draw,Away,2006-10-21,1,4,4,5,8,2,5,6,7,2,-1,-1,1,0,12.0,16.0,-4.0,3
7053,7053,2006-07,2006,2007,Fulham,Wigan,Loss,Home,2006-10-28,0,4,5,5,6,3,3,4,5,1,2,1,1,1,12.0,10.0,2.0,3
7054,7054,2006-07,2006,2007,Fulham,Everton,Win,Home,2006-11-04,3,1,4,5,5,4,4,5,6,-3,0,0,-1,1,12.0,11.0,1.0,4
7055,7055,2006-07,2006,2007,Fulham,Portsmouth,Draw,Away,2006-11-11,1,3,4,7,8,3,3,6,6,0,1,1,2,0,12.0,17.0,-5.0,4
7056,7056,2006-07,2006,2007,Fulham,Man City,Loss,Away,2006-11-18,0,4,4,5,8,1,4,4,5,3,0,1,3,0,12.0,15.0,-3.0,4
7057,7057,2006-07,2006,2007,Fulham,Reading,Loss,Home,2006-11-25,0,1,4,4,5,6,6,6,6,-5,-2,-2,-1,1,12.0,21.0,-9.0,4
7058,7058,2006-07,2006,2007,Fulham,Arsenal,Win,Home,2006-11-29,3,0,1,4,4,1,4,4,5,-1,-3,0,-1,1,12.0,4.0,8.0,4
7059,7059,2006-07,2006,2007,Fulham,Blackburn,Loss,Away,2006-12-02,0,3,3,4,7,1,1,1,1,2,2,3,6,0,12.0,6.0,6.0,5
7060,7060,2006-07,2006,2007,Fulham,Liverpool,Loss,Away,2006-12-09,0,3,3,3,4,4,7,8,8,-1,-4,-5,-4,0,12.0,3.0,9.0,5
7061,7061,2006-07,2006,2007,Fulham,Middlesbrough,Win,Home,2006-12-18,3,0,3,3,3,1,1,2,3,-1,2,1,0,1,12.0,14.0,-2.0,5
7062,7062,2006-07,2006,2007,Fulham,West Ham,Draw,Home,2006-12-23,1,3,3,6,6,3,3,3,6,0,0,3,0,1,12.0,9.0,3.0,5
7063,7063,2006-07,2006,2007,Fulham,Charlton,Draw,Away,2006-12-27,1,4,4,4,7,0,0,3,3,4,4,1,4,0,12.0,13.0,-1.0,5
7064,7064,2006-07,2006,2007,Fulham,Chelsea,Draw,Away,2006-12-30,1,2,5,5,5,4,7,10,11,-2,-2,-5,-6,0,12.0,1.0,11.0,5
7065,7065,2006-07,2006,2007,Fulham,Watford,Draw,Home,2007-01-01,1,2,3,6,6,0,0,1,2,2,3,5,4,1,12.0,21.0,-9.0,6
7066,7066,2006-07,2006,2007,Fulham,West Ham,Draw,Away,2007-01-13,1,2,3,4,7,0,0,1,4,2,3,3,3,0,12.0,9.0,3.0,6
7067,7067,2006-07,2006,2007,Fulham,Tottenham,Draw,Home,2007-01-20,1,2,3,4,5,1,1,4,4,1,2,0,1,1,12.0,5.0,7.0,6
7068,7068,2006-07,2006,2007,Fulham,Sheffield United,Loss,Away,2007-01-30,0,2,3,4,5,1,1,4,4,1,2,0,1,0,12.0,21.0,-9.0,6
7069,7069,2006-07,2006,2007,Fulham,Newcastle,Win,Home,2007-02-03,3,1,2,3,4,4,7,8,8,-3,-5,-5,-4,1,12.0,7.0,5.0,7
7070,7070,2006-07,2006,2007,Fulham,Bolton,Loss,Away,2007-02-11,0,3,4,5,6,4,4,5,5,-1,0,0,1,0,12.0,8.0,4.0,7
7071,7071,2006-07,2006,2007,Fulham,Man United,Loss,Home,2007-02-24,0,3,3,4,5,6,9,9,12,-3,-6,-5,-7,1,12.0,2.0,10.0,7
7072,7072,2006-07,2006,2007,Fulham,Aston Villa,Draw,Home,2007-03-03,1,0,3,3,4,3,3,6,6,-3,0,-3,-2,1,12.0,16.0,-4.0,8
7073,7073,2006-07,2006,2007,Fulham,Wigan,Draw,Away,2007-03-17,1,1,1,4,4,6,7,7,10,-5,-6,-3,-6,0,12.0,10.0,2.0,8
7074,7074,2006-07,2006,2007,Fulham,Portsmouth,Draw,Home,2007-03-31,1,2,2,2,5,1,1,4,4,1,1,-2,1,1,12.0,17.0,-5.0,8
7075,7075,2006-07,2006,2007,Fulham,Everton,Loss,Away,2007-04-06,0,2,3,3,3,4,5,8,8,-2,-2,-5,-5,0,12.0,11.0,1.0,9
7076,7076,2006-07,2006,2007,Fulham,Man City,Loss,Home,2007-04-09,0,1,2,3,3,4,7,7,7,-3,-5,-4,-4,1,12.0,15.0,-3.0,9
7077,7077,2006-07,2006,2007,Fulham,Reading,Loss,Away,2007-04-14,0,0,1,2,3,1,1,2,2,-1,0,0,1,0,12.0,21.0,-9.0,9
7078,7078,2006-07,2006,2007,Fulham,Blackburn,Draw,Home,2007-04-21,1,0,0,1,2,3,3,3,6,-3,-3,-2,-4,1,12.0,6.0,6.0,9
7079,7079,2006-07,2006,2007,Fulham,Arsenal,Loss,Away,2007-04-29,0,1,1,1,2,4,7,8,8,-3,-6,-7,-6,0,12.0,4.0,8.0,9
7080,7080,2006-07,2006,2007,Fulham,Liverpool,Win,Home,2007-05-05,3,1,1,1,1,3,6,7,10,-2,-5,-6,-9,1,12.0,3.0,9.0,10
7081,7081,2006-07,2006,2007,Fulham,Middlesbrough,Loss,Away,2007-05-13,0,3,4,4,4,3,4,4,4,0,0,0,0,0,12.0,14.0,-2.0,10
7082,7082,2007-08,2007,2008,Fulham,Arsenal,Loss,Away,2007-08-12,0,3,3,4,4,2,5,6,9,1,-2,-2,-5,0,16.0,4.0,12.0,1
7083,7083,2007-08,2007,2008,Fulham,Bolton,Win,Home,2007-08-15,3,0,3,3,4,1,1,2,2,-1,2,1,2,1,16.0,7.0,9.0,1
7084,7084,2007-08,2007,2008,Fulham,Middlesbrough,Loss,Home,2007-08-18,0,3,3,6,6,0,3,6,6,3,0,0,0,1,16.0,12.0,4.0,1
7085,7085,2007-08,2007,2008,Fulham,Aston Villa,Loss,Away,2007-08-25,0,3,3,3,6,1,2,5,8,2,1,-2,-2,0,16.0,11.0,5.0,1
7086,7086,2007-08,2007,2008,Fulham,Tottenham,Draw,Home,2007-09-01,1,0,3,3,3,3,3,3,6,-3,0,0,-3,1,16.0,5.0,11.0,2
7087,7087,2007-08,2007,2008,Fulham,Wigan,Draw,Away,2007-09-15,1,1,1,4,4,1,4,7,7,0,-3,-3,-3,0,16.0,17.0,-1.0,2
7088,7088,2007-08,2007,2008,Fulham,Man City,Draw,Home,2007-09-22,1,2,2,2,5,3,3,6,9,-1,-1,-4,-4,1,16.0,14.0,2.0,2
7089,7089,2007-08,2007,2008,Fulham,Chelsea,Draw,Away,2007-09-29,1,2,3,3,3,1,1,4,5,1,2,-1,-2,0,16.0,2.0,14.0,2
7090,7090,2007-08,2007,2008,Fulham,Portsmouth,Loss,Home,2007-10-07,0,2,3,4,4,6,7,7,7,-4,-4,-3,-3,1,16.0,9.0,7.0,3
7091,7091,2007-08,2007,2008,Fulham,Derby,Draw,Home,2007-10-20,1,1,2,3,4,1,1,4,4,0,1,-1,0,1,16.0,21.0,-5.0,3
7092,7092,2007-08,2007,2008,Fulham,Sunderland,Draw,Away,2007-10-27,1,1,2,3,4,0,0,1,4,1,2,2,0,0,16.0,21.0,-5.0,3
7093,7093,2007-08,2007,2008,Fulham,Reading,Win,Home,2007-11-03,3,2,2,3,4,3,6,6,9,-1,-4,-3,-5,1,16.0,8.0,8.0,4
7094,7094,2007-08,2007,2008,Fulham,Liverpool,Loss,Away,2007-11-10,0,4,5,5,6,2,5,6,9,2,0,-1,-3,0,16.0,3.0,13.0,4
7095,7095,2007-08,2007,2008,Fulham,Blackburn,Draw,Home,2007-11-25,1,3,4,5,5,1,4,7,10,2,0,-2,-5,1,16.0,10.0,6.0,4
7096,7096,2007-08,2007,2008,Fulham,Man United,Loss,Away,2007-12-03,0,1,4,5,6,3,4,7,10,-2,0,-2,-4,0,16.0,1.0,15.0,5
7097,7097,2007-08,2007,2008,Fulham,Everton,Loss,Away,2007-12-08,0,1,1,4,5,4,5,8,11,-3,-4,-4,-6,0,16.0,6.0,10.0,5
7098,7098,2007-08,2007,2008,Fulham,Newcastle,Loss,Home,2007-12-15,0,0,1,1,4,4,4,4,5,-4,-3,-3,-1,1,16.0,13.0,3.0,5
7099,7099,2007-08,2007,2008,Fulham,Wigan,Draw,Home,2007-12-22,1,0,0,1,1,3,4,4,4,-3,-4,-3,-3,1,16.0,17.0,-1.0,5
7100,7100,2007-08,2007,2008,Fulham,Tottenham,Loss,Away,2007-12-26,0,1,1,1,2,3,6,6,7,-2,-5,-5,-5,0,16.0,5.0,11.0,5
7101,7101,2007-08,2007,2008,Fulham,Birmingham,Draw,Away,2007-12-29,1,1,1,1,1,3,4,4,7,-2,-3,-3,-6,0,16.0,21.0,-5.0,5
7102,7102,2007-08,2007,2008,Fulham,Chelsea,Loss,Home,2008-01-01,0,1,2,2,2,4,7,7,10,-3,-5,-5,-8,1,16.0,2.0,14.0,6
7103,7103,2007-08,2007,2008,Fulham,West Ham,Loss,Away,2008-01-12,0,1,1,2,2,3,4,7,7,-2,-3,-5,-5,0,16.0,15.0,1.0,6
7104,7104,2007-08,2007,2008,Fulham,Arsenal,Loss,Home,2008-01-19,0,0,1,1,2,4,7,8,11,-4,-6,-7,-9,1,16.0,4.0,12.0,6
7105,7105,2007-08,2007,2008,Fulham,Bolton,Draw,Away,2008-01-29,1,0,0,1,1,1,4,4,4,-1,-4,-3,-3,0,16.0,7.0,9.0,6
7106,7106,2007-08,2007,2008,Fulham,Aston Villa,Win,Home,2008-02-03,3,1,1,1,2,2,5,8,11,-1,-4,-7,-9,1,16.0,11.0,5.0,7
7107,7107,2007-08,2007,2008,Fulham,Middlesbrough,Loss,Away,2008-02-09,0,4,4,4,4,4,5,6,6,0,-1,-2,-2,0,16.0,12.0,4.0,7
7108,7108,2007-08,2007,2008,Fulham,West Ham,Loss,Home,2008-02-23,0,3,4,4,4,1,4,5,8,2,0,-1,-4,1,16.0,15.0,1.0,7
7109,7109,2007-08,2007,2008,Fulham,Man United,Loss,Home,2008-03-01,0,0,3,4,4,3,4,7,10,-3,-1,-3,-6,1,16.0,1.0,15.0,8
7110,7110,2007-08,2007,2008,Fulham,Blackburn,Draw,Away,2008-03-08,1,0,0,3,4,6,6,7,8,-6,-6,-4,-4,0,16.0,10.0,6.0,8
7111,7111,2007-08,2007,2008,Fulham,Everton,Win,Home,2008-03-16,3,1,1,1,4,6,9,12,13,-5,-8,-11,-9,1,16.0,6.0,10.0,8
7112,7112,2007-08,2007,2008,Fulham,Newcastle,Loss,Away,2008-03-22,0,4,4,4,4,1,1,1,1,3,3,3,3,0,16.0,13.0,3.0,8
7113,7113,2007-08,2007,2008,Fulham,Derby,Draw,Away,2008-03-29,1,3,4,4,4,0,0,1,1,3,4,3,3,0,16.0,21.0,-5.0,8
7114,7114,2007-08,2007,2008,Fulham,Sunderland,Loss,Home,2008-04-05,0,1,4,5,5,6,6,6,7,-5,-2,-1,-2,1,16.0,21.0,-5.0,9
7115,7115,2007-08,2007,2008,Fulham,Reading,Win,Away,2008-04-12,3,1,1,4,5,1,4,4,7,0,-3,0,-2,0,16.0,8.0,8.0,9
7116,7116,2007-08,2007,2008,Fulham,Liverpool,Loss,Home,2008-04-19,0,3,4,4,7,4,7,7,10,-1,-3,-3,-3,1,16.0,3.0,13.0,9
7117,7117,2007-08,2007,2008,Fulham,Man City,Win,Away,2008-04-26,3,3,3,4,4,6,6,6,7,-3,-3,-2,-3,0,16.0,14.0,2.0,9
7118,7118,2007-08,2007,2008,Fulham,Birmingham,Win,Home,2008-05-03,3,3,6,6,7,1,2,2,5,2,4,4,2,1,16.0,21.0,-5.0,10
7119,7119,2007-08,2007,2008,Fulham,Portsmouth,Win,Away,2008-05-11,3,6,6,9,9,0,0,1,4,6,6,8,5,0,16.0,9.0,7.0,10
7120,7120,2008-09,2008,2009,Fulham,Hull,Loss,Away,2008-08-16,0,6,9,9,12,0,0,0,0,6,9,9,12,0,17.0,21.0,-4.0,1
7121,7121,2008-09,2008,2009,Fulham,Arsenal,Win,Home,2008-08-23,3,3,6,9,9,6,9,12,15,-3,-3,-3,-6,1,17.0,3.0,14.0,1
7122,7122,2008-09,2008,2009,Fulham,Bolton,Win,Home,2008-09-13,3,3,6,9,12,1,4,5,8,2,2,4,4,1,17.0,16.0,1.0,2
7123,7123,2008-09,2008,2009,Fulham,Blackburn,Loss,Away,2008-09-20,0,6,6,9,12,0,1,4,4,6,5,5,8,0,17.0,7.0,10.0,2
7124,7124,2008-09,2008,2009,Fulham,West Ham,Loss,Home,2008-09-27,0,3,6,6,9,3,6,6,9,0,0,0,0,1,17.0,10.0,7.0,2
7125,7125,2008-09,2008,2009,Fulham,West Brom,Loss,Away,2008-10-04,0,0,3,6,6,3,6,7,7,-3,-3,-1,-1,0,17.0,21.0,-4.0,3
7126,7126,2008-09,2008,2009,Fulham,Sunderland,Draw,Home,2008-10-18,1,0,0,3,6,1,4,5,5,-1,-4,-2,1,1,17.0,15.0,2.0,3
7127,7127,2008-09,2008,2009,Fulham,Portsmouth,Draw,Away,2008-10-26,1,1,1,1,4,4,7,7,10,-3,-6,-6,-6,0,17.0,8.0,9.0,3
7128,7128,2008-09,2008,2009,Fulham,Wigan,Win,Home,2008-10-29,3,2,2,2,2,0,0,3,4,2,2,-1,-2,1,17.0,14.0,3.0,3
7129,7129,2008-09,2008,2009,Fulham,Everton,Loss,Away,2008-11-01,0,4,5,5,5,4,4,5,5,0,1,0,0,0,17.0,5.0,12.0,4
7130,7130,2008-09,2008,2009,Fulham,Newcastle,Win,Home,2008-11-09,3,3,4,5,5,6,6,7,8,-3,-2,-2,-3,1,17.0,12.0,5.0,4
7131,7131,2008-09,2008,2009,Fulham,Tottenham,Win,Home,2008-11-15,3,3,6,7,8,6,7,10,10,-3,-1,-3,-2,1,17.0,11.0,6.0,4
7132,7132,2008-09,2008,2009,Fulham,Liverpool,Draw,Away,2008-11-22,1,6,6,9,10,6,6,9,12,0,0,0,-2,0,17.0,4.0,13.0,4
7133,7133,2008-09,2008,2009,Fulham,Aston Villa,Draw,Away,2008-11-29,1,4,7,7,10,4,4,4,7,0,3,3,3,0,17.0,6.0,11.0,4
7134,7134,2008-09,2008,2009,Fulham,Man City,Draw,Home,2008-12-06,1,2,5,8,8,3,4,4,4,-1,1,4,4,1,17.0,9.0,8.0,5
7135,7135,2008-09,2008,2009,Fulham,Stoke,Draw,Away,2008-12-13,1,2,3,6,9,2,5,5,6,0,-2,1,3,0,17.0,21.0,-4.0,5
7136,7136,2008-09,2008,2009,Fulham,Middlesbrough,Win,Home,2008-12-20,3,2,3,4,7,1,2,2,3,1,1,2,4,1,17.0,13.0,4.0,5
7137,7137,2008-09,2008,2009,Fulham,Tottenham,Draw,Away,2008-12-26,1,4,5,6,7,1,4,4,7,3,1,2,0,0,17.0,11.0,6.0,5
7138,7138,2008-09,2008,2009,Fulham,Chelsea,Draw,Home,2008-12-28,1,4,5,6,7,4,5,8,8,0,0,-2,-1,1,17.0,2.0,15.0,5
7139,7139,2008-09,2008,2009,Fulham,West Ham,Loss,Away,2009-01-18,0,2,5,6,7,4,7,7,8,-2,-2,-1,-1,0,17.0,10.0,7.0,6
7140,7140,2008-09,2008,2009,Fulham,Sunderland,Loss,Away,2009-01-27,0,1,2,5,6,1,1,2,5,0,1,3,1,0,17.0,15.0,2.0,6
7141,7141,2008-09,2008,2009,Fulham,Portsmouth,Win,Home,2009-01-31,3,0,1,2,5,1,1,1,1,-1,0,1,4,1,17.0,8.0,9.0,6
7142,7142,2008-09,2008,2009,Fulham,Wigan,Draw,Away,2009-02-07,1,3,3,4,5,2,2,2,5,1,1,2,0,0,17.0,14.0,3.0,7
7143,7143,2008-09,2008,2009,Fulham,Man United,Loss,Away,2009-02-18,0,4,4,4,5,6,9,12,15,-2,-5,-8,-10,0,17.0,1.0,16.0,7
7144,7144,2008-09,2008,2009,Fulham,West Brom,Win,Home,2009-02-22,3,1,4,4,4,1,1,4,4,0,3,0,0,1,17.0,21.0,-4.0,7
7145,7145,2008-09,2008,2009,Fulham,Arsenal,Draw,Away,2009-02-28,1,3,4,7,7,2,3,4,7,1,1,3,0,0,17.0,3.0,14.0,7
7146,7146,2008-09,2008,2009,Fulham,Hull,Loss,Home,2009-03-04,0,4,4,5,8,0,1,2,2,4,3,3,6,1,17.0,21.0,-4.0,8
7147,7147,2008-09,2008,2009,Fulham,Blackburn,Loss,Home,2009-03-11,0,1,4,4,5,4,4,4,5,-3,0,0,0,1,17.0,7.0,10.0,8
7148,7148,2008-09,2008,2009,Fulham,Bolton,Win,Away,2009-03-14,3,0,1,4,4,3,6,6,9,-3,-5,-2,-5,0,17.0,16.0,1.0,8
7149,7149,2008-09,2008,2009,Fulham,Man United,Win,Home,2009-03-21,3,3,3,4,7,3,6,9,12,0,-3,-5,-5,1,17.0,1.0,16.0,8
7150,7150,2008-09,2008,2009,Fulham,Liverpool,Loss,Home,2009-04-04,0,6,6,6,7,6,9,9,10,0,-3,-3,-3,1,17.0,4.0,13.0,9
7151,7151,2008-09,2008,2009,Fulham,Man City,Win,Away,2009-04-12,3,3,6,6,6,3,3,6,6,0,3,0,0,0,17.0,9.0,8.0,9
7152,7152,2008-09,2008,2009,Fulham,Middlesbrough,Draw,Away,2009-04-18,1,3,6,9,9,3,3,4,4,0,3,5,5,0,17.0,13.0,4.0,9
7153,7153,2008-09,2008,2009,Fulham,Stoke,Win,Home,2009-04-25,3,4,4,7,10,4,7,10,10,0,-3,-3,0,1,17.0,21.0,-4.0,9
7154,7154,2008-09,2008,2009,Fulham,Chelsea,Loss,Away,2009-05-02,0,4,7,7,10,4,7,10,10,0,0,-3,0,0,17.0,2.0,15.0,10
7155,7155,2008-09,2008,2009,Fulham,Aston Villa,Win,Home,2009-05-09,3,3,4,7,7,4,5,6,6,-1,-1,1,1,1,17.0,6.0,11.0,10
7156,7156,2008-09,2008,2009,Fulham,Newcastle,Win,Away,2009-05-16,3,3,6,7,10,3,4,4,5,0,2,3,5,0,17.0,12.0,5.0,10
7157,7157,2008-09,2008,2009,Fulham,Everton,Loss,Home,2009-05-24,0,6,6,9,10,4,7,7,8,2,-1,2,2,1,17.0,5.0,12.0,10
7158,7158,2009-10,2009,2010,Fulham,Portsmouth,Win,Away,2009-08-15,3,3,6,6,9,3,3,3,4,0,3,3,5,0,7.0,14.0,-7.0,1
7159,7159,2009-10,2009,2010,Fulham,Chelsea,Loss,Home,2009-08-23,0,3,6,9,9,6,9,12,15,-3,-3,-3,-6,1,7.0,3.0,4.0,1
7160,7160,2009-10,2009,2010,Fulham,Aston Villa,Loss,Away,2009-08-30,0,3,3,6,9,3,6,7,7,0,-3,-1,2,0,7.0,6.0,1.0,1
7161,7161,2009-10,2009,2010,Fulham,Everton,Win,Home,2009-09-13,3,0,3,3,6,3,3,6,9,-3,0,-3,-3,1,7.0,5.0,2.0,2
7162,7162,2009-10,2009,2010,Fulham,Wolves,Loss,Away,2009-09-20,0,3,3,6,6,1,1,4,4,2,2,2,2,0,7.0,21.0,-14.0,2
7163,7163,2009-10,2009,2010,Fulham,Arsenal,Loss,Home,2009-09-26,0,3,3,3,6,3,3,6,9,0,0,-3,-3,1,7.0,4.0,3.0,2
7164,7164,2009-10,2009,2010,Fulham,West Ham,Draw,Away,2009-10-04,1,0,3,3,3,0,0,1,1,0,3,2,2,0,7.0,9.0,-2.0,3
7165,7165,2009-10,2009,2010,Fulham,Hull,Win,Home,2009-10-19,3,1,1,4,4,3,3,3,4,-2,-2,1,0,1,7.0,17.0,-10.0,3
7166,7166,2009-10,2009,2010,Fulham,Man City,Draw,Away,2009-10-25,1,4,4,4,7,2,5,5,8,2,-1,-1,-1,0,7.0,10.0,-3.0,3
7167,7167,2009-10,2009,2010,Fulham,Liverpool,Win,Home,2009-10-31,3,4,5,5,5,3,3,6,9,1,2,-1,-4,1,7.0,2.0,5.0,3
7168,7168,2009-10,2009,2010,Fulham,Wigan,Draw,Away,2009-11-08,1,4,7,8,8,3,4,4,7,1,3,4,1,0,7.0,11.0,-4.0,4
7169,7169,2009-10,2009,2010,Fulham,Birmingham,Loss,Away,2009-11-21,0,4,5,8,9,2,5,5,5,2,0,3,4,0,7.0,21.0,-14.0,4
7170,7170,2009-10,2009,2010,Fulham,Blackburn,Win,Home,2009-11-25,3,1,4,5,8,6,6,6,9,-5,-2,-1,-1,1,7.0,15.0,-8.0,4
7171,7171,2009-10,2009,2010,Fulham,Bolton,Draw,Home,2009-11-28,1,3,4,7,8,0,0,3,3,3,4,4,5,1,7.0,13.0,-6.0,4
7172,7172,2009-10,2009,2010,Fulham,Sunderland,Win,Home,2009-12-06,3,4,4,5,8,3,3,4,4,1,1,1,4,1,7.0,16.0,-9.0,5
7173,7173,2009-10,2009,2010,Fulham,Burnley,Draw,Away,2009-12-12,1,4,7,7,8,0,1,2,5,4,6,5,3,0,7.0,21.0,-14.0,5
7174,7174,2009-10,2009,2010,Fulham,Man United,Win,Home,2009-12-19,3,4,5,8,8,3,6,9,12,1,-1,-1,-4,1,7.0,1.0,6.0,5
7175,7175,2009-10,2009,2010,Fulham,Tottenham,Draw,Home,2009-12-26,1,4,7,8,11,6,6,7,8,-2,1,1,3,1,7.0,8.0,-1.0,5
7176,7176,2009-10,2009,2010,Fulham,Chelsea,Loss,Away,2009-12-28,0,4,5,8,9,2,5,6,6,2,0,2,3,0,7.0,3.0,4.0,5
7177,7177,2009-10,2009,2010,Fulham,Stoke,Loss,Away,2010-01-05,0,1,4,5,8,0,0,1,1,1,4,4,7,0,7.0,12.0,-5.0,6
7178,7178,2009-10,2009,2010,Fulham,Blackburn,Loss,Away,2010-01-17,0,0,1,4,5,1,2,2,2,-1,-1,2,3,0,7.0,15.0,-8.0,6
7179,7179,2009-10,2009,2010,Fulham,Tottenham,Loss,Away,2010-01-26,0,0,0,1,4,1,4,5,8,-1,-4,-4,-4,0,7.0,8.0,-1.0,6
7180,7180,2009-10,2009,2010,Fulham,Aston Villa,Loss,Home,2010-01-30,0,0,0,0,1,2,2,2,5,-2,-2,-2,-4,1,7.0,6.0,1.0,6
7181,7181,2009-10,2009,2010,Fulham,Portsmouth,Win,Home,2010-02-03,3,0,0,0,0,1,1,1,4,-1,-1,-1,-4,1,7.0,14.0,-7.0,7
7182,7182,2009-10,2009,2010,Fulham,Bolton,Draw,Away,2010-02-06,1,3,3,3,3,3,3,3,4,0,0,0,-1,0,7.0,13.0,-6.0,7
7183,7183,2009-10,2009,2010,Fulham,Burnley,Win,Home,2010-02-09,3,4,4,4,4,3,3,3,3,1,1,1,1,1,7.0,21.0,-14.0,7
7184,7184,2009-10,2009,2010,Fulham,Birmingham,Win,Home,2010-02-21,3,4,7,7,7,3,4,4,5,1,3,3,2,1,7.0,21.0,-14.0,7
7185,7185,2009-10,2009,2010,Fulham,Sunderland,Draw,Away,2010-02-28,1,6,7,10,10,1,2,3,3,5,5,7,7,0,7.0,16.0,-9.0,7
7186,7186,2009-10,2009,2010,Fulham,Man United,Loss,Away,2010-03-14,0,4,7,8,11,6,6,7,10,-2,1,1,1,0,7.0,1.0,6.0,8
7187,7187,2009-10,2009,2010,Fulham,Man City,Loss,Home,2010-03-21,0,1,4,7,8,4,5,6,9,-3,-1,1,-1,1,7.0,10.0,-3.0,8
7188,7188,2009-10,2009,2010,Fulham,Hull,Loss,Away,2010-03-27,0,0,1,4,7,0,0,0,0,0,1,4,7,0,7.0,17.0,-10.0,8
7189,7189,2009-10,2009,2010,Fulham,Wigan,Win,Home,2010-04-04,3,0,0,1,4,3,3,3,6,-3,-3,-2,-2,1,7.0,11.0,-4.0,9
7190,7190,2009-10,2009,2010,Fulham,Liverpool,Draw,Away,2010-04-11,1,3,3,3,4,4,4,7,7,-1,-1,-4,-3,0,7.0,2.0,5.0,9
7191,7191,2009-10,2009,2010,Fulham,Wolves,Draw,Home,2010-04-17,1,4,4,4,4,1,2,5,6,3,2,-1,-2,1,7.0,21.0,-14.0,9
7192,7192,2009-10,2009,2010,Fulham,Everton,Loss,Away,2010-04-25,0,2,5,5,5,4,5,6,9,-2,0,-1,-4,0,7.0,5.0,2.0,9
7193,7193,2009-10,2009,2010,Fulham,West Ham,Win,Home,2010-05-02,3,1,2,5,5,3,6,7,7,-2,-4,-2,-2,1,7.0,9.0,-2.0,10
7194,7194,2009-10,2009,2010,Fulham,Stoke,Loss,Home,2010-05-05,0,3,4,5,8,1,1,2,5,2,3,3,3,1,7.0,12.0,-5.0,10
7195,7195,2009-10,2009,2010,Fulham,Arsenal,Loss,Away,2010-05-09,0,3,3,4,5,1,1,1,4,2,2,3,1,0,7.0,4.0,3.0,10
7196,7196,2010-11,2010,2011,Fulham,Bolton,Draw,Away,2010-08-14,1,0,3,3,4,3,4,7,7,-3,-1,-4,-3,0,12.0,14.0,-2.0,1
7197,7197,2010-11,2010,2011,Fulham,Man United,Draw,Home,2010-08-22,1,1,1,4,4,6,9,12,15,-5,-8,-8,-11,1,12.0,2.0,10.0,1
7198,7198,2010-11,2010,2011,Fulham,Blackpool,Draw,Away,2010-08-28,1,2,2,2,5,3,3,3,3,-1,-1,-1,2,0,12.0,21.0,-9.0,1
7199,7199,2010-11,2010,2011,Fulham,Wolves,Win,Home,2010-09-11,3,2,3,3,3,2,5,8,8,0,-2,-5,-5,1,12.0,15.0,-3.0,2
7200,7200,2010-11,2010,2011,Fulham,Blackburn,Draw,Away,2010-09-18,1,4,5,6,6,1,1,4,7,3,4,2,-1,0,12.0,10.0,2.0,2
7201,7201,2010-11,2010,2011,Fulham,Everton,Draw,Home,2010-09-25,1,4,5,6,7,1,1,2,2,3,4,4,5,1,12.0,8.0,4.0,2
7202,7202,2010-11,2010,2011,Fulham,West Ham,Draw,Away,2010-10-02,1,2,5,6,7,4,4,4,4,-2,1,2,3,0,12.0,17.0,-5.0,3
7203,7203,2010-11,2010,2011,Fulham,Tottenham,Loss,Home,2010-10-16,0,2,3,6,7,3,6,7,7,-1,-3,-1,0,1,12.0,4.0,8.0,3
7204,7204,2010-11,2010,2011,Fulham,West Brom,Loss,Away,2010-10-23,0,1,2,3,6,2,5,8,9,-1,-3,-5,-3,0,12.0,21.0,-9.0,3
7205,7205,2010-11,2010,2011,Fulham,Wigan,Win,Home,2010-10-30,3,0,1,2,3,2,5,6,6,-2,-4,-4,-3,1,12.0,16.0,-4.0,3
7206,7206,2010-11,2010,2011,Fulham,Aston Villa,Draw,Home,2010-11-06,1,3,3,4,5,1,2,2,5,2,1,2,0,1,12.0,6.0,6.0,4
7207,7207,2010-11,2010,2011,Fulham,Chelsea,Loss,Away,2010-11-10,0,4,4,4,5,3,6,7,10,1,-2,-3,-5,0,12.0,1.0,11.0,4
7208,7208,2010-11,2010,2011,Fulham,Newcastle,Draw,Away,2010-11-13,1,1,4,4,4,3,6,9,10,-2,-2,-5,-6,0,12.0,21.0,-9.0,4
7209,7209,2010-11,2010,2011,Fulham,Man City,Loss,Home,2010-11-21,0,1,2,5,5,2,5,5,5,-1,-3,0,0,1,12.0,5.0,7.0,4
7210,7210,2010-11,2010,2011,Fulham,Birmingham,Draw,Home,2010-11-27,1,1,1,2,5,4,4,5,6,-3,-3,-3,-1,1,12.0,9.0,3.0,4
7211,7211,2010-11,2010,2011,Fulham,Arsenal,Loss,Away,2010-12-04,0,1,2,2,3,3,6,9,9,-2,-4,-7,-6,0,12.0,3.0,9.0,5
7212,7212,2010-11,2010,2011,Fulham,Sunderland,Draw,Home,2010-12-11,1,1,1,2,2,3,4,7,8,-2,-3,-5,-6,1,12.0,13.0,-1.0,5
7213,7213,2010-11,2010,2011,Fulham,West Ham,Loss,Home,2010-12-26,0,1,2,2,3,1,1,4,4,0,1,-2,-1,1,12.0,17.0,-5.0,5
7214,7214,2010-11,2010,2011,Fulham,Stoke,Win,Away,2010-12-28,3,1,1,2,2,3,4,5,8,-2,-3,-3,-6,0,12.0,11.0,1.0,5
7215,7215,2010-11,2010,2011,Fulham,Tottenham,Loss,Away,2011-01-01,0,3,4,4,5,6,7,8,11,-3,-3,-4,-6,0,12.0,4.0,8.0,6
7216,7216,2010-11,2010,2011,Fulham,West Brom,Win,Home,2011-01-04,3,3,3,4,4,0,0,0,3,3,3,4,1,1,12.0,21.0,-9.0,6
7217,7217,2010-11,2010,2011,Fulham,Wigan,Draw,Away,2011-01-15,1,3,6,6,7,1,2,5,6,2,4,1,1,0,12.0,16.0,-4.0,6
7218,7218,2010-11,2010,2011,Fulham,Stoke,Win,Home,2011-01-22,3,4,4,7,7,3,6,6,9,1,-2,1,-2,1,12.0,11.0,1.0,6
7219,7219,2010-11,2010,2011,Fulham,Liverpool,Loss,Away,2011-01-26,0,4,7,7,10,4,4,4,7,0,3,3,3,0,12.0,7.0,5.0,6
7220,7220,2010-11,2010,2011,Fulham,Newcastle,Win,Home,2011-02-02,3,3,4,7,7,2,5,8,8,1,-1,-1,-1,1,12.0,21.0,-9.0,7
7221,7221,2010-11,2010,2011,Fulham,Aston Villa,Draw,Away,2011-02-05,1,3,6,7,10,3,6,7,7,0,0,0,3,0,12.0,6.0,6.0,7
7222,7222,2010-11,2010,2011,Fulham,Chelsea,Draw,Home,2011-02-14,1,4,4,7,8,3,6,9,9,1,-2,-2,-1,1,12.0,1.0,11.0,7
7223,7223,2010-11,2010,2011,Fulham,Man City,Draw,Away,2011-02-27,1,2,5,5,8,3,4,4,7,-1,1,1,1,0,12.0,5.0,7.0,7
7224,7224,2010-11,2010,2011,Fulham,Blackburn,Win,Home,2011-03-05,3,2,3,6,6,1,1,1,4,1,2,5,2,1,12.0,10.0,2.0,8
7225,7225,2010-11,2010,2011,Fulham,Everton,Loss,Away,2011-03-19,0,4,5,6,9,4,7,7,10,0,-2,-1,-1,0,12.0,8.0,4.0,8
7226,7226,2010-11,2010,2011,Fulham,Blackpool,Win,Home,2011-04-03,3,3,4,5,6,1,1,4,5,2,3,1,1,1,12.0,21.0,-9.0,9
7227,7227,2010-11,2010,2011,Fulham,Man United,Loss,Away,2011-04-09,0,3,6,7,8,6,6,6,9,-3,0,1,-1,0,12.0,2.0,10.0,9
7228,7228,2010-11,2010,2011,Fulham,Wolves,Draw,Away,2011-04-23,1,3,3,6,7,0,3,4,7,3,0,2,0,0,12.0,15.0,-3.0,9
7229,7229,2010-11,2010,2011,Fulham,Bolton,Win,Home,2011-04-27,3,1,4,4,7,6,6,6,9,-5,-2,-2,-2,1,12.0,14.0,-2.0,9
7230,7230,2010-11,2010,2011,Fulham,Sunderland,Win,Away,2011-04-30,3,4,4,7,7,3,3,3,3,1,1,4,4,0,12.0,13.0,-1.0,9
7231,7231,2010-11,2010,2011,Fulham,Liverpool,Loss,Home,2011-05-09,0,6,7,7,10,6,7,10,10,0,0,-3,0,1,12.0,7.0,5.0,10
7232,7232,2010-11,2010,2011,Fulham,Birmingham,Win,Away,2011-05-15,3,3,6,7,7,1,1,1,4,2,5,6,3,0,12.0,9.0,3.0,10
7233,7233,2010-11,2010,2011,Fulham,Arsenal,Draw,Home,2011-05-22,1,3,6,9,10,0,3,3,4,3,3,6,6,1,12.0,3.0,9.0,10
7234,7234,2011-12,2011,2012,Fulham,Aston Villa,Draw,Home,2011-08-13,1,4,4,7,10,6,7,7,8,-2,-3,0,2,1,8.0,9.0,-1.0,1
7235,7235,2011-12,2011,2012,Fulham,Wolves,Loss,Away,2011-08-21,0,2,5,5,8,3,6,9,10,-1,-1,-4,-2,0,8.0,17.0,-9.0,1
7236,7236,2011-12,2011,2012,Fulham,Newcastle,Loss,Away,2011-08-28,0,1,2,5,5,4,5,6,9,-3,-3,-1,-4,0,8.0,12.0,-4.0,1
7237,7237,2011-12,2011,2012,Fulham,Blackburn,Draw,Home,2011-09-11,1,0,1,2,5,0,0,3,4,0,1,-1,1,1,8.0,15.0,-7.0,2
7238,7238,2011-12,2011,2012,Fulham,Man City,Draw,Home,2011-09-18,1,1,1,2,3,6,9,12,15,-5,-8,-10,-12,1,8.0,3.0,5.0,2
7239,7239,2011-12,2011,2012,Fulham,West Brom,Draw,Away,2011-09-24,1,2,2,2,3,3,3,3,3,-1,-1,-1,0,0,8.0,11.0,-3.0,2
7240,7240,2011-12,2011,2012,Fulham,QPR,Win,Home,2011-10-02,3,2,3,3,3,4,5,5,8,-2,-2,-2,-5,1,8.0,21.0,-13.0,3
7241,7241,2011-12,2011,2012,Fulham,Stoke,Loss,Away,2011-10-15,0,4,5,6,6,1,1,4,7,3,4,2,-1,0,8.0,13.0,-5.0,3
7242,7242,2011-12,2011,2012,Fulham,Everton,Loss,Home,2011-10-23,0,3,4,5,6,0,0,3,4,3,4,2,2,1,8.0,7.0,1.0,3
7243,7243,2011-12,2011,2012,Fulham,Wigan,Win,Away,2011-10-29,3,0,3,4,5,0,0,0,0,0,3,4,5,0,8.0,16.0,-8.0,3
7244,7244,2011-12,2011,2012,Fulham,Tottenham,Loss,Home,2011-11-06,0,3,3,6,7,6,7,10,13,-3,-4,-4,-6,1,8.0,5.0,3.0,4
7245,7245,2011-12,2011,2012,Fulham,Sunderland,Draw,Away,2011-11-19,1,3,3,3,6,1,4,4,5,2,-1,-1,1,0,8.0,10.0,-2.0,4
7246,7246,2011-12,2011,2012,Fulham,Arsenal,Draw,Away,2011-11-26,1,1,4,4,4,6,9,12,15,-5,-5,-8,-11,0,8.0,4.0,4.0,4
7247,7247,2011-12,2011,2012,Fulham,Liverpool,Win,Home,2011-12-05,3,2,2,5,5,4,5,8,9,-2,-3,-3,-4,1,8.0,6.0,2.0,5
7248,7248,2011-12,2011,2012,Fulham,Swansea,Loss,Away,2011-12-10,0,4,5,5,8,1,1,2,5,3,4,3,3,0,8.0,21.0,-13.0,5
7249,7249,2011-12,2011,2012,Fulham,Bolton,Win,Home,2011-12-17,3,3,4,5,5,0,0,0,3,3,4,5,2,1,8.0,14.0,-6.0,5
7250,7250,2011-12,2011,2012,Fulham,Man United,Loss,Home,2011-12-21,0,3,6,7,8,6,9,10,13,-3,-3,-3,-5,1,8.0,1.0,7.0,5
7251,7251,2011-12,2011,2012,Fulham,Chelsea,Draw,Away,2011-12-26,1,3,3,6,7,2,5,8,11,1,-2,-2,-4,0,8.0,2.0,6.0,5
7252,7252,2011-12,2011,2012,Fulham,Norwich,Draw,Away,2011-12-31,1,1,4,4,7,1,2,5,5,0,2,-1,2,0,8.0,21.0,-13.0,5
7253,7253,2011-12,2011,2012,Fulham,Arsenal,Win,Home,2012-01-02,3,2,2,5,5,4,7,7,10,-2,-5,-2,-5,1,8.0,4.0,4.0,6
7254,7254,2011-12,2011,2012,Fulham,Blackburn,Loss,Away,2012-01-14,0,4,5,5,8,3,4,4,4,1,1,1,4,0,8.0,15.0,-7.0,6
7255,7255,2011-12,2011,2012,Fulham,Newcastle,Win,Home,2012-01-21,3,3,4,5,5,6,6,9,9,-3,-2,-4,-4,1,8.0,12.0,-4.0,6
7256,7256,2011-12,2011,2012,Fulham,West Brom,Draw,Home,2012-02-01,1,3,6,7,8,3,3,3,4,0,3,4,4,1,8.0,11.0,-3.0,7
7257,7257,2011-12,2011,2012,Fulham,Man City,Loss,Away,2012-02-04,0,4,4,7,8,3,6,9,9,1,-2,-2,-1,0,8.0,3.0,5.0,7
7258,7258,2011-12,2011,2012,Fulham,Stoke,Win,Home,2012-02-11,3,1,4,4,7,0,0,1,4,1,4,3,3,1,8.0,13.0,-5.0,7
7259,7259,2011-12,2011,2012,Fulham,QPR,Win,Away,2012-02-25,3,3,4,7,7,0,1,4,4,3,3,3,3,0,8.0,21.0,-13.0,7
7260,7260,2011-12,2011,2012,Fulham,Wolves,Win,Home,2012-03-04,3,6,6,7,10,1,4,4,4,5,2,3,6,1,8.0,17.0,-9.0,8
7261,7261,2011-12,2011,2012,Fulham,Aston Villa,Loss,Away,2012-03-10,0,6,9,9,10,2,2,2,3,4,7,7,7,0,8.0,9.0,-1.0,8
7262,7262,2011-12,2011,2012,Fulham,Swansea,Loss,Home,2012-03-17,0,3,6,9,9,6,6,6,9,-3,0,3,0,1,8.0,21.0,-13.0,8
7263,7263,2011-12,2011,2012,Fulham,Man United,Loss,Away,2012-03-26,0,0,3,6,9,6,9,12,15,-6,-6,-6,-6,0,8.0,1.0,7.0,8
7264,7264,2011-12,2011,2012,Fulham,Norwich,Win,Home,2012-03-31,3,0,0,3,6,3,4,4,4,-3,-4,-1,2,1,8.0,21.0,-13.0,8
7265,7265,2011-12,2011,2012,Fulham,Bolton,Win,Away,2012-04-07,3,3,3,3,6,6,9,9,9,-3,-6,-6,-3,0,8.0,14.0,-6.0,9
7266,7266,2011-12,2011,2012,Fulham,Chelsea,Draw,Home,2012-04-09,1,6,6,6,6,6,7,7,10,0,-1,-1,-4,1,8.0,2.0,6.0,9
7267,7267,2011-12,2011,2012,Fulham,Wigan,Win,Home,2012-04-21,3,4,7,7,7,6,6,9,12,-2,1,-2,-5,1,8.0,16.0,-8.0,9
7268,7268,2011-12,2011,2012,Fulham,Everton,Loss,Away,2012-04-28,0,4,7,10,10,4,5,8,11,0,2,2,-1,0,8.0,7.0,1.0,9
7269,7269,2011-12,2011,2012,Fulham,Liverpool,Win,Away,2012-05-01,3,3,4,7,10,3,6,7,7,0,-2,0,3,0,8.0,6.0,2.0,10
7270,7270,2011-12,2011,2012,Fulham,Sunderland,Win,Home,2012-05-06,3,3,6,7,10,2,3,3,4,1,3,4,6,1,8.0,10.0,-2.0,10
7271,7271,2011-12,2011,2012,Fulham,Tottenham,Loss,Away,2012-05-13,0,6,6,9,10,4,7,7,7,2,-1,2,3,0,8.0,5.0,3.0,10
7272,7272,2012-13,2012,2013,Fulham,Norwich,Win,Home,2012-08-18,3,3,6,6,9,4,4,4,4,-1,2,2,5,1,9.0,12.0,-3.0,1
7273,7273,2012-13,2012,2013,Fulham,Man United,Loss,Away,2012-08-25,0,3,6,9,9,3,6,6,7,0,0,3,2,0,9.0,2.0,7.0,1
7274,7274,2012-13,2012,2013,Fulham,West Ham,Loss,Away,2012-09-01,0,3,3,6,9,3,3,3,4,0,0,3,5,0,9.0,21.0,-12.0,2
7275,7275,2012-13,2012,2013,Fulham,West Brom,Win,Home,2012-09-15,3,0,3,3,6,4,7,7,8,-4,-4,-4,-2,1,9.0,10.0,-1.0,2
7276,7276,2012-13,2012,2013,Fulham,Wigan,Win,Away,2012-09-22,3,3,3,6,6,1,4,4,7,2,-1,2,-1,0,9.0,15.0,-6.0,2
7277,7277,2012-13,2012,2013,Fulham,Man City,Loss,Home,2012-09-29,0,6,6,6,9,2,5,6,9,4,1,0,0,1,9.0,1.0,8.0,2
7278,7278,2012-13,2012,2013,Fulham,Southampton,Draw,Away,2012-10-07,1,3,6,6,6,3,3,3,3,0,3,3,3,0,9.0,21.0,-12.0,3
7279,7279,2012-13,2012,2013,Fulham,Aston Villa,Win,Home,2012-10-20,3,1,4,7,7,1,1,4,5,0,3,3,2,1,9.0,16.0,-7.0,3
7280,7280,2012-13,2012,2013,Fulham,Reading,Draw,Away,2012-10-27,1,4,4,7,10,1,2,2,2,3,2,5,8,0,9.0,21.0,-12.0,3
7281,7281,2012-13,2012,2013,Fulham,Everton,Draw,Home,2012-11-03,1,4,5,5,8,2,3,6,9,2,2,-1,-1,1,9.0,7.0,2.0,4
7282,7282,2012-13,2012,2013,Fulham,Arsenal,Draw,Away,2012-11-10,1,2,5,6,6,3,3,6,6,-1,2,0,0,0,9.0,3.0,6.0,4
7283,7283,2012-13,2012,2013,Fulham,Sunderland,Loss,Home,2012-11-18,0,2,3,6,7,0,1,2,2,2,2,4,5,1,9.0,13.0,-4.0,4
7284,7284,2012-13,2012,2013,Fulham,Stoke,Loss,Away,2012-11-24,0,1,2,3,6,4,4,5,5,-3,-2,-2,1,0,9.0,14.0,-5.0,4
7285,7285,2012-13,2012,2013,Fulham,Chelsea,Draw,Away,2012-11-28,1,0,1,2,3,1,2,3,3,-1,-1,-1,0,0,9.0,6.0,3.0,4
7286,7286,2012-13,2012,2013,Fulham,Tottenham,Loss,Home,2012-12-01,0,1,1,2,3,6,6,6,6,-5,-5,-4,-3,1,9.0,4.0,5.0,5
7287,7287,2012-13,2012,2013,Fulham,Newcastle,Win,Home,2012-12-10,3,1,1,1,2,3,3,3,3,-2,-2,-2,-1,1,9.0,5.0,4.0,5
7288,7288,2012-13,2012,2013,Fulham,QPR,Loss,Away,2012-12-15,0,3,4,4,4,2,3,3,3,1,1,1,1,0,9.0,17.0,-8.0,5
7289,7289,2012-13,2012,2013,Fulham,Liverpool,Loss,Away,2012-12-22,0,3,3,4,4,3,6,6,7,0,-3,-2,-3,0,9.0,8.0,1.0,5
7290,7290,2012-13,2012,2013,Fulham,Southampton,Draw,Home,2012-12-26,1,0,3,3,4,3,3,4,7,-3,0,-1,-3,1,9.0,21.0,-12.0,5
7291,7291,2012-13,2012,2013,Fulham,Swansea,Loss,Home,2012-12-29,0,1,1,4,4,2,2,2,5,-1,-1,2,-1,1,9.0,11.0,-2.0,5
7292,7292,2012-13,2012,2013,Fulham,West Brom,Win,Away,2013-01-01,3,1,1,1,4,3,6,7,7,-2,-5,-6,-3,0,9.0,10.0,-1.0,6
7293,7293,2012-13,2012,2013,Fulham,Wigan,Draw,Home,2013-01-12,1,3,4,4,4,3,3,3,3,0,1,1,1,1,9.0,15.0,-6.0,6
7294,7294,2012-13,2012,2013,Fulham,Man City,Loss,Away,2013-01-19,0,4,4,5,5,6,9,9,12,-2,-5,-4,-7,0,9.0,1.0,8.0,6
7295,7295,2012-13,2012,2013,Fulham,West Ham,Win,Home,2013-01-30,3,1,4,4,5,1,1,4,4,0,3,0,1,1,9.0,21.0,-12.0,6
7296,7296,2012-13,2012,2013,Fulham,Man United,Loss,Home,2013-02-02,0,3,4,7,7,4,7,10,13,-1,-3,-3,-6,1,9.0,2.0,7.0,7
7297,7297,2012-13,2012,2013,Fulham,Norwich,Draw,Away,2013-02-09,1,3,3,4,7,2,2,3,3,1,1,1,4,0,9.0,12.0,-3.0,7
7298,7298,2012-13,2012,2013,Fulham,Stoke,Win,Home,2013-02-23,3,1,4,4,5,3,4,4,4,-2,0,0,1,1,9.0,14.0,-5.0,7
7299,7299,2012-13,2012,2013,Fulham,Sunderland,Draw,Away,2013-03-02,1,4,4,7,7,0,0,1,4,4,4,6,3,0,9.0,13.0,-4.0,8
7300,7300,2012-13,2012,2013,Fulham,Tottenham,Win,Away,2013-03-17,3,4,5,5,8,3,6,9,12,1,-1,-4,-4,0,9.0,4.0,5.0,8
7301,7301,2012-13,2012,2013,Fulham,QPR,Win,Home,2013-04-01,3,4,7,8,8,3,6,6,6,1,1,2,2,1,9.0,17.0,-8.0,9
7302,7302,2012-13,2012,2013,Fulham,Newcastle,Loss,Away,2013-04-07,0,6,7,10,11,0,3,3,6,6,4,7,5,0,9.0,5.0,4.0,9
7303,7303,2012-13,2012,2013,Fulham,Aston Villa,Draw,Away,2013-04-13,1,3,6,7,10,3,6,9,9,0,0,-2,1,0,9.0,16.0,-7.0,9
7304,7304,2012-13,2012,2013,Fulham,Chelsea,Loss,Home,2013-04-17,0,1,4,7,8,3,6,9,9,-2,-2,-2,-1,1,9.0,6.0,3.0,9
7305,7305,2012-13,2012,2013,Fulham,Arsenal,Loss,Home,2013-04-20,0,1,1,4,7,4,7,10,13,-3,-6,-6,-6,1,9.0,3.0,6.0,9
7306,7306,2012-13,2012,2013,Fulham,Everton,Loss,Away,2013-04-27,0,0,1,1,4,1,4,5,8,-1,-3,-4,-4,0,9.0,7.0,2.0,9
7307,7307,2012-13,2012,2013,Fulham,Reading,Loss,Home,2013-05-04,0,0,0,1,1,1,2,2,2,-1,-2,-1,-1,1,9.0,21.0,-12.0,10
7308,7308,2012-13,2012,2013,Fulham,Liverpool,Loss,Home,2013-05-12,0,0,0,0,1,4,5,6,7,-4,-5,-6,-6,1,9.0,8.0,1.0,10
7309,7309,2012-13,2012,2013,Fulham,Swansea,Win,Away,2013-05-19,3,0,0,0,0,3,4,4,5,-3,-4,-4,-5,0,9.0,11.0,-2.0,10
7310,7310,2013-14,2013,2014,Fulham,Sunderland,Win,Away,2013-08-17,3,3,3,3,3,1,2,2,5,2,1,1,-2,0,12.0,17.0,-5.0,1
7311,7311,2013-14,2013,2014,Fulham,Arsenal,Loss,Home,2013-08-24,0,6,6,6,6,3,6,9,10,3,0,-3,-4,1,12.0,4.0,8.0,1
7312,7312,2013-14,2013,2014,Fulham,Newcastle,Loss,Away,2013-08-31,0,3,6,6,6,1,1,4,5,2,5,2,1,0,12.0,16.0,-4.0,1
7313,7313,2013-14,2013,2014,Fulham,West Brom,Draw,Home,2013-09-14,1,0,3,6,6,1,1,2,2,-1,2,4,4,1,12.0,8.0,4.0,2
7314,7314,2013-14,2013,2014,Fulham,Chelsea,Loss,Away,2013-09-21,0,1,1,4,7,1,4,7,10,0,-3,-3,-3,0,12.0,3.0,9.0,2
7315,7315,2013-14,2013,2014,Fulham,Cardiff,Loss,Home,2013-09-28,0,1,1,1,4,1,2,5,5,0,-1,-4,-1,1,12.0,21.0,-9.0,2
7316,7316,2013-14,2013,2014,Fulham,Stoke,Win,Home,2013-10-05,3,0,1,1,1,0,1,4,7,0,0,-3,-6,1,12.0,13.0,-1.0,3
7317,7317,2013-14,2013,2014,Fulham,Crystal Palace,Win,Away,2013-10-21,3,3,3,4,4,0,0,0,3,3,3,4,1,0,12.0,21.0,-9.0,3
7318,7318,2013-14,2013,2014,Fulham,Southampton,Loss,Away,2013-10-26,0,6,6,6,7,4,7,10,11,2,-1,-4,-4,0,12.0,14.0,-2.0,3
7319,7319,2013-14,2013,2014,Fulham,Man United,Loss,Home,2013-11-02,0,3,6,6,6,4,7,7,7,-1,-1,-1,-1,1,12.0,1.0,11.0,4
7320,7320,2013-14,2013,2014,Fulham,Liverpool,Loss,Away,2013-11-09,0,0,3,6,6,3,4,7,10,-3,-1,-1,-4,0,12.0,7.0,5.0,4
7321,7321,2013-14,2013,2014,Fulham,Swansea,Loss,Home,2013-11-23,0,0,0,3,6,1,2,5,5,-1,-2,-2,1,1,12.0,9.0,3.0,4
7322,7322,2013-14,2013,2014,Fulham,West Ham,Loss,Away,2013-11-30,0,0,0,0,3,0,1,2,2,0,-1,-2,1,0,12.0,10.0,2.0,4
7323,7323,2013-14,2013,2014,Fulham,Tottenham,Loss,Home,2013-12-04,0,0,0,0,0,1,1,2,5,-1,-1,-2,-5,1,12.0,5.0,7.0,5
7324,7324,2013-14,2013,2014,Fulham,Aston Villa,Win,Home,2013-12-08,3,0,0,0,0,4,5,8,9,-4,-5,-8,-9,1,12.0,15.0,-3.0,5
7325,7325,2013-14,2013,2014,Fulham,Everton,Loss,Away,2013-12-14,0,3,3,3,3,4,7,8,9,-1,-4,-5,-6,0,12.0,6.0,6.0,5
7326,7326,2013-14,2013,2014,Fulham,Man City,Loss,Home,2013-12-21,0,3,3,3,3,4,7,10,13,-1,-4,-7,-10,1,12.0,2.0,10.0,5
7327,7327,2013-14,2013,2014,Fulham,Norwich,Win,Away,2013-12-26,3,0,3,3,3,2,5,5,8,-2,-2,-2,-5,0,12.0,11.0,1.0,5
7328,7328,2013-14,2013,2014,Fulham,Hull,Loss,Away,2013-12-28,0,3,3,6,6,1,2,3,3,2,1,3,3,0,12.0,21.0,-9.0,5
7329,7329,2013-14,2013,2014,Fulham,West Ham,Win,Home,2014-01-01,3,3,3,3,6,1,1,2,2,2,2,1,4,1,12.0,10.0,2.0,6
7330,7330,2013-14,2013,2014,Fulham,Sunderland,Loss,Home,2014-01-11,0,3,6,6,6,1,4,5,6,2,2,1,0,1,12.0,17.0,-5.0,6
7331,7331,2013-14,2013,2014,Fulham,Arsenal,Loss,Away,2014-01-18,0,3,3,6,6,6,9,12,13,-3,-6,-6,-7,0,12.0,4.0,8.0,6
7332,7332,2013-14,2013,2014,Fulham,Swansea,Loss,Away,2014-01-28,0,0,3,3,6,0,0,1,1,0,3,2,5,0,12.0,9.0,3.0,6
7333,7333,2013-14,2013,2014,Fulham,Southampton,Loss,Home,2014-02-01,0,0,0,3,3,2,5,5,5,-2,-5,-2,-2,1,12.0,14.0,-2.0,7
7334,7334,2013-14,2013,2014,Fulham,Man United,Draw,Away,2014-02-09,1,0,0,0,3,3,3,6,6,-3,-3,-6,-3,0,12.0,1.0,11.0,7
7335,7335,2013-14,2013,2014,Fulham,Liverpool,Loss,Home,2014-02-12,0,1,1,1,1,4,7,8,11,-3,-6,-7,-10,1,12.0,7.0,5.0,7
7336,7336,2013-14,2013,2014,Fulham,West Brom,Draw,Away,2014-02-22,1,1,1,1,1,1,2,2,3,0,-1,-1,-2,0,12.0,8.0,4.0,7
7337,7337,2013-14,2013,2014,Fulham,Chelsea,Loss,Home,2014-03-01,0,1,2,2,2,4,7,10,11,-3,-5,-8,-9,1,12.0,3.0,9.0,8
7338,7338,2013-14,2013,2014,Fulham,Cardiff,Loss,Away,2014-03-08,0,1,1,2,2,0,1,1,4,1,0,1,-2,0,12.0,21.0,-9.0,8
7339,7339,2013-14,2013,2014,Fulham,Newcastle,Win,Home,2014-03-15,3,0,1,1,2,6,6,6,6,-6,-5,-5,-4,1,12.0,16.0,-4.0,8
7340,7340,2013-14,2013,2014,Fulham,Man City,Loss,Away,2014-03-22,0,3,3,4,4,6,7,7,10,-3,-4,-3,-6,0,12.0,2.0,10.0,8
7341,7341,2013-14,2013,2014,Fulham,Everton,Loss,Home,2014-03-30,0,3,3,3,4,6,9,12,12,-3,-6,-9,-8,1,12.0,6.0,6.0,8
7342,7342,2013-14,2013,2014,Fulham,Aston Villa,Win,Away,2014-04-05,3,0,3,3,3,0,3,6,6,0,0,-3,-3,0,12.0,15.0,-3.0,9
7343,7343,2013-14,2013,2014,Fulham,Norwich,Win,Home,2014-04-12,3,3,3,6,6,0,3,3,4,3,0,3,2,1,12.0,11.0,1.0,9
7344,7344,2013-14,2013,2014,Fulham,Tottenham,Loss,Away,2014-04-19,0,6,6,6,9,4,4,7,7,2,2,-1,2,0,12.0,5.0,7.0,9
7345,7345,2013-14,2013,2014,Fulham,Hull,Draw,Home,2014-04-26,1,3,6,6,6,3,3,3,6,0,3,3,0,1,12.0,21.0,-9.0,9
7346,7346,2013-14,2013,2014,Fulham,Stoke,Loss,Away,2014-05-03,0,1,4,7,7,1,4,4,7,0,0,3,0,0,12.0,13.0,-1.0,10
7347,7347,2013-14,2013,2014,Fulham,Crystal Palace,Draw,Home,2014-05-11,1,1,1,4,7,1,4,7,10,0,-3,-3,-3,1,12.0,21.0,-9.0,10
7348,7348,2017-18,2017,2018,Huddersfield,Crystal Palace,Win,Away,2017-08-12,3,0,0,0,0,3,3,3,3,-3,-3,-3,-3,0,21.0,14.0,7.0,1
7349,7349,2017-18,2017,2018,Huddersfield,Newcastle,Win,Home,2017-08-20,3,3,3,3,3,3,4,7,8,0,-1,-4,-5,1,21.0,21.0,0.0,1
7350,7350,2017-18,2017,2018,Huddersfield,Southampton,Draw,Home,2017-08-26,1,6,6,6,6,4,4,5,8,2,2,1,-2,1,21.0,8.0,13.0,1
7351,7351,2017-18,2017,2018,Huddersfield,West Ham,Loss,Away,2017-09-11,0,4,7,7,7,0,0,3,3,4,7,4,4,0,21.0,11.0,10.0,2
7352,7352,2017-18,2017,2018,Huddersfield,Leicester,Draw,Home,2017-09-16,1,1,4,7,7,0,3,3,4,1,1,4,3,1,21.0,12.0,9.0,2
7353,7353,2017-18,2017,2018,Huddersfield,Burnley,Draw,Away,2017-09-23,1,1,2,5,8,4,5,5,8,-3,-3,0,0,0,21.0,16.0,5.0,2
7354,7354,2017-18,2017,2018,Huddersfield,Tottenham,Loss,Home,2017-09-30,0,2,2,3,6,4,7,8,8,-2,-5,-5,-2,1,21.0,2.0,19.0,2
7355,7355,2017-18,2017,2018,Huddersfield,Swansea,Loss,Away,2017-10-14,0,1,2,2,3,0,1,1,4,1,1,1,-1,0,21.0,15.0,6.0,3
7356,7356,2017-18,2017,2018,Huddersfield,Man United,Win,Home,2017-10-21,3,0,1,2,2,4,7,10,11,-4,-6,-8,-9,1,21.0,6.0,15.0,3
7357,7357,2017-18,2017,2018,Huddersfield,Liverpool,Loss,Away,2017-10-28,0,3,3,4,5,1,2,5,6,2,1,-1,-1,0,21.0,4.0,17.0,3
7358,7358,2017-18,2017,2018,Huddersfield,West Brom,Win,Home,2017-11-04,3,3,3,3,4,0,1,2,2,3,2,1,2,1,21.0,10.0,11.0,4
7359,7359,2017-18,2017,2018,Huddersfield,Bournemouth,Loss,Away,2017-11-18,0,3,6,6,6,3,6,6,7,0,0,0,-1,0,21.0,9.0,12.0,4
7360,7360,2017-18,2017,2018,Huddersfield,Man City,Loss,Home,2017-11-26,0,3,3,6,6,6,9,12,15,-3,-6,-6,-9,1,21.0,3.0,18.0,4
7361,7361,2017-18,2017,2018,Huddersfield,Arsenal,Loss,Away,2017-11-29,0,0,3,3,6,6,6,9,12,-6,-3,-6,-6,0,21.0,5.0,16.0,4
7362,7362,2017-18,2017,2018,Huddersfield,Everton,Loss,Away,2017-12-02,0,0,0,3,3,3,4,7,7,-3,-4,-4,-4,0,21.0,7.0,14.0,5
7363,7363,2017-18,2017,2018,Huddersfield,Brighton,Win,Home,2017-12-09,3,0,0,0,3,1,1,2,5,-1,-1,-2,-2,1,21.0,21.0,0.0,5
7364,7364,2017-18,2017,2018,Huddersfield,Chelsea,Loss,Home,2017-12-12,0,3,3,3,3,3,6,7,10,0,-3,-4,-7,1,21.0,1.0,20.0,5
7365,7365,2017-18,2017,2018,Huddersfield,Watford,Win,Away,2017-12-16,3,3,3,3,3,0,1,1,4,3,2,2,-1,0,21.0,17.0,4.0,5
7366,7366,2017-18,2017,2018,Huddersfield,Southampton,Draw,Away,2017-12-23,1,3,6,6,6,0,1,2,2,3,5,4,4,0,21.0,8.0,13.0,5
7367,7367,2017-18,2017,2018,Huddersfield,Stoke,Draw,Home,2017-12-26,1,4,4,7,7,3,3,3,6,1,1,4,1,1,21.0,13.0,8.0,5
7368,7368,2017-18,2017,2018,Huddersfield,Burnley,Draw,Home,2017-12-30,1,2,5,5,8,1,2,5,8,1,3,0,0,1,21.0,16.0,5.0,5
7369,7369,2017-18,2017,2018,Huddersfield,Leicester,Loss,Away,2018-01-01,0,2,3,6,6,0,1,1,4,2,2,5,2,0,21.0,12.0,9.0,6
7370,7370,2017-18,2017,2018,Huddersfield,West Ham,Loss,Home,2018-01-13,0,1,2,3,6,4,5,5,8,-3,-3,-2,-2,1,21.0,11.0,10.0,6
7371,7371,2017-18,2017,2018,Huddersfield,Stoke,Loss,Away,2018-01-20,0,0,1,2,3,0,0,1,4,0,1,1,-1,0,21.0,13.0,8.0,6
7372,7372,2017-18,2017,2018,Huddersfield,Liverpool,Loss,Home,2018-01-30,0,0,0,1,2,3,6,9,12,-3,-6,-8,-10,1,21.0,4.0,17.0,6
7373,7373,2017-18,2017,2018,Huddersfield,Man United,Loss,Away,2018-02-03,0,0,0,0,1,3,6,9,10,-3,-6,-9,-9,0,21.0,6.0,15.0,7
7374,7374,2017-18,2017,2018,Huddersfield,Bournemouth,Win,Home,2018-02-11,3,0,0,0,0,6,7,10,11,-6,-7,-10,-11,1,21.0,9.0,12.0,7
7375,7375,2017-18,2017,2018,Huddersfield,West Brom,Win,Away,2018-02-24,3,3,3,3,3,0,0,1,4,3,3,2,-1,0,21.0,10.0,11.0,7
7376,7376,2017-18,2017,2018,Huddersfield,Tottenham,Loss,Away,2018-03-03,0,6,6,6,6,6,7,10,11,0,-1,-4,-5,0,21.0,2.0,19.0,8
7377,7377,2017-18,2017,2018,Huddersfield,Swansea,Draw,Home,2018-03-10,1,3,6,6,6,3,6,7,10,0,0,-1,-4,1,21.0,15.0,6.0,8
7378,7378,2017-18,2017,2018,Huddersfield,Crystal Palace,Loss,Home,2018-03-17,0,1,4,7,7,0,0,0,1,1,4,7,6,1,21.0,14.0,7.0,8
7379,7379,2017-18,2017,2018,Huddersfield,Newcastle,Loss,Away,2018-03-31,0,1,1,4,7,3,4,7,8,-2,-3,-3,-1,0,21.0,21.0,0.0,8
7380,7380,2017-18,2017,2018,Huddersfield,Brighton,Draw,Away,2018-04-07,1,0,1,1,4,0,3,6,7,0,-2,-5,-3,0,21.0,21.0,0.0,9
7381,7381,2017-18,2017,2018,Huddersfield,Watford,Win,Home,2018-04-14,3,1,1,2,2,1,1,1,4,0,0,1,-2,1,21.0,17.0,4.0,9
7382,7382,2017-18,2017,2018,Huddersfield,Everton,Loss,Home,2018-04-28,0,4,4,4,5,4,5,5,8,0,-1,-1,-3,1,21.0,7.0,14.0,9
7383,7383,2017-18,2017,2018,Huddersfield,Man City,Draw,Away,2018-05-06,1,3,4,4,4,6,9,9,12,-3,-5,-5,-8,0,21.0,3.0,18.0,10
7384,7384,2017-18,2017,2018,Huddersfield,Chelsea,Draw,Away,2018-05-09,1,1,4,5,5,6,9,12,13,-5,-5,-7,-8,0,21.0,1.0,20.0,10
7385,7385,2017-18,2017,2018,Huddersfield,Arsenal,Loss,Home,2018-05-13,0,2,2,5,6,3,3,6,6,-1,-1,-1,0,1,21.0,5.0,16.0,10
7386,7386,2008-09,2008,2009,Hull,Fulham,Win,Home,2008-08-16,3,0,0,0,0,6,9,9,12,-6,-9,-9,-12,1,21.0,17.0,4.0,1
7387,7387,2008-09,2008,2009,Hull,Blackburn,Draw,Away,2008-08-23,1,3,3,3,3,3,6,9,10,0,-3,-6,-7,0,21.0,7.0,14.0,1
7388,7388,2008-09,2008,2009,Hull,Wigan,Loss,Home,2008-08-30,0,4,4,4,4,0,0,3,4,4,4,1,0,1,21.0,14.0,7.0,1
7389,7389,2008-09,2008,2009,Hull,Newcastle,Win,Away,2008-09-13,3,1,4,4,4,3,4,4,4,-2,0,0,0,0,21.0,12.0,9.0,2
7390,7390,2008-09,2008,2009,Hull,Everton,Draw,Home,2008-09-21,1,3,4,7,7,3,6,6,9,0,-2,1,-2,1,21.0,5.0,16.0,2
7391,7391,2008-09,2008,2009,Hull,Arsenal,Win,Away,2008-09-27,3,4,4,5,8,6,9,9,12,-2,-5,-4,-4,0,21.0,3.0,18.0,2
7392,7392,2008-09,2008,2009,Hull,Tottenham,Win,Away,2008-10-05,3,4,7,7,8,1,1,2,2,3,6,5,6,0,21.0,11.0,10.0,3
7393,7393,2008-09,2008,2009,Hull,West Ham,Win,Home,2008-10-19,3,6,7,10,10,3,6,6,9,3,1,4,1,1,21.0,10.0,11.0,3
7394,7394,2008-09,2008,2009,Hull,West Brom,Win,Away,2008-10-25,3,6,9,10,13,3,6,6,9,3,3,4,4,0,21.0,21.0,0.0,3
7395,7395,2008-09,2008,2009,Hull,Chelsea,Loss,Home,2008-10-29,0,6,9,12,13,3,6,9,10,3,3,3,3,1,21.0,2.0,19.0,3
7396,7396,2008-09,2008,2009,Hull,Man United,Loss,Away,2008-11-01,0,3,6,9,12,4,7,10,13,-1,-1,-1,-1,0,21.0,1.0,20.0,4
7397,7397,2008-09,2008,2009,Hull,Bolton,Loss,Home,2008-11-08,0,0,3,6,9,3,3,4,7,-3,0,2,2,1,21.0,16.0,5.0,4
7398,7398,2008-09,2008,2009,Hull,Man City,Draw,Home,2008-11-16,1,0,0,3,6,0,0,3,4,0,0,0,2,1,21.0,9.0,12.0,4
7399,7399,2008-09,2008,2009,Hull,Portsmouth,Draw,Away,2008-11-22,1,1,1,1,4,4,4,4,5,-3,-3,-3,-1,0,21.0,8.0,13.0,4
7400,7400,2008-09,2008,2009,Hull,Stoke,Draw,Away,2008-11-29,1,2,2,2,2,3,4,7,10,-1,-2,-5,-8,0,21.0,21.0,0.0,4
7401,7401,2008-09,2008,2009,Hull,Middlesbrough,Win,Home,2008-12-06,3,2,3,3,3,1,2,5,6,1,1,-2,-3,1,21.0,13.0,8.0,5
7402,7402,2008-09,2008,2009,Hull,Liverpool,Draw,Away,2008-12-13,1,4,5,6,6,4,5,8,11,0,0,-2,-5,0,21.0,4.0,17.0,5
7403,7403,2008-09,2008,2009,Hull,Sunderland,Loss,Home,2008-12-20,0,4,5,6,7,3,3,3,6,1,2,3,1,1,21.0,15.0,6.0,5
7404,7404,2008-09,2008,2009,Hull,Man City,Loss,Away,2008-12-26,0,1,4,5,6,0,1,1,4,1,3,4,2,0,21.0,9.0,12.0,5
7405,7405,2008-09,2008,2009,Hull,Aston Villa,Loss,Home,2008-12-30,0,0,1,4,5,4,7,10,11,-4,-6,-6,-6,1,21.0,6.0,15.0,5
7406,7406,2008-09,2008,2009,Hull,Everton,Loss,Away,2009-01-10,0,0,0,1,4,6,7,10,10,-6,-7,-9,-6,0,21.0,5.0,16.0,6
7407,7407,2008-09,2008,2009,Hull,Arsenal,Loss,Home,2009-01-17,0,0,0,0,1,6,7,8,9,-6,-7,-8,-8,1,21.0,3.0,18.0,6
7408,7408,2008-09,2008,2009,Hull,West Ham,Loss,Away,2009-01-28,0,0,0,0,0,4,7,10,10,-4,-7,-10,-10,0,21.0,10.0,11.0,6
7409,7409,2008-09,2008,2009,Hull,West Brom,Draw,Home,2009-01-31,1,0,0,0,0,3,3,6,6,-3,-3,-6,-6,1,21.0,21.0,0.0,6
7410,7410,2008-09,2008,2009,Hull,Chelsea,Draw,Away,2009-02-07,1,1,1,1,1,3,6,6,7,-2,-5,-5,-6,0,21.0,2.0,19.0,7
7411,7411,2008-09,2008,2009,Hull,Tottenham,Loss,Home,2009-02-23,0,2,2,2,2,1,4,5,5,1,-2,-3,-3,1,21.0,11.0,10.0,7
7412,7412,2008-09,2008,2009,Hull,Blackburn,Loss,Home,2009-03-01,0,1,2,2,2,0,1,2,5,1,1,0,-3,1,21.0,7.0,14.0,8
7413,7413,2008-09,2008,2009,Hull,Fulham,Win,Away,2009-03-04,3,0,1,2,2,4,4,5,8,-4,-3,-3,-6,0,21.0,17.0,4.0,8
7414,7414,2008-09,2008,2009,Hull,Newcastle,Draw,Home,2009-03-14,1,3,3,4,5,0,1,4,5,3,2,0,0,1,21.0,12.0,9.0,8
7415,7415,2008-09,2008,2009,Hull,Wigan,Loss,Away,2009-03-22,0,4,4,4,5,3,3,4,5,1,1,0,0,0,21.0,14.0,7.0,8
7416,7416,2008-09,2008,2009,Hull,Portsmouth,Draw,Home,2009-04-04,1,1,4,4,4,4,4,5,8,-3,0,-1,-4,1,21.0,8.0,13.0,9
7417,7417,2008-09,2008,2009,Hull,Middlesbrough,Loss,Away,2009-04-11,0,1,2,5,5,0,1,1,4,1,1,4,1,0,21.0,13.0,8.0,9
7418,7418,2008-09,2008,2009,Hull,Sunderland,Loss,Away,2009-04-18,0,1,1,2,5,0,0,0,1,1,1,2,4,0,21.0,15.0,6.0,9
7419,7419,2008-09,2008,2009,Hull,Liverpool,Loss,Home,2009-04-25,0,0,1,1,2,4,7,10,13,-4,-6,-9,-11,1,21.0,4.0,17.0,9
7420,7420,2008-09,2008,2009,Hull,Aston Villa,Loss,Away,2009-05-04,0,0,0,1,1,2,3,3,3,-2,-3,-2,-2,0,21.0,6.0,15.0,10
7421,7421,2008-09,2008,2009,Hull,Stoke,Loss,Home,2009-05-09,0,0,0,0,1,0,3,4,7,0,-3,-4,-6,1,21.0,21.0,0.0,10
7422,7422,2008-09,2008,2009,Hull,Bolton,Draw,Away,2009-05-16,1,0,0,0,0,2,3,3,3,-2,-3,-3,-3,0,21.0,16.0,5.0,10
7423,7423,2008-09,2008,2009,Hull,Man United,Loss,Home,2009-05-24,0,1,1,1,1,4,7,10,13,-3,-6,-9,-12,1,21.0,1.0,20.0,10
7424,7424,2009-10,2009,2010,Hull,Chelsea,Loss,Away,2009-08-15,0,1,1,1,1,6,9,12,15,-5,-8,-11,-14,0,17.0,3.0,14.0,1
7425,7425,2009-10,2009,2010,Hull,Tottenham,Loss,Home,2009-08-19,0,0,1,1,1,3,6,7,10,-3,-5,-6,-9,1,17.0,8.0,9.0,1
7426,7426,2009-10,2009,2010,Hull,Bolton,Win,Home,2009-08-22,3,0,0,1,1,0,1,2,3,0,-1,-1,-2,1,17.0,13.0,4.0,1
7427,7427,2009-10,2009,2010,Hull,Wolves,Draw,Away,2009-08-29,1,3,3,3,4,3,3,3,4,0,0,0,0,0,17.0,21.0,-4.0,1
7428,7428,2009-10,2009,2010,Hull,Sunderland,Loss,Away,2009-09-12,0,4,4,4,4,3,3,6,6,1,1,-2,-2,0,17.0,16.0,1.0,2
7429,7429,2009-10,2009,2010,Hull,Birmingham,Loss,Home,2009-09-19,0,1,4,4,4,0,1,4,4,1,3,0,0,1,17.0,21.0,-4.0,2
7430,7430,2009-10,2009,2010,Hull,Liverpool,Loss,Away,2009-09-26,0,0,1,4,4,6,9,9,12,-6,-8,-5,-8,0,17.0,2.0,15.0,2
7431,7431,2009-10,2009,2010,Hull,Wigan,Win,Home,2009-10-03,3,0,0,1,4,3,6,6,6,-3,-6,-5,-2,1,17.0,11.0,6.0,3
7432,7432,2009-10,2009,2010,Hull,Fulham,Loss,Away,2009-10-19,0,3,3,3,4,1,1,4,4,2,2,-1,0,0,17.0,7.0,10.0,3
7433,7433,2009-10,2009,2010,Hull,Portsmouth,Draw,Home,2009-10-24,1,3,3,3,3,3,3,3,3,0,0,0,0,1,17.0,14.0,3.0,3
7434,7434,2009-10,2009,2010,Hull,Burnley,Loss,Away,2009-10-31,0,1,4,4,4,0,3,3,6,1,1,1,-2,0,17.0,21.0,-4.0,3
7435,7435,2009-10,2009,2010,Hull,Stoke,Win,Home,2009-11-08,3,1,1,4,4,4,7,8,8,-3,-6,-4,-4,1,17.0,12.0,5.0,4
7436,7436,2009-10,2009,2010,Hull,West Ham,Draw,Home,2009-11-21,1,3,4,4,7,3,4,5,5,0,0,-1,2,1,17.0,9.0,8.0,4
7437,7437,2009-10,2009,2010,Hull,Everton,Win,Home,2009-11-25,3,4,4,5,5,3,4,4,5,1,0,1,0,1,17.0,5.0,12.0,4
7438,7438,2009-10,2009,2010,Hull,Man City,Draw,Away,2009-11-28,1,4,7,7,8,2,3,4,5,2,4,3,3,0,17.0,10.0,7.0,4
7439,7439,2009-10,2009,2010,Hull,Aston Villa,Loss,Away,2009-12-05,0,4,5,8,8,2,5,5,6,2,0,3,2,0,17.0,6.0,11.0,5
7440,7440,2009-10,2009,2010,Hull,Blackburn,Draw,Home,2009-12-12,1,1,4,5,8,2,2,5,8,-1,2,0,0,1,17.0,15.0,2.0,5
7441,7441,2009-10,2009,2010,Hull,Arsenal,Loss,Away,2009-12-19,0,1,2,5,6,4,7,7,7,-3,-5,-2,-1,0,17.0,4.0,13.0,5
7442,7442,2009-10,2009,2010,Hull,Man United,Loss,Home,2009-12-27,0,1,1,2,5,3,3,6,9,-2,-2,-4,-4,1,17.0,1.0,16.0,5
7443,7443,2009-10,2009,2010,Hull,Bolton,Draw,Away,2009-12-29,1,0,1,1,2,4,5,5,6,-4,-4,-4,-4,0,17.0,13.0,4.0,5
7444,7444,2009-10,2009,2010,Hull,Tottenham,Draw,Away,2010-01-16,1,1,1,2,2,4,7,10,10,-3,-6,-8,-8,0,17.0,8.0,9.0,6
7445,7445,2009-10,2009,2010,Hull,Man United,Loss,Away,2010-01-23,0,2,2,2,3,4,7,10,10,-2,-5,-8,-7,0,17.0,1.0,16.0,6
7446,7446,2009-10,2009,2010,Hull,Wolves,Draw,Home,2010-01-30,1,1,2,2,2,1,1,1,4,0,1,1,-2,1,17.0,21.0,-4.0,6
7447,7447,2009-10,2009,2010,Hull,Chelsea,Draw,Home,2010-02-02,1,1,2,3,3,6,9,12,13,-5,-7,-9,-10,1,17.0,3.0,14.0,7
7448,7448,2009-10,2009,2010,Hull,Man City,Win,Home,2010-02-06,3,2,2,3,4,3,6,9,12,-1,-4,-6,-8,1,17.0,10.0,7.0,7
7449,7449,2009-10,2009,2010,Hull,Blackburn,Loss,Away,2010-02-10,0,4,5,5,6,1,4,7,7,3,1,-2,-1,0,17.0,15.0,2.0,7
7450,7450,2009-10,2009,2010,Hull,West Ham,Loss,Away,2010-02-20,0,3,4,5,5,3,4,5,6,0,0,0,-1,0,17.0,9.0,8.0,7
7451,7451,2009-10,2009,2010,Hull,Everton,Loss,Away,2010-03-07,0,0,3,4,5,3,6,6,9,-3,-3,-2,-4,0,17.0,5.0,12.0,8
7452,7452,2009-10,2009,2010,Hull,Arsenal,Loss,Home,2010-03-13,0,0,0,3,4,6,9,12,12,-6,-9,-9,-8,1,17.0,4.0,13.0,8
7453,7453,2009-10,2009,2010,Hull,Portsmouth,Loss,Away,2010-03-20,0,0,0,0,3,0,3,3,4,0,-3,-3,-1,0,17.0,14.0,3.0,8
7454,7454,2009-10,2009,2010,Hull,Fulham,Win,Home,2010-03-27,3,0,0,0,0,0,1,4,7,0,-1,-4,-7,1,17.0,7.0,10.0,8
7455,7455,2009-10,2009,2010,Hull,Stoke,Loss,Away,2010-04-03,0,3,3,3,3,3,4,5,5,0,-1,-2,-2,0,17.0,12.0,5.0,9
7456,7456,2009-10,2009,2010,Hull,Burnley,Loss,Home,2010-04-10,0,3,3,3,3,0,0,0,1,3,3,3,2,1,17.0,21.0,-4.0,9
7457,7457,2009-10,2009,2010,Hull,Birmingham,Draw,Away,2010-04-17,1,0,3,3,3,1,2,2,2,-1,1,1,1,0,17.0,21.0,-4.0,9
7458,7458,2009-10,2009,2010,Hull,Aston Villa,Loss,Home,2010-04-21,0,1,1,4,4,4,7,7,8,-3,-6,-3,-4,1,17.0,6.0,11.0,9
7459,7459,2009-10,2009,2010,Hull,Sunderland,Loss,Home,2010-04-24,0,1,1,1,4,3,6,6,7,-2,-5,-5,-3,1,17.0,16.0,1.0,9
7460,7460,2009-10,2009,2010,Hull,Wigan,Draw,Away,2010-05-03,1,0,1,1,1,3,4,4,4,-3,-3,-3,-3,0,17.0,11.0,6.0,10
7461,7461,2009-10,2009,2010,Hull,Liverpool,Draw,Home,2010-05-09,1,1,1,2,2,3,6,7,8,-2,-5,-5,-6,1,17.0,2.0,15.0,10
7462,7462,2013-14,2013,2014,Hull,Chelsea,Loss,Away,2013-08-18,0,2,2,2,3,6,7,10,13,-4,-5,-8,-10,0,21.0,3.0,18.0,1
7463,7463,2013-14,2013,2014,Hull,Norwich,Win,Home,2013-08-24,3,1,2,2,2,4,7,7,7,-3,-5,-5,-5,1,21.0,11.0,10.0,1
7464,7464,2013-14,2013,2014,Hull,Man City,Loss,Away,2013-08-31,0,3,4,5,5,3,3,6,9,0,1,-1,-4,0,21.0,2.0,19.0,1
7465,7465,2013-14,2013,2014,Hull,Cardiff,Draw,Home,2013-09-14,1,3,3,4,5,4,4,4,4,-1,-1,0,1,1,21.0,21.0,0.0,2
7466,7466,2013-14,2013,2014,Hull,Newcastle,Win,Away,2013-09-21,3,1,4,4,5,6,7,7,7,-5,-3,-3,-2,0,21.0,16.0,5.0,2
7467,7467,2013-14,2013,2014,Hull,West Ham,Win,Home,2013-09-28,3,4,4,7,7,1,1,2,5,3,3,5,2,1,21.0,10.0,11.0,2
7468,7468,2013-14,2013,2014,Hull,Aston Villa,Draw,Home,2013-10-05,1,6,7,7,10,6,6,6,6,0,1,1,4,1,21.0,15.0,6.0,3
7469,7469,2013-14,2013,2014,Hull,Everton,Loss,Away,2013-10-19,0,4,7,8,8,3,6,9,10,1,1,-1,-2,0,21.0,6.0,15.0,3
7470,7470,2013-14,2013,2014,Hull,Tottenham,Loss,Away,2013-10-27,0,1,4,7,8,3,4,7,10,-2,0,0,-2,0,21.0,5.0,16.0,3
7471,7471,2013-14,2013,2014,Hull,Sunderland,Win,Home,2013-11-02,3,0,1,4,7,3,3,3,3,-3,-2,1,4,1,21.0,17.0,4.0,4
7472,7472,2013-14,2013,2014,Hull,Southampton,Loss,Away,2013-11-09,0,3,3,4,7,4,5,8,11,-1,-2,-4,-4,0,21.0,14.0,7.0,4
7473,7473,2013-14,2013,2014,Hull,Crystal Palace,Loss,Home,2013-11-23,0,3,3,3,4,1,1,1,1,2,2,2,3,1,21.0,21.0,0.0,4
7474,7474,2013-14,2013,2014,Hull,Liverpool,Win,Home,2013-12-01,3,0,3,3,3,4,4,7,8,-4,-1,-4,-5,1,21.0,7.0,14.0,5
7475,7475,2013-14,2013,2014,Hull,Arsenal,Loss,Away,2013-12-04,0,3,3,6,6,6,6,9,12,-3,-3,-3,-6,0,21.0,4.0,17.0,5
7476,7476,2013-14,2013,2014,Hull,Swansea,Draw,Away,2013-12-09,1,3,3,3,6,3,6,7,7,0,-3,-4,-1,0,21.0,9.0,12.0,5
7477,7477,2013-14,2013,2014,Hull,Stoke,Draw,Home,2013-12-14,1,1,4,4,4,4,4,7,8,-3,0,-3,-4,1,21.0,13.0,8.0,5
7478,7478,2013-14,2013,2014,Hull,West Brom,Draw,Away,2013-12-21,1,2,2,5,5,0,0,0,1,2,2,5,4,0,21.0,8.0,13.0,5
7479,7479,2013-14,2013,2014,Hull,Man United,Loss,Home,2013-12-26,0,2,3,3,6,6,6,6,7,-4,-3,-3,-1,1,21.0,1.0,20.0,5
7480,7480,2013-14,2013,2014,Hull,Fulham,Win,Home,2013-12-28,3,1,2,3,3,3,3,6,6,-2,-1,-3,-3,1,21.0,12.0,9.0,5
7481,7481,2013-14,2013,2014,Hull,Liverpool,Loss,Away,2014-01-01,0,3,4,5,6,0,3,6,9,3,1,-1,-3,0,21.0,7.0,14.0,6
7482,7482,2013-14,2013,2014,Hull,Chelsea,Loss,Home,2014-01-11,0,3,3,4,5,6,9,10,13,-3,-6,-6,-8,1,21.0,3.0,18.0,6
7483,7483,2013-14,2013,2014,Hull,Norwich,Loss,Away,2014-01-18,0,0,3,3,4,1,1,1,2,-1,2,2,2,0,21.0,11.0,10.0,6
7484,7484,2013-14,2013,2014,Hull,Crystal Palace,Loss,Away,2014-01-28,0,0,0,3,3,3,4,4,7,-3,-4,-1,-4,0,21.0,21.0,0.0,6
7485,7485,2013-14,2013,2014,Hull,Tottenham,Draw,Home,2014-02-01,1,0,0,0,3,3,6,9,12,-3,-6,-9,-9,1,21.0,5.0,16.0,7
7486,7486,2013-14,2013,2014,Hull,Sunderland,Win,Away,2014-02-08,3,1,1,1,1,6,7,10,10,-5,-6,-9,-9,0,21.0,17.0,4.0,7
7487,7487,2013-14,2013,2014,Hull,Southampton,Loss,Home,2014-02-11,0,4,4,4,4,4,5,6,9,0,-1,-2,-5,1,21.0,14.0,7.0,7
7488,7488,2013-14,2013,2014,Hull,Cardiff,Win,Away,2014-02-22,3,3,4,4,4,1,4,4,4,2,0,0,0,0,21.0,21.0,0.0,7
7489,7489,2013-14,2013,2014,Hull,Newcastle,Loss,Home,2014-03-01,0,3,6,7,7,3,3,3,4,0,3,4,3,1,21.0,16.0,5.0,8
7490,7490,2013-14,2013,2014,Hull,Man City,Loss,Home,2014-03-15,0,3,3,6,7,4,4,7,10,-1,-1,-1,-3,1,21.0,2.0,19.0,8
7491,7491,2013-14,2013,2014,Hull,West Brom,Win,Home,2014-03-22,3,0,3,3,6,3,4,5,5,-3,-1,-2,1,1,21.0,8.0,13.0,8
7492,7492,2013-14,2013,2014,Hull,West Ham,Loss,Away,2014-03-26,0,3,3,6,6,0,0,3,6,3,3,3,0,0,21.0,10.0,11.0,8
7493,7493,2013-14,2013,2014,Hull,Stoke,Loss,Away,2014-03-29,0,3,3,3,6,6,7,10,10,-3,-4,-7,-4,0,21.0,13.0,8.0,8
7494,7494,2013-14,2013,2014,Hull,Swansea,Win,Home,2014-04-05,3,0,3,3,3,4,4,4,5,-4,-1,-1,-2,1,21.0,9.0,12.0,9
7495,7495,2013-14,2013,2014,Hull,Arsenal,Loss,Home,2014-04-20,0,3,3,6,6,3,4,5,5,0,-1,1,1,1,21.0,4.0,17.0,9
7496,7496,2013-14,2013,2014,Hull,Fulham,Draw,Away,2014-04-26,1,3,3,3,6,3,6,6,6,0,-3,-3,0,0,21.0,12.0,9.0,9
7497,7497,2013-14,2013,2014,Hull,Aston Villa,Loss,Away,2014-05-03,0,1,4,4,4,1,1,1,1,0,3,3,3,0,21.0,15.0,6.0,10
7498,7498,2013-14,2013,2014,Hull,Man United,Loss,Away,2014-05-06,0,1,1,4,4,3,3,6,9,-2,-2,-2,-5,0,21.0,1.0,20.0,10
7499,7499,2013-14,2013,2014,Hull,Everton,Loss,Home,2014-05-11,0,0,1,1,4,0,3,3,6,0,-2,-2,-2,1,21.0,6.0,15.0,10
7500,7500,2014-15,2014,2015,Hull,QPR,Win,Away,2014-08-16,3,0,0,1,1,0,0,1,1,0,0,0,0,0,16.0,21.0,-5.0,1
7501,7501,2014-15,2014,2015,Hull,Stoke,Draw,Home,2014-08-24,1,3,3,3,4,3,6,6,7,0,-3,-3,-3,1,16.0,9.0,7.0,1
7502,7502,2014-15,2014,2015,Hull,Aston Villa,Loss,Away,2014-08-31,0,4,4,4,4,4,4,4,7,0,0,0,-3,0,16.0,15.0,1.0,1
7503,7503,2014-15,2014,2015,Hull,West Ham,Draw,Home,2014-09-15,1,1,4,4,4,3,3,3,6,-2,1,1,-2,1,16.0,13.0,3.0,2
7504,7504,2014-15,2014,2015,Hull,Newcastle,Draw,Away,2014-09-20,1,1,2,5,5,1,2,2,2,0,0,3,3,0,16.0,10.0,6.0,2
7505,7505,2014-15,2014,2015,Hull,Man City,Loss,Home,2014-09-27,0,2,2,3,6,2,2,5,8,0,0,-2,-2,1,16.0,1.0,15.0,2
7506,7506,2014-15,2014,2015,Hull,Crystal Palace,Win,Home,2014-10-04,3,1,2,2,3,6,7,8,8,-5,-5,-6,-5,1,16.0,11.0,5.0,3
7507,7507,2014-15,2014,2015,Hull,Arsenal,Draw,Away,2014-10-18,1,3,4,5,5,1,4,5,6,2,0,0,-1,0,16.0,4.0,12.0,3
7508,7508,2014-15,2014,2015,Hull,Liverpool,Draw,Away,2014-10-25,1,4,4,5,6,6,7,7,7,-2,-3,-2,-1,0,16.0,2.0,14.0,3
7509,7509,2014-15,2014,2015,Hull,Southampton,Loss,Home,2014-11-01,0,2,5,5,6,6,6,9,12,-4,-1,-4,-6,1,16.0,8.0,8.0,4
7510,7510,2014-15,2014,2015,Hull,Burnley,Loss,Away,2014-11-08,0,1,2,5,5,0,0,1,1,1,2,4,4,0,16.0,21.0,-5.0,4
7511,7511,2014-15,2014,2015,Hull,Tottenham,Loss,Home,2014-11-23,0,0,1,2,5,3,3,3,6,-3,-2,-1,-1,1,16.0,6.0,10.0,4
7512,7512,2014-15,2014,2015,Hull,Man United,Loss,Away,2014-11-29,0,0,0,1,2,6,6,7,8,-6,-6,-6,-6,0,16.0,7.0,9.0,4
7513,7513,2014-15,2014,2015,Hull,Everton,Draw,Away,2014-12-03,1,0,0,0,1,3,4,5,8,-3,-4,-5,-7,0,16.0,5.0,11.0,5
7514,7514,2014-15,2014,2015,Hull,West Brom,Draw,Home,2014-12-06,1,1,1,1,1,0,0,0,3,1,1,1,-2,1,16.0,17.0,-1.0,5
7515,7515,2014-15,2014,2015,Hull,Chelsea,Loss,Away,2014-12-13,0,2,2,2,2,3,4,7,10,-1,-2,-5,-8,0,16.0,3.0,13.0,5
7516,7516,2014-15,2014,2015,Hull,Swansea,Loss,Home,2014-12-20,0,1,2,2,2,0,3,4,4,1,-1,-2,-2,1,16.0,12.0,4.0,5
7517,7517,2014-15,2014,2015,Hull,Sunderland,Win,Away,2014-12-26,3,0,1,2,2,4,5,5,6,-4,-4,-3,-4,0,16.0,14.0,2.0,5
7518,7518,2014-15,2014,2015,Hull,Leicester,Loss,Home,2014-12-28,0,3,3,4,5,0,0,0,0,3,3,4,5,1,16.0,21.0,-5.0,5
7519,7519,2014-15,2014,2015,Hull,Everton,Win,Home,2015-01-01,3,3,3,3,4,0,0,3,3,3,3,0,1,1,16.0,5.0,11.0,6
7520,7520,2014-15,2014,2015,Hull,West Brom,Loss,Away,2015-01-10,0,3,6,6,6,1,1,1,4,2,5,5,2,0,16.0,17.0,-1.0,6
7521,7521,2014-15,2014,2015,Hull,West Ham,Loss,Away,2015-01-18,0,3,3,6,6,2,2,2,5,1,1,4,1,0,16.0,13.0,3.0,6
7522,7522,2014-15,2014,2015,Hull,Newcastle,Loss,Home,2015-01-31,0,0,3,3,6,0,1,4,4,0,2,-1,2,1,16.0,10.0,6.0,6
7523,7523,2014-15,2014,2015,Hull,Man City,Draw,Away,2015-02-07,1,0,0,3,3,1,2,5,6,-1,-2,-2,-3,0,16.0,1.0,15.0,7
7524,7524,2014-15,2014,2015,Hull,Aston Villa,Win,Home,2015-02-10,3,1,1,1,4,0,0,0,1,1,1,1,3,1,16.0,15.0,1.0,7
7525,7525,2014-15,2014,2015,Hull,QPR,Win,Home,2015-02-21,3,4,4,4,4,3,3,3,3,1,1,1,1,1,16.0,21.0,-5.0,7
7526,7526,2014-15,2014,2015,Hull,Stoke,Loss,Away,2015-02-28,0,6,7,7,7,3,4,7,10,3,3,0,-3,0,16.0,9.0,7.0,7
7527,7527,2014-15,2014,2015,Hull,Sunderland,Draw,Home,2015-03-03,1,3,6,7,7,1,1,2,5,2,5,5,2,1,16.0,14.0,2.0,8
7528,7528,2014-15,2014,2015,Hull,Leicester,Draw,Away,2015-03-14,1,1,4,7,8,1,1,1,1,0,3,6,7,0,16.0,21.0,-5.0,8
7529,7529,2014-15,2014,2015,Hull,Chelsea,Loss,Home,2015-03-22,0,2,2,5,8,4,5,8,11,-2,-3,-3,-3,1,16.0,3.0,13.0,8
7530,7530,2014-15,2014,2015,Hull,Swansea,Loss,Away,2015-04-04,0,1,2,2,5,3,3,6,9,-2,-1,-4,-4,0,16.0,12.0,4.0,9
7531,7531,2014-15,2014,2015,Hull,Southampton,Loss,Away,2015-04-11,0,0,1,2,2,3,4,7,7,-3,-3,-5,-5,0,16.0,8.0,8.0,9
7532,7532,2014-15,2014,2015,Hull,Crystal Palace,Win,Away,2015-04-25,3,0,0,1,2,3,6,9,12,-3,-6,-8,-10,0,16.0,11.0,5.0,9
7533,7533,2014-15,2014,2015,Hull,Liverpool,Win,Home,2015-04-28,3,3,3,3,4,4,4,4,7,-1,-1,-1,-3,1,16.0,2.0,14.0,9
7534,7534,2014-15,2014,2015,Hull,Arsenal,Loss,Home,2015-05-04,0,6,6,6,6,4,7,10,13,2,-1,-4,-7,1,16.0,4.0,12.0,10
7535,7535,2014-15,2014,2015,Hull,Burnley,Loss,Home,2015-05-09,0,3,6,6,6,0,0,0,1,3,6,6,5,1,16.0,21.0,-5.0,10
7536,7536,2014-15,2014,2015,Hull,Tottenham,Loss,Away,2015-05-16,0,0,3,6,6,0,1,4,4,0,2,2,2,0,16.0,6.0,10.0,10
7537,7537,2014-15,2014,2015,Hull,Man United,Draw,Home,2015-05-24,1,0,0,3,6,4,4,4,4,-4,-4,-1,2,1,16.0,7.0,9.0,10
7538,7538,2016-17,2016,2017,Hull,Leicester,Win,Home,2016-08-13,3,1,1,1,4,4,5,8,9,-3,-4,-7,-5,1,21.0,1.0,20.0,1
7539,7539,2016-17,2016,2017,Hull,Swansea,Win,Away,2016-08-20,3,4,4,4,4,4,7,10,10,0,-3,-6,-6,0,21.0,12.0,9.0,1
7540,7540,2016-17,2016,2017,Hull,Man United,Loss,Home,2016-08-27,0,6,7,7,7,6,9,9,12,0,-2,-2,-5,1,21.0,5.0,16.0,1
7541,7541,2016-17,2016,2017,Hull,Burnley,Draw,Away,2016-09-10,1,3,6,7,7,3,3,6,7,0,3,1,0,0,21.0,21.0,0.0,2
7542,7542,2016-17,2016,2017,Hull,Arsenal,Loss,Home,2016-09-17,0,1,4,7,8,6,7,7,10,-5,-3,0,-2,1,21.0,2.0,19.0,2
7543,7543,2016-17,2016,2017,Hull,Liverpool,Loss,Away,2016-09-24,0,1,1,4,7,6,7,7,10,-5,-6,-3,-3,0,21.0,8.0,13.0,2
7544,7544,2016-17,2016,2017,Hull,Chelsea,Loss,Home,2016-10-01,0,0,1,1,4,0,1,4,7,0,0,-3,-3,1,21.0,10.0,11.0,3
7545,7545,2016-17,2016,2017,Hull,Bournemouth,Loss,Away,2016-10-15,0,0,0,1,1,4,4,7,8,-4,-4,-6,-7,0,21.0,16.0,5.0,3
7546,7546,2016-17,2016,2017,Hull,Stoke,Loss,Home,2016-10-22,0,0,0,0,1,4,5,5,5,-4,-5,-5,-4,1,21.0,9.0,12.0,3
7547,7547,2016-17,2016,2017,Hull,Watford,Loss,Away,2016-10-29,0,0,0,0,0,4,5,5,8,-4,-5,-5,-8,0,21.0,13.0,8.0,3
7548,7548,2016-17,2016,2017,Hull,Southampton,Win,Home,2016-11-06,3,0,0,0,0,1,4,5,8,-1,-4,-5,-8,1,21.0,6.0,15.0,4
7549,7549,2016-17,2016,2017,Hull,Sunderland,Loss,Away,2016-11-19,0,3,3,3,3,3,3,3,4,0,0,0,-1,0,21.0,17.0,4.0,4
7550,7550,2016-17,2016,2017,Hull,West Brom,Draw,Home,2016-11-26,1,3,3,3,3,6,6,6,7,-3,-3,-3,-4,1,21.0,14.0,7.0,4
7551,7551,2016-17,2016,2017,Hull,Middlesbrough,Loss,Away,2016-12-05,0,1,4,4,4,1,2,5,6,0,2,-1,-2,0,21.0,21.0,0.0,5
7552,7552,2016-17,2016,2017,Hull,Crystal Palace,Draw,Home,2016-12-10,1,1,1,4,4,3,3,3,3,-2,-2,1,1,1,21.0,15.0,6.0,5
7553,7553,2016-17,2016,2017,Hull,Tottenham,Loss,Away,2016-12-14,0,1,2,2,5,3,3,6,7,-2,-1,-4,-2,0,21.0,3.0,18.0,5
7554,7554,2016-17,2016,2017,Hull,West Ham,Loss,Away,2016-12-17,0,1,1,2,2,4,4,5,5,-3,-3,-3,-3,0,21.0,7.0,14.0,5
7555,7555,2016-17,2016,2017,Hull,Man City,Loss,Home,2016-12-26,0,0,1,1,2,6,6,6,9,-6,-5,-5,-7,1,21.0,4.0,17.0,5
7556,7556,2016-17,2016,2017,Hull,Everton,Draw,Home,2016-12-30,1,0,0,1,1,3,6,6,7,-3,-6,-5,-6,1,21.0,11.0,10.0,5
7557,7557,2016-17,2016,2017,Hull,West Brom,Loss,Away,2017-01-02,0,1,1,1,2,3,3,6,6,-2,-2,-5,-4,0,21.0,14.0,7.0,6
7558,7558,2016-17,2016,2017,Hull,Bournemouth,Win,Home,2017-01-14,3,1,1,1,1,4,4,4,7,-3,-3,-3,-6,1,21.0,16.0,5.0,6
7559,7559,2016-17,2016,2017,Hull,Chelsea,Loss,Away,2017-01-22,0,3,4,4,4,3,6,9,12,0,-2,-5,-8,0,21.0,10.0,11.0,6
7560,7560,2016-17,2016,2017,Hull,Man United,Draw,Away,2017-02-01,1,3,3,4,4,2,5,8,11,1,-2,-4,-7,0,21.0,5.0,16.0,7
7561,7561,2016-17,2016,2017,Hull,Liverpool,Win,Home,2017-02-04,3,1,4,4,5,1,2,3,6,0,2,1,-1,1,21.0,8.0,13.0,7
7562,7562,2016-17,2016,2017,Hull,Arsenal,Loss,Away,2017-02-11,0,4,4,7,7,0,3,6,7,4,1,1,0,0,21.0,2.0,19.0,7
7563,7563,2016-17,2016,2017,Hull,Burnley,Draw,Home,2017-02-25,1,3,4,4,7,1,4,4,7,2,0,0,0,1,21.0,21.0,0.0,7
7564,7564,2016-17,2016,2017,Hull,Leicester,Loss,Away,2017-03-04,0,1,4,5,5,3,3,3,3,-2,1,2,2,0,21.0,1.0,20.0,8
7565,7565,2016-17,2016,2017,Hull,Swansea,Win,Home,2017-03-11,3,1,1,4,5,3,6,6,9,-2,-5,-2,-4,1,21.0,12.0,9.0,8
7566,7566,2016-17,2016,2017,Hull,Everton,Loss,Away,2017-03-18,0,3,4,4,7,3,6,7,10,0,-2,-3,-3,0,21.0,11.0,10.0,8
7567,7567,2016-17,2016,2017,Hull,West Ham,Win,Home,2017-04-01,3,3,3,4,4,0,0,1,2,3,3,3,2,1,21.0,7.0,14.0,9
7568,7568,2016-17,2016,2017,Hull,Middlesbrough,Win,Home,2017-04-05,3,3,6,6,7,1,1,1,2,2,5,5,5,1,21.0,21.0,0.0,9
7569,7569,2016-17,2016,2017,Hull,Man City,Loss,Away,2017-04-08,0,6,6,9,9,1,2,3,6,5,4,6,3,0,21.0,4.0,17.0,9
7570,7570,2016-17,2016,2017,Hull,Stoke,Loss,Away,2017-04-15,0,3,6,6,9,0,0,0,1,3,6,6,8,0,21.0,9.0,12.0,9
7571,7571,2016-17,2016,2017,Hull,Watford,Win,Home,2017-04-22,3,0,3,6,6,3,6,9,9,-3,-3,-3,-3,1,21.0,13.0,8.0,9
7572,7572,2016-17,2016,2017,Hull,Southampton,Draw,Away,2017-04-29,1,3,3,6,9,0,3,6,7,3,0,0,2,0,21.0,6.0,15.0,9
7573,7573,2016-17,2016,2017,Hull,Sunderland,Loss,Home,2017-05-06,0,4,4,4,7,0,1,1,1,4,3,3,6,1,21.0,17.0,4.0,10
7574,7574,2016-17,2016,2017,Hull,Crystal Palace,Loss,Away,2017-05-14,0,1,4,4,4,0,0,3,4,1,4,1,0,0,21.0,15.0,6.0,10
7575,7575,2016-17,2016,2017,Hull,Tottenham,Loss,Home,2017-05-21,0,0,1,4,4,6,6,9,12,-6,-5,-5,-8,1,21.0,3.0,18.0,10
7576,7576,1993-94,1993,1994,Ipswich,Oldham,Win,Away,1993-08-14,3,0,0,0,0,0,0,0,0,0,0,0,0,0,16.0,19.0,-3.0,1
7577,7577,1993-94,1993,1994,Ipswich,Southampton,Win,Home,1993-08-17,3,3,3,3,3,0,0,0,0,3,3,3,3,1,16.0,18.0,-2.0,1
7578,7578,1993-94,1993,1994,Ipswich,Chelsea,Win,Home,1993-08-21,3,6,6,6,6,1,1,1,1,5,5,5,5,1,16.0,11.0,5.0,1
7579,7579,1993-94,1993,1994,Ipswich,Norwich,Loss,Away,1993-08-25,0,6,9,9,9,6,6,6,6,0,3,3,3,0,16.0,3.0,13.0,1
7580,7580,1993-94,1993,1994,Ipswich,Sheffield United,Draw,Away,1993-08-28,1,3,6,9,9,3,3,6,6,0,3,3,3,0,16.0,14.0,2.0,1
7581,7581,1993-94,1993,1994,Ipswich,Newcastle,Draw,Home,1993-08-31,1,1,4,7,10,4,5,5,5,-3,-1,2,5,1,16.0,21.0,-5.0,1
7582,7582,1993-94,1993,1994,Ipswich,Arsenal,Loss,Away,1993-09-11,0,2,2,5,8,4,7,10,13,-2,-5,-5,-5,0,16.0,10.0,6.0,2
7583,7583,1993-94,1993,1994,Ipswich,Aston Villa,Loss,Home,1993-09-18,0,1,2,2,5,4,7,7,8,-3,-5,-5,-3,1,16.0,2.0,14.0,2
7584,7584,1993-94,1993,1994,Ipswich,Tottenham,Draw,Home,1993-09-26,1,0,1,2,2,4,5,5,8,-4,-4,-3,-6,1,16.0,8.0,8.0,2
7585,7585,1993-94,1993,1994,Ipswich,QPR,Loss,Away,1993-10-02,0,1,1,2,3,2,2,5,8,-1,-1,-3,-5,0,16.0,5.0,11.0,3
7586,7586,1993-94,1993,1994,Ipswich,Leeds,Draw,Home,1993-10-17,1,1,1,1,2,6,9,12,15,-5,-8,-11,-13,1,16.0,17.0,-1.0,3
7587,7587,1993-94,1993,1994,Ipswich,Wimbledon,Win,Away,1993-10-25,3,1,2,2,2,1,2,5,8,0,0,-3,-6,0,16.0,12.0,4.0,3
7588,7588,1993-94,1993,1994,Ipswich,Everton,Loss,Home,1993-10-30,0,4,4,5,5,1,1,1,4,3,3,4,1,1,16.0,13.0,3.0,3
7589,7589,1993-94,1993,1994,Ipswich,Sheffield Weds,Loss,Home,1993-11-06,0,3,4,4,5,2,3,3,4,1,1,1,1,1,16.0,7.0,9.0,4
7590,7590,1993-94,1993,1994,Ipswich,Swindon,Draw,Away,1993-11-20,1,0,3,4,4,0,1,2,2,0,2,2,2,0,16.0,21.0,-5.0,4
7591,7591,1993-94,1993,1994,Ipswich,Man United,Draw,Away,1993-11-24,1,1,1,4,5,6,9,12,15,-5,-8,-8,-10,0,16.0,1.0,15.0,4
7592,7592,1993-94,1993,1994,Ipswich,Blackburn,Win,Home,1993-11-27,3,2,2,2,5,6,6,9,10,-4,-4,-7,-5,1,16.0,4.0,12.0,4
7593,7593,1993-94,1993,1994,Ipswich,Oldham,Draw,Home,1993-12-04,1,4,5,5,5,3,3,3,6,1,2,2,-1,1,16.0,19.0,-3.0,5
7594,7594,1993-94,1993,1994,Ipswich,Southampton,Win,Away,1993-12-08,3,4,5,6,6,0,3,3,6,4,2,3,0,0,16.0,18.0,-2.0,5
7595,7595,1993-94,1993,1994,Ipswich,Chelsea,Draw,Away,1993-12-11,1,4,7,8,9,0,1,1,1,4,6,7,8,0,16.0,11.0,5.0,5
7596,7596,1993-94,1993,1994,Ipswich,Norwich,Win,Home,1993-12-18,3,4,5,8,9,4,4,5,8,0,1,3,1,1,16.0,3.0,13.0,5
7597,7597,1993-94,1993,1994,Ipswich,West Ham,Draw,Home,1993-12-27,1,4,7,8,11,3,3,6,9,1,4,2,2,1,16.0,21.0,-5.0,5
7598,7598,1993-94,1993,1994,Ipswich,Liverpool,Loss,Home,1994-01-01,0,4,5,8,9,2,3,4,7,2,2,4,2,1,16.0,6.0,10.0,6
7599,7599,1993-94,1993,1994,Ipswich,Leeds,Draw,Away,1994-01-15,1,1,4,5,8,2,3,6,6,-1,1,-1,2,0,16.0,17.0,-1.0,6
7600,7600,1993-94,1993,1994,Ipswich,Wimbledon,Draw,Home,1994-01-22,1,1,2,5,6,3,4,4,7,-2,-2,1,-1,1,16.0,12.0,4.0,6
7601,7601,1993-94,1993,1994,Ipswich,Coventry,Loss,Away,1994-02-02,0,2,2,3,6,0,1,4,7,2,1,-1,-1,0,16.0,15.0,1.0,7
7602,7602,1993-94,1993,1994,Ipswich,Man City,Loss,Away,1994-02-05,0,1,2,2,3,1,1,2,2,0,1,0,1,0,16.0,9.0,7.0,7
7603,7603,1993-94,1993,1994,Ipswich,Everton,Draw,Away,1994-02-12,1,0,1,2,2,3,6,6,6,-3,-5,-4,-4,0,16.0,13.0,3.0,7
7604,7604,1993-94,1993,1994,Ipswich,Sheffield United,Win,Home,1994-02-26,3,1,1,2,3,1,1,2,5,0,0,0,-2,1,16.0,14.0,2.0,7
7605,7605,1993-94,1993,1994,Ipswich,Arsenal,Loss,Home,1994-03-05,0,4,4,4,5,4,5,6,7,0,-1,-2,-2,1,16.0,10.0,6.0,8
7606,7606,1993-94,1993,1994,Ipswich,Aston Villa,Win,Away,1994-03-12,3,3,4,4,4,4,5,8,11,-1,-1,-4,-7,0,16.0,2.0,14.0,8
7607,7607,1993-94,1993,1994,Ipswich,Tottenham,Draw,Away,1994-03-19,1,3,6,7,7,2,2,2,2,1,4,5,5,0,16.0,8.0,8.0,8
7608,7608,1993-94,1993,1994,Ipswich,Newcastle,Loss,Away,1994-03-22,0,4,4,7,8,6,9,12,12,-2,-5,-5,-4,0,16.0,21.0,-5.0,8
7609,7609,1993-94,1993,1994,Ipswich,QPR,Loss,Home,1994-03-26,0,1,4,4,7,4,7,8,8,-3,-3,-4,-1,1,16.0,5.0,11.0,8
7610,7610,1993-94,1993,1994,Ipswich,Man City,Draw,Home,1994-03-29,1,0,1,4,4,2,2,3,6,-2,-1,1,-2,1,16.0,9.0,7.0,8
7611,7611,1993-94,1993,1994,Ipswich,West Ham,Loss,Away,1994-04-02,0,1,1,2,5,0,0,1,2,1,1,1,3,0,16.0,21.0,-5.0,9
7612,7612,1993-94,1993,1994,Ipswich,Coventry,Loss,Home,1994-04-04,0,1,1,1,2,3,3,3,3,-2,-2,-2,-1,1,16.0,15.0,1.0,9
7613,7613,1993-94,1993,1994,Ipswich,Liverpool,Loss,Away,1994-04-09,0,0,1,1,1,1,1,1,4,-1,0,0,-3,0,16.0,6.0,10.0,9
7614,7614,1993-94,1993,1994,Ipswich,Swindon,Draw,Home,1994-04-16,1,0,0,1,1,1,1,2,2,-1,-1,-1,-1,1,16.0,21.0,-5.0,9
7615,7615,1993-94,1993,1994,Ipswich,Sheffield Weds,Loss,Away,1994-04-23,0,1,1,1,2,4,7,10,13,-3,-6,-9,-11,0,16.0,7.0,9.0,9
7616,7616,1993-94,1993,1994,Ipswich,Man United,Loss,Home,1994-05-01,0,1,1,1,1,6,6,9,9,-5,-5,-8,-8,1,16.0,1.0,15.0,10
7617,7617,1993-94,1993,1994,Ipswich,Blackburn,Draw,Away,1994-05-07,1,0,1,1,1,3,4,4,7,-3,-3,-3,-6,0,16.0,4.0,12.0,10
7618,7618,1994-95,1994,1995,Ipswich,Nott'm Forest,Loss,Home,1994-08-20,0,1,1,2,2,0,0,0,0,1,1,2,2,1,19.0,21.0,-2.0,1
7619,7619,1994-95,1994,1995,Ipswich,Wimbledon,Draw,Away,1994-08-23,1,1,1,1,2,1,4,7,10,0,-3,-6,-8,0,19.0,6.0,13.0,1
7620,7620,1994-95,1994,1995,Ipswich,QPR,Win,Away,1994-08-27,3,1,2,2,2,3,6,7,7,-2,-4,-5,-5,0,19.0,9.0,10.0,1
7621,7621,1994-95,1994,1995,Ipswich,Tottenham,Loss,Home,1994-08-30,0,4,4,5,5,3,6,6,9,1,-2,-1,-4,1,19.0,15.0,4.0,1
7622,7622,1994-95,1994,1995,Ipswich,Aston Villa,Loss,Away,1994-09-10,0,3,4,4,5,4,5,6,9,-1,-1,-2,-4,0,19.0,10.0,9.0,2
7623,7623,1994-95,1994,1995,Ipswich,Norwich,Loss,Home,1994-09-19,0,0,3,4,4,2,5,6,6,-2,-2,-2,-2,1,19.0,12.0,7.0,2
7624,7624,1994-95,1994,1995,Ipswich,Man United,Win,Home,1994-09-24,3,0,0,3,4,3,6,9,10,-3,-6,-6,-6,1,19.0,1.0,18.0,2
7625,7625,1994-95,1994,1995,Ipswich,Southampton,Loss,Away,1994-10-01,0,3,3,3,6,4,7,7,7,-1,-4,-4,-1,0,19.0,18.0,1.0,3
7626,7626,1994-95,1994,1995,Ipswich,Coventry,Loss,Away,1994-10-10,0,3,3,3,3,1,4,5,5,2,-1,-2,-2,0,19.0,11.0,8.0,3
7627,7627,1994-95,1994,1995,Ipswich,Sheffield Weds,Loss,Home,1994-10-16,0,0,3,3,3,3,4,5,5,-3,-1,-2,-2,1,19.0,7.0,12.0,3
7628,7628,1994-95,1994,1995,Ipswich,Chelsea,Loss,Away,1994-10-23,0,0,0,3,3,3,3,6,6,-3,-3,-3,-3,0,19.0,14.0,5.0,3
7629,7629,1994-95,1994,1995,Ipswich,Liverpool,Loss,Home,1994-10-29,0,0,0,0,3,3,6,9,10,-3,-6,-9,-7,1,19.0,8.0,11.0,3
7630,7630,1994-95,1994,1995,Ipswich,Leeds,Win,Home,1994-11-01,3,0,0,0,0,6,7,7,10,-6,-7,-7,-10,1,19.0,5.0,14.0,4
7631,7631,1994-95,1994,1995,Ipswich,Crystal Palace,Loss,Away,1994-11-05,0,3,3,3,3,6,9,9,9,-3,-6,-6,-6,0,19.0,21.0,-2.0,4
7632,7632,1994-95,1994,1995,Ipswich,Blackburn,Loss,Home,1994-11-19,0,3,3,3,3,6,9,9,12,-3,-6,-6,-9,1,19.0,2.0,17.0,4
7633,7633,1994-95,1994,1995,Ipswich,Newcastle,Draw,Away,1994-11-26,1,0,3,3,3,1,4,4,7,-1,-1,-1,-4,0,19.0,3.0,16.0,4
7634,7634,1994-95,1994,1995,Ipswich,Man City,Loss,Home,1994-12-03,0,1,1,4,4,6,6,7,7,-5,-5,-3,-3,1,19.0,16.0,3.0,5
7635,7635,1994-95,1994,1995,Ipswich,Nott'm Forest,Loss,Away,1994-12-10,0,1,1,1,4,1,1,2,2,0,0,-1,2,0,19.0,21.0,-2.0,5
7636,7636,1994-95,1994,1995,Ipswich,Wimbledon,Draw,Home,1994-12-16,1,0,1,1,1,3,3,6,9,-3,-2,-5,-8,1,19.0,6.0,13.0,5
7637,7637,1994-95,1994,1995,Ipswich,West Ham,Draw,Away,1994-12-26,1,1,1,2,2,4,4,4,4,-3,-3,-2,-2,0,19.0,13.0,6.0,5
7638,7638,1994-95,1994,1995,Ipswich,Arsenal,Loss,Home,1994-12-28,0,2,2,2,3,1,4,5,6,1,-2,-3,-3,1,19.0,4.0,15.0,5
7639,7639,1994-95,1994,1995,Ipswich,Everton,Loss,Away,1994-12-31,0,1,2,2,2,1,2,5,8,0,0,-3,-6,0,19.0,17.0,2.0,5
7640,7640,1994-95,1994,1995,Ipswich,Leicester,Win,Home,1995-01-02,3,0,1,2,2,1,1,2,2,-1,0,0,0,1,19.0,21.0,-2.0,6
7641,7641,1994-95,1994,1995,Ipswich,Liverpool,Win,Away,1995-01-14,3,3,3,4,5,6,9,12,13,-3,-6,-8,-8,0,19.0,8.0,11.0,6
7642,7642,1994-95,1994,1995,Ipswich,Chelsea,Draw,Home,1995-01-21,1,6,6,6,7,2,2,2,3,4,4,4,4,1,19.0,14.0,5.0,6
7643,7643,1994-95,1994,1995,Ipswich,Blackburn,Loss,Away,1995-01-28,0,4,7,7,7,3,6,9,12,1,1,-2,-5,0,19.0,2.0,17.0,6
7644,7644,1994-95,1994,1995,Ipswich,Crystal Palace,Loss,Home,1995-02-04,0,1,4,7,7,1,4,4,4,0,0,3,3,1,19.0,21.0,-2.0,7
7645,7645,1994-95,1994,1995,Ipswich,Man City,Loss,Away,1995-02-22,0,0,1,4,7,1,1,2,3,-1,0,2,4,0,19.0,16.0,3.0,7
7646,7646,1994-95,1994,1995,Ipswich,Southampton,Win,Home,1995-02-25,3,0,0,1,4,2,3,4,5,-2,-3,-3,-1,1,19.0,18.0,1.0,7
7647,7647,1994-95,1994,1995,Ipswich,Newcastle,Loss,Home,1995-02-28,0,3,3,3,4,6,6,9,12,-3,-3,-6,-8,1,19.0,3.0,16.0,7
7648,7648,1994-95,1994,1995,Ipswich,Man United,Loss,Away,1995-03-04,0,3,3,3,3,3,6,9,10,0,-3,-6,-7,0,19.0,1.0,18.0,8
7649,7649,1994-95,1994,1995,Ipswich,Tottenham,Loss,Away,1995-03-08,0,0,3,3,3,1,2,5,5,-1,1,-2,-2,0,19.0,15.0,4.0,8
7650,7650,1994-95,1994,1995,Ipswich,Norwich,Loss,Away,1995-03-20,0,0,0,3,3,1,2,3,4,-1,-2,0,-1,0,19.0,12.0,7.0,8
7651,7651,1994-95,1994,1995,Ipswich,Aston Villa,Loss,Home,1995-04-01,0,0,0,0,3,1,1,1,2,-1,-1,-1,1,1,19.0,10.0,9.0,9
7652,7652,1994-95,1994,1995,Ipswich,Leeds,Loss,Away,1995-04-05,0,0,0,0,0,1,4,7,10,-1,-4,-7,-10,0,19.0,5.0,14.0,9
7653,7653,1994-95,1994,1995,Ipswich,QPR,Loss,Home,1995-04-11,0,0,0,0,0,3,6,9,9,-3,-6,-9,-9,1,19.0,9.0,10.0,9
7654,7654,1994-95,1994,1995,Ipswich,Arsenal,Loss,Away,1995-04-15,0,0,0,0,0,0,3,3,3,0,-3,-3,-3,0,19.0,4.0,15.0,9
7655,7655,1994-95,1994,1995,Ipswich,West Ham,Draw,Home,1995-04-17,1,0,0,0,0,4,7,8,9,-4,-7,-8,-9,1,19.0,13.0,6.0,9
7656,7656,1994-95,1994,1995,Ipswich,Leicester,Loss,Away,1995-04-29,0,1,1,1,1,0,0,3,3,1,1,-2,-2,0,19.0,21.0,-2.0,9
7657,7657,1994-95,1994,1995,Ipswich,Coventry,Win,Home,1995-05-06,3,1,1,1,1,0,3,3,3,1,-2,-2,-2,1,19.0,11.0,8.0,10
7658,7658,1994-95,1994,1995,Ipswich,Everton,Loss,Home,1995-05-09,0,3,4,4,4,2,3,4,7,1,1,0,-3,1,19.0,17.0,2.0,10
7659,7659,1994-95,1994,1995,Ipswich,Sheffield Weds,Loss,Away,1995-05-14,0,3,3,4,4,1,2,2,5,2,1,2,-1,0,19.0,7.0,12.0,10
7660,7660,2000-01,2000,2001,Ipswich,Tottenham,Loss,Away,2000-08-19,0,0,3,3,4,3,4,7,10,-3,-1,-4,-6,0,21.0,10.0,11.0,1
7661,7661,2000-01,2000,2001,Ipswich,Man United,Draw,Home,2000-08-22,1,0,0,3,3,6,9,12,15,-6,-9,-9,-12,1,21.0,1.0,20.0,1
7662,7662,2000-01,2000,2001,Ipswich,Sunderland,Win,Home,2000-08-26,3,1,1,1,4,3,3,6,7,-2,-2,-5,-3,1,21.0,7.0,14.0,1
7663,7663,2000-01,2000,2001,Ipswich,Leicester,Loss,Away,2000-09-06,0,4,4,4,4,4,5,5,8,0,-1,-1,-4,0,21.0,8.0,13.0,2
7664,7664,2000-01,2000,2001,Ipswich,Aston Villa,Loss,Home,2000-09-09,0,3,4,4,4,1,2,2,3,2,2,2,1,1,21.0,6.0,15.0,2
7665,7665,2000-01,2000,2001,Ipswich,Leeds,Win,Away,2000-09-16,3,0,3,4,4,1,4,7,8,-1,-1,-3,-4,0,21.0,3.0,18.0,2
7666,7666,2000-01,2000,2001,Ipswich,Arsenal,Draw,Home,2000-09-23,1,3,3,6,7,4,5,8,11,-1,-2,-2,-4,1,21.0,2.0,19.0,2
7667,7667,2000-01,2000,2001,Ipswich,Everton,Win,Away,2000-09-30,3,4,4,4,7,1,4,4,5,3,0,0,2,0,21.0,13.0,8.0,2
7668,7668,2000-01,2000,2001,Ipswich,West Ham,Draw,Home,2000-10-14,1,4,7,7,7,4,5,5,6,0,2,2,1,1,21.0,9.0,12.0,3
7669,7669,2000-01,2000,2001,Ipswich,Bradford,Win,Away,2000-10-21,3,4,5,8,8,1,1,1,2,3,4,7,6,0,21.0,17.0,4.0,3
7670,7670,2000-01,2000,2001,Ipswich,Middlesbrough,Win,Home,2000-10-28,3,4,7,8,11,0,3,4,5,4,4,4,6,1,21.0,12.0,9.0,3
7671,7671,2000-01,2000,2001,Ipswich,Newcastle,Loss,Away,2000-11-04,0,6,7,10,11,0,3,6,6,6,4,4,5,0,21.0,11.0,10.0,4
7672,7672,2000-01,2000,2001,Ipswich,Charlton,Win,Home,2000-11-11,3,3,6,7,10,3,6,6,7,0,0,1,3,1,21.0,21.0,0.0,4
7673,7673,2000-01,2000,2001,Ipswich,Coventry,Win,Away,2000-11-20,3,3,6,9,10,0,0,0,3,3,6,9,7,0,21.0,14.0,7.0,4
7674,7674,2000-01,2000,2001,Ipswich,Man City,Win,Away,2000-11-25,3,6,6,9,12,0,0,0,3,6,6,9,9,0,21.0,21.0,0.0,4
7675,7675,2000-01,2000,2001,Ipswich,Derby,Loss,Home,2000-12-02,0,6,9,9,12,3,4,5,5,3,5,4,7,1,21.0,16.0,5.0,5
7676,7676,2000-01,2000,2001,Ipswich,Liverpool,Win,Away,2000-12-10,3,3,6,9,9,3,3,6,6,0,3,3,3,0,21.0,4.0,17.0,5
7677,7677,2000-01,2000,2001,Ipswich,Southampton,Win,Home,2000-12-16,3,3,6,9,12,3,3,6,7,0,3,3,5,1,21.0,15.0,6.0,5
7678,7678,2000-01,2000,2001,Ipswich,Man United,Loss,Away,2000-12-23,0,6,6,9,12,1,4,7,10,5,2,2,2,0,21.0,1.0,20.0,5
7679,7679,2000-01,2000,2001,Ipswich,Chelsea,Draw,Home,2000-12-26,1,3,6,6,9,3,6,9,9,0,0,-3,0,1,21.0,5.0,16.0,5
7680,7680,2000-01,2000,2001,Ipswich,Tottenham,Win,Home,2000-12-30,3,1,4,7,7,1,2,3,3,0,2,4,4,1,21.0,10.0,11.0,5
7681,7681,2000-01,2000,2001,Ipswich,Sunderland,Loss,Away,2001-01-01,0,4,4,7,10,4,7,7,10,0,-3,0,0,0,21.0,7.0,14.0,6
7682,7682,2000-01,2000,2001,Ipswich,Leicester,Win,Home,2001-01-14,3,3,4,4,7,0,3,6,6,3,1,-2,1,1,21.0,8.0,13.0,6
7683,7683,2000-01,2000,2001,Ipswich,Chelsea,Loss,Away,2001-01-20,0,3,6,7,7,4,5,8,8,-1,1,-1,-1,0,21.0,5.0,16.0,6
7684,7684,2000-01,2000,2001,Ipswich,Leeds,Loss,Home,2001-02-03,0,3,3,6,7,6,6,9,10,-3,-3,-3,-3,1,21.0,3.0,18.0,7
7685,7685,2000-01,2000,2001,Ipswich,Arsenal,Loss,Away,2001-02-10,0,0,3,3,6,6,7,8,8,-6,-4,-5,-2,0,21.0,2.0,19.0,7
7686,7686,2000-01,2000,2001,Ipswich,Everton,Win,Home,2001-02-24,3,0,0,3,3,4,4,5,8,-4,-4,-2,-5,1,21.0,13.0,8.0,7
7687,7687,2000-01,2000,2001,Ipswich,Bradford,Win,Home,2001-03-04,3,3,3,3,6,0,0,0,1,3,3,3,5,1,21.0,17.0,4.0,8
7688,7688,2000-01,2000,2001,Ipswich,Aston Villa,Loss,Away,2001-03-10,0,6,6,6,6,1,2,5,5,5,4,1,1,0,21.0,6.0,15.0,8
7689,7689,2000-01,2000,2001,Ipswich,West Ham,Win,Away,2001-03-17,3,3,6,6,6,0,3,4,4,3,3,2,2,0,21.0,9.0,12.0,8
7690,7690,2000-01,2000,2001,Ipswich,Southampton,Win,Away,2001-04-02,3,3,6,9,9,6,9,12,15,-3,-3,-3,-6,0,21.0,15.0,6.0,9
7691,7691,2000-01,2000,2001,Ipswich,Liverpool,Draw,Home,2001-04-10,1,6,6,9,12,4,4,5,8,2,2,4,4,1,21.0,4.0,17.0,9
7692,7692,2000-01,2000,2001,Ipswich,Newcastle,Win,Home,2001-04-14,3,4,7,7,10,1,2,2,2,3,5,5,8,1,21.0,11.0,10.0,9
7693,7693,2000-01,2000,2001,Ipswich,Middlesbrough,Win,Away,2001-04-16,3,4,7,10,10,4,4,7,8,0,3,3,2,0,21.0,12.0,9.0,9
7694,7694,2000-01,2000,2001,Ipswich,Coventry,Win,Home,2001-04-21,3,6,7,10,13,3,6,9,9,3,1,1,4,1,21.0,14.0,7.0,9
7695,7695,2000-01,2000,2001,Ipswich,Charlton,Loss,Away,2001-04-30,0,6,9,10,13,4,4,4,7,2,5,6,6,0,21.0,21.0,0.0,9
7696,7696,2000-01,2000,2001,Ipswich,Man City,Win,Home,2001-05-07,3,3,6,9,10,4,7,7,7,-1,-1,2,3,1,21.0,21.0,0.0,10
7697,7697,2000-01,2000,2001,Ipswich,Derby,Draw,Away,2001-05-19,1,3,6,9,12,3,3,6,6,0,3,3,6,0,21.0,16.0,5.0,10
7698,7698,2001-02,2001,2002,Ipswich,Sunderland,Loss,Away,2001-08-18,0,4,4,7,10,4,7,8,8,0,-3,-1,2,0,5.0,7.0,-2.0,1
7699,7699,2001-02,2001,2002,Ipswich,Derby,Win,Home,2001-08-21,3,1,4,4,7,4,7,7,7,-3,-3,-3,0,1,5.0,17.0,-12.0,1
7700,7700,2001-02,2001,2002,Ipswich,Charlton,Loss,Home,2001-08-25,0,3,4,7,7,0,0,3,6,3,4,4,1,1,5.0,9.0,-4.0,1
7701,7701,2001-02,2001,2002,Ipswich,Leicester,Draw,Away,2001-09-08,1,3,3,4,7,0,0,3,3,3,3,1,4,0,5.0,13.0,-8.0,2
7702,7702,2001-02,2001,2002,Ipswich,Blackburn,Draw,Home,2001-09-16,1,1,4,4,5,3,4,4,5,-2,0,0,0,1,5.0,21.0,-16.0,2
7703,7703,2001-02,2001,2002,Ipswich,Man United,Loss,Away,2001-09-22,0,2,2,5,5,3,4,5,8,-1,-2,0,-3,0,5.0,1.0,4.0,2
7704,7704,2001-02,2001,2002,Ipswich,Leeds,Loss,Home,2001-09-30,0,1,2,2,5,6,7,8,11,-5,-5,-6,-6,1,5.0,4.0,1.0,2
7705,7705,2001-02,2001,2002,Ipswich,Everton,Draw,Home,2001-10-13,1,0,1,2,2,3,3,3,6,-3,-2,-1,-4,1,5.0,16.0,-11.0,3
7706,7706,2001-02,2001,2002,Ipswich,Fulham,Draw,Away,2001-10-21,1,1,1,2,3,1,2,2,3,0,-1,0,0,0,5.0,21.0,-16.0,3
7707,7707,2001-02,2001,2002,Ipswich,Southampton,Draw,Away,2001-10-24,1,2,2,2,3,0,3,3,6,2,-1,-1,-3,0,5.0,10.0,-5.0,3
7708,7708,2001-02,2001,2002,Ipswich,West Ham,Loss,Home,2001-10-28,0,2,3,3,3,6,6,6,9,-4,-3,-3,-6,1,5.0,15.0,-10.0,3
7709,7709,2001-02,2001,2002,Ipswich,Chelsea,Loss,Away,2001-11-04,0,1,2,3,3,1,2,5,6,0,0,-2,-3,0,5.0,6.0,-1.0,4
7710,7710,2001-02,2001,2002,Ipswich,Bolton,Loss,Home,2001-11-18,0,0,1,2,3,1,4,4,4,-1,-3,-2,-1,1,5.0,21.0,-16.0,4
7711,7711,2001-02,2001,2002,Ipswich,Middlesbrough,Draw,Away,2001-11-25,1,0,0,1,2,4,4,7,8,-4,-4,-6,-6,0,5.0,14.0,-9.0,4
7712,7712,2001-02,2001,2002,Ipswich,Arsenal,Loss,Home,2001-12-01,0,1,1,1,2,4,4,5,6,-3,-3,-4,-4,1,5.0,2.0,3.0,5
7713,7713,2001-02,2001,2002,Ipswich,Newcastle,Loss,Home,2001-12-09,0,1,1,1,1,4,4,7,10,-3,-3,-6,-9,1,5.0,11.0,-6.0,5
7714,7714,2001-02,2001,2002,Ipswich,Aston Villa,Loss,Away,2001-12-17,0,0,1,1,1,1,1,2,3,-1,0,-1,-2,0,5.0,8.0,-3.0,5
7715,7715,2001-02,2001,2002,Ipswich,Tottenham,Win,Away,2001-12-22,3,0,0,1,1,3,6,9,10,-3,-6,-8,-9,0,5.0,12.0,-7.0,5
7716,7716,2001-02,2001,2002,Ipswich,Leicester,Win,Home,2001-12-26,3,3,3,3,4,2,2,5,6,1,1,-2,-2,1,5.0,13.0,-8.0,5
7717,7717,2001-02,2001,2002,Ipswich,Sunderland,Win,Home,2001-12-29,3,6,6,6,6,6,6,7,10,0,0,-1,-4,1,5.0,7.0,-2.0,5
7718,7718,2001-02,2001,2002,Ipswich,Charlton,Loss,Away,2002-01-01,0,6,9,9,9,4,4,5,8,2,5,4,1,0,5.0,9.0,-4.0,6
7719,7719,2001-02,2001,2002,Ipswich,Tottenham,Win,Home,2002-01-12,3,3,6,9,9,4,4,4,7,-1,2,5,2,1,5.0,12.0,-7.0,6
7720,7720,2001-02,2001,2002,Ipswich,Derby,Win,Away,2002-01-19,3,3,6,9,12,0,3,3,6,3,3,6,6,0,5.0,17.0,-12.0,6
7721,7721,2001-02,2001,2002,Ipswich,Fulham,Win,Home,2002-01-30,3,6,6,9,12,4,7,7,8,2,-1,2,4,1,5.0,21.0,-16.0,6
7722,7722,2001-02,2001,2002,Ipswich,Everton,Win,Away,2002-02-02,3,6,9,9,12,2,5,5,5,4,4,4,7,0,5.0,16.0,-11.0,7
7723,7723,2001-02,2001,2002,Ipswich,Liverpool,Loss,Home,2002-02-09,0,6,9,12,12,6,9,10,11,0,0,2,1,1,5.0,3.0,2.0,7
7724,7724,2001-02,2001,2002,Ipswich,Southampton,Loss,Home,2002-03-02,0,3,6,9,12,1,2,5,6,2,4,4,6,1,5.0,10.0,-5.0,8
7725,7725,2001-02,2001,2002,Ipswich,Leeds,Loss,Away,2002-03-06,0,0,3,6,9,2,3,3,3,-2,0,3,6,0,5.0,4.0,1.0,8
7726,7726,2001-02,2001,2002,Ipswich,Blackburn,Loss,Away,2002-03-13,0,0,0,3,6,4,4,4,4,-4,-4,-1,2,0,5.0,21.0,-16.0,8
7727,7727,2001-02,2001,2002,Ipswich,Newcastle,Draw,Away,2002-03-16,1,0,0,0,3,0,3,6,9,0,-3,-6,-6,0,5.0,11.0,-6.0,8
7728,7728,2001-02,2001,2002,Ipswich,Aston Villa,Draw,Home,2002-03-23,1,1,1,1,1,0,3,3,4,1,-2,-2,-3,1,5.0,8.0,-3.0,8
7729,7729,2001-02,2001,2002,Ipswich,West Ham,Loss,Away,2002-03-30,0,2,2,2,2,3,3,6,6,-1,-1,-4,-4,0,5.0,15.0,-10.0,8
7730,7730,2001-02,2001,2002,Ipswich,Chelsea,Draw,Home,2002-04-01,1,1,2,2,2,3,6,9,12,-2,-4,-7,-10,1,5.0,6.0,-1.0,9
7731,7731,2001-02,2001,2002,Ipswich,Bolton,Loss,Away,2002-04-06,0,1,2,3,3,3,6,6,6,-2,-4,-3,-3,0,5.0,21.0,-16.0,9
7732,7732,2001-02,2001,2002,Ipswich,Arsenal,Loss,Away,2002-04-21,0,1,1,2,3,6,9,12,15,-5,-8,-10,-12,0,5.0,2.0,3.0,9
7733,7733,2001-02,2001,2002,Ipswich,Middlesbrough,Win,Home,2002-04-24,3,0,1,1,2,3,6,7,10,-3,-5,-6,-8,1,5.0,14.0,-9.0,9
7734,7734,2001-02,2001,2002,Ipswich,Man United,Loss,Home,2002-04-27,0,3,3,4,4,6,9,9,12,-3,-6,-5,-8,1,5.0,1.0,4.0,9
7735,7735,2001-02,2001,2002,Ipswich,Liverpool,Loss,Away,2002-05-11,0,3,3,3,4,3,6,9,12,0,-3,-6,-8,0,5.0,3.0,2.0,10
7736,7736,1993-94,1993,1994,Leeds,Man City,Draw,Away,1993-08-14,1,0,0,0,0,0,0,0,0,0,0,0,0,0,17.0,9.0,8.0,1
7737,7737,1993-94,1993,1994,Leeds,West Ham,Win,Home,1993-08-17,3,1,1,1,1,0,0,0,0,1,1,1,1,1,17.0,21.0,-4.0,1
7738,7738,1993-94,1993,1994,Leeds,Norwich,Loss,Home,1993-08-21,0,4,4,4,4,3,3,3,3,1,1,1,1,1,17.0,3.0,14.0,1
7739,7739,1993-94,1993,1994,Leeds,Arsenal,Loss,Away,1993-08-24,0,3,4,4,4,6,6,6,6,-3,-2,-2,-2,0,17.0,10.0,7.0,1
7740,7740,1993-94,1993,1994,Leeds,Liverpool,Loss,Away,1993-08-28,0,0,3,4,4,3,6,9,9,-3,-3,-5,-5,0,17.0,6.0,11.0,1
7741,7741,1993-94,1993,1994,Leeds,Oldham,Win,Home,1993-08-30,3,0,0,3,4,2,2,5,5,-2,-2,-2,-1,1,17.0,19.0,-2.0,1
7742,7742,1993-94,1993,1994,Leeds,Southampton,Win,Away,1993-09-11,3,3,3,3,6,0,3,3,3,3,0,0,3,0,17.0,18.0,-1.0,2
7743,7743,1993-94,1993,1994,Leeds,Sheffield United,Win,Home,1993-09-18,3,6,6,6,6,1,2,5,5,5,4,1,1,1,17.0,14.0,3.0,2
7744,7744,1993-94,1993,1994,Leeds,Coventry,Win,Away,1993-09-25,3,6,9,9,9,2,5,6,7,4,4,3,2,0,17.0,15.0,2.0,2
7745,7745,1993-94,1993,1994,Leeds,Wimbledon,Win,Home,1993-10-02,3,6,9,12,12,4,7,10,11,2,2,2,1,1,17.0,12.0,5.0,3
7746,7746,1993-94,1993,1994,Leeds,Ipswich,Draw,Away,1993-10-17,1,6,9,12,15,1,1,1,2,5,8,11,13,0,17.0,16.0,1.0,3
7747,7747,1993-94,1993,1994,Leeds,Blackburn,Draw,Home,1993-10-23,1,4,7,10,13,4,5,5,8,0,2,5,5,1,17.0,4.0,13.0,3
7748,7748,1993-94,1993,1994,Leeds,Sheffield Weds,Draw,Away,1993-10-30,1,2,5,8,11,2,2,3,6,0,3,5,5,0,17.0,7.0,10.0,3
7749,7749,1993-94,1993,1994,Leeds,Chelsea,Win,Home,1993-11-06,3,2,3,6,9,0,0,0,3,2,3,6,6,1,17.0,11.0,6.0,4
7750,7750,1993-94,1993,1994,Leeds,Tottenham,Draw,Away,1993-11-20,1,4,5,6,9,0,1,1,4,4,4,5,5,0,17.0,8.0,9.0,4
7751,7751,1993-94,1993,1994,Leeds,Everton,Draw,Away,1993-11-23,1,4,5,6,7,0,3,3,4,4,2,3,3,0,17.0,13.0,4.0,4
7752,7752,1993-94,1993,1994,Leeds,Swindon,Win,Home,1993-11-27,3,2,5,6,7,4,4,4,5,-2,1,2,2,1,17.0,21.0,-4.0,4
7753,7753,1993-94,1993,1994,Leeds,Man City,Win,Home,1993-12-04,3,4,5,8,9,1,2,2,2,3,3,6,7,1,17.0,9.0,8.0,5
7754,7754,1993-94,1993,1994,Leeds,West Ham,Win,Away,1993-12-08,3,6,7,8,11,6,7,10,10,0,0,-2,1,0,17.0,21.0,-4.0,5
7755,7755,1993-94,1993,1994,Leeds,Norwich,Loss,Away,1993-12-13,0,6,9,10,11,1,2,5,6,5,7,5,5,0,17.0,3.0,14.0,5
7756,7756,1993-94,1993,1994,Leeds,Arsenal,Win,Home,1993-12-18,3,3,6,9,10,4,4,7,8,-1,2,2,2,1,17.0,10.0,7.0,5
7757,7757,1993-94,1993,1994,Leeds,Newcastle,Draw,Away,1993-12-22,1,3,6,9,12,4,7,7,10,-1,-1,2,2,0,17.0,21.0,-4.0,5
7758,7758,1993-94,1993,1994,Leeds,QPR,Draw,Home,1993-12-29,1,4,4,7,10,6,6,7,8,-2,-2,0,2,1,17.0,5.0,12.0,5
7759,7759,1993-94,1993,1994,Leeds,Man United,Draw,Away,1994-01-01,1,2,5,5,8,4,7,8,11,-2,-2,-3,-3,0,17.0,1.0,16.0,6
7760,7760,1993-94,1993,1994,Leeds,Ipswich,Draw,Home,1994-01-15,1,2,3,6,6,1,4,5,8,1,-1,1,-2,1,17.0,16.0,1.0,6
7761,7761,1993-94,1993,1994,Leeds,Blackburn,Loss,Away,1994-01-23,0,2,3,4,7,6,9,10,13,-4,-6,-6,-6,0,17.0,4.0,13.0,6
7762,7762,1993-94,1993,1994,Leeds,Aston Villa,Loss,Away,1994-02-06,0,1,2,3,4,4,4,7,7,-3,-2,-4,-3,0,17.0,2.0,15.0,7
7763,7763,1993-94,1993,1994,Leeds,Liverpool,Win,Home,1994-02-19,3,0,1,2,3,1,4,7,8,-1,-3,-5,-5,1,17.0,6.0,11.0,7
7764,7764,1993-94,1993,1994,Leeds,Oldham,Draw,Away,1994-02-28,1,3,3,4,5,6,7,7,7,-3,-4,-3,-2,0,17.0,19.0,-2.0,7
7765,7765,1993-94,1993,1994,Leeds,Southampton,Draw,Home,1994-03-05,1,4,4,4,5,6,6,9,12,-2,-2,-5,-7,1,17.0,18.0,-1.0,8
7766,7766,1993-94,1993,1994,Leeds,Sheffield United,Draw,Away,1994-03-13,1,2,5,5,5,1,2,2,2,1,3,3,3,0,17.0,14.0,3.0,8
7767,7767,1993-94,1993,1994,Leeds,Aston Villa,Win,Home,1994-03-16,3,2,3,6,6,3,4,5,8,-1,-1,1,-2,1,17.0,2.0,15.0,8
7768,7768,1993-94,1993,1994,Leeds,Coventry,Win,Home,1994-03-19,3,4,5,6,9,0,0,3,4,4,5,3,5,1,17.0,15.0,2.0,8
7769,7769,1993-94,1993,1994,Leeds,Wimbledon,Loss,Away,1994-03-27,0,6,7,8,9,0,3,6,6,6,4,2,3,0,17.0,12.0,5.0,8
7770,7770,1993-94,1993,1994,Leeds,Newcastle,Draw,Home,1994-04-01,1,3,6,7,8,6,9,12,15,-3,-3,-5,-7,1,17.0,21.0,-4.0,9
7771,7771,1993-94,1993,1994,Leeds,QPR,Win,Away,1994-04-04,3,1,4,7,8,3,6,7,10,-2,-2,0,-2,0,17.0,5.0,12.0,9
7772,7772,1993-94,1993,1994,Leeds,Tottenham,Win,Home,1994-04-17,3,4,4,7,10,0,3,6,7,4,1,1,3,1,17.0,8.0,9.0,9
7773,7773,1993-94,1993,1994,Leeds,Chelsea,Draw,Away,1994-04-23,1,6,7,7,10,1,2,5,5,5,5,2,5,0,17.0,11.0,6.0,9
7774,7774,1993-94,1993,1994,Leeds,Man United,Loss,Home,1994-04-27,0,4,7,8,8,3,6,6,9,1,1,2,-1,1,17.0,1.0,16.0,9
7775,7775,1993-94,1993,1994,Leeds,Everton,Win,Home,1994-04-30,3,1,4,7,8,1,4,4,4,0,0,3,4,1,17.0,13.0,4.0,9
7776,7776,1993-94,1993,1994,Leeds,Sheffield Weds,Draw,Home,1994-05-03,1,3,4,7,10,4,5,8,11,-1,-1,-1,-1,1,17.0,7.0,10.0,10
7777,7777,1993-94,1993,1994,Leeds,Swindon,Win,Away,1994-05-07,3,4,4,5,8,3,3,4,4,1,1,1,4,0,17.0,21.0,-4.0,10
7778,7778,1994-95,1994,1995,Leeds,West Ham,Draw,Away,1994-08-20,1,4,7,7,8,2,5,5,5,2,2,2,3,0,5.0,13.0,-8.0,1
7779,7779,1994-95,1994,1995,Leeds,Arsenal,Win,Home,1994-08-23,3,4,5,8,8,3,3,4,7,1,2,4,1,1,5.0,4.0,1.0,1
7780,7780,1994-95,1994,1995,Leeds,Chelsea,Loss,Home,1994-08-27,0,4,7,8,11,6,6,7,10,-2,1,1,1,1,5.0,14.0,-9.0,1
7781,7781,1994-95,1994,1995,Leeds,Crystal Palace,Win,Away,1994-08-30,3,3,4,7,8,2,2,2,2,1,2,5,6,0,5.0,21.0,-16.0,1
7782,7782,1994-95,1994,1995,Leeds,Man United,Win,Home,1994-09-11,3,3,6,7,10,6,7,10,11,-3,-1,-3,-1,1,5.0,1.0,4.0,2
7783,7783,1994-95,1994,1995,Leeds,Coventry,Loss,Away,1994-09-17,0,6,6,9,10,1,1,1,2,5,5,8,8,0,5.0,11.0,-6.0,2
7784,7784,1994-95,1994,1995,Leeds,Sheffield Weds,Draw,Away,1994-09-26,1,3,6,6,9,1,2,5,5,2,4,1,4,0,5.0,7.0,-2.0,2
7785,7785,1994-95,1994,1995,Leeds,Man City,Win,Home,1994-10-01,3,1,4,7,7,4,5,5,8,-3,-1,2,-1,1,5.0,16.0,-11.0,3
7786,7786,1994-95,1994,1995,Leeds,Norwich,Loss,Away,1994-10-08,0,4,4,7,10,3,6,7,8,1,-2,0,2,0,5.0,12.0,-7.0,3
7787,7787,1994-95,1994,1995,Leeds,Tottenham,Draw,Home,1994-10-15,1,3,4,4,7,4,4,4,4,-1,0,0,3,1,5.0,15.0,-10.0,3
7788,7788,1994-95,1994,1995,Leeds,Leicester,Win,Home,1994-10-24,3,1,4,5,5,3,4,5,8,-2,0,0,-3,1,5.0,21.0,-16.0,3
7789,7789,1994-95,1994,1995,Leeds,Southampton,Win,Away,1994-10-29,3,4,4,7,8,0,3,6,9,4,1,1,-1,0,5.0,18.0,-13.0,3
7790,7790,1994-95,1994,1995,Leeds,Ipswich,Loss,Away,1994-11-01,0,6,7,7,10,0,0,0,0,6,7,7,10,0,5.0,19.0,-14.0,4
7791,7791,1994-95,1994,1995,Leeds,Wimbledon,Win,Home,1994-11-05,3,3,6,7,7,3,3,3,3,0,3,4,4,1,5.0,6.0,-1.0,4
7792,7792,1994-95,1994,1995,Leeds,QPR,Loss,Away,1994-11-19,0,3,6,9,10,3,6,6,6,0,0,3,4,0,5.0,9.0,-4.0,4
7793,7793,1994-95,1994,1995,Leeds,Nott'm Forest,Win,Home,1994-11-26,3,3,3,6,9,1,1,1,4,2,2,5,5,1,5.0,21.0,-16.0,4
7794,7794,1994-95,1994,1995,Leeds,Everton,Loss,Away,1994-12-04,0,3,6,6,9,6,7,10,11,-3,-1,-4,-2,0,5.0,17.0,-12.0,5
7795,7795,1994-95,1994,1995,Leeds,West Ham,Draw,Home,1994-12-10,1,3,3,6,6,0,0,3,3,3,3,3,3,1,5.0,13.0,-8.0,5
7796,7796,1994-95,1994,1995,Leeds,Arsenal,Win,Away,1994-12-17,3,1,4,4,7,4,5,5,5,-3,-1,-1,2,0,5.0,4.0,1.0,5
7797,7797,1994-95,1994,1995,Leeds,Newcastle,Draw,Home,1994-12-26,1,4,4,7,7,4,4,5,5,0,0,2,2,1,5.0,3.0,2.0,5
7798,7798,1994-95,1994,1995,Leeds,Liverpool,Loss,Home,1994-12-31,0,4,5,5,8,6,7,8,9,-2,-2,-3,-1,1,5.0,8.0,-3.0,5
7799,7799,1994-95,1994,1995,Leeds,Aston Villa,Draw,Away,1995-01-02,1,1,4,5,5,4,5,5,6,-3,-1,0,-1,0,5.0,10.0,-5.0,6
7800,7800,1994-95,1994,1995,Leeds,Southampton,Draw,Home,1995-01-14,1,1,2,5,6,2,3,3,6,-1,-1,2,0,1,5.0,18.0,-13.0,6
7801,7801,1994-95,1994,1995,Leeds,QPR,Win,Home,1995-01-24,3,2,2,3,6,3,4,5,8,-1,-2,-2,-2,1,5.0,9.0,-4.0,6
7802,7802,1994-95,1994,1995,Leeds,Blackburn,Draw,Away,1995-02-01,1,4,5,5,6,3,6,9,12,1,-1,-4,-6,0,5.0,2.0,3.0,7
7803,7803,1994-95,1994,1995,Leeds,Wimbledon,Draw,Away,1995-02-04,1,4,5,6,6,3,6,7,10,1,-1,-1,-4,0,5.0,6.0,-1.0,7
7804,7804,1994-95,1994,1995,Leeds,Everton,Win,Home,1995-02-22,3,2,5,6,7,4,4,5,8,-2,1,1,-1,1,5.0,17.0,-12.0,7
7805,7805,1994-95,1994,1995,Leeds,Man City,Draw,Away,1995-02-25,1,4,5,8,9,3,4,4,5,1,1,4,4,0,5.0,16.0,-11.0,7
7806,7806,1994-95,1994,1995,Leeds,Sheffield Weds,Loss,Home,1995-03-04,0,4,5,6,9,0,0,3,6,4,5,3,3,1,5.0,7.0,-2.0,8
7807,7807,1994-95,1994,1995,Leeds,Chelsea,Win,Away,1995-03-11,3,1,4,5,6,4,7,8,9,-3,-3,-3,-3,0,5.0,14.0,-9.0,8
7808,7808,1994-95,1994,1995,Leeds,Leicester,Win,Away,1995-03-15,3,3,4,7,8,0,1,1,2,3,3,6,6,0,5.0,21.0,-16.0,8
7809,7809,1994-95,1994,1995,Leeds,Coventry,Win,Home,1995-03-18,3,6,6,7,10,4,5,6,9,2,1,1,1,1,5.0,11.0,-6.0,8
7810,7810,1994-95,1994,1995,Leeds,Nott'm Forest,Loss,Away,1995-03-22,0,6,9,9,10,6,9,10,11,0,0,-1,-1,0,5.0,21.0,-16.0,8
7811,7811,1994-95,1994,1995,Leeds,Man United,Draw,Away,1995-04-02,1,3,6,9,9,3,4,7,10,0,2,2,-1,0,5.0,1.0,4.0,9
7812,7812,1994-95,1994,1995,Leeds,Ipswich,Win,Home,1995-04-05,3,1,4,7,10,0,0,0,0,1,4,7,10,1,5.0,19.0,-14.0,9
7813,7813,1994-95,1994,1995,Leeds,Liverpool,Win,Away,1995-04-09,3,4,4,7,10,4,7,7,10,0,-3,0,0,0,5.0,8.0,-3.0,9
7814,7814,1994-95,1994,1995,Leeds,Blackburn,Draw,Home,1995-04-15,1,6,7,7,10,6,9,10,13,0,-2,-3,-3,1,5.0,2.0,3.0,9
7815,7815,1994-95,1994,1995,Leeds,Newcastle,Win,Away,1995-04-17,3,4,7,8,8,3,4,4,7,1,3,4,1,0,5.0,3.0,2.0,9
7816,7816,1994-95,1994,1995,Leeds,Aston Villa,Win,Home,1995-04-29,3,4,7,10,11,0,1,4,4,4,6,6,7,1,5.0,10.0,-5.0,9
7817,7817,1994-95,1994,1995,Leeds,Norwich,Win,Home,1995-05-06,3,6,7,10,13,0,0,0,0,6,7,10,13,1,5.0,12.0,-7.0,10
7818,7818,1994-95,1994,1995,Leeds,Crystal Palace,Win,Home,1995-05-09,3,6,9,10,13,3,3,3,6,3,6,7,7,1,5.0,21.0,-16.0,10
7819,7819,1994-95,1994,1995,Leeds,Tottenham,Draw,Away,1995-05-14,1,6,9,12,13,0,1,2,5,6,8,10,8,0,5.0,15.0,-10.0,10
7820,7820,1995-96,1995,1996,Leeds,West Ham,Win,Away,1995-08-19,3,4,7,10,13,4,4,5,8,0,3,5,5,0,5.0,14.0,-9.0,1
7821,7821,1995-96,1995,1996,Leeds,Liverpool,Win,Home,1995-08-21,3,4,7,10,13,6,6,6,7,-2,1,4,6,1,5.0,4.0,1.0,1
7822,7822,1995-96,1995,1996,Leeds,Aston Villa,Win,Home,1995-08-26,3,6,7,10,13,6,7,10,11,0,0,0,2,1,5.0,18.0,-13.0,1
7823,7823,1995-96,1995,1996,Leeds,Southampton,Draw,Away,1995-08-30,1,6,9,10,13,0,1,1,2,6,8,9,11,0,5.0,10.0,-5.0,1
7824,7824,1995-96,1995,1996,Leeds,Tottenham,Loss,Away,1995-09-09,0,4,7,10,11,1,1,2,3,3,6,8,8,0,5.0,7.0,-2.0,2
7825,7825,1995-96,1995,1996,Leeds,QPR,Loss,Home,1995-09-16,0,1,4,7,10,0,3,3,3,1,1,4,7,1,5.0,8.0,-3.0,2
7826,7826,1995-96,1995,1996,Leeds,Wimbledon,Win,Away,1995-09-23,3,0,1,4,7,3,4,4,7,-3,-3,0,0,0,5.0,9.0,-4.0,2
7827,7827,1995-96,1995,1996,Leeds,Sheffield Weds,Win,Home,1995-09-30,3,3,3,4,7,1,4,5,5,2,-1,-1,2,1,5.0,13.0,-8.0,2
7828,7828,1995-96,1995,1996,Leeds,Arsenal,Loss,Home,1995-10-14,0,6,6,6,7,3,6,9,10,3,0,-3,-3,1,5.0,12.0,-7.0,3
7829,7829,1995-96,1995,1996,Leeds,Man City,Draw,Away,1995-10-21,1,3,6,6,6,0,0,0,0,3,6,6,6,0,5.0,17.0,-12.0,3
7830,7830,1995-96,1995,1996,Leeds,Coventry,Win,Home,1995-10-28,3,1,4,7,7,1,1,1,1,0,3,6,6,1,5.0,16.0,-11.0,3
7831,7831,1995-96,1995,1996,Leeds,Middlesbrough,Draw,Away,1995-11-04,1,4,4,7,10,3,6,9,12,1,-2,-2,-2,0,5.0,21.0,-16.0,4
7832,7832,1995-96,1995,1996,Leeds,Chelsea,Win,Home,1995-11-18,3,4,5,5,8,1,1,4,7,3,4,1,1,1,5.0,11.0,-6.0,4
7833,7833,1995-96,1995,1996,Leeds,Newcastle,Loss,Away,1995-11-25,0,4,7,8,8,4,7,8,11,0,0,0,-3,0,5.0,6.0,-1.0,4
7834,7834,1995-96,1995,1996,Leeds,Man City,Loss,Home,1995-12-02,0,3,4,7,8,6,7,10,10,-3,-3,-3,-2,1,5.0,17.0,-12.0,5
7835,7835,1995-96,1995,1996,Leeds,Wimbledon,Draw,Home,1995-12-09,1,0,3,4,7,2,2,3,3,-2,1,1,4,1,5.0,9.0,-4.0,5
7836,7836,1995-96,1995,1996,Leeds,Sheffield Weds,Loss,Away,1995-12-16,0,1,1,4,5,4,5,5,6,-3,-4,-1,-1,0,5.0,13.0,-8.0,5
7837,7837,1995-96,1995,1996,Leeds,Man United,Win,Home,1995-12-24,3,1,1,1,4,1,2,3,6,0,-1,-2,-2,1,5.0,2.0,3.0,5
7838,7838,1995-96,1995,1996,Leeds,Bolton,Win,Away,1995-12-27,3,3,4,4,4,1,1,2,2,2,3,2,2,0,5.0,21.0,-16.0,5
7839,7839,1995-96,1995,1996,Leeds,Everton,Loss,Away,1995-12-30,0,6,6,7,7,3,3,6,7,3,3,1,0,0,5.0,15.0,-10.0,5
7840,7840,1995-96,1995,1996,Leeds,Blackburn,Draw,Home,1996-01-01,1,3,6,6,7,6,7,10,10,-3,-1,-4,-3,1,5.0,1.0,4.0,6
7841,7841,1995-96,1995,1996,Leeds,West Ham,Win,Home,1996-01-13,3,1,4,7,7,0,3,3,3,1,1,4,4,1,5.0,14.0,-9.0,6
7842,7842,1995-96,1995,1996,Leeds,Liverpool,Loss,Away,1996-01-20,0,4,4,7,10,4,5,8,11,0,-1,-1,-1,0,5.0,4.0,1.0,6
7843,7843,1995-96,1995,1996,Leeds,Nott'm Forest,Loss,Away,1996-01-31,0,3,4,4,7,3,3,6,9,0,1,-2,-2,0,5.0,3.0,2.0,6
7844,7844,1995-96,1995,1996,Leeds,Aston Villa,Loss,Away,1996-02-03,0,0,3,4,4,3,4,7,7,-3,-1,-3,-3,0,5.0,18.0,-13.0,7
7845,7845,1995-96,1995,1996,Leeds,Bolton,Loss,Home,1996-03-02,0,0,0,3,4,3,3,3,3,-3,-3,0,1,1,5.0,21.0,-16.0,8
7846,7846,1995-96,1995,1996,Leeds,QPR,Win,Away,1996-03-06,3,0,0,0,3,4,4,4,4,-4,-4,-4,-1,0,5.0,8.0,-3.0,8
7847,7847,1995-96,1995,1996,Leeds,Blackburn,Loss,Away,1996-03-13,0,3,3,3,3,1,1,1,4,2,2,2,-1,0,5.0,1.0,4.0,8
7848,7848,1995-96,1995,1996,Leeds,Everton,Draw,Home,1996-03-17,1,3,3,3,3,4,7,7,10,-1,-4,-4,-7,1,5.0,15.0,-10.0,8
7849,7849,1995-96,1995,1996,Leeds,Middlesbrough,Loss,Home,1996-03-30,0,1,4,4,4,2,2,2,3,-1,2,2,1,1,5.0,21.0,-16.0,8
7850,7850,1995-96,1995,1996,Leeds,Southampton,Win,Home,1996-04-03,3,1,1,4,4,3,3,3,3,-2,-2,1,1,1,5.0,10.0,-5.0,9
7851,7851,1995-96,1995,1996,Leeds,Arsenal,Loss,Away,1996-04-06,0,3,4,4,7,3,6,9,10,0,-2,-5,-3,0,5.0,12.0,-7.0,9
7852,7852,1995-96,1995,1996,Leeds,Nott'm Forest,Loss,Home,1996-04-08,0,3,3,4,4,3,6,7,10,0,-3,-3,-6,1,5.0,3.0,2.0,9
7853,7853,1995-96,1995,1996,Leeds,Chelsea,Loss,Away,1996-04-13,0,0,3,3,4,0,1,1,2,0,2,2,2,0,5.0,11.0,-6.0,9
7854,7854,1995-96,1995,1996,Leeds,Man United,Loss,Away,1996-04-17,0,0,0,3,3,3,6,9,12,-3,-6,-6,-9,0,5.0,2.0,3.0,9
7855,7855,1995-96,1995,1996,Leeds,Newcastle,Loss,Home,1996-04-29,0,0,0,0,3,6,6,9,9,-6,-6,-9,-6,1,5.0,6.0,-1.0,9
7856,7856,1995-96,1995,1996,Leeds,Tottenham,Loss,Home,1996-05-02,0,0,0,0,0,2,3,3,6,-2,-3,-3,-6,1,5.0,7.0,-2.0,10
7857,7857,1995-96,1995,1996,Leeds,Coventry,Draw,Away,1996-05-04,1,0,0,0,0,4,7,7,10,-4,-7,-7,-10,0,5.0,16.0,-11.0,10
7858,7858,1996-97,1996,1997,Leeds,Derby,Draw,Away,1996-08-17,1,1,1,1,1,0,0,0,0,1,1,1,1,0,13.0,21.0,-8.0,1
7859,7859,1996-97,1996,1997,Leeds,Sheffield Weds,Loss,Home,1996-08-20,0,2,2,2,2,4,4,5,5,-2,-2,-3,-3,1,13.0,15.0,-2.0,1
7860,7860,1996-97,1996,1997,Leeds,Wimbledon,Win,Home,1996-08-26,3,1,2,2,2,0,1,1,1,1,1,1,1,1,13.0,14.0,-1.0,1
7861,7861,1996-97,1996,1997,Leeds,Blackburn,Win,Away,1996-09-04,3,3,4,5,5,1,1,4,5,2,3,1,0,0,13.0,7.0,6.0,2
7862,7862,1996-97,1996,1997,Leeds,Man United,Loss,Home,1996-09-07,0,6,6,7,8,2,3,6,9,4,3,1,-1,1,13.0,1.0,12.0,2
7863,7863,1996-97,1996,1997,Leeds,Coventry,Loss,Away,1996-09-14,0,3,6,6,7,0,0,1,1,3,6,5,6,0,13.0,16.0,-3.0,2
7864,7864,1996-97,1996,1997,Leeds,Newcastle,Loss,Home,1996-09-21,0,0,3,6,6,6,9,9,12,-6,-6,-3,-6,1,13.0,2.0,11.0,2
7865,7865,1996-97,1996,1997,Leeds,Leicester,Loss,Away,1996-09-28,0,0,0,3,6,3,4,4,4,-3,-4,-1,2,0,13.0,21.0,-8.0,2
7866,7866,1996-97,1996,1997,Leeds,Nott'm Forest,Win,Home,1996-10-12,3,0,0,0,3,1,1,2,3,-1,-1,-2,0,1,13.0,9.0,4.0,3
7867,7867,1996-97,1996,1997,Leeds,Aston Villa,Loss,Away,1996-10-19,0,3,3,3,3,0,1,2,3,3,2,1,0,0,13.0,4.0,9.0,3
7868,7868,1996-97,1996,1997,Leeds,Arsenal,Loss,Away,1996-10-26,0,3,3,3,3,4,7,10,13,-1,-4,-7,-10,0,13.0,5.0,8.0,3
7869,7869,1996-97,1996,1997,Leeds,Sunderland,Win,Home,1996-11-02,3,0,3,3,3,3,4,4,7,-3,-1,-1,-4,1,13.0,21.0,-8.0,4
7870,7870,1996-97,1996,1997,Leeds,Liverpool,Loss,Home,1996-11-16,0,3,3,6,6,3,3,6,9,0,0,0,-3,1,13.0,3.0,10.0,4
7871,7871,1996-97,1996,1997,Leeds,Southampton,Win,Away,1996-11-23,3,3,3,3,6,1,4,7,8,2,-1,-4,-2,0,13.0,17.0,-4.0,4
7872,7872,1996-97,1996,1997,Leeds,Chelsea,Win,Home,1996-12-01,3,3,6,6,6,2,5,8,8,1,1,-2,-2,1,13.0,11.0,2.0,5
7873,7873,1996-97,1996,1997,Leeds,Middlesbrough,Draw,Away,1996-12-07,1,6,6,9,9,0,1,1,1,6,5,8,8,0,13.0,12.0,1.0,5
7874,7874,1996-97,1996,1997,Leeds,Tottenham,Draw,Home,1996-12-14,1,4,7,7,10,3,3,6,9,1,4,1,1,1,13.0,8.0,5.0,5
7875,7875,1996-97,1996,1997,Leeds,Everton,Draw,Away,1996-12-21,1,2,5,8,8,4,4,7,8,-2,1,1,0,0,13.0,6.0,7.0,5
7876,7876,1996-97,1996,1997,Leeds,Coventry,Loss,Home,1996-12-26,0,2,3,6,9,6,6,6,6,-4,-3,0,3,1,13.0,16.0,-3.0,5
7877,7877,1996-97,1996,1997,Leeds,Man United,Loss,Away,1996-12-28,0,1,2,3,6,6,7,8,11,-5,-5,-5,-5,0,13.0,1.0,12.0,5
7878,7878,1996-97,1996,1997,Leeds,Newcastle,Loss,Away,1997-01-01,0,0,1,2,3,3,4,4,5,-3,-3,-2,-2,0,13.0,2.0,11.0,6
7879,7879,1996-97,1996,1997,Leeds,Leicester,Win,Home,1997-01-11,3,0,0,1,2,2,2,3,6,-2,-2,-2,-4,1,13.0,21.0,-8.0,6
7880,7880,1996-97,1996,1997,Leeds,West Ham,Win,Away,1997-01-20,3,3,3,3,4,1,4,4,5,2,-1,-1,-1,0,13.0,10.0,3.0,6
7881,7881,1996-97,1996,1997,Leeds,Derby,Draw,Home,1997-01-29,1,6,6,6,6,1,2,2,2,5,4,4,4,1,13.0,21.0,-8.0,6
7882,7882,1996-97,1996,1997,Leeds,Arsenal,Draw,Home,1997-02-01,1,4,7,7,7,6,6,9,10,-2,1,-2,-3,1,13.0,5.0,8.0,7
7883,7883,1996-97,1996,1997,Leeds,Liverpool,Loss,Away,1997-02-19,0,2,5,8,8,6,7,7,10,-4,-2,1,-2,0,13.0,3.0,10.0,7
7884,7884,1996-97,1996,1997,Leeds,Sunderland,Win,Away,1997-02-22,3,1,2,5,8,1,2,5,6,0,0,0,2,0,13.0,21.0,-8.0,7
7885,7885,1996-97,1996,1997,Leeds,West Ham,Win,Home,1997-03-01,3,3,4,5,8,3,3,3,3,0,1,2,5,1,13.0,10.0,3.0,8
7886,7886,1996-97,1996,1997,Leeds,Everton,Win,Home,1997-03-08,3,6,6,7,8,1,2,5,5,5,4,2,3,1,13.0,6.0,7.0,8
7887,7887,1996-97,1996,1997,Leeds,Southampton,Draw,Home,1997-03-12,1,6,9,9,10,4,5,5,5,2,4,4,5,1,13.0,17.0,-4.0,8
7888,7888,1996-97,1996,1997,Leeds,Tottenham,Loss,Away,1997-03-15,0,4,7,10,10,3,3,4,4,1,4,6,6,0,13.0,8.0,5.0,8
7889,7889,1996-97,1996,1997,Leeds,Sheffield Weds,Draw,Away,1997-03-22,1,1,4,7,10,3,6,9,12,-2,-2,-2,-2,0,13.0,15.0,-2.0,8
7890,7890,1996-97,1996,1997,Leeds,Blackburn,Draw,Home,1997-04-07,1,1,2,5,8,0,3,4,5,1,-1,1,3,1,13.0,7.0,6.0,9
7891,7891,1996-97,1996,1997,Leeds,Wimbledon,Loss,Away,1997-04-16,0,2,2,3,6,0,1,2,2,2,1,1,4,0,13.0,14.0,-1.0,9
7892,7892,1996-97,1996,1997,Leeds,Nott'm Forest,Draw,Away,1997-04-19,1,1,2,2,3,1,2,3,4,0,0,-1,-1,0,13.0,9.0,4.0,9
7893,7893,1996-97,1996,1997,Leeds,Aston Villa,Draw,Home,1997-04-22,1,1,2,3,3,1,4,7,10,0,-2,-4,-7,1,13.0,4.0,9.0,9
7894,7894,1996-97,1996,1997,Leeds,Chelsea,Draw,Away,1997-05-03,1,2,2,3,4,6,6,6,6,-4,-4,-3,-2,0,13.0,11.0,2.0,10
7895,7895,1996-97,1996,1997,Leeds,Middlesbrough,Draw,Home,1997-05-11,1,2,3,3,4,2,5,5,5,0,-2,-2,-1,1,13.0,12.0,1.0,10
7896,7896,1997-98,1997,1998,Leeds,Arsenal,Draw,Home,1997-08-09,1,2,3,4,4,3,4,5,8,-1,-1,-1,-4,1,11.0,3.0,8.0,1
7897,7897,1997-98,1997,1998,Leeds,Sheffield Weds,Win,Away,1997-08-13,3,2,3,4,5,1,1,1,1,1,2,3,4,0,11.0,7.0,4.0,1
7898,7898,1997-98,1997,1998,Leeds,Crystal Palace,Loss,Home,1997-08-23,0,4,5,6,7,3,3,3,6,1,2,3,1,1,11.0,21.0,-10.0,1
7899,7899,1997-98,1997,1998,Leeds,Liverpool,Loss,Home,1997-08-26,0,3,4,5,6,1,2,3,3,2,2,2,3,1,11.0,4.0,7.0,1
7900,7900,1997-98,1997,1998,Leeds,Aston Villa,Loss,Away,1997-08-30,0,0,3,4,5,0,0,0,3,0,3,4,2,0,11.0,5.0,6.0,1
7901,7901,1997-98,1997,1998,Leeds,Blackburn,Win,Away,1997-09-14,3,0,0,3,4,6,7,10,13,-6,-7,-7,-9,0,11.0,13.0,-2.0,2
7902,7902,1997-98,1997,1998,Leeds,Leicester,Loss,Home,1997-09-20,0,3,3,3,6,3,4,5,8,0,-1,-2,-2,1,11.0,9.0,2.0,2
7903,7903,1997-98,1997,1998,Leeds,Southampton,Win,Away,1997-09-24,3,3,3,3,3,1,1,4,4,2,2,-1,-1,0,11.0,16.0,-5.0,2
7904,7904,1997-98,1997,1998,Leeds,Man United,Win,Home,1997-09-27,3,3,6,6,6,2,5,8,11,1,1,-2,-5,1,11.0,1.0,10.0,2
7905,7905,1997-98,1997,1998,Leeds,Coventry,Draw,Away,1997-10-04,1,6,6,9,9,2,3,6,6,4,3,3,3,0,11.0,17.0,-6.0,3
7906,7906,1997-98,1997,1998,Leeds,Newcastle,Win,Home,1997-10-18,3,4,7,7,10,3,6,9,9,1,1,-2,1,1,11.0,2.0,9.0,3
7907,7907,1997-98,1997,1998,Leeds,Wimbledon,Loss,Away,1997-10-25,0,4,7,10,10,4,4,5,8,0,3,5,2,0,11.0,8.0,3.0,3
7908,7908,1997-98,1997,1998,Leeds,Tottenham,Win,Away,1997-11-01,3,3,4,7,10,3,3,4,5,0,1,3,5,0,11.0,10.0,1.0,4
7909,7909,1997-98,1997,1998,Leeds,Derby,Win,Home,1997-11-08,3,3,6,7,10,3,4,5,8,0,2,2,2,1,11.0,12.0,-1.0,4
7910,7910,1997-98,1997,1998,Leeds,West Ham,Win,Home,1997-11-23,3,6,6,9,10,0,3,3,6,6,3,6,4,1,11.0,14.0,-3.0,4
7911,7911,1997-98,1997,1998,Leeds,Barnsley,Win,Away,1997-11-29,3,6,9,9,12,3,4,4,7,3,5,5,5,0,11.0,21.0,-10.0,4
7912,7912,1997-98,1997,1998,Leeds,Everton,Draw,Home,1997-12-06,1,6,9,12,12,0,0,0,0,6,9,12,12,1,11.0,15.0,-4.0,5
7913,7913,1997-98,1997,1998,Leeds,Chelsea,Draw,Away,1997-12-13,1,4,7,10,13,6,9,9,12,-2,-2,1,1,0,11.0,6.0,5.0,5
7914,7914,1997-98,1997,1998,Leeds,Bolton,Win,Home,1997-12-20,3,2,5,8,11,1,4,7,8,1,1,1,3,1,11.0,21.0,-10.0,5
7915,7915,1997-98,1997,1998,Leeds,Liverpool,Loss,Away,1997-12-26,0,4,5,8,11,6,6,9,9,-2,-1,-1,2,0,11.0,4.0,7.0,5
7916,7916,1997-98,1997,1998,Leeds,Aston Villa,Draw,Home,1997-12-28,1,3,4,5,8,4,4,7,7,-1,0,-2,1,1,11.0,5.0,6.0,5
7917,7917,1997-98,1997,1998,Leeds,Arsenal,Loss,Away,1998-01-10,0,1,4,5,6,4,4,7,7,-3,0,-2,-1,0,11.0,3.0,8.0,6
7918,7918,1997-98,1997,1998,Leeds,Sheffield Weds,Loss,Home,1998-01-17,0,1,1,4,5,4,5,5,5,-3,-4,-1,0,1,11.0,7.0,4.0,6
7919,7919,1997-98,1997,1998,Leeds,Crystal Palace,Win,Away,1998-01-31,3,0,1,1,4,0,1,2,3,0,0,-1,1,0,11.0,21.0,-10.0,6
7920,7920,1997-98,1997,1998,Leeds,Leicester,Loss,Away,1998-02-07,0,3,3,4,4,4,5,6,6,-1,-2,-2,-2,0,11.0,9.0,2.0,7
7921,7921,1997-98,1997,1998,Leeds,Newcastle,Draw,Away,1998-02-22,1,3,3,3,4,3,3,6,6,0,0,-3,-2,0,11.0,2.0,9.0,7
7922,7922,1997-98,1997,1998,Leeds,Southampton,Loss,Home,1998-02-28,0,1,4,4,4,3,6,6,9,-2,-2,-2,-5,1,11.0,16.0,-5.0,7
7923,7923,1997-98,1997,1998,Leeds,Tottenham,Win,Home,1998-03-04,3,1,1,4,4,3,4,7,7,-2,-3,-3,-3,1,11.0,10.0,1.0,8
7924,7924,1997-98,1997,1998,Leeds,Blackburn,Win,Home,1998-03-11,3,3,4,4,7,3,3,4,7,0,1,0,0,1,11.0,13.0,-2.0,8
7925,7925,1997-98,1997,1998,Leeds,Derby,Win,Away,1998-03-15,3,6,6,7,7,3,6,6,9,3,0,1,-2,0,11.0,12.0,-1.0,8
7926,7926,1997-98,1997,1998,Leeds,West Ham,Loss,Away,1998-03-30,0,6,9,9,10,4,5,6,9,2,4,3,1,0,11.0,14.0,-3.0,8
7927,7927,1997-98,1997,1998,Leeds,Barnsley,Win,Home,1998-04-04,3,3,6,9,9,0,3,6,9,3,3,3,0,1,11.0,21.0,-10.0,9
7928,7928,1997-98,1997,1998,Leeds,Chelsea,Win,Home,1998-04-08,3,3,6,9,12,3,6,6,6,0,0,3,6,1,11.0,6.0,5.0,9
7929,7929,1997-98,1997,1998,Leeds,Everton,Loss,Away,1998-04-11,0,6,6,9,12,1,4,4,5,5,2,5,7,0,11.0,15.0,-4.0,9
7930,7930,1997-98,1997,1998,Leeds,Bolton,Win,Away,1998-04-18,3,3,6,6,9,3,4,4,7,0,2,2,2,0,11.0,21.0,-10.0,9
7931,7931,1997-98,1997,1998,Leeds,Coventry,Draw,Home,1998-04-25,1,3,6,9,9,2,2,3,6,1,4,6,3,1,11.0,17.0,-6.0,9
7932,7932,1997-98,1997,1998,Leeds,Man United,Loss,Away,1998-05-04,0,4,4,7,10,4,5,8,11,0,-1,-1,-1,0,11.0,1.0,10.0,10
7933,7933,1997-98,1997,1998,Leeds,Wimbledon,Draw,Home,1998-05-10,1,1,4,4,7,1,2,2,3,0,2,2,4,1,11.0,8.0,3.0,10
7934,7934,1998-99,1998,1999,Leeds,Middlesbrough,Draw,Away,1998-08-15,1,1,2,5,5,2,3,6,6,-1,-1,-1,-1,0,5.0,21.0,-16.0,1
7935,7935,1998-99,1998,1999,Leeds,Blackburn,Win,Home,1998-08-24,3,2,2,3,6,4,4,7,8,-2,-2,-4,-2,1,5.0,6.0,-1.0,1
7936,7936,1998-99,1998,1999,Leeds,Wimbledon,Draw,Away,1998-08-29,1,4,5,5,6,4,5,5,6,0,0,0,0,0,5.0,15.0,-10.0,1
7937,7937,1998-99,1998,1999,Leeds,Southampton,Win,Home,1998-09-08,3,4,5,6,6,0,0,1,1,4,5,5,5,1,5.0,12.0,-7.0,2
7938,7938,1998-99,1998,1999,Leeds,Everton,Draw,Away,1998-09-12,1,4,7,8,9,3,3,4,5,1,4,4,4,0,5.0,17.0,-12.0,2
7939,7939,1998-99,1998,1999,Leeds,Aston Villa,Draw,Home,1998-09-19,1,4,5,8,9,6,9,12,13,-2,-4,-4,-4,1,5.0,7.0,-2.0,2
7940,7940,1998-99,1998,1999,Leeds,Tottenham,Draw,Away,1998-09-26,1,2,5,6,9,1,4,7,7,1,1,-1,2,0,5.0,14.0,-9.0,2
7941,7941,1998-99,1998,1999,Leeds,Leicester,Loss,Home,1998-10-03,0,2,3,6,7,1,2,2,2,1,1,4,5,1,5.0,10.0,-5.0,3
7942,7942,1998-99,1998,1999,Leeds,Nott'm Forest,Draw,Away,1998-10-17,1,1,2,3,6,0,1,1,1,1,1,2,5,0,5.0,21.0,-16.0,3
7943,7943,1998-99,1998,1999,Leeds,Chelsea,Draw,Home,1998-10-25,1,1,2,3,4,4,7,10,13,-3,-5,-7,-9,1,5.0,4.0,1.0,3
7944,7944,1998-99,1998,1999,Leeds,Derby,Draw,Away,1998-10-31,1,2,2,3,4,1,1,1,4,1,1,2,0,0,5.0,9.0,-4.0,3
7945,7945,1998-99,1998,1999,Leeds,Sheffield Weds,Win,Home,1998-11-08,3,2,3,3,4,2,2,2,5,0,1,1,-1,1,5.0,16.0,-11.0,4
7946,7946,1998-99,1998,1999,Leeds,Liverpool,Win,Away,1998-11-14,3,4,5,6,6,0,3,4,5,4,2,2,1,0,5.0,3.0,2.0,4
7947,7947,1998-99,1998,1999,Leeds,Charlton,Win,Home,1998-11-21,3,6,7,8,9,2,3,6,6,4,4,2,3,1,5.0,21.0,-16.0,4
7948,7948,1998-99,1998,1999,Leeds,Man United,Loss,Away,1998-11-29,0,6,9,10,11,3,4,7,8,3,5,3,3,0,5.0,2.0,3.0,4
7949,7949,1998-99,1998,1999,Leeds,West Ham,Win,Home,1998-12-05,3,3,6,9,10,6,9,10,13,-3,-3,-1,-3,1,5.0,8.0,-3.0,5
7950,7950,1998-99,1998,1999,Leeds,Coventry,Win,Home,1998-12-14,3,3,6,9,12,1,1,4,7,2,5,5,5,1,5.0,11.0,-6.0,5
7951,7951,1998-99,1998,1999,Leeds,Arsenal,Loss,Away,1998-12-20,0,6,6,9,12,1,2,2,3,5,4,7,9,0,5.0,1.0,4.0,5
7952,7952,1998-99,1998,1999,Leeds,Newcastle,Win,Away,1998-12-26,3,3,6,6,9,4,5,8,8,-1,1,-2,1,0,5.0,13.0,-8.0,5
7953,7953,1998-99,1998,1999,Leeds,Wimbledon,Draw,Home,1998-12-29,1,3,6,9,9,3,6,9,9,0,0,0,0,1,5.0,15.0,-10.0,5
7954,7954,1998-99,1998,1999,Leeds,Blackburn,Loss,Away,1999-01-09,0,4,4,7,10,4,5,6,9,0,-1,1,1,0,5.0,6.0,-1.0,6
7955,7955,1998-99,1998,1999,Leeds,Middlesbrough,Win,Home,1999-01-16,3,1,4,4,7,1,1,4,7,0,3,0,0,1,5.0,21.0,-16.0,6
7956,7956,1998-99,1998,1999,Leeds,Southampton,Loss,Away,1999-01-30,0,3,4,7,7,3,4,4,7,0,0,3,0,0,5.0,12.0,-7.0,6
7957,7957,1998-99,1998,1999,Leeds,Newcastle,Loss,Home,1999-02-06,0,3,3,4,7,4,4,4,4,-1,-1,0,3,1,5.0,13.0,-8.0,7
7958,7958,1998-99,1998,1999,Leeds,Aston Villa,Win,Away,1999-02-17,3,0,3,3,4,0,3,4,7,0,0,-1,-3,0,5.0,7.0,-2.0,7
7959,7959,1998-99,1998,1999,Leeds,Everton,Win,Home,1999-02-20,3,3,3,6,6,3,3,3,4,0,0,3,2,1,5.0,17.0,-12.0,7
7960,7960,1998-99,1998,1999,Leeds,Leicester,Win,Away,1999-03-01,3,6,6,6,9,0,1,1,2,6,5,5,7,0,5.0,10.0,-5.0,8
7961,7961,1998-99,1998,1999,Leeds,Tottenham,Win,Home,1999-03-10,3,6,9,9,9,4,5,6,7,2,4,3,2,1,5.0,14.0,-9.0,8
7962,7962,1998-99,1998,1999,Leeds,Sheffield Weds,Win,Away,1999-03-13,3,6,9,12,12,0,3,6,9,6,6,6,3,0,5.0,16.0,-11.0,8
7963,7963,1998-99,1998,1999,Leeds,Derby,Win,Home,1999-03-20,3,6,9,12,15,6,7,7,10,0,2,5,5,1,5.0,9.0,-4.0,8
7964,7964,1998-99,1998,1999,Leeds,Nott'm Forest,Win,Home,1999-04-03,3,6,9,12,15,3,3,4,4,3,6,8,11,1,5.0,21.0,-16.0,9
7965,7965,1998-99,1998,1999,Leeds,Liverpool,Draw,Home,1999-04-12,1,6,9,12,15,4,4,4,5,2,5,8,10,1,5.0,3.0,2.0,9
7966,7966,1998-99,1998,1999,Leeds,Charlton,Draw,Away,1999-04-17,1,4,7,10,13,3,3,4,4,1,4,6,9,0,5.0,21.0,-16.0,9
7967,7967,1998-99,1998,1999,Leeds,Man United,Draw,Home,1999-04-25,1,2,5,8,11,4,7,10,13,-2,-2,-2,-2,1,5.0,2.0,3.0,9
7968,7968,1998-99,1998,1999,Leeds,West Ham,Win,Away,1999-05-01,3,2,3,6,9,6,7,7,8,-4,-4,-1,1,0,5.0,8.0,-3.0,10
7969,7969,1998-99,1998,1999,Leeds,Chelsea,Loss,Away,1999-05-05,0,4,5,6,9,4,5,6,9,0,0,0,0,0,5.0,4.0,1.0,10
7970,7970,1998-99,1998,1999,Leeds,Arsenal,Win,Home,1999-05-11,3,3,4,5,6,6,9,12,15,-3,-5,-7,-9,1,5.0,1.0,4.0,10
7971,7971,1998-99,1998,1999,Leeds,Coventry,Draw,Away,1999-05-16,1,3,6,7,8,4,4,4,4,-1,2,3,4,0,5.0,11.0,-6.0,10
7972,7972,1999-00,1999,2000,Leeds,Derby,Draw,Home,1999-08-07,1,4,4,7,8,1,4,4,5,3,0,3,3,1,4.0,8.0,-4.0,1
7973,7973,1999-00,1999,2000,Leeds,Southampton,Win,Away,1999-08-11,3,2,5,5,8,6,9,12,13,-4,-4,-7,-5,0,4.0,17.0,-13.0,1
7974,7974,1999-00,1999,2000,Leeds,Man United,Loss,Away,1999-08-14,0,4,5,8,8,4,7,8,11,0,-2,0,-3,0,4.0,1.0,3.0,1
7975,7975,1999-00,1999,2000,Leeds,Sunderland,Win,Home,1999-08-21,3,3,4,5,8,4,4,4,7,-1,0,1,1,1,4.0,21.0,-17.0,1
7976,7976,1999-00,1999,2000,Leeds,Liverpool,Loss,Home,1999-08-23,0,3,6,7,8,0,3,6,6,3,3,1,2,1,4.0,7.0,-3.0,1
7977,7977,1999-00,1999,2000,Leeds,Tottenham,Win,Away,1999-08-28,3,3,3,6,7,6,9,9,9,-3,-6,-3,-2,0,4.0,11.0,-7.0,1
7978,7978,1999-00,1999,2000,Leeds,Coventry,Win,Away,1999-09-11,3,3,6,6,9,1,4,5,5,2,2,1,4,0,4.0,15.0,-11.0,2
7979,7979,1999-00,1999,2000,Leeds,Middlesbrough,Win,Home,1999-09-19,3,6,6,9,9,3,3,6,9,3,3,3,0,1,4.0,9.0,-5.0,2
7980,7980,1999-00,1999,2000,Leeds,Newcastle,Win,Home,1999-09-25,3,6,9,9,12,3,3,3,4,3,6,6,8,1,4.0,13.0,-9.0,2
7981,7981,1999-00,1999,2000,Leeds,Watford,Win,Away,1999-10-03,3,6,9,12,12,3,3,3,3,3,6,9,9,0,4.0,21.0,-17.0,3
7982,7982,1999-00,1999,2000,Leeds,Sheffield Weds,Win,Home,1999-10-16,3,6,9,12,15,3,3,3,3,3,6,9,12,1,4.0,12.0,-8.0,3
7983,7983,1999-00,1999,2000,Leeds,Everton,Draw,Away,1999-10-24,1,6,9,12,15,1,4,7,10,5,5,5,5,0,4.0,14.0,-10.0,3
7984,7984,1999-00,1999,2000,Leeds,West Ham,Win,Home,1999-10-30,3,4,7,10,13,1,1,4,4,3,6,6,9,1,4.0,5.0,-1.0,3
7985,7985,1999-00,1999,2000,Leeds,Wimbledon,Loss,Away,1999-11-07,0,4,7,10,13,2,5,5,6,2,2,5,7,0,4.0,16.0,-12.0,4
7986,7986,1999-00,1999,2000,Leeds,Bradford,Win,Home,1999-11-20,3,3,4,7,10,1,4,4,4,2,0,3,6,1,4.0,21.0,-17.0,4
7987,7987,1999-00,1999,2000,Leeds,Southampton,Win,Home,1999-11-28,3,3,6,7,10,3,4,5,5,0,2,2,5,1,4.0,17.0,-13.0,4
7988,7988,1999-00,1999,2000,Leeds,Derby,Win,Away,1999-12-05,3,6,6,9,10,0,0,3,3,6,6,6,7,0,4.0,8.0,-4.0,5
7989,7989,1999-00,1999,2000,Leeds,Chelsea,Win,Away,1999-12-19,3,6,9,9,12,3,4,5,5,3,5,4,7,0,4.0,3.0,1.0,5
7990,7990,1999-00,1999,2000,Leeds,Leicester,Win,Home,1999-12-26,3,6,9,12,12,0,3,6,6,6,6,6,6,1,4.0,10.0,-6.0,5
7991,7991,1999-00,1999,2000,Leeds,Arsenal,Loss,Away,1999-12-28,0,6,9,12,15,1,4,7,10,5,5,5,5,0,4.0,2.0,2.0,5
7992,7992,1999-00,1999,2000,Leeds,Aston Villa,Loss,Home,2000-01-03,0,3,6,9,12,4,7,7,8,-1,-1,2,4,1,4.0,6.0,-2.0,6
7993,7993,1999-00,1999,2000,Leeds,Sunderland,Win,Away,2000-01-23,3,0,3,6,9,0,1,1,4,0,2,5,5,0,4.0,21.0,-17.0,6
7994,7994,1999-00,1999,2000,Leeds,Liverpool,Loss,Away,2000-02-05,0,3,3,6,9,4,4,7,8,-1,-1,-1,1,0,4.0,7.0,-3.0,7
7995,7995,1999-00,1999,2000,Leeds,Tottenham,Win,Home,2000-02-12,3,3,3,3,6,0,1,1,4,3,2,2,2,1,4.0,11.0,-7.0,7
7996,7996,1999-00,1999,2000,Leeds,Man United,Loss,Home,2000-02-20,0,3,6,6,6,3,6,9,10,0,0,-3,-4,1,4.0,1.0,3.0,7
7997,7997,1999-00,1999,2000,Leeds,Middlesbrough,Draw,Away,2000-02-26,1,3,3,6,6,3,3,3,4,0,0,3,2,0,4.0,9.0,-5.0,7
7998,7998,1999-00,1999,2000,Leeds,Coventry,Win,Home,2000-03-05,3,1,4,4,7,0,3,3,4,1,1,1,3,1,4.0,15.0,-11.0,8
7999,7999,1999-00,1999,2000,Leeds,Bradford,Win,Away,2000-03-12,3,4,4,7,7,2,2,5,8,2,2,2,-1,0,4.0,21.0,-17.0,8
8000,8000,1999-00,1999,2000,Leeds,Wimbledon,Win,Home,2000-03-19,3,6,7,7,10,3,4,4,4,3,3,3,6,1,4.0,16.0,-12.0,8
8001,8001,1999-00,1999,2000,Leeds,Leicester,Loss,Away,2000-03-26,0,6,9,10,10,0,3,4,7,6,6,6,3,0,4.0,10.0,-6.0,8
8002,8002,1999-00,1999,2000,Leeds,Chelsea,Loss,Home,2000-04-01,0,3,6,9,10,2,3,6,9,1,3,3,1,1,4.0,3.0,1.0,9
8003,8003,1999-00,1999,2000,Leeds,Aston Villa,Loss,Away,2000-04-09,0,0,3,6,9,6,6,7,10,-6,-3,-1,-1,0,4.0,6.0,-2.0,9
8004,8004,1999-00,1999,2000,Leeds,Arsenal,Loss,Home,2000-04-16,0,0,0,3,6,6,9,9,10,-6,-9,-6,-4,1,4.0,2.0,2.0,9
8005,8005,1999-00,1999,2000,Leeds,Newcastle,Draw,Away,2000-04-23,1,0,0,0,3,0,3,3,6,0,-3,-3,-3,0,4.0,13.0,-9.0,9
8006,8006,1999-00,1999,2000,Leeds,Sheffield Weds,Win,Away,2000-04-30,3,1,1,1,1,3,6,6,6,-2,-5,-5,-5,0,4.0,12.0,-8.0,9
8007,8007,1999-00,1999,2000,Leeds,Watford,Win,Home,2000-05-03,3,4,4,4,4,0,0,1,1,4,4,3,3,1,4.0,21.0,-17.0,10
8008,8008,1999-00,1999,2000,Leeds,Everton,Draw,Home,2000-05-08,1,6,7,7,7,1,4,5,8,5,3,2,-1,1,4.0,14.0,-10.0,10
8009,8009,1999-00,1999,2000,Leeds,West Ham,Draw,Away,2000-05-14,1,4,7,8,8,0,0,3,6,4,7,5,2,0,4.0,5.0,-1.0,10
8010,8010,2000-01,2000,2001,Leeds,Everton,Win,Home,2000-08-19,3,2,5,8,9,1,1,2,5,1,4,6,4,1,3.0,13.0,-10.0,1
8011,8011,2000-01,2000,2001,Leeds,Middlesbrough,Win,Away,2000-08-26,3,4,5,8,11,4,7,8,9,0,-2,0,2,0,3.0,12.0,-9.0,1
8012,8012,2000-01,2000,2001,Leeds,Man City,Loss,Home,2000-09-05,0,6,7,8,11,3,3,4,7,3,4,4,4,1,3.0,21.0,-18.0,2
8013,8013,2000-01,2000,2001,Leeds,Coventry,Draw,Away,2000-09-09,1,3,6,7,8,3,6,6,6,0,0,1,2,0,3.0,14.0,-11.0,2
8014,8014,2000-01,2000,2001,Leeds,Ipswich,Loss,Home,2000-09-16,0,1,4,7,8,0,3,4,4,1,1,3,4,1,3.0,21.0,-18.0,2
8015,8015,2000-01,2000,2001,Leeds,Derby,Draw,Away,2000-09-23,1,1,1,4,7,1,2,3,3,0,-1,1,4,0,3.0,16.0,-13.0,2
8016,8016,2000-01,2000,2001,Leeds,Tottenham,Win,Home,2000-09-30,3,1,2,2,5,1,4,7,7,0,-2,-5,-2,1,3.0,10.0,-7.0,2
8017,8017,2000-01,2000,2001,Leeds,Charlton,Win,Home,2000-10-14,3,4,4,5,5,4,7,8,9,0,-3,-3,-4,1,3.0,21.0,-18.0,3
8018,8018,2000-01,2000,2001,Leeds,Man United,Loss,Away,2000-10-21,0,6,7,7,8,3,4,7,10,3,3,0,-2,0,3.0,1.0,2.0,3
8019,8019,2000-01,2000,2001,Leeds,Bradford,Draw,Away,2000-10-29,1,3,6,7,7,0,1,1,1,3,5,6,6,0,3.0,17.0,-14.0,3
8020,8020,2000-01,2000,2001,Leeds,Liverpool,Win,Home,2000-11-04,3,1,4,7,8,6,9,9,10,-5,-5,-2,-2,1,3.0,4.0,-1.0,4
8021,8021,2000-01,2000,2001,Leeds,Chelsea,Draw,Away,2000-11-12,1,4,4,7,10,3,6,6,9,1,-2,1,1,0,3.0,5.0,-2.0,4
8022,8022,2000-01,2000,2001,Leeds,West Ham,Loss,Home,2000-11-18,0,4,5,5,8,4,7,7,8,0,-2,-2,0,1,3.0,9.0,-6.0,4
8023,8023,2000-01,2000,2001,Leeds,Arsenal,Win,Home,2000-11-26,3,1,4,5,5,1,4,7,10,0,0,-2,-5,1,3.0,2.0,1.0,4
8024,8024,2000-01,2000,2001,Leeds,Leicester,Loss,Away,2000-12-02,0,3,4,7,8,3,4,7,10,0,0,0,-2,0,3.0,8.0,-5.0,5
8025,8025,2000-01,2000,2001,Leeds,Southampton,Loss,Away,2000-12-09,0,3,3,4,7,0,3,4,7,3,0,0,0,0,3.0,15.0,-12.0,5
8026,8026,2000-01,2000,2001,Leeds,Sunderland,Win,Home,2000-12-16,3,0,3,3,4,6,9,12,13,-6,-6,-9,-9,1,3.0,7.0,-4.0,5
8027,8027,2000-01,2000,2001,Leeds,Aston Villa,Loss,Home,2000-12-23,0,3,3,6,6,2,3,4,4,1,0,2,2,1,3.0,6.0,-3.0,5
8028,8028,2000-01,2000,2001,Leeds,Newcastle,Loss,Away,2000-12-26,0,3,3,3,6,3,3,4,7,0,0,-1,-1,0,3.0,11.0,-8.0,5
8029,8029,2000-01,2000,2001,Leeds,Middlesbrough,Draw,Home,2001-01-01,1,0,3,3,3,4,5,8,8,-4,-2,-5,-5,1,3.0,12.0,-9.0,6
8030,8030,2000-01,2000,2001,Leeds,Man City,Win,Away,2001-01-13,3,1,1,4,4,1,2,2,3,0,-1,2,1,0,3.0,21.0,-18.0,6
8031,8031,2000-01,2000,2001,Leeds,Newcastle,Loss,Home,2001-01-20,0,4,4,4,7,3,4,7,7,1,0,-3,0,1,3.0,11.0,-8.0,6
8032,8032,2000-01,2000,2001,Leeds,Aston Villa,Win,Away,2001-01-24,3,3,4,4,4,0,0,0,3,3,4,4,1,0,3.0,6.0,-3.0,6
8033,8033,2000-01,2000,2001,Leeds,Coventry,Win,Home,2001-01-31,3,3,6,7,7,0,1,2,5,3,5,5,2,1,3.0,14.0,-11.0,6
8034,8034,2000-01,2000,2001,Leeds,Ipswich,Win,Away,2001-02-03,3,6,6,9,10,3,3,6,7,3,3,3,3,0,3.0,21.0,-18.0,7
8035,8035,2000-01,2000,2001,Leeds,Everton,Draw,Away,2001-02-07,1,6,9,9,12,1,4,5,5,5,5,4,7,0,3.0,13.0,-10.0,7
8036,8036,2000-01,2000,2001,Leeds,Derby,Draw,Home,2001-02-10,1,4,7,10,10,3,4,4,7,1,3,6,3,1,3.0,16.0,-13.0,7
8037,8037,2000-01,2000,2001,Leeds,Tottenham,Win,Away,2001-02-24,3,2,5,8,11,4,5,6,7,-2,0,2,4,0,3.0,10.0,-7.0,7
8038,8038,2000-01,2000,2001,Leeds,Man United,Draw,Home,2001-03-03,1,4,5,8,11,4,7,10,13,0,-2,-2,-2,1,3.0,1.0,2.0,8
8039,8039,2000-01,2000,2001,Leeds,Charlton,Win,Away,2001-03-17,3,4,5,6,9,2,5,6,9,2,0,0,0,0,3.0,21.0,-18.0,8
8040,8040,2000-01,2000,2001,Leeds,Sunderland,Win,Away,2001-03-31,3,4,7,8,9,4,4,5,5,0,3,3,4,0,3.0,7.0,-4.0,8
8041,8041,2000-01,2000,2001,Leeds,Southampton,Win,Home,2001-04-07,3,6,7,10,11,3,6,9,12,3,1,1,-1,1,3.0,15.0,-12.0,9
8042,8042,2000-01,2000,2001,Leeds,Liverpool,Win,Away,2001-04-13,3,6,9,10,13,4,5,5,6,2,4,5,7,0,3.0,4.0,-1.0,9
8043,8043,2000-01,2000,2001,Leeds,West Ham,Win,Away,2001-04-21,3,6,9,12,13,3,4,4,4,3,5,8,9,0,3.0,9.0,-6.0,9
8044,8044,2000-01,2000,2001,Leeds,Chelsea,Win,Home,2001-04-28,3,6,9,12,15,3,6,9,12,3,3,3,3,1,3.0,5.0,-2.0,9
8045,8045,2000-01,2000,2001,Leeds,Arsenal,Loss,Away,2001-05-05,0,6,9,12,15,6,6,9,12,0,3,3,3,0,3.0,2.0,1.0,10
8046,8046,2000-01,2000,2001,Leeds,Bradford,Win,Home,2001-05-13,3,3,6,9,12,1,1,4,7,2,5,5,5,1,3.0,17.0,-14.0,10
8047,8047,2000-01,2000,2001,Leeds,Leicester,Win,Home,2001-05-19,3,3,6,9,12,3,3,3,3,0,3,6,9,1,3.0,8.0,-5.0,10
8048,8048,2001-02,2001,2002,Leeds,Southampton,Win,Home,2001-08-18,3,6,6,9,12,6,6,7,7,0,0,2,5,1,4.0,10.0,-6.0,1
8049,8049,2001-02,2001,2002,Leeds,Arsenal,Win,Away,2001-08-21,3,6,9,9,12,3,4,7,10,3,5,2,2,0,4.0,2.0,2.0,1
8050,8050,2001-02,2001,2002,Leeds,West Ham,Draw,Away,2001-08-25,1,6,9,12,12,0,3,3,3,6,6,9,9,0,4.0,15.0,-11.0,1
8051,8051,2001-02,2001,2002,Leeds,Bolton,Draw,Home,2001-09-08,1,4,7,10,13,6,9,9,12,-2,-2,1,1,1,4.0,21.0,-17.0,2
8052,8052,2001-02,2001,2002,Leeds,Charlton,Win,Away,2001-09-16,3,2,5,8,11,4,4,4,4,-2,1,4,7,0,4.0,9.0,-5.0,2
8053,8053,2001-02,2001,2002,Leeds,Derby,Win,Home,2001-09-23,3,4,5,8,11,1,2,2,5,3,3,6,6,1,4.0,17.0,-13.0,2
8054,8054,2001-02,2001,2002,Leeds,Ipswich,Win,Away,2001-09-30,3,6,7,8,11,1,2,2,5,5,5,6,6,0,4.0,5.0,-1.0,2
8055,8055,2001-02,2001,2002,Leeds,Liverpool,Draw,Away,2001-10-13,1,6,9,10,11,6,9,9,9,0,0,1,2,0,4.0,3.0,1.0,3
8056,8056,2001-02,2001,2002,Leeds,Chelsea,Draw,Home,2001-10-21,1,4,7,10,11,4,5,8,9,0,2,2,2,1,4.0,6.0,-2.0,3
8057,8057,2001-02,2001,2002,Leeds,Man United,Draw,Away,2001-10-27,1,2,5,8,11,3,6,9,9,-1,-1,-1,2,0,4.0,1.0,3.0,3
8058,8058,2001-02,2001,2002,Leeds,Tottenham,Win,Home,2001-11-04,3,2,3,6,9,6,9,9,9,-4,-6,-3,0,1,4.0,12.0,-8.0,4
8059,8059,2001-02,2001,2002,Leeds,Sunderland,Loss,Away,2001-11-18,0,4,5,6,9,1,1,1,4,3,4,5,5,0,4.0,7.0,-3.0,4
8060,8060,2001-02,2001,2002,Leeds,Aston Villa,Draw,Home,2001-11-25,1,3,4,5,6,1,4,7,7,2,0,-2,-1,1,4.0,8.0,-4.0,4
8061,8061,2001-02,2001,2002,Leeds,Fulham,Draw,Away,2001-12-02,1,1,4,5,6,4,7,10,11,-3,-3,-5,-5,0,4.0,21.0,-17.0,5
8062,8062,2001-02,2001,2002,Leeds,Blackburn,Win,Away,2001-12-09,3,2,2,5,6,1,2,5,6,1,0,0,0,0,4.0,21.0,-17.0,5
8063,8063,2001-02,2001,2002,Leeds,Leicester,Draw,Home,2001-12-16,1,4,5,5,8,3,4,4,7,1,1,1,1,1,4.0,13.0,-9.0,5
8064,8064,2001-02,2001,2002,Leeds,Everton,Win,Home,2001-12-19,3,4,5,6,6,3,6,7,8,1,-1,-1,-2,1,4.0,16.0,-12.0,5
8065,8065,2001-02,2001,2002,Leeds,Newcastle,Loss,Home,2001-12-22,0,4,7,8,9,6,9,10,13,-2,-2,-2,-4,1,4.0,11.0,-7.0,5
8066,8066,2001-02,2001,2002,Leeds,Bolton,Win,Away,2001-12-26,3,3,4,7,8,1,1,1,2,2,3,6,6,0,4.0,21.0,-17.0,5
8067,8067,2001-02,2001,2002,Leeds,Southampton,Win,Away,2001-12-29,3,3,6,7,10,3,6,9,9,0,0,-2,1,0,4.0,10.0,-6.0,5
8068,8068,2001-02,2001,2002,Leeds,West Ham,Win,Home,2002-01-01,3,6,6,9,10,4,5,6,9,2,1,3,1,1,4.0,15.0,-11.0,6
8069,8069,2001-02,2001,2002,Leeds,Newcastle,Loss,Away,2002-01-12,0,6,9,9,12,0,3,6,9,6,6,3,3,0,4.0,11.0,-7.0,6
8070,8070,2001-02,2001,2002,Leeds,Arsenal,Draw,Home,2002-01-20,1,3,6,9,9,4,7,10,10,-1,-1,-1,-1,1,4.0,2.0,2.0,6
8071,8071,2001-02,2001,2002,Leeds,Chelsea,Loss,Away,2002-01-30,0,1,4,7,10,4,4,7,7,-3,0,0,3,0,4.0,6.0,-2.0,6
8072,8072,2001-02,2001,2002,Leeds,Liverpool,Loss,Home,2002-02-03,0,1,1,4,7,6,7,8,8,-5,-6,-4,-1,1,4.0,3.0,1.0,7
8073,8073,2001-02,2001,2002,Leeds,Middlesbrough,Draw,Away,2002-02-09,1,0,1,1,4,4,5,5,8,-4,-4,-4,-4,0,4.0,14.0,-10.0,7
8074,8074,2001-02,2001,2002,Leeds,Charlton,Draw,Home,2002-02-24,1,1,1,2,2,1,4,4,4,0,-3,-2,-2,1,4.0,9.0,-5.0,7
8075,8075,2001-02,2001,2002,Leeds,Everton,Draw,Away,2002-03-03,1,2,2,2,3,1,1,2,3,1,1,0,0,0,4.0,16.0,-12.0,8
8076,8076,2001-02,2001,2002,Leeds,Ipswich,Win,Home,2002-03-06,3,2,3,3,3,0,3,6,9,2,0,-3,-6,1,4.0,5.0,-1.0,8
8077,8077,2001-02,2001,2002,Leeds,Blackburn,Win,Home,2002-03-17,3,4,5,6,6,6,7,7,7,-2,-2,-1,-1,1,4.0,21.0,-17.0,8
8078,8078,2001-02,2001,2002,Leeds,Leicester,Win,Away,2002-03-23,3,6,7,8,9,2,2,2,2,4,5,6,7,0,4.0,13.0,-9.0,8
8079,8079,2001-02,2001,2002,Leeds,Man United,Loss,Home,2002-03-30,0,6,9,10,11,3,6,7,10,3,3,3,1,1,4.0,1.0,3.0,8
8080,8080,2001-02,2001,2002,Leeds,Tottenham,Loss,Away,2002-04-01,0,3,6,9,10,4,4,4,4,-1,2,5,6,0,4.0,12.0,-8.0,9
8081,8081,2001-02,2001,2002,Leeds,Sunderland,Win,Home,2002-04-07,3,0,3,6,9,3,4,4,7,-3,-1,2,2,1,4.0,7.0,-3.0,9
8082,8082,2001-02,2001,2002,Leeds,Aston Villa,Win,Away,2002-04-13,3,3,3,6,9,1,1,2,2,2,2,4,7,0,4.0,8.0,-4.0,9
8083,8083,2001-02,2001,2002,Leeds,Fulham,Loss,Home,2002-04-20,0,6,6,6,9,1,2,2,2,5,4,4,7,1,4.0,21.0,-17.0,9
8084,8084,2001-02,2001,2002,Leeds,Derby,Win,Away,2002-04-27,3,3,6,6,6,0,0,0,0,3,6,6,6,0,4.0,17.0,-13.0,9
8085,8085,2001-02,2001,2002,Leeds,Middlesbrough,Win,Home,2002-05-11,3,3,6,9,9,0,0,3,6,3,6,6,3,1,4.0,14.0,-10.0,10
8086,8086,2002-03,2002,2003,Leeds,Man City,Win,Home,2002-08-17,3,6,6,9,12,0,3,4,7,6,3,5,5,1,5.0,21.0,-16.0,1
8087,8087,2002-03,2002,2003,Leeds,West Brom,Win,Away,2002-08-24,3,6,9,9,12,0,0,0,0,6,9,9,12,0,5.0,21.0,-16.0,1
8088,8088,2002-03,2002,2003,Leeds,Sunderland,Loss,Home,2002-08-28,0,6,9,12,12,1,2,3,3,5,7,9,9,1,5.0,17.0,-12.0,1
8089,8089,2002-03,2002,2003,Leeds,Birmingham,Loss,Away,2002-08-31,0,3,6,9,12,1,1,1,1,2,5,8,11,0,5.0,21.0,-16.0,1
8090,8090,2002-03,2002,2003,Leeds,Newcastle,Win,Away,2002-09-11,3,0,3,6,9,1,4,4,7,-1,-1,2,2,0,5.0,4.0,1.0,2
8091,8091,2002-03,2002,2003,Leeds,Man United,Win,Home,2002-09-14,3,3,3,6,9,3,4,5,8,0,-1,1,1,1,5.0,3.0,2.0,2
8092,8092,2002-03,2002,2003,Leeds,Blackburn,Loss,Away,2002-09-22,0,6,6,6,9,1,1,2,5,5,5,4,4,0,5.0,10.0,-5.0,2
8093,8093,2002-03,2002,2003,Leeds,Arsenal,Loss,Home,2002-09-28,0,3,6,6,6,6,9,10,13,-3,-3,-4,-7,1,5.0,1.0,4.0,2
8094,8094,2002-03,2002,2003,Leeds,Aston Villa,Draw,Away,2002-10-06,1,0,3,6,6,3,3,6,6,-3,0,0,0,0,5.0,8.0,-3.0,3
8095,8095,2002-03,2002,2003,Leeds,Liverpool,Loss,Home,2002-10-19,0,1,1,4,7,6,9,12,13,-5,-8,-8,-6,1,5.0,2.0,3.0,3
8096,8096,2002-03,2002,2003,Leeds,Middlesbrough,Draw,Away,2002-10-26,1,1,1,1,4,3,6,9,9,-2,-5,-8,-5,0,5.0,12.0,-7.0,3
8097,8097,2002-03,2002,2003,Leeds,Everton,Loss,Home,2002-11-03,0,1,2,2,2,6,6,9,9,-5,-4,-7,-7,1,5.0,15.0,-10.0,4
8098,8098,2002-03,2002,2003,Leeds,West Ham,Win,Away,2002-11-10,3,1,1,2,2,0,3,6,6,1,-2,-4,-4,0,5.0,7.0,-2.0,4
8099,8099,2002-03,2002,2003,Leeds,Bolton,Loss,Home,2002-11-17,0,3,4,4,5,1,2,2,2,2,2,2,3,1,5.0,16.0,-11.0,4
8100,8100,2002-03,2002,2003,Leeds,Tottenham,Loss,Away,2002-11-24,0,3,3,4,4,0,1,1,4,3,2,3,0,0,5.0,9.0,-4.0,4
8101,8101,2002-03,2002,2003,Leeds,Charlton,Loss,Home,2002-12-01,0,0,3,3,4,6,6,7,7,-6,-3,-4,-3,1,5.0,14.0,-9.0,5
8102,8102,2002-03,2002,2003,Leeds,Fulham,Loss,Away,2002-12-07,0,0,0,3,3,3,4,4,4,-3,-4,-1,-1,0,5.0,13.0,-8.0,5
8103,8103,2002-03,2002,2003,Leeds,Bolton,Win,Away,2002-12-16,3,0,0,0,3,1,2,5,6,-1,-2,-5,-3,0,5.0,16.0,-11.0,5
8104,8104,2002-03,2002,2003,Leeds,Southampton,Draw,Home,2002-12-21,1,3,3,3,3,4,7,10,10,-1,-4,-7,-7,1,5.0,11.0,-6.0,5
8105,8105,2002-03,2002,2003,Leeds,Sunderland,Win,Away,2002-12-26,3,4,4,4,4,4,4,4,4,0,0,0,0,0,5.0,17.0,-12.0,5
8106,8106,2002-03,2002,2003,Leeds,Chelsea,Win,Home,2002-12-28,3,4,7,7,7,4,5,8,11,0,2,-1,-4,1,5.0,6.0,-1.0,5
8107,8107,2002-03,2002,2003,Leeds,Birmingham,Win,Home,2003-01-01,3,6,7,10,10,1,2,5,5,5,5,5,5,1,5.0,21.0,-16.0,6
8108,8108,2002-03,2002,2003,Leeds,Man City,Loss,Away,2003-01-11,0,6,9,10,13,4,7,7,8,2,2,3,5,0,5.0,21.0,-16.0,6
8109,8109,2002-03,2002,2003,Leeds,West Brom,Draw,Home,2003-01-18,1,3,6,9,10,0,0,1,1,3,6,8,9,1,5.0,21.0,-16.0,6
8110,8110,2002-03,2002,2003,Leeds,Chelsea,Loss,Away,2003-01-28,0,1,4,7,10,3,3,3,4,-2,1,4,6,0,5.0,6.0,-1.0,6
8111,8111,2002-03,2002,2003,Leeds,Everton,Loss,Away,2003-02-01,0,1,1,4,7,6,6,7,8,-5,-5,-3,-1,0,5.0,15.0,-10.0,7
8112,8112,2002-03,2002,2003,Leeds,West Ham,Win,Home,2003-02-08,3,0,1,1,4,3,3,3,4,-3,-2,-2,0,1,5.0,7.0,-2.0,7
8113,8113,2002-03,2002,2003,Leeds,Newcastle,Loss,Home,2003-02-22,0,3,3,4,4,4,7,10,11,-1,-4,-6,-7,1,5.0,4.0,1.0,7
8114,8114,2002-03,2002,2003,Leeds,Man United,Loss,Away,2003-03-05,0,3,3,3,4,2,5,8,11,1,-2,-5,-7,0,5.0,3.0,2.0,8
8115,8115,2002-03,2002,2003,Leeds,Middlesbrough,Loss,Home,2003-03-15,0,0,3,3,3,4,7,8,8,-4,-4,-5,-5,1,5.0,12.0,-7.0,8
8116,8116,2002-03,2002,2003,Leeds,Liverpool,Loss,Away,2003-03-23,0,0,0,3,3,6,6,7,10,-6,-6,-4,-7,0,5.0,2.0,3.0,8
8117,8117,2002-03,2002,2003,Leeds,Charlton,Win,Away,2003-04-05,3,0,0,0,3,1,1,4,7,-1,-1,-4,-4,0,5.0,14.0,-9.0,9
8118,8118,2002-03,2002,2003,Leeds,Tottenham,Draw,Home,2003-04-12,1,3,3,3,3,3,3,3,4,0,0,0,-1,1,5.0,9.0,-4.0,9
8119,8119,2002-03,2002,2003,Leeds,Southampton,Loss,Away,2003-04-19,0,4,4,4,4,2,3,6,6,2,1,-2,-2,0,5.0,11.0,-6.0,9
8120,8120,2002-03,2002,2003,Leeds,Fulham,Win,Home,2003-04-22,3,1,4,4,4,3,3,3,4,-2,1,1,0,1,5.0,13.0,-8.0,9
8121,8121,2002-03,2002,2003,Leeds,Blackburn,Loss,Home,2003-04-26,0,3,4,7,7,1,4,7,7,2,0,0,0,1,5.0,10.0,-5.0,9
8122,8122,2002-03,2002,2003,Leeds,Arsenal,Win,Away,2003-05-04,3,3,3,4,7,4,5,6,9,-1,-2,-2,-2,0,5.0,1.0,4.0,10
8123,8123,2002-03,2002,2003,Leeds,Aston Villa,Win,Home,2003-05-11,3,3,6,6,7,3,4,7,8,0,2,-1,-1,1,5.0,8.0,-3.0,10
8124,8124,2003-04,2003,2004,Leeds,Newcastle,Draw,Home,2003-08-17,1,6,6,9,9,4,7,8,8,2,-1,1,1,1,15.0,3.0,12.0,1
8125,8125,2003-04,2003,2004,Leeds,Tottenham,Loss,Away,2003-08-23,0,4,7,7,10,0,0,0,3,4,7,7,7,0,15.0,10.0,5.0,1
8126,8126,2003-04,2003,2004,Leeds,Southampton,Draw,Home,2003-08-26,1,1,4,7,7,2,5,5,6,-1,-1,2,1,1,15.0,8.0,7.0,1
8127,8127,2003-04,2003,2004,Leeds,Middlesbrough,Win,Away,2003-08-30,3,1,2,5,8,1,1,1,1,0,1,4,7,0,15.0,11.0,4.0,1
8128,8128,2003-04,2003,2004,Leeds,Leicester,Loss,Away,2003-09-15,0,4,4,5,8,1,1,2,5,3,3,3,3,0,15.0,21.0,-6.0,2
8129,8129,2003-04,2003,2004,Leeds,Birmingham,Loss,Home,2003-09-20,0,3,4,4,5,4,5,8,9,-1,-1,-4,-4,1,15.0,13.0,2.0,2
8130,8130,2003-04,2003,2004,Leeds,Everton,Loss,Away,2003-09-28,0,0,3,4,4,1,1,2,5,-1,2,2,-1,0,15.0,7.0,8.0,2
8131,8131,2003-04,2003,2004,Leeds,Blackburn,Win,Home,2003-10-04,3,0,0,3,4,3,3,4,4,-3,-3,-1,0,1,15.0,6.0,9.0,3
8132,8132,2003-04,2003,2004,Leeds,Man United,Loss,Home,2003-10-18,0,3,3,3,6,6,7,10,10,-3,-4,-7,-4,1,15.0,1.0,14.0,3
8133,8133,2003-04,2003,2004,Leeds,Liverpool,Loss,Away,2003-10-25,0,3,3,3,3,0,0,3,6,3,3,0,-3,0,15.0,5.0,10.0,3
8134,8134,2003-04,2003,2004,Leeds,Arsenal,Loss,Home,2003-11-01,0,0,3,3,3,4,7,10,11,-4,-4,-7,-8,1,15.0,2.0,13.0,4
8135,8135,2003-04,2003,2004,Leeds,Portsmouth,Loss,Away,2003-11-08,0,0,0,3,3,0,3,3,3,0,-3,0,0,0,15.0,21.0,-6.0,4
8136,8136,2003-04,2003,2004,Leeds,Bolton,Loss,Home,2003-11-22,0,0,0,0,3,4,4,4,5,-4,-4,-4,-2,1,15.0,17.0,-2.0,4
8137,8137,2003-04,2003,2004,Leeds,Charlton,Win,Away,2003-11-29,3,0,0,0,0,4,7,8,11,-4,-7,-8,-11,0,15.0,12.0,3.0,4
8138,8138,2003-04,2003,2004,Leeds,Chelsea,Draw,Home,2003-12-06,1,3,3,3,3,6,9,12,15,-3,-6,-9,-12,1,15.0,4.0,11.0,5
8139,8139,2003-04,2003,2004,Leeds,Fulham,Win,Home,2003-12-14,3,4,4,4,4,4,7,7,7,0,-3,-3,-3,1,15.0,14.0,1.0,5
8140,8140,2003-04,2003,2004,Leeds,Man City,Draw,Away,2003-12-22,1,4,7,7,7,1,1,1,1,3,6,6,6,0,15.0,9.0,6.0,5
8141,8141,2003-04,2003,2004,Leeds,Aston Villa,Draw,Home,2003-12-26,1,4,5,8,8,6,6,9,9,-2,-1,-1,-1,1,15.0,16.0,-1.0,5
8142,8142,2003-04,2003,2004,Leeds,Wolves,Loss,Away,2003-12-28,0,2,5,6,9,0,0,1,1,2,5,5,8,0,15.0,21.0,-6.0,5
8143,8143,2003-04,2003,2004,Leeds,Newcastle,Loss,Away,2004-01-07,0,1,2,5,6,1,2,5,6,0,0,0,0,0,15.0,3.0,12.0,6
8144,8144,2003-04,2003,2004,Leeds,Tottenham,Loss,Home,2004-01-10,0,0,1,2,5,3,3,3,3,-3,-2,-1,2,1,15.0,10.0,5.0,6
8145,8145,2003-04,2003,2004,Leeds,Southampton,Loss,Away,2004-01-17,0,0,0,1,2,1,1,1,4,-1,-1,0,-2,0,15.0,8.0,7.0,6
8146,8146,2003-04,2003,2004,Leeds,Middlesbrough,Loss,Home,2004-01-31,0,0,0,0,1,1,4,4,5,-1,-4,-4,-4,1,15.0,11.0,4.0,6
8147,8147,2003-04,2003,2004,Leeds,Aston Villa,Loss,Away,2004-02-07,0,0,0,0,0,3,3,6,9,-3,-3,-6,-9,0,15.0,16.0,-1.0,7
8148,8148,2003-04,2003,2004,Leeds,Wolves,Win,Home,2004-02-10,3,0,0,0,0,1,2,5,5,-1,-2,-5,-5,1,15.0,21.0,-6.0,7
8149,8149,2003-04,2003,2004,Leeds,Man United,Draw,Away,2004-02-21,1,3,3,3,3,3,6,6,7,0,-3,-3,-4,0,15.0,1.0,14.0,7
8150,8150,2003-04,2003,2004,Leeds,Liverpool,Draw,Home,2004-02-29,1,4,4,4,4,4,5,6,6,0,-1,-2,-2,1,15.0,5.0,10.0,7
8151,8151,2003-04,2003,2004,Leeds,Fulham,Loss,Away,2004-03-13,0,2,5,5,5,1,1,2,5,1,4,3,0,0,15.0,14.0,1.0,8
8152,8152,2003-04,2003,2004,Leeds,Man City,Win,Home,2004-03-22,3,1,2,5,5,3,6,6,7,-2,-4,-1,-2,1,15.0,9.0,6.0,8
8153,8153,2003-04,2003,2004,Leeds,Birmingham,Loss,Away,2004-03-27,0,3,4,5,8,0,3,6,7,3,1,-1,1,0,15.0,13.0,2.0,8
8154,8154,2003-04,2003,2004,Leeds,Leicester,Win,Home,2004-04-05,3,3,3,4,5,2,5,6,7,1,-2,-2,-2,1,15.0,21.0,-6.0,9
8155,8155,2003-04,2003,2004,Leeds,Blackburn,Win,Away,2004-04-10,3,3,6,6,7,0,3,3,4,3,3,3,3,0,15.0,6.0,9.0,9
8156,8156,2003-04,2003,2004,Leeds,Everton,Draw,Home,2004-04-13,1,6,6,9,9,3,4,5,8,3,2,4,1,1,15.0,7.0,8.0,9
8157,8157,2003-04,2003,2004,Leeds,Arsenal,Loss,Away,2004-04-16,0,4,7,7,10,4,5,8,11,0,2,-1,-1,0,15.0,2.0,13.0,9
8158,8158,2003-04,2003,2004,Leeds,Portsmouth,Loss,Home,2004-04-25,0,1,4,7,7,6,7,10,13,-5,-3,-3,-6,1,15.0,21.0,-6.0,9
8159,8159,2003-04,2003,2004,Leeds,Bolton,Loss,Away,2004-05-02,0,0,1,4,7,6,9,10,10,-6,-8,-6,-3,0,15.0,17.0,-2.0,10
8160,8160,2003-04,2003,2004,Leeds,Charlton,Draw,Home,2004-05-08,1,0,0,1,4,1,1,2,5,-1,-1,-1,-1,1,15.0,12.0,3.0,10
8161,8161,2003-04,2003,2004,Leeds,Chelsea,Loss,Away,2004-05-15,0,1,1,1,2,4,4,5,5,-3,-3,-4,-3,0,15.0,4.0,11.0,10
8162,8162,1994-95,1994,1995,Leicester,Newcastle,Loss,Home,1994-08-21,0,0,0,0,0,3,6,9,12,-3,-6,-9,-12,1,21.0,3.0,18.0,1
8163,8163,1994-95,1994,1995,Leicester,Blackburn,Loss,Away,1994-08-23,0,0,0,0,0,2,2,5,6,-2,-2,-5,-6,0,21.0,2.0,19.0,1
8164,8164,1994-95,1994,1995,Leicester,Nott'm Forest,Loss,Away,1994-08-27,0,0,0,0,0,4,4,4,4,-4,-4,-4,-4,0,21.0,21.0,0.0,1
8165,8165,1994-95,1994,1995,Leicester,QPR,Draw,Home,1994-08-31,1,0,0,0,0,3,3,6,7,-3,-3,-6,-7,1,21.0,9.0,12.0,1
8166,8166,1994-95,1994,1995,Leicester,Wimbledon,Loss,Away,1994-09-10,0,1,1,1,1,0,1,2,2,1,0,-1,-1,0,21.0,6.0,15.0,2
8167,8167,1994-95,1994,1995,Leicester,Tottenham,Win,Home,1994-09-17,3,1,1,1,1,3,3,6,9,-2,-2,-5,-8,1,21.0,15.0,6.0,2
8168,8168,1994-95,1994,1995,Leicester,Everton,Draw,Away,1994-09-24,1,3,4,4,4,1,1,1,1,2,3,3,3,0,21.0,17.0,4.0,2
8169,8169,1994-95,1994,1995,Leicester,Coventry,Draw,Home,1994-10-03,1,4,4,5,5,3,4,4,4,1,0,1,1,1,21.0,11.0,10.0,3
8170,8170,1994-95,1994,1995,Leicester,Chelsea,Loss,Away,1994-10-08,0,2,5,5,6,3,3,3,6,-1,2,2,0,0,21.0,14.0,7.0,3
8171,8171,1994-95,1994,1995,Leicester,Southampton,Win,Home,1994-10-15,3,1,2,5,5,6,9,10,13,-5,-7,-5,-8,1,21.0,18.0,3.0,3
8172,8172,1994-95,1994,1995,Leicester,Leeds,Loss,Away,1994-10-24,0,3,4,5,8,1,4,5,5,2,0,0,3,0,21.0,5.0,16.0,3
8173,8173,1994-95,1994,1995,Leicester,Crystal Palace,Loss,Home,1994-10-29,0,3,3,4,5,3,3,6,6,0,0,-2,-1,1,21.0,21.0,0.0,3
8174,8174,1994-95,1994,1995,Leicester,West Ham,Loss,Away,1994-11-05,0,0,3,3,4,0,3,3,6,0,0,0,-2,0,21.0,13.0,8.0,4
8175,8175,1994-95,1994,1995,Leicester,Man City,Loss,Home,1994-11-20,0,0,0,3,3,1,1,4,7,-1,-1,-1,-4,1,21.0,16.0,5.0,4
8176,8176,1994-95,1994,1995,Leicester,Arsenal,Win,Home,1994-11-23,3,0,0,0,3,1,2,5,8,-1,-2,-5,-5,1,21.0,4.0,17.0,4
8177,8177,1994-95,1994,1995,Leicester,Norwich,Loss,Away,1994-11-26,0,3,3,3,3,1,2,2,5,2,1,1,-2,0,21.0,12.0,9.0,4
8178,8178,1994-95,1994,1995,Leicester,Aston Villa,Draw,Home,1994-12-03,1,3,3,3,3,4,4,4,4,-1,-1,-1,-1,1,21.0,10.0,11.0,5
8179,8179,1994-95,1994,1995,Leicester,Newcastle,Loss,Away,1994-12-10,0,1,4,4,4,1,1,2,5,0,3,2,-1,0,21.0,3.0,18.0,5
8180,8180,1994-95,1994,1995,Leicester,Blackburn,Draw,Home,1994-12-17,1,1,1,4,4,6,9,12,15,-5,-8,-8,-11,1,21.0,2.0,19.0,5
8181,8181,1994-95,1994,1995,Leicester,Liverpool,Loss,Home,1994-12-26,0,1,2,2,5,2,3,4,4,-1,-1,-2,1,1,21.0,8.0,13.0,5
8182,8182,1994-95,1994,1995,Leicester,Man United,Draw,Away,1994-12-28,1,1,1,2,2,3,6,9,10,-2,-5,-7,-8,0,21.0,1.0,20.0,5
8183,8183,1994-95,1994,1995,Leicester,Sheffield Weds,Loss,Home,1994-12-31,0,1,2,2,3,6,6,6,9,-5,-4,-4,-6,1,21.0,7.0,14.0,5
8184,8184,1994-95,1994,1995,Leicester,Ipswich,Loss,Away,1995-01-02,0,1,1,2,2,0,1,2,2,1,0,0,0,0,21.0,19.0,2.0,6
8185,8185,1994-95,1994,1995,Leicester,Crystal Palace,Loss,Away,1995-01-14,0,0,1,1,2,0,1,2,2,0,0,-1,0,0,21.0,21.0,0.0,6
8186,8186,1994-95,1994,1995,Leicester,Man City,Win,Away,1995-01-25,3,0,0,1,1,2,3,3,3,-2,-3,-2,-2,0,21.0,16.0,5.0,6
8187,8187,1994-95,1994,1995,Leicester,West Ham,Loss,Home,1995-02-04,0,3,3,3,4,0,0,3,3,3,3,0,1,1,21.0,13.0,8.0,7
8188,8188,1994-95,1994,1995,Leicester,Arsenal,Draw,Away,1995-02-11,1,3,3,3,3,1,4,5,5,2,-1,-2,-2,0,21.0,4.0,17.0,7
8189,8189,1994-95,1994,1995,Leicester,Aston Villa,Draw,Away,1995-02-22,1,1,4,4,4,6,6,9,12,-5,-2,-5,-8,0,21.0,10.0,11.0,7
8190,8190,1994-95,1994,1995,Leicester,Coventry,Loss,Away,1995-02-25,0,2,2,5,5,6,7,8,8,-4,-5,-3,-3,0,21.0,11.0,10.0,7
8191,8191,1994-95,1994,1995,Leicester,Everton,Draw,Home,1995-03-04,1,1,2,2,5,3,4,7,7,-2,-2,-5,-2,1,21.0,17.0,4.0,8
8192,8192,1994-95,1994,1995,Leicester,QPR,Loss,Away,1995-03-08,0,1,2,3,3,4,5,8,8,-3,-3,-5,-5,0,21.0,9.0,12.0,8
8193,8193,1994-95,1994,1995,Leicester,Nott'm Forest,Loss,Home,1995-03-11,0,1,1,2,3,4,5,5,5,-3,-4,-3,-2,1,21.0,21.0,0.0,8
8194,8194,1994-95,1994,1995,Leicester,Leeds,Loss,Home,1995-03-15,0,0,1,1,2,3,4,7,8,-3,-3,-6,-6,1,21.0,5.0,16.0,8
8195,8195,1994-95,1994,1995,Leicester,Tottenham,Loss,Away,1995-03-18,0,0,0,1,1,4,5,5,6,-4,-5,-4,-5,0,21.0,15.0,6.0,8
8196,8196,1994-95,1994,1995,Leicester,Wimbledon,Loss,Home,1995-04-01,0,0,0,0,1,6,9,9,9,-6,-9,-9,-8,1,21.0,6.0,15.0,9
8197,8197,1994-95,1994,1995,Leicester,Norwich,Win,Home,1995-04-05,3,0,0,0,0,3,3,4,5,-3,-3,-4,-5,1,21.0,12.0,9.0,9
8198,8198,1994-95,1994,1995,Leicester,Sheffield Weds,Loss,Away,1995-04-08,0,3,3,3,3,0,0,0,1,3,3,3,2,0,21.0,7.0,14.0,9
8199,8199,1994-95,1994,1995,Leicester,Man United,Loss,Home,1995-04-15,0,3,3,3,3,4,4,5,8,-1,-1,-2,-5,1,21.0,1.0,20.0,9
8200,8200,1994-95,1994,1995,Leicester,Liverpool,Loss,Away,1995-04-17,0,0,3,3,3,3,3,6,7,-3,0,-3,-4,0,21.0,8.0,13.0,9
8201,8201,1994-95,1994,1995,Leicester,Ipswich,Win,Home,1995-04-29,3,0,0,3,3,1,1,1,1,-1,-1,2,2,1,21.0,19.0,2.0,9
8202,8202,1994-95,1994,1995,Leicester,Chelsea,Draw,Home,1995-05-06,1,3,3,3,6,4,5,8,8,-1,-2,-5,-2,1,21.0,14.0,7.0,10
8203,8203,1994-95,1994,1995,Leicester,Southampton,Draw,Away,1995-05-14,1,4,4,4,4,1,4,5,8,3,0,-1,-4,0,21.0,18.0,3.0,10
8204,8204,1996-97,1996,1997,Leicester,Sunderland,Draw,Away,1996-08-17,1,2,5,5,5,0,0,0,0,2,5,5,5,0,21.0,21.0,0.0,1
8205,8205,1996-97,1996,1997,Leicester,Southampton,Win,Home,1996-08-21,3,2,3,6,6,2,5,5,8,0,-2,1,-2,1,21.0,17.0,4.0,1
8206,8206,1996-97,1996,1997,Leicester,Arsenal,Loss,Home,1996-08-24,0,4,5,6,9,3,6,7,8,1,-1,-1,1,1,21.0,5.0,16.0,1
8207,8207,1996-97,1996,1997,Leicester,Sheffield Weds,Loss,Away,1996-09-02,0,3,4,5,6,6,9,10,10,-3,-5,-5,-4,0,21.0,15.0,6.0,2
8208,8208,1996-97,1996,1997,Leicester,Nott'm Forest,Draw,Away,1996-09-07,1,0,3,4,5,2,2,5,8,-2,1,-1,-3,0,21.0,9.0,12.0,2
8209,8209,1996-97,1996,1997,Leicester,Liverpool,Loss,Home,1996-09-15,0,1,1,4,5,6,7,10,11,-5,-6,-6,-6,1,21.0,3.0,18.0,2
8210,8210,1996-97,1996,1997,Leicester,Tottenham,Win,Away,1996-09-22,3,1,1,1,4,3,3,4,5,-2,-2,-3,-1,0,21.0,8.0,13.0,2
8211,8211,1996-97,1996,1997,Leicester,Leeds,Win,Home,1996-09-28,3,3,4,4,4,0,0,3,6,3,4,1,-2,1,21.0,13.0,8.0,2
8212,8212,1996-97,1996,1997,Leicester,Chelsea,Loss,Home,1996-10-12,0,6,6,7,7,1,2,5,6,5,4,2,1,1,21.0,11.0,10.0,3
8213,8213,1996-97,1996,1997,Leicester,West Ham,Loss,Away,1996-10-19,0,3,6,6,7,0,3,3,4,3,3,3,3,0,21.0,10.0,11.0,3
8214,8214,1996-97,1996,1997,Leicester,Newcastle,Win,Home,1996-10-26,3,0,3,6,6,6,9,12,15,-6,-6,-6,-9,1,21.0,2.0,19.0,3
8215,8215,1996-97,1996,1997,Leicester,Derby,Loss,Away,1996-11-02,0,3,3,6,9,1,1,1,2,2,2,5,7,0,21.0,21.0,0.0,4
8216,8216,1996-97,1996,1997,Leicester,Aston Villa,Win,Away,1996-11-16,3,3,3,3,6,3,6,6,6,0,-3,-3,0,0,21.0,4.0,17.0,4
8217,8217,1996-97,1996,1997,Leicester,Everton,Loss,Home,1996-11-23,0,3,6,6,6,4,5,8,11,-1,1,-2,-5,1,21.0,6.0,15.0,4
8218,8218,1996-97,1996,1997,Leicester,Man United,Loss,Away,1996-11-30,0,3,3,6,6,4,4,4,4,-1,-1,2,2,0,21.0,1.0,20.0,4
8219,8219,1996-97,1996,1997,Leicester,Middlesbrough,Win,Away,1996-12-03,3,0,3,3,6,1,1,1,2,-1,2,2,4,0,21.0,12.0,9.0,5
8220,8220,1996-97,1996,1997,Leicester,Blackburn,Draw,Home,1996-12-07,1,3,3,6,6,4,5,8,8,-1,-2,-2,-2,1,21.0,7.0,14.0,5
8221,8221,1996-97,1996,1997,Leicester,Coventry,Loss,Home,1996-12-21,0,4,4,4,7,3,3,3,4,1,1,1,3,1,21.0,16.0,5.0,5
8222,8222,1996-97,1996,1997,Leicester,Liverpool,Draw,Away,1996-12-26,1,1,4,4,4,4,7,7,10,-3,-3,-3,-6,0,21.0,3.0,18.0,5
8223,8223,1996-97,1996,1997,Leicester,Nott'm Forest,Draw,Home,1996-12-28,1,1,2,5,5,3,3,4,4,-2,-1,1,1,1,21.0,9.0,12.0,5
8224,8224,1996-97,1996,1997,Leicester,Leeds,Loss,Away,1997-01-11,0,2,2,3,6,0,0,1,2,2,2,2,4,0,21.0,13.0,8.0,6
8225,8225,1996-97,1996,1997,Leicester,Wimbledon,Win,Home,1997-01-18,3,1,2,2,3,4,4,7,10,-3,-2,-5,-7,1,21.0,14.0,7.0,6
8226,8226,1996-97,1996,1997,Leicester,Sunderland,Draw,Home,1997-01-29,1,3,4,5,5,4,5,5,8,-1,-1,0,-3,1,21.0,21.0,0.0,6
8227,8227,1996-97,1996,1997,Leicester,Newcastle,Loss,Away,1997-02-02,0,4,4,5,6,4,5,8,11,0,-1,-3,-5,0,21.0,2.0,19.0,7
8228,8228,1996-97,1996,1997,Leicester,Derby,Win,Home,1997-02-22,3,1,4,4,5,4,4,5,5,-3,0,-1,0,1,21.0,21.0,0.0,7
8229,8229,1996-97,1996,1997,Leicester,Wimbledon,Win,Away,1997-03-01,3,3,4,7,7,4,5,5,5,-1,-1,2,2,0,21.0,14.0,7.0,8
8230,8230,1996-97,1996,1997,Leicester,Aston Villa,Win,Home,1997-03-05,3,6,6,7,10,4,7,10,10,2,-1,-3,0,1,21.0,4.0,17.0,8
8231,8231,1996-97,1996,1997,Leicester,Coventry,Draw,Away,1997-03-08,1,6,9,9,10,1,2,2,3,5,7,7,7,0,21.0,16.0,5.0,8
8232,8232,1996-97,1996,1997,Leicester,Middlesbrough,Loss,Home,1997-03-15,0,4,7,10,10,3,3,4,7,1,4,6,3,1,21.0,12.0,9.0,8
8233,8233,1996-97,1996,1997,Leicester,Tottenham,Draw,Home,1997-03-19,1,1,4,7,10,6,6,6,7,-5,-2,1,3,1,21.0,8.0,13.0,8
8234,8234,1996-97,1996,1997,Leicester,Southampton,Draw,Away,1997-03-22,1,1,2,5,8,0,1,2,5,1,1,3,3,0,21.0,17.0,4.0,8
8235,8235,1996-97,1996,1997,Leicester,Everton,Draw,Away,1997-04-09,1,2,2,3,6,0,3,3,4,2,-1,0,2,0,21.0,6.0,15.0,9
8236,8236,1996-97,1996,1997,Leicester,Arsenal,Loss,Away,1997-04-12,0,2,3,3,4,3,6,9,12,-1,-3,-6,-8,0,21.0,5.0,16.0,9
8237,8237,1996-97,1996,1997,Leicester,Chelsea,Loss,Away,1997-04-19,0,1,2,3,3,0,0,0,3,1,2,3,0,0,21.0,11.0,10.0,9
8238,8238,1996-97,1996,1997,Leicester,West Ham,Loss,Home,1997-04-23,0,0,1,2,3,1,2,5,6,-1,-1,-3,-3,1,21.0,10.0,11.0,9
8239,8239,1996-97,1996,1997,Leicester,Man United,Draw,Home,1997-05-03,1,0,0,1,2,6,6,9,12,-6,-6,-8,-10,1,21.0,1.0,20.0,10
8240,8240,1996-97,1996,1997,Leicester,Sheffield Weds,Win,Home,1997-05-07,3,1,1,1,2,0,3,4,7,1,-2,-3,-5,1,21.0,15.0,6.0,10
8241,8241,1996-97,1996,1997,Leicester,Blackburn,Win,Away,1997-05-11,3,4,4,4,4,1,4,5,5,3,0,-1,-1,0,21.0,7.0,14.0,10
8242,8242,1997-98,1997,1998,Leicester,Aston Villa,Win,Home,1997-08-09,3,6,7,7,7,3,4,5,5,3,3,2,2,1,9.0,5.0,4.0,1
8243,8243,1997-98,1997,1998,Leicester,Liverpool,Win,Away,1997-08-13,3,6,9,10,10,2,2,5,5,4,7,5,5,0,9.0,4.0,5.0,1
8244,8244,1997-98,1997,1998,Leicester,Man United,Draw,Home,1997-08-23,1,6,9,12,13,6,9,10,11,0,0,2,2,1,9.0,1.0,8.0,1
8245,8245,1997-98,1997,1998,Leicester,Arsenal,Draw,Home,1997-08-27,1,4,7,10,13,6,7,10,10,-2,0,0,3,1,9.0,3.0,6.0,1
8246,8246,1997-98,1997,1998,Leicester,Sheffield Weds,Loss,Away,1997-08-30,0,2,5,8,11,1,1,1,2,1,4,7,9,0,9.0,7.0,2.0,1
8247,8247,1997-98,1997,1998,Leicester,Tottenham,Win,Home,1997-09-13,3,1,2,5,8,4,7,7,7,-3,-5,-2,1,1,9.0,10.0,-1.0,2
8248,8248,1997-98,1997,1998,Leicester,Leeds,Win,Away,1997-09-20,3,3,4,5,8,3,3,3,6,0,1,2,2,0,9.0,11.0,-2.0,2
8249,8249,1997-98,1997,1998,Leicester,Blackburn,Draw,Home,1997-09-24,1,6,6,7,8,1,4,7,8,5,2,0,0,1,9.0,13.0,-4.0,2
8250,8250,1997-98,1997,1998,Leicester,Barnsley,Win,Away,1997-09-27,3,4,7,7,8,0,0,0,3,4,7,7,5,0,9.0,21.0,-12.0,2
8251,8251,1997-98,1997,1998,Leicester,Derby,Loss,Home,1997-10-06,0,4,7,10,10,6,6,9,12,-2,1,1,-2,1,9.0,12.0,-3.0,3
8252,8252,1997-98,1997,1998,Leicester,Chelsea,Loss,Away,1997-10-18,0,3,4,7,10,3,4,4,7,0,0,3,3,0,9.0,6.0,3.0,3
8253,8253,1997-98,1997,1998,Leicester,West Ham,Win,Home,1997-10-27,3,0,3,4,7,3,6,6,6,-3,-3,-2,1,1,9.0,14.0,-5.0,3
8254,8254,1997-98,1997,1998,Leicester,Newcastle,Draw,Away,1997-11-01,1,3,3,6,7,1,4,4,7,2,-1,2,0,0,9.0,2.0,7.0,4
8255,8255,1997-98,1997,1998,Leicester,Wimbledon,Loss,Home,1997-11-10,0,4,4,4,7,3,4,7,7,1,0,-3,0,1,9.0,8.0,1.0,4
8256,8256,1997-98,1997,1998,Leicester,Bolton,Draw,Home,1997-11-22,1,1,4,4,4,1,4,4,4,0,0,0,0,1,9.0,21.0,-12.0,4
8257,8257,1997-98,1997,1998,Leicester,Coventry,Win,Away,1997-11-29,3,1,2,5,5,1,4,5,5,0,-2,0,0,0,9.0,17.0,-8.0,4
8258,8258,1997-98,1997,1998,Leicester,Crystal Palace,Draw,Home,1997-12-06,1,4,4,5,8,0,3,4,7,4,1,1,1,1,9.0,21.0,-12.0,5
8259,8259,1997-98,1997,1998,Leicester,Southampton,Loss,Away,1997-12-13,0,4,5,5,6,0,0,3,6,4,5,2,0,0,9.0,16.0,-7.0,5
8260,8260,1997-98,1997,1998,Leicester,Everton,Loss,Home,1997-12-20,0,1,4,5,5,2,2,2,2,-1,2,3,3,1,9.0,15.0,-6.0,5
8261,8261,1997-98,1997,1998,Leicester,Arsenal,Loss,Away,1997-12-26,0,0,1,4,5,3,3,3,6,-3,-2,1,-1,0,9.0,3.0,6.0,5
8262,8262,1997-98,1997,1998,Leicester,Sheffield Weds,Draw,Home,1997-12-28,1,0,0,1,4,1,1,4,7,-1,-1,-3,-3,1,9.0,7.0,2.0,5
8263,8263,1997-98,1997,1998,Leicester,Aston Villa,Draw,Away,1998-01-10,1,1,1,1,2,4,5,5,8,-3,-4,-4,-6,0,9.0,5.0,4.0,6
8264,8264,1997-98,1997,1998,Leicester,Liverpool,Draw,Home,1998-01-17,1,2,2,2,2,6,9,12,15,-4,-7,-10,-13,1,9.0,4.0,5.0,6
8265,8265,1997-98,1997,1998,Leicester,Man United,Win,Away,1998-01-31,3,2,3,3,3,3,3,6,9,-1,0,-3,-6,0,9.0,1.0,8.0,6
8266,8266,1997-98,1997,1998,Leicester,Leeds,Win,Home,1998-02-07,3,4,5,6,6,3,3,4,4,1,2,2,2,1,9.0,11.0,-2.0,7
8267,8267,1997-98,1997,1998,Leicester,Tottenham,Draw,Away,1998-02-14,1,6,7,8,9,3,6,6,7,3,1,2,2,0,9.0,10.0,-1.0,7
8268,8268,1997-98,1997,1998,Leicester,Chelsea,Win,Home,1998-02-21,3,4,7,8,9,3,3,6,6,1,4,2,3,1,9.0,6.0,3.0,7
8269,8269,1997-98,1997,1998,Leicester,Blackburn,Loss,Away,1998-02-28,0,4,7,10,11,0,1,4,4,4,6,6,7,0,9.0,13.0,-4.0,7
8270,8270,1997-98,1997,1998,Leicester,Wimbledon,Loss,Away,1998-03-14,0,3,4,7,10,0,3,6,7,3,1,1,3,0,9.0,8.0,1.0,8
8271,8271,1997-98,1997,1998,Leicester,Bolton,Loss,Away,1998-03-28,0,0,3,4,7,3,3,4,5,-3,0,0,2,0,9.0,21.0,-12.0,8
8272,8272,1997-98,1997,1998,Leicester,Coventry,Draw,Home,1998-04-04,1,0,0,3,4,4,7,10,13,-4,-7,-7,-9,1,9.0,17.0,-8.0,9
8273,8273,1997-98,1997,1998,Leicester,Crystal Palace,Win,Away,1998-04-11,3,1,1,1,4,3,3,3,3,-2,-2,-2,1,0,9.0,21.0,-12.0,9
8274,8274,1997-98,1997,1998,Leicester,Southampton,Draw,Home,1998-04-14,1,4,4,4,4,0,3,3,6,4,1,1,-2,1,9.0,16.0,-7.0,9
8275,8275,1997-98,1997,1998,Leicester,Everton,Draw,Away,1998-04-18,1,4,5,5,5,4,5,5,8,0,0,0,-3,0,9.0,15.0,-6.0,9
8276,8276,1997-98,1997,1998,Leicester,Derby,Win,Away,1998-04-26,3,2,5,6,6,3,4,4,4,-1,1,2,2,0,9.0,12.0,-3.0,9
8277,8277,1997-98,1997,1998,Leicester,Newcastle,Draw,Home,1998-04-29,1,4,5,8,9,1,4,4,5,3,1,4,4,1,9.0,2.0,7.0,9
8278,8278,1997-98,1997,1998,Leicester,Barnsley,Win,Home,1998-05-02,3,4,5,6,9,1,1,4,4,3,4,2,5,1,9.0,21.0,-12.0,10
8279,8279,1997-98,1997,1998,Leicester,West Ham,Loss,Away,1998-05-10,0,4,7,8,9,1,1,4,5,3,6,4,4,0,9.0,14.0,-5.0,10
8280,8280,1998-99,1998,1999,Leicester,Man United,Draw,Away,1998-08-15,1,3,4,7,8,6,9,10,11,-3,-5,-3,-3,0,10.0,2.0,8.0,1
8281,8281,1998-99,1998,1999,Leicester,Everton,Win,Home,1998-08-22,3,1,4,5,8,2,2,2,3,-1,2,3,5,1,10.0,17.0,-7.0,1
8282,8282,1998-99,1998,1999,Leicester,Blackburn,Loss,Away,1998-08-29,0,4,4,7,8,1,4,4,7,3,0,3,1,0,10.0,6.0,4.0,1
8283,8283,1998-99,1998,1999,Leicester,Middlesbrough,Loss,Home,1998-09-09,0,3,4,4,7,1,2,3,4,2,2,1,3,1,10.0,21.0,-11.0,2
8284,8284,1998-99,1998,1999,Leicester,Arsenal,Draw,Home,1998-09-12,1,0,3,4,4,2,3,6,6,-2,0,-2,-2,1,10.0,1.0,9.0,2
8285,8285,1998-99,1998,1999,Leicester,Derby,Loss,Away,1998-09-19,0,1,1,4,5,6,7,8,9,-5,-6,-4,-4,0,10.0,9.0,1.0,2
8286,8286,1998-99,1998,1999,Leicester,Wimbledon,Draw,Home,1998-09-27,1,1,1,1,4,3,6,7,8,-2,-5,-6,-4,1,10.0,15.0,-5.0,2
8287,8287,1998-99,1998,1999,Leicester,Leeds,Win,Away,1998-10-03,3,1,2,2,2,2,3,6,7,-1,-1,-4,-5,0,10.0,5.0,5.0,3
8288,8288,1998-99,1998,1999,Leicester,Tottenham,Win,Home,1998-10-19,3,4,4,5,5,4,5,5,8,0,-1,0,-3,1,10.0,14.0,-4.0,3
8289,8289,1998-99,1998,1999,Leicester,Aston Villa,Draw,Away,1998-10-24,1,6,7,7,8,4,7,8,11,2,0,-1,-3,0,10.0,7.0,3.0,3
8290,8290,1998-99,1998,1999,Leicester,Liverpool,Win,Home,1998-10-31,3,4,7,8,8,4,5,5,6,0,2,3,2,1,10.0,3.0,7.0,3
8291,8291,1998-99,1998,1999,Leicester,Charlton,Draw,Away,1998-11-07,1,4,7,10,11,4,4,7,8,0,3,3,3,0,10.0,21.0,-11.0,4
8292,8292,1998-99,1998,1999,Leicester,West Ham,Loss,Away,1998-11-14,0,4,5,8,11,4,4,5,5,0,1,3,6,0,10.0,8.0,2.0,4
8293,8293,1998-99,1998,1999,Leicester,Chelsea,Loss,Home,1998-11-21,0,1,4,5,8,4,5,8,9,-3,-1,-3,-1,1,10.0,4.0,6.0,4
8294,8294,1998-99,1998,1999,Leicester,Coventry,Draw,Away,1998-11-28,1,0,1,4,5,3,6,6,6,-3,-5,-2,-1,0,10.0,11.0,-1.0,4
8295,8295,1998-99,1998,1999,Leicester,Southampton,Win,Home,1998-12-05,3,1,1,2,5,3,3,4,5,-2,-2,-2,0,1,10.0,12.0,-2.0,5
8296,8296,1998-99,1998,1999,Leicester,Nott'm Forest,Win,Home,1998-12-12,3,4,4,4,5,1,1,2,2,3,3,2,3,1,10.0,21.0,-11.0,5
8297,8297,1998-99,1998,1999,Leicester,Newcastle,Loss,Away,1998-12-19,0,6,7,7,7,2,5,5,6,4,2,2,1,0,10.0,13.0,-3.0,5
8298,8298,1998-99,1998,1999,Leicester,Sheffield Weds,Win,Away,1998-12-26,3,3,6,7,7,3,6,7,10,0,0,0,-3,0,10.0,16.0,-6.0,5
8299,8299,1998-99,1998,1999,Leicester,Blackburn,Draw,Home,1998-12-28,1,3,6,9,10,4,5,8,8,-1,1,1,2,1,10.0,6.0,4.0,5
8300,8300,1998-99,1998,1999,Leicester,Everton,Draw,Away,1999-01-09,1,4,4,7,10,1,1,4,5,3,3,3,5,0,10.0,17.0,-7.0,6
8301,8301,1998-99,1998,1999,Leicester,Man United,Loss,Home,1999-01-16,0,2,5,5,8,4,7,7,8,-2,-2,-2,0,1,10.0,2.0,8.0,6
8302,8302,1998-99,1998,1999,Leicester,Middlesbrough,Draw,Away,1999-01-30,1,1,2,5,5,1,1,1,4,0,1,4,1,0,10.0,21.0,-11.0,6
8303,8303,1998-99,1998,1999,Leicester,Sheffield Weds,Loss,Home,1999-02-06,0,1,2,3,6,3,4,4,4,-2,-2,-1,2,1,10.0,16.0,-6.0,7
8304,8304,1998-99,1998,1999,Leicester,Arsenal,Loss,Away,1999-02-20,0,1,1,2,3,4,7,10,11,-3,-6,-8,-8,0,10.0,1.0,9.0,7
8305,8305,1998-99,1998,1999,Leicester,Leeds,Loss,Home,1999-03-01,0,0,1,1,2,6,6,6,9,-6,-5,-5,-7,1,10.0,5.0,5.0,8
8306,8306,1998-99,1998,1999,Leicester,Wimbledon,Win,Away,1999-03-06,3,0,0,1,1,4,5,5,6,-4,-5,-4,-5,0,10.0,15.0,-5.0,8
8307,8307,1998-99,1998,1999,Leicester,Charlton,Draw,Home,1999-03-13,1,3,3,3,4,1,4,7,10,2,-1,-4,-6,1,10.0,21.0,-11.0,8
8308,8308,1998-99,1998,1999,Leicester,Tottenham,Win,Away,1999-04-03,3,4,4,4,4,3,6,7,8,1,-2,-3,-4,0,10.0,14.0,-4.0,9
8309,8309,1998-99,1998,1999,Leicester,Aston Villa,Draw,Home,1999-04-06,1,4,7,7,7,1,1,1,1,3,6,6,6,1,10.0,7.0,3.0,9
8310,8310,1998-99,1998,1999,Leicester,West Ham,Draw,Home,1999-04-10,1,4,5,8,8,1,4,7,7,3,1,1,1,1,10.0,8.0,2.0,9
8311,8311,1998-99,1998,1999,Leicester,Chelsea,Draw,Away,1999-04-18,1,2,5,6,9,4,7,10,10,-2,-2,-4,-1,0,10.0,4.0,6.0,9
8312,8312,1998-99,1998,1999,Leicester,Liverpool,Win,Away,1999-04-21,3,2,3,6,7,1,2,5,5,1,1,1,2,0,10.0,3.0,7.0,9
8313,8313,1998-99,1998,1999,Leicester,Coventry,Win,Home,1999-04-24,3,4,5,6,9,0,3,6,6,4,2,0,3,1,10.0,11.0,-1.0,9
8314,8314,1998-99,1998,1999,Leicester,Southampton,Loss,Away,1999-05-01,0,6,7,8,9,2,2,2,3,4,5,6,6,0,10.0,12.0,-2.0,10
8315,8315,1998-99,1998,1999,Leicester,Derby,Loss,Home,1999-05-05,0,3,6,7,8,1,1,4,4,2,5,3,4,1,10.0,9.0,1.0,10
8316,8316,1998-99,1998,1999,Leicester,Newcastle,Win,Home,1999-05-08,3,0,3,6,7,2,3,3,4,-2,0,3,3,1,10.0,13.0,-3.0,10
8317,8317,1998-99,1998,1999,Leicester,Nott'm Forest,Loss,Away,1999-05-16,0,3,3,6,9,6,6,6,6,-3,-3,0,3,0,10.0,21.0,-11.0,10
8318,8318,1999-00,1999,2000,Leicester,Arsenal,Loss,Away,1999-08-07,0,3,3,3,6,3,6,9,12,0,-3,-6,-6,0,10.0,2.0,8.0,1
8319,8319,1999-00,1999,2000,Leicester,Coventry,Win,Home,1999-08-11,3,0,3,3,3,1,2,5,5,-1,1,-2,-2,1,10.0,15.0,-5.0,1
8320,8320,1999-00,1999,2000,Leicester,Chelsea,Draw,Home,1999-08-14,1,3,3,6,6,6,7,10,13,-3,-4,-4,-7,1,10.0,3.0,7.0,1
8321,8321,1999-00,1999,2000,Leicester,West Ham,Loss,Away,1999-08-21,0,4,4,4,7,4,7,7,7,0,-3,-3,0,0,10.0,5.0,5.0,1
8322,8322,1999-00,1999,2000,Leicester,Middlesbrough,Win,Away,1999-08-24,3,1,4,4,4,6,9,9,9,-5,-5,-5,-5,0,10.0,9.0,1.0,1
8323,8323,1999-00,1999,2000,Leicester,Watford,Win,Home,1999-08-30,3,3,4,7,7,3,6,6,6,0,-2,1,1,1,10.0,21.0,-11.0,1
8324,8324,1999-00,1999,2000,Leicester,Sunderland,Loss,Away,1999-09-11,0,6,6,7,10,4,4,5,8,2,2,2,2,0,10.0,21.0,-11.0,2
8325,8325,1999-00,1999,2000,Leicester,Liverpool,Draw,Home,1999-09-18,1,3,6,6,7,3,6,6,6,0,0,0,1,1,10.0,7.0,3.0,2
8326,8326,1999-00,1999,2000,Leicester,Aston Villa,Win,Home,1999-09-25,3,1,4,7,7,3,6,9,9,-2,-2,-2,-2,1,10.0,6.0,4.0,2
8327,8327,1999-00,1999,2000,Leicester,Tottenham,Win,Away,1999-10-03,3,4,4,7,10,4,5,5,8,0,-1,2,2,0,10.0,11.0,-1.0,3
8328,8328,1999-00,1999,2000,Leicester,Southampton,Win,Home,1999-10-16,3,6,7,7,10,2,2,2,5,4,5,5,5,1,10.0,17.0,-7.0,3
8329,8329,1999-00,1999,2000,Leicester,Bradford,Loss,Away,1999-10-23,0,6,9,10,10,0,3,3,4,6,6,7,6,0,10.0,21.0,-11.0,3
8330,8330,1999-00,1999,2000,Leicester,Sheffield Weds,Win,Home,1999-10-30,3,3,6,9,10,1,4,4,4,2,2,5,6,1,10.0,12.0,-2.0,3
8331,8331,1999-00,1999,2000,Leicester,Man United,Loss,Away,1999-11-06,0,3,6,9,12,3,6,6,7,0,0,3,5,0,10.0,1.0,9.0,4
8332,8332,1999-00,1999,2000,Leicester,Wimbledon,Win,Home,1999-11-20,3,3,3,6,9,4,5,8,8,-1,-2,-2,1,1,10.0,16.0,-6.0,4
8333,8333,1999-00,1999,2000,Leicester,Coventry,Win,Away,1999-11-27,3,3,6,6,9,4,7,8,11,-1,-1,-2,-2,0,10.0,15.0,-5.0,4
8334,8334,1999-00,1999,2000,Leicester,Arsenal,Loss,Home,1999-12-04,0,6,6,9,9,6,6,7,10,0,0,2,-1,1,10.0,2.0,8.0,5
8335,8335,1999-00,1999,2000,Leicester,Derby,Loss,Home,1999-12-18,0,3,6,6,9,0,0,0,3,3,6,6,6,1,10.0,8.0,2.0,5
8336,8336,1999-00,1999,2000,Leicester,Leeds,Loss,Away,1999-12-26,0,0,3,6,6,6,9,12,12,-6,-6,-6,-6,0,10.0,4.0,6.0,5
8337,8337,1999-00,1999,2000,Leicester,Newcastle,Loss,Home,1999-12-28,0,0,0,3,6,1,4,7,8,-1,-4,-4,-2,1,10.0,13.0,-3.0,5
8338,8338,1999-00,1999,2000,Leicester,Everton,Draw,Away,2000-01-03,1,0,0,0,3,4,7,7,8,-4,-7,-7,-5,0,10.0,14.0,-4.0,6
8339,8339,1999-00,1999,2000,Leicester,Chelsea,Draw,Away,2000-01-15,1,1,1,1,1,4,5,8,11,-3,-4,-7,-10,0,10.0,3.0,7.0,6
8340,8340,1999-00,1999,2000,Leicester,West Ham,Loss,Home,2000-01-22,0,2,2,2,2,2,3,4,4,0,-1,-2,-2,1,10.0,5.0,5.0,6
8341,8341,1999-00,1999,2000,Leicester,Middlesbrough,Win,Home,2000-02-05,3,1,2,2,2,1,1,1,4,0,1,1,-2,1,10.0,9.0,1.0,7
8342,8342,1999-00,1999,2000,Leicester,Watford,Draw,Away,2000-02-12,1,3,4,5,5,0,0,0,3,3,4,5,2,0,10.0,21.0,-11.0,7
8343,8343,1999-00,1999,2000,Leicester,Sunderland,Win,Home,2000-03-05,3,4,4,5,6,1,2,2,2,3,2,3,4,1,10.0,21.0,-11.0,8
8344,8344,1999-00,1999,2000,Leicester,Wimbledon,Loss,Away,2000-03-11,0,4,7,7,8,1,1,1,4,3,6,6,4,0,10.0,16.0,-6.0,8
8345,8345,1999-00,1999,2000,Leicester,Man United,Loss,Home,2000-03-18,0,3,4,7,7,4,5,8,8,-1,-1,-1,-1,1,10.0,1.0,9.0,8
8346,8346,1999-00,1999,2000,Leicester,Leeds,Win,Home,2000-03-26,3,0,3,4,7,6,9,10,10,-6,-6,-6,-3,1,10.0,4.0,6.0,8
8347,8347,1999-00,1999,2000,Leicester,Derby,Loss,Away,2000-04-02,0,3,3,6,7,0,0,3,4,3,3,3,3,0,10.0,8.0,2.0,9
8348,8348,1999-00,1999,2000,Leicester,Everton,Draw,Home,2000-04-08,1,3,3,3,6,3,3,3,4,0,0,0,2,1,10.0,14.0,-4.0,9
8349,8349,1999-00,1999,2000,Leicester,Newcastle,Win,Away,2000-04-15,3,1,4,4,4,3,3,6,9,-2,1,-2,-5,0,10.0,13.0,-3.0,9
8350,8350,1999-00,1999,2000,Leicester,Tottenham,Loss,Home,2000-04-19,0,4,4,7,7,0,0,1,1,4,4,6,6,1,10.0,11.0,-1.0,9
8351,8351,1999-00,1999,2000,Leicester,Aston Villa,Draw,Away,2000-04-22,1,3,4,4,7,6,9,12,12,-3,-5,-8,-5,0,10.0,6.0,4.0,9
8352,8352,1999-00,1999,2000,Leicester,Southampton,Win,Away,2000-04-29,3,1,4,5,5,0,3,6,6,1,1,-1,-1,0,10.0,17.0,-7.0,9
8353,8353,1999-00,1999,2000,Leicester,Liverpool,Win,Away,2000-05-03,3,4,4,7,8,1,4,7,10,3,0,0,-2,0,10.0,7.0,3.0,10
8354,8354,1999-00,1999,2000,Leicester,Bradford,Win,Home,2000-05-06,3,6,7,7,10,6,7,7,7,0,0,0,3,1,10.0,21.0,-11.0,10
8355,8355,1999-00,1999,2000,Leicester,Sheffield Weds,Loss,Away,2000-05-14,0,6,9,10,10,1,1,1,4,5,8,9,6,0,10.0,12.0,-2.0,10
8356,8356,2000-01,2000,2001,Leicester,Aston Villa,Draw,Home,2000-08-19,1,3,6,9,10,1,2,3,6,2,4,6,4,1,8.0,6.0,2.0,1
8357,8357,2000-01,2000,2001,Leicester,West Ham,Win,Away,2000-08-23,3,1,4,7,10,1,1,1,1,0,3,6,9,0,8.0,9.0,-1.0,1
8358,8358,2000-01,2000,2001,Leicester,Bradford,Draw,Away,2000-08-26,1,4,4,7,10,3,6,6,9,1,-2,1,1,0,8.0,17.0,-9.0,1
8359,8359,2000-01,2000,2001,Leicester,Ipswich,Win,Home,2000-09-06,3,4,5,5,8,4,4,4,4,0,1,1,4,1,8.0,21.0,-13.0,2
8360,8360,2000-01,2000,2001,Leicester,Southampton,Win,Home,2000-09-09,3,4,7,8,8,2,2,3,6,2,5,5,2,1,8.0,15.0,-7.0,2
8361,8361,2000-01,2000,2001,Leicester,Chelsea,Win,Away,2000-09-17,3,6,7,10,11,2,3,3,6,4,4,7,5,0,8.0,5.0,3.0,2
8362,8362,2000-01,2000,2001,Leicester,Everton,Draw,Home,2000-09-24,1,6,9,10,13,3,3,4,7,3,6,6,6,1,8.0,13.0,-5.0,2
8363,8363,2000-01,2000,2001,Leicester,Sunderland,Draw,Away,2000-10-01,1,4,7,10,11,4,4,5,5,0,3,5,6,0,8.0,7.0,1.0,3
8364,8364,2000-01,2000,2001,Leicester,Man United,Loss,Home,2000-10-14,0,2,5,8,11,1,4,7,10,1,1,1,1,1,8.0,1.0,7.0,3
8365,8365,2000-01,2000,2001,Leicester,Liverpool,Loss,Away,2000-10-21,0,1,2,5,8,3,4,5,8,-2,-2,0,0,0,8.0,4.0,4.0,3
8366,8366,2000-01,2000,2001,Leicester,Derby,Win,Home,2000-10-28,3,0,1,2,5,0,0,1,1,0,1,1,4,1,8.0,16.0,-8.0,3
8367,8367,2000-01,2000,2001,Leicester,Man City,Win,Away,2000-11-04,3,3,3,4,5,3,6,6,7,0,-3,-2,-2,0,8.0,21.0,-13.0,4
8368,8368,2000-01,2000,2001,Leicester,Newcastle,Draw,Home,2000-11-11,1,6,6,6,7,3,3,6,9,3,3,0,-2,1,8.0,11.0,-3.0,4
8369,8369,2000-01,2000,2001,Leicester,Middlesbrough,Win,Away,2000-11-18,3,4,7,7,7,0,0,0,0,4,7,7,7,0,8.0,12.0,-4.0,4
8370,8370,2000-01,2000,2001,Leicester,Tottenham,Loss,Away,2000-11-25,0,4,7,10,10,3,6,6,9,1,1,4,1,0,8.0,10.0,-2.0,4
8371,8371,2000-01,2000,2001,Leicester,Leeds,Win,Home,2000-12-02,3,3,4,7,10,3,4,7,8,0,0,0,2,1,8.0,3.0,5.0,5
8372,8372,2000-01,2000,2001,Leicester,Coventry,Loss,Away,2000-12-10,0,3,6,7,10,1,1,1,1,2,5,6,9,0,8.0,14.0,-6.0,5
8373,8373,2000-01,2000,2001,Leicester,Charlton,Win,Home,2000-12-16,3,3,3,6,7,1,1,4,4,2,2,2,3,1,8.0,21.0,-13.0,5
8374,8374,2000-01,2000,2001,Leicester,West Ham,Win,Home,2000-12-23,3,3,6,6,9,2,5,8,11,1,1,-2,-2,1,8.0,9.0,-1.0,5
8375,8375,2000-01,2000,2001,Leicester,Arsenal,Loss,Away,2000-12-26,0,6,6,9,9,1,4,7,7,5,2,2,2,0,8.0,2.0,6.0,5
8376,8376,2000-01,2000,2001,Leicester,Bradford,Loss,Home,2001-01-01,0,3,6,6,9,0,0,1,4,3,6,5,5,1,8.0,17.0,-9.0,6
8377,8377,2000-01,2000,2001,Leicester,Ipswich,Loss,Away,2001-01-14,0,0,3,6,6,3,4,4,7,-3,-1,2,-1,0,8.0,21.0,-13.0,6
8378,8378,2000-01,2000,2001,Leicester,Arsenal,Draw,Home,2001-01-20,1,0,0,3,6,1,2,5,5,-1,-2,-2,1,1,8.0,2.0,6.0,6
8379,8379,2000-01,2000,2001,Leicester,Southampton,Loss,Away,2001-01-31,0,1,1,1,4,2,2,5,8,-1,-1,-4,-4,0,8.0,15.0,-7.0,6
8380,8380,2000-01,2000,2001,Leicester,Chelsea,Win,Home,2001-02-03,3,1,1,1,1,6,7,10,11,-5,-6,-9,-10,1,8.0,5.0,3.0,7
8381,8381,2000-01,2000,2001,Leicester,Everton,Loss,Away,2001-02-10,0,3,4,4,4,1,2,5,6,2,2,-1,-2,0,8.0,13.0,-5.0,7
8382,8382,2000-01,2000,2001,Leicester,Sunderland,Win,Home,2001-02-24,3,3,3,4,4,1,1,2,5,2,2,2,-1,1,8.0,7.0,1.0,7
8383,8383,2000-01,2000,2001,Leicester,Liverpool,Win,Home,2001-03-03,3,3,6,6,7,4,5,6,9,-1,1,0,-2,1,8.0,4.0,4.0,8
8384,8384,2000-01,2000,2001,Leicester,Man United,Loss,Away,2001-03-17,0,6,6,9,9,4,5,8,11,2,1,1,-2,0,8.0,1.0,7.0,8
8385,8385,2000-01,2000,2001,Leicester,Charlton,Loss,Away,2001-04-01,0,3,6,6,9,1,2,5,6,2,4,1,3,0,8.0,21.0,-13.0,9
8386,8386,2000-01,2000,2001,Leicester,Aston Villa,Loss,Away,2001-04-04,0,0,3,6,6,4,7,8,8,-4,-4,-2,-2,0,8.0,6.0,2.0,9
8387,8387,2000-01,2000,2001,Leicester,Coventry,Loss,Home,2001-04-07,0,0,0,3,6,3,4,5,6,-3,-4,-2,0,1,8.0,14.0,-6.0,9
8388,8388,2000-01,2000,2001,Leicester,Man City,Loss,Home,2001-04-14,0,0,0,0,3,0,0,1,1,0,0,-1,2,1,8.0,21.0,-13.0,9
8389,8389,2000-01,2000,2001,Leicester,Derby,Loss,Away,2001-04-16,0,0,0,0,0,0,0,1,4,0,0,-1,-4,0,8.0,16.0,-8.0,9
8390,8390,2000-01,2000,2001,Leicester,Middlesbrough,Loss,Home,2001-04-21,0,0,0,0,0,3,4,4,7,-3,-4,-4,-7,1,8.0,12.0,-4.0,9
8391,8391,2000-01,2000,2001,Leicester,Newcastle,Loss,Away,2001-04-28,0,0,0,0,0,4,4,5,5,-4,-4,-5,-5,0,8.0,11.0,-3.0,9
8392,8392,2000-01,2000,2001,Leicester,Tottenham,Win,Home,2001-05-05,3,0,0,0,0,1,1,4,7,-1,-1,-4,-7,1,8.0,10.0,-2.0,10
8393,8393,2000-01,2000,2001,Leicester,Leeds,Loss,Away,2001-05-19,0,3,3,3,3,3,6,9,12,0,-3,-6,-9,0,8.0,3.0,5.0,10
8394,8394,2001-02,2001,2002,Leicester,Bolton,Loss,Home,2001-08-18,0,3,3,3,3,3,6,6,6,0,-3,-3,-3,1,13.0,21.0,-8.0,1
8395,8395,2001-02,2001,2002,Leicester,Arsenal,Loss,Away,2001-08-25,0,0,3,3,3,3,3,4,7,-3,0,-1,-4,0,13.0,2.0,11.0,1
8396,8396,2001-02,2001,2002,Leicester,Ipswich,Draw,Home,2001-09-08,1,0,0,3,3,3,3,4,7,-3,-3,-1,-4,1,13.0,5.0,8.0,2
8397,8397,2001-02,2001,2002,Leicester,Derby,Win,Away,2001-09-15,3,1,1,1,4,2,2,5,6,-1,-1,-4,-2,0,13.0,17.0,-4.0,2
8398,8398,2001-02,2001,2002,Leicester,Middlesbrough,Loss,Home,2001-09-17,0,4,4,4,4,3,3,3,3,1,1,1,1,1,13.0,14.0,-1.0,2
8399,8399,2001-02,2001,2002,Leicester,Fulham,Draw,Home,2001-09-22,1,3,4,4,4,1,2,5,5,2,2,-1,-1,1,13.0,21.0,-8.0,2
8400,8400,2001-02,2001,2002,Leicester,Newcastle,Loss,Away,2001-09-26,0,1,4,5,5,3,6,7,8,-2,-2,-2,-3,0,13.0,11.0,2.0,2
8401,8401,2001-02,2001,2002,Leicester,Charlton,Loss,Away,2001-09-29,0,1,1,4,5,1,2,5,5,0,-1,-1,0,0,13.0,9.0,4.0,2
8402,8402,2001-02,2001,2002,Leicester,Chelsea,Loss,Away,2001-10-13,0,0,1,1,4,2,5,6,9,-2,-4,-5,-5,0,13.0,6.0,7.0,3
8403,8403,2001-02,2001,2002,Leicester,Liverpool,Loss,Home,2001-10-20,0,0,0,1,1,4,7,10,10,-4,-7,-9,-9,1,13.0,3.0,10.0,3
8404,8404,2001-02,2001,2002,Leicester,Blackburn,Draw,Away,2001-10-29,1,0,0,0,1,4,4,7,8,-4,-4,-7,-7,0,13.0,21.0,-8.0,3
8405,8405,2001-02,2001,2002,Leicester,Sunderland,Win,Home,2001-11-03,3,1,1,1,1,1,1,4,5,0,0,-3,-4,1,13.0,7.0,6.0,4
8406,8406,2001-02,2001,2002,Leicester,Man United,Loss,Away,2001-11-17,0,4,4,4,4,1,1,4,7,3,3,0,-3,0,13.0,1.0,12.0,4
8407,8407,2001-02,2001,2002,Leicester,Everton,Draw,Home,2001-11-24,1,3,4,4,4,2,2,5,6,1,2,-1,-2,1,13.0,16.0,-3.0,4
8408,8408,2001-02,2001,2002,Leicester,Aston Villa,Win,Away,2001-12-01,3,1,4,5,5,2,2,5,8,-1,2,0,-3,0,13.0,8.0,5.0,5
8409,8409,2001-02,2001,2002,Leicester,Southampton,Loss,Home,2001-12-08,0,4,4,7,8,3,3,3,3,1,1,4,5,1,13.0,10.0,3.0,5
8410,8410,2001-02,2001,2002,Leicester,Leeds,Draw,Away,2001-12-16,1,3,4,4,7,4,5,5,8,-1,-1,-1,-1,0,13.0,4.0,9.0,5
8411,8411,2001-02,2001,2002,Leicester,West Ham,Draw,Home,2001-12-22,1,1,4,5,5,4,5,5,5,-3,-1,0,0,1,13.0,15.0,-2.0,5
8412,8412,2001-02,2001,2002,Leicester,Ipswich,Loss,Away,2001-12-26,0,2,2,5,6,3,3,3,4,-1,-1,2,2,0,13.0,5.0,8.0,5
8413,8413,2001-02,2001,2002,Leicester,Bolton,Draw,Away,2001-12-29,1,1,2,2,5,0,1,1,1,1,1,1,4,0,13.0,21.0,-8.0,5
8414,8414,2001-02,2001,2002,Leicester,West Ham,Loss,Away,2002-01-12,0,1,2,3,3,1,4,5,6,0,-2,-2,-3,0,13.0,15.0,-2.0,6
8415,8415,2001-02,2001,2002,Leicester,Newcastle,Draw,Home,2002-01-19,1,1,1,2,3,3,3,6,9,-2,-2,-4,-6,1,13.0,11.0,2.0,6
8416,8416,2001-02,2001,2002,Leicester,Arsenal,Loss,Home,2002-01-23,0,1,2,2,3,2,5,8,11,-1,-3,-6,-8,1,13.0,2.0,11.0,6
8417,8417,2001-02,2001,2002,Leicester,Liverpool,Loss,Away,2002-01-30,0,1,1,2,2,4,5,5,6,-3,-4,-3,-4,0,13.0,3.0,10.0,6
8418,8418,2001-02,2001,2002,Leicester,Chelsea,Loss,Home,2002-02-02,0,0,1,1,2,6,7,7,10,-6,-6,-6,-8,1,13.0,6.0,7.0,7
8419,8419,2001-02,2001,2002,Leicester,Tottenham,Loss,Away,2002-02-09,0,0,0,1,1,0,1,1,4,0,-1,0,-3,0,13.0,12.0,1.0,7
8420,8420,2001-02,2001,2002,Leicester,Derby,Loss,Home,2002-02-23,0,0,0,0,1,3,3,3,3,-3,-3,-3,-2,1,13.0,17.0,-4.0,7
8421,8421,2001-02,2001,2002,Leicester,Middlesbrough,Loss,Away,2002-03-02,0,0,0,0,0,3,4,5,8,-3,-4,-5,-8,0,13.0,14.0,-1.0,8
8422,8422,2001-02,2001,2002,Leicester,Charlton,Draw,Home,2002-03-09,1,0,0,0,0,4,4,5,8,-4,-4,-5,-8,1,13.0,9.0,4.0,8
8423,8423,2001-02,2001,2002,Leicester,Southampton,Draw,Away,2002-03-16,1,1,1,1,1,4,5,5,6,-3,-4,-4,-5,0,13.0,10.0,3.0,8
8424,8424,2001-02,2001,2002,Leicester,Leeds,Loss,Home,2002-03-23,0,2,2,2,2,6,7,8,9,-4,-5,-6,-7,1,13.0,4.0,9.0,8
8425,8425,2001-02,2001,2002,Leicester,Blackburn,Win,Home,2002-03-30,3,1,2,2,2,3,6,7,7,-2,-4,-5,-5,1,13.0,21.0,-8.0,8
8426,8426,2001-02,2001,2002,Leicester,Sunderland,Loss,Away,2002-04-01,0,3,4,5,5,1,1,4,4,2,3,1,1,0,13.0,7.0,6.0,9
8427,8427,2001-02,2001,2002,Leicester,Man United,Loss,Home,2002-04-06,0,3,3,4,5,3,6,9,10,0,-3,-5,-5,1,13.0,1.0,12.0,9
8428,8428,2001-02,2001,2002,Leicester,Everton,Draw,Away,2002-04-13,1,0,3,3,4,3,3,6,9,-3,0,-3,-5,0,13.0,16.0,-3.0,9
8429,8429,2001-02,2001,2002,Leicester,Aston Villa,Draw,Home,2002-04-20,1,1,1,4,4,0,1,1,2,1,0,3,2,1,13.0,8.0,5.0,9
8430,8430,2001-02,2001,2002,Leicester,Fulham,Draw,Away,2002-04-27,1,2,2,2,5,6,7,7,8,-4,-5,-5,-3,0,13.0,21.0,-8.0,9
8431,8431,2001-02,2001,2002,Leicester,Tottenham,Win,Home,2002-05-11,3,2,3,3,3,4,5,5,8,-2,-2,-2,-5,1,13.0,12.0,1.0,10
8432,8432,2003-04,2003,2004,Leicester,Southampton,Draw,Home,2003-08-16,1,4,5,6,6,3,4,4,4,1,1,2,2,1,21.0,8.0,13.0,1
8433,8433,2003-04,2003,2004,Leicester,Chelsea,Loss,Away,2003-08-23,0,4,5,6,7,6,6,7,10,-2,-1,-1,-3,0,21.0,4.0,17.0,1
8434,8434,2003-04,2003,2004,Leicester,Middlesbrough,Draw,Home,2003-08-26,1,1,4,5,6,0,0,0,0,1,4,5,6,1,21.0,11.0,10.0,1
8435,8435,2003-04,2003,2004,Leicester,Aston Villa,Loss,Away,2003-08-30,0,1,2,5,6,1,1,1,4,0,1,4,2,0,21.0,16.0,5.0,1
8436,8436,2003-04,2003,2004,Leicester,Leeds,Win,Home,2003-09-15,3,1,1,2,5,4,4,5,8,-3,-3,-3,-3,1,21.0,15.0,6.0,2
8437,8437,2003-04,2003,2004,Leicester,Liverpool,Loss,Away,2003-09-20,0,3,4,4,5,6,7,8,8,-3,-3,-4,-3,0,21.0,5.0,16.0,2
8438,8438,2003-04,2003,2004,Leicester,Man United,Loss,Home,2003-09-27,0,3,3,4,4,4,4,7,10,-1,-1,-3,-6,1,21.0,1.0,20.0,2
8439,8439,2003-04,2003,2004,Leicester,Fulham,Loss,Away,2003-10-04,0,0,3,3,4,4,5,8,8,-4,-2,-5,-4,0,21.0,14.0,7.0,3
8440,8440,2003-04,2003,2004,Leicester,Tottenham,Loss,Home,2003-10-19,0,0,0,3,3,4,4,4,4,-4,-4,-1,-1,1,21.0,10.0,11.0,3
8441,8441,2003-04,2003,2004,Leicester,Wolves,Loss,Away,2003-10-25,0,0,0,0,3,4,5,5,5,-4,-5,-5,-2,0,21.0,21.0,0.0,3
8442,8442,2003-04,2003,2004,Leicester,Blackburn,Win,Home,2003-11-02,3,0,0,0,0,0,0,0,3,0,0,0,-3,1,21.0,6.0,15.0,4
8443,8443,2003-04,2003,2004,Leicester,Man City,Win,Away,2003-11-09,3,3,3,3,3,3,6,6,7,0,-3,-3,-4,0,21.0,9.0,12.0,4
8444,8444,2003-04,2003,2004,Leicester,Charlton,Draw,Home,2003-11-22,1,6,6,6,6,6,7,10,13,0,-1,-4,-7,1,21.0,12.0,9.0,4
8445,8445,2003-04,2003,2004,Leicester,Portsmouth,Win,Away,2003-11-29,3,4,7,7,7,3,3,3,6,1,4,4,1,0,21.0,21.0,0.0,4
8446,8446,2003-04,2003,2004,Leicester,Arsenal,Draw,Home,2003-12-06,1,4,7,10,10,4,7,10,11,0,0,0,-1,1,21.0,2.0,19.0,5
8447,8447,2003-04,2003,2004,Leicester,Birmingham,Loss,Home,2003-12-13,0,4,5,8,11,0,0,1,1,4,5,7,10,1,21.0,13.0,8.0,5
8448,8448,2003-04,2003,2004,Leicester,Everton,Loss,Away,2003-12-20,0,1,4,5,8,4,4,7,7,-3,0,-2,1,0,21.0,7.0,14.0,5
8449,8449,2003-04,2003,2004,Leicester,Newcastle,Draw,Home,2003-12-26,1,0,1,4,5,4,5,6,9,-4,-4,-2,-4,1,21.0,3.0,18.0,5
8450,8450,2003-04,2003,2004,Leicester,Bolton,Draw,Away,2003-12-28,1,1,1,2,5,1,4,4,7,0,-3,-2,-2,0,21.0,17.0,4.0,5
8451,8451,2003-04,2003,2004,Leicester,Southampton,Draw,Away,2004-01-07,1,2,2,2,3,0,3,6,9,2,-1,-4,-6,0,21.0,8.0,13.0,6
8452,8452,2003-04,2003,2004,Leicester,Chelsea,Loss,Home,2004-01-11,0,2,3,3,3,3,3,6,6,-1,0,-3,-3,1,21.0,4.0,17.0,6
8453,8453,2003-04,2003,2004,Leicester,Middlesbrough,Draw,Away,2004-01-17,1,1,2,3,3,3,3,4,5,-2,-1,-1,-2,0,21.0,11.0,10.0,6
8454,8454,2003-04,2003,2004,Leicester,Aston Villa,Loss,Home,2004-01-31,0,1,2,3,4,0,3,6,7,1,-1,-3,-3,1,21.0,16.0,5.0,6
8455,8455,2003-04,2003,2004,Leicester,Newcastle,Loss,Away,2004-02-07,0,1,1,2,3,4,5,8,8,-3,-4,-6,-5,0,21.0,3.0,18.0,7
8456,8456,2003-04,2003,2004,Leicester,Bolton,Draw,Home,2004-02-10,1,0,1,1,2,4,7,10,10,-4,-6,-9,-8,1,21.0,17.0,4.0,7
8457,8457,2003-04,2003,2004,Leicester,Tottenham,Draw,Away,2004-02-22,1,1,1,2,2,6,6,9,12,-5,-5,-7,-10,0,21.0,10.0,11.0,7
8458,8458,2003-04,2003,2004,Leicester,Wolves,Draw,Home,2004-02-28,1,2,2,2,3,3,3,4,5,-1,-1,-2,-2,1,21.0,21.0,0.0,7
8459,8459,2003-04,2003,2004,Leicester,Birmingham,Win,Away,2004-03-13,3,2,3,3,3,6,7,10,11,-4,-4,-7,-8,0,21.0,13.0,8.0,8
8460,8460,2003-04,2003,2004,Leicester,Everton,Draw,Home,2004-03-20,1,4,5,6,6,6,7,7,7,-2,-2,-1,-1,1,21.0,7.0,14.0,8
8461,8461,2003-04,2003,2004,Leicester,Liverpool,Draw,Home,2004-03-28,1,4,5,6,7,6,6,7,10,-2,-1,-1,-3,1,21.0,5.0,16.0,8
8462,8462,2003-04,2003,2004,Leicester,Leeds,Loss,Away,2004-04-05,0,2,5,6,7,3,3,4,5,-1,2,2,2,0,21.0,15.0,6.0,9
8463,8463,2003-04,2003,2004,Leicester,Fulham,Loss,Home,2004-04-10,0,1,2,5,6,2,2,5,6,-1,0,0,0,1,21.0,14.0,7.0,9
8464,8464,2003-04,2003,2004,Leicester,Man United,Loss,Away,2004-04-13,0,0,1,2,5,4,7,7,8,-4,-6,-5,-3,0,21.0,1.0,20.0,9
8465,8465,2003-04,2003,2004,Leicester,Blackburn,Loss,Away,2004-04-17,0,0,0,1,2,3,3,3,6,-3,-3,-2,-4,0,21.0,6.0,15.0,9
8466,8466,2003-04,2003,2004,Leicester,Man City,Draw,Home,2004-04-24,1,0,0,0,1,1,2,3,4,-1,-2,-3,-3,1,21.0,9.0,12.0,9
8467,8467,2003-04,2003,2004,Leicester,Charlton,Draw,Away,2004-05-01,1,1,1,1,1,0,1,4,5,1,0,-3,-4,0,21.0,12.0,9.0,10
8468,8468,2003-04,2003,2004,Leicester,Portsmouth,Win,Home,2004-05-08,3,2,2,2,2,2,5,8,11,0,-3,-6,-9,1,21.0,21.0,0.0,10
8469,8469,2003-04,2003,2004,Leicester,Arsenal,Loss,Away,2004-05-15,0,4,5,5,5,4,5,6,9,0,0,-1,-4,0,21.0,2.0,19.0,10
8470,8470,2014-15,2014,2015,Leicester,Everton,Draw,Home,2014-08-16,1,3,4,5,5,3,3,6,6,0,1,-1,-1,1,21.0,5.0,16.0,1
8471,8471,2014-15,2014,2015,Leicester,Chelsea,Loss,Away,2014-08-23,0,1,4,5,6,6,7,10,10,-5,-3,-5,-4,0,21.0,3.0,18.0,1
8472,8472,2014-15,2014,2015,Leicester,Arsenal,Draw,Home,2014-08-31,1,1,1,4,5,4,7,10,13,-3,-6,-6,-8,1,21.0,4.0,17.0,1
8473,8473,2014-15,2014,2015,Leicester,Stoke,Win,Away,2014-09-13,3,1,2,2,5,4,4,7,10,-3,-2,-5,-5,0,21.0,9.0,12.0,2
8474,8474,2014-15,2014,2015,Leicester,Man United,Win,Home,2014-09-21,3,4,4,5,5,4,5,5,6,0,-1,0,-1,1,21.0,7.0,14.0,2
8475,8475,2014-15,2014,2015,Leicester,Crystal Palace,Loss,Away,2014-09-27,0,6,7,7,8,4,5,5,5,2,2,2,3,0,21.0,11.0,10.0,2
8476,8476,2014-15,2014,2015,Leicester,Burnley,Draw,Home,2014-10-04,1,3,6,7,7,1,2,3,3,2,4,4,4,1,21.0,21.0,0.0,3
8477,8477,2014-15,2014,2015,Leicester,Newcastle,Loss,Away,2014-10-18,0,1,4,7,8,1,2,2,3,0,2,5,5,0,21.0,10.0,11.0,3
8478,8478,2014-15,2014,2015,Leicester,Swansea,Loss,Away,2014-10-25,0,1,1,4,7,1,2,2,2,0,-1,2,5,0,21.0,12.0,9.0,3
8479,8479,2014-15,2014,2015,Leicester,West Brom,Loss,Home,2014-11-01,0,0,1,1,4,2,2,5,8,-2,-1,-4,-4,1,21.0,17.0,4.0,4
8480,8480,2014-15,2014,2015,Leicester,Southampton,Loss,Away,2014-11-08,0,0,0,1,1,6,9,9,12,-6,-9,-8,-11,0,21.0,8.0,13.0,4
8481,8481,2014-15,2014,2015,Leicester,Sunderland,Draw,Home,2014-11-22,1,0,0,0,1,4,4,4,7,-4,-4,-4,-6,1,21.0,14.0,7.0,4
8482,8482,2014-15,2014,2015,Leicester,QPR,Loss,Away,2014-11-29,0,1,1,1,1,1,1,4,4,0,0,-3,-3,0,21.0,21.0,0.0,4
8483,8483,2014-15,2014,2015,Leicester,Liverpool,Loss,Home,2014-12-02,0,1,1,1,1,3,3,3,4,-2,-2,-2,-3,1,21.0,2.0,19.0,5
8484,8484,2014-15,2014,2015,Leicester,Aston Villa,Loss,Away,2014-12-07,0,0,1,1,1,4,5,6,6,-4,-4,-5,-5,0,21.0,15.0,6.0,5
8485,8485,2014-15,2014,2015,Leicester,Man City,Loss,Home,2014-12-13,0,0,0,1,1,6,9,12,13,-6,-9,-11,-12,1,21.0,1.0,20.0,5
8486,8486,2014-15,2014,2015,Leicester,West Ham,Loss,Away,2014-12-20,0,0,0,0,1,4,7,10,10,-4,-7,-10,-9,0,21.0,13.0,8.0,5
8487,8487,2014-15,2014,2015,Leicester,Tottenham,Loss,Home,2014-12-26,0,0,0,0,0,6,7,7,10,-6,-7,-7,-10,1,21.0,6.0,15.0,5
8488,8488,2014-15,2014,2015,Leicester,Hull,Win,Away,2014-12-28,3,0,0,0,0,3,3,4,5,-3,-3,-4,-5,0,21.0,16.0,5.0,5
8489,8489,2014-15,2014,2015,Leicester,Liverpool,Draw,Away,2015-01-01,1,3,3,3,3,6,7,7,8,-3,-4,-4,-5,0,21.0,2.0,19.0,6
8490,8490,2014-15,2014,2015,Leicester,Aston Villa,Win,Home,2015-01-10,3,4,4,4,4,2,2,3,3,2,2,1,1,1,21.0,15.0,6.0,6
8491,8491,2014-15,2014,2015,Leicester,Stoke,Loss,Home,2015-01-17,0,4,7,7,7,1,4,7,7,3,3,0,0,1,21.0,9.0,12.0,6
8492,8492,2014-15,2014,2015,Leicester,Man United,Loss,Away,2015-01-31,0,3,4,7,7,3,4,5,8,0,0,2,-1,0,21.0,7.0,14.0,6
8493,8493,2014-15,2014,2015,Leicester,Crystal Palace,Loss,Home,2015-02-07,0,0,3,4,7,3,6,7,8,-3,-3,-3,-1,1,21.0,11.0,10.0,7
8494,8494,2014-15,2014,2015,Leicester,Arsenal,Loss,Away,2015-02-10,0,0,0,3,4,3,6,9,9,-3,-6,-6,-5,0,21.0,4.0,17.0,7
8495,8495,2014-15,2014,2015,Leicester,Everton,Draw,Away,2015-02-22,1,0,0,0,3,1,4,5,6,-1,-4,-5,-3,0,21.0,5.0,16.0,7
8496,8496,2014-15,2014,2015,Leicester,Man City,Loss,Away,2015-03-04,0,1,1,1,1,3,6,7,8,-2,-5,-6,-7,0,21.0,1.0,20.0,8
8497,8497,2014-15,2014,2015,Leicester,Hull,Draw,Home,2015-03-14,1,1,1,1,1,1,4,7,8,0,-3,-6,-7,1,21.0,16.0,5.0,8
8498,8498,2014-15,2014,2015,Leicester,Tottenham,Loss,Away,2015-03-21,0,1,2,2,2,3,6,7,7,-2,-4,-5,-5,0,21.0,6.0,15.0,8
8499,8499,2014-15,2014,2015,Leicester,West Ham,Win,Home,2015-04-04,3,1,1,2,2,3,3,3,4,-2,-2,-1,-2,1,21.0,13.0,8.0,9
8500,8500,2014-15,2014,2015,Leicester,West Brom,Win,Away,2015-04-11,3,3,4,4,5,0,3,3,6,3,1,1,-1,0,21.0,17.0,4.0,9
8501,8501,2014-15,2014,2015,Leicester,Swansea,Win,Home,2015-04-18,3,6,6,7,7,4,7,7,7,2,-1,0,0,1,21.0,12.0,9.0,9
8502,8502,2014-15,2014,2015,Leicester,Burnley,Win,Away,2015-04-25,3,6,9,9,10,0,1,1,4,6,8,8,6,0,21.0,21.0,0.0,9
8503,8503,2014-15,2014,2015,Leicester,Chelsea,Loss,Home,2015-04-29,0,6,9,12,12,4,7,10,13,2,2,2,-1,1,21.0,3.0,18.0,9
8504,8504,2014-15,2014,2015,Leicester,Newcastle,Win,Home,2015-05-02,3,3,6,9,12,0,0,0,0,3,6,9,12,1,21.0,10.0,11.0,10
8505,8505,2014-15,2014,2015,Leicester,Southampton,Win,Home,2015-05-09,3,3,6,9,12,1,1,4,4,2,5,5,8,1,21.0,8.0,13.0,10
8506,8506,2014-15,2014,2015,Leicester,Sunderland,Draw,Away,2015-05-16,1,6,6,9,12,6,7,7,10,0,-1,2,2,0,21.0,14.0,7.0,10
8507,8507,2014-15,2014,2015,Leicester,QPR,Win,Home,2015-05-24,3,4,7,7,10,3,3,4,4,1,4,3,6,1,21.0,21.0,0.0,10
8508,8508,2015-16,2015,2016,Leicester,Sunderland,Win,Home,2015-08-08,3,4,7,10,10,1,2,5,8,3,5,5,2,1,14.0,16.0,-2.0,1
8509,8509,2015-16,2015,2016,Leicester,West Ham,Win,Away,2015-08-15,3,6,7,10,13,3,3,3,6,3,4,7,7,0,14.0,12.0,2.0,1
8510,8510,2015-16,2015,2016,Leicester,Tottenham,Draw,Home,2015-08-22,1,6,9,10,13,1,4,7,7,5,5,3,6,1,14.0,5.0,9.0,1
8511,8511,2015-16,2015,2016,Leicester,Bournemouth,Draw,Away,2015-08-29,1,4,7,10,11,3,3,3,3,1,4,7,8,0,14.0,21.0,-7.0,1
8512,8512,2015-16,2015,2016,Leicester,Aston Villa,Win,Home,2015-09-13,3,2,5,8,11,1,1,4,4,1,4,4,7,1,14.0,17.0,-3.0,2
8513,8513,2015-16,2015,2016,Leicester,Stoke,Draw,Away,2015-09-19,1,4,5,8,11,0,1,2,2,4,4,6,9,0,14.0,9.0,5.0,2
8514,8514,2015-16,2015,2016,Leicester,Arsenal,Loss,Home,2015-09-26,0,4,5,6,9,3,6,7,10,1,-1,-1,-1,1,14.0,3.0,11.0,2
8515,8515,2015-16,2015,2016,Leicester,Norwich,Win,Away,2015-10-03,3,1,4,5,6,2,5,5,6,-1,-1,0,0,0,14.0,21.0,-7.0,3
8516,8516,2015-16,2015,2016,Leicester,Southampton,Draw,Away,2015-10-17,1,3,4,7,8,6,6,7,10,-3,-2,0,-2,0,14.0,7.0,7.0,3
8517,8517,2015-16,2015,2016,Leicester,Crystal Palace,Win,Home,2015-10-24,3,4,4,5,8,3,6,6,6,1,-2,-1,2,1,14.0,10.0,4.0,3
8518,8518,2015-16,2015,2016,Leicester,West Brom,Win,Away,2015-10-31,3,4,7,7,8,6,6,6,9,-2,1,1,-1,0,14.0,13.0,1.0,3
8519,8519,2015-16,2015,2016,Leicester,Watford,Win,Home,2015-11-07,3,6,7,10,10,6,6,7,7,0,1,3,3,1,14.0,21.0,-7.0,4
8520,8520,2015-16,2015,2016,Leicester,Newcastle,Win,Away,2015-11-21,3,6,9,10,13,4,4,7,7,2,5,3,6,0,14.0,15.0,-1.0,4
8521,8521,2015-16,2015,2016,Leicester,Man United,Draw,Home,2015-11-28,1,6,9,12,13,6,7,8,11,0,2,4,2,1,14.0,4.0,10.0,4
8522,8522,2015-16,2015,2016,Leicester,Swansea,Win,Away,2015-12-05,3,4,7,10,13,1,1,1,4,3,6,9,9,0,14.0,8.0,6.0,5
8523,8523,2015-16,2015,2016,Leicester,Chelsea,Win,Home,2015-12-14,3,4,7,10,13,1,4,4,4,3,3,6,9,1,14.0,1.0,13.0,5
8524,8524,2015-16,2015,2016,Leicester,Everton,Win,Away,2015-12-19,3,6,7,10,13,2,3,6,7,4,4,4,6,0,14.0,11.0,3.0,5
8525,8525,2015-16,2015,2016,Leicester,Liverpool,Loss,Away,2015-12-26,0,6,9,10,13,1,1,4,7,5,8,6,6,0,14.0,6.0,8.0,5
8526,8526,2015-16,2015,2016,Leicester,Man City,Draw,Home,2015-12-29,1,3,6,9,10,3,6,6,9,0,0,3,1,1,14.0,2.0,12.0,5
8527,8527,2015-16,2015,2016,Leicester,Bournemouth,Draw,Home,2016-01-02,1,1,4,7,10,1,4,7,10,0,0,0,0,1,14.0,21.0,-7.0,6
8528,8528,2015-16,2015,2016,Leicester,Tottenham,Win,Away,2016-01-13,3,2,2,5,8,4,7,10,10,-2,-5,-5,-2,0,14.0,5.0,9.0,6
8529,8529,2015-16,2015,2016,Leicester,Aston Villa,Draw,Away,2016-01-16,1,4,5,5,8,3,3,4,5,1,2,1,3,0,14.0,17.0,-3.0,6
8530,8530,2015-16,2015,2016,Leicester,Stoke,Win,Home,2016-01-23,3,4,5,6,6,4,4,7,10,0,1,-1,-4,1,14.0,9.0,5.0,6
8531,8531,2015-16,2015,2016,Leicester,Liverpool,Win,Home,2016-02-02,3,4,7,8,9,3,4,4,7,1,3,4,2,1,14.0,6.0,8.0,7
8532,8532,2015-16,2015,2016,Leicester,Man City,Win,Away,2016-02-06,3,6,7,10,11,4,7,8,11,2,0,2,0,0,14.0,2.0,12.0,7
8533,8533,2015-16,2015,2016,Leicester,Arsenal,Loss,Away,2016-02-14,0,6,9,10,13,4,4,5,6,2,5,5,7,0,14.0,3.0,11.0,7
8534,8534,2015-16,2015,2016,Leicester,Norwich,Win,Home,2016-02-27,3,3,6,9,10,1,1,1,1,2,5,8,9,1,14.0,21.0,-7.0,7
8535,8535,2015-16,2015,2016,Leicester,West Brom,Draw,Home,2016-03-01,1,3,6,9,12,6,6,7,8,-3,0,2,4,1,14.0,13.0,1.0,8
8536,8536,2015-16,2015,2016,Leicester,Watford,Win,Away,2016-03-05,3,4,4,7,10,1,4,4,5,3,0,3,5,0,14.0,21.0,-7.0,8
8537,8537,2015-16,2015,2016,Leicester,Newcastle,Win,Home,2016-03-14,3,4,7,7,10,0,0,3,3,4,7,4,7,1,14.0,15.0,-1.0,8
8538,8538,2015-16,2015,2016,Leicester,Crystal Palace,Win,Away,2016-03-19,3,6,7,10,10,1,1,1,2,5,6,9,8,0,14.0,10.0,4.0,8
8539,8539,2015-16,2015,2016,Leicester,Southampton,Win,Home,2016-04-03,3,6,9,10,13,6,7,7,7,0,2,3,6,1,14.0,7.0,7.0,9
8540,8540,2015-16,2015,2016,Leicester,Sunderland,Win,Away,2016-04-10,3,6,9,12,13,2,3,4,4,4,6,8,9,0,14.0,16.0,-2.0,9
8541,8541,2015-16,2015,2016,Leicester,West Ham,Draw,Home,2016-04-17,1,6,9,12,15,2,3,6,9,4,6,6,6,1,14.0,12.0,2.0,9
8542,8542,2015-16,2015,2016,Leicester,Swansea,Win,Home,2016-04-24,3,4,7,10,13,3,4,7,7,1,3,3,6,1,14.0,8.0,6.0,9
8543,8543,2015-16,2015,2016,Leicester,Man United,Draw,Away,2016-05-01,1,4,7,10,13,6,6,9,12,-2,1,1,1,0,14.0,4.0,10.0,10
8544,8544,2015-16,2015,2016,Leicester,Everton,Win,Home,2016-05-07,3,4,5,8,11,3,4,5,6,1,1,3,5,1,14.0,11.0,3.0,10
8545,8545,2015-16,2015,2016,Leicester,Chelsea,Draw,Away,2016-05-15,1,4,7,8,11,1,2,5,5,3,5,3,6,0,14.0,1.0,13.0,10
8546,8546,2016-17,2016,2017,Leicester,Hull,Loss,Away,2016-08-13,0,4,5,8,9,1,1,1,4,3,4,7,5,0,1.0,21.0,-20.0,1
8547,8547,2016-17,2016,2017,Leicester,Arsenal,Draw,Home,2016-08-20,1,1,4,5,8,3,4,7,8,-2,0,-2,0,1,1.0,2.0,-1.0,1
8548,8548,2016-17,2016,2017,Leicester,Swansea,Win,Home,2016-08-27,3,1,2,5,6,3,4,7,10,-2,-2,-2,-4,1,1.0,12.0,-11.0,1
8549,8549,2016-17,2016,2017,Leicester,Liverpool,Loss,Away,2016-09-10,0,4,4,5,8,1,4,5,6,3,0,0,2,0,1.0,8.0,-7.0,2
8550,8550,2016-17,2016,2017,Leicester,Burnley,Win,Home,2016-09-17,3,3,4,4,5,1,4,4,7,2,0,0,-2,1,1.0,21.0,-20.0,2
8551,8551,2016-17,2016,2017,Leicester,Man United,Loss,Away,2016-09-24,0,3,6,7,7,0,3,6,9,3,3,1,-2,0,1.0,5.0,-4.0,2
8552,8552,2016-17,2016,2017,Leicester,Southampton,Draw,Home,2016-10-02,1,3,3,6,7,6,6,7,7,-3,-3,-1,0,1,1.0,6.0,-5.0,3
8553,8553,2016-17,2016,2017,Leicester,Chelsea,Loss,Away,2016-10-15,0,1,4,4,7,3,3,4,7,-2,1,0,0,0,1.0,10.0,-9.0,3
8554,8554,2016-17,2016,2017,Leicester,Crystal Palace,Win,Home,2016-10-22,3,1,1,4,4,1,4,7,10,0,-3,-3,-6,1,1.0,15.0,-14.0,3
8555,8555,2016-17,2016,2017,Leicester,Tottenham,Draw,Away,2016-10-29,1,3,4,4,7,2,5,8,11,1,-1,-4,-4,0,1.0,3.0,-2.0,3
8556,8556,2016-17,2016,2017,Leicester,West Brom,Loss,Home,2016-11-06,0,4,4,5,5,0,1,2,3,4,3,3,2,1,1.0,14.0,-13.0,4
8557,8557,2016-17,2016,2017,Leicester,Watford,Loss,Away,2016-11-19,0,1,4,4,5,3,4,7,8,-2,0,-3,-3,0,1.0,13.0,-12.0,4
8558,8558,2016-17,2016,2017,Leicester,Middlesbrough,Draw,Home,2016-11-26,1,0,1,4,4,1,4,5,5,-1,-3,-1,-1,1,1.0,21.0,-20.0,4
8559,8559,2016-17,2016,2017,Leicester,Sunderland,Loss,Away,2016-12-03,0,1,1,2,5,3,6,6,6,-2,-5,-4,-1,0,1.0,17.0,-16.0,5
8560,8560,2016-17,2016,2017,Leicester,Man City,Win,Home,2016-12-10,3,1,1,1,2,3,6,7,10,-2,-5,-6,-8,1,1.0,4.0,-3.0,5
8561,8561,2016-17,2016,2017,Leicester,Bournemouth,Loss,Away,2016-12-13,0,3,4,4,4,3,3,6,6,0,1,-2,-2,0,1.0,16.0,-15.0,5
8562,8562,2016-17,2016,2017,Leicester,Stoke,Draw,Away,2016-12-17,1,3,3,4,4,1,4,7,7,2,-1,-3,-3,0,1.0,9.0,-8.0,5
8563,8563,2016-17,2016,2017,Leicester,Everton,Loss,Home,2016-12-26,0,1,4,4,5,3,3,4,4,-2,1,0,1,1,1.0,11.0,-10.0,5
8564,8564,2016-17,2016,2017,Leicester,West Ham,Win,Home,2016-12-31,3,1,1,4,4,6,9,10,10,-5,-8,-6,-6,1,1.0,7.0,-6.0,5
8565,8565,2016-17,2016,2017,Leicester,Middlesbrough,Draw,Away,2017-01-02,1,3,4,4,7,0,3,3,3,3,1,1,4,0,1.0,21.0,-20.0,6
8566,8566,2016-17,2016,2017,Leicester,Chelsea,Loss,Home,2017-01-14,0,4,4,5,5,3,6,9,12,1,-2,-4,-7,1,1.0,10.0,-9.0,6
8567,8567,2016-17,2016,2017,Leicester,Southampton,Loss,Away,2017-01-22,0,1,4,4,5,0,0,0,3,1,4,4,2,0,1.0,6.0,-5.0,6
8568,8568,2016-17,2016,2017,Leicester,Burnley,Loss,Away,2017-01-31,0,0,1,4,4,3,3,6,9,-3,-2,-2,-5,0,1.0,21.0,-20.0,6
8569,8569,2016-17,2016,2017,Leicester,Man United,Loss,Home,2017-02-05,0,0,0,1,4,2,3,6,9,-2,-3,-5,-5,1,1.0,5.0,-4.0,7
8570,8570,2016-17,2016,2017,Leicester,Swansea,Loss,Away,2017-02-12,0,0,0,0,1,3,6,6,9,-3,-6,-6,-8,0,1.0,12.0,-11.0,7
8571,8571,2016-17,2016,2017,Leicester,Liverpool,Win,Home,2017-02-27,3,0,0,0,0,3,4,4,5,-3,-4,-4,-5,1,1.0,8.0,-7.0,7
8572,8572,2016-17,2016,2017,Leicester,Hull,Win,Home,2017-03-04,3,3,3,3,3,1,4,5,5,2,-1,-2,-2,1,1.0,21.0,-20.0,8
8573,8573,2016-17,2016,2017,Leicester,West Ham,Win,Away,2017-03-18,3,6,6,6,6,0,1,2,5,6,5,4,1,0,1.0,7.0,-6.0,8
8574,8574,2016-17,2016,2017,Leicester,Stoke,Win,Home,2017-04-01,3,6,9,9,9,1,4,4,7,5,5,5,2,1,1.0,9.0,-8.0,9
8575,8575,2016-17,2016,2017,Leicester,Sunderland,Win,Home,2017-04-04,3,6,9,12,12,1,1,1,1,5,8,11,11,1,1.0,17.0,-16.0,9
8576,8576,2016-17,2016,2017,Leicester,Everton,Loss,Away,2017-04-09,0,6,9,12,15,1,4,7,7,5,5,5,8,0,1.0,11.0,-10.0,9
8577,8577,2016-17,2016,2017,Leicester,Crystal Palace,Draw,Away,2017-04-15,1,3,6,9,12,3,6,9,12,0,0,0,0,0,1.0,15.0,-14.0,9
8578,8578,2016-17,2016,2017,Leicester,Arsenal,Loss,Away,2017-04-26,0,1,4,7,10,3,6,7,7,-2,-2,0,3,0,1.0,2.0,-1.0,9
8579,8579,2016-17,2016,2017,Leicester,West Brom,Win,Away,2017-04-29,3,1,1,4,7,0,0,1,4,1,1,3,3,0,1.0,14.0,-13.0,9
8580,8580,2016-17,2016,2017,Leicester,Watford,Win,Home,2017-05-06,3,3,4,4,7,0,3,3,6,3,1,1,1,1,1.0,13.0,-12.0,10
8581,8581,2016-17,2016,2017,Leicester,Man City,Loss,Away,2017-05-13,0,6,6,7,7,4,5,8,11,2,1,-1,-4,0,1.0,4.0,-3.0,10
8582,8582,2016-17,2016,2017,Leicester,Tottenham,Loss,Home,2017-05-18,0,3,6,6,7,3,6,9,12,0,0,-3,-5,1,1.0,3.0,-2.0,10
8583,8583,2016-17,2016,2017,Leicester,Bournemouth,Draw,Home,2017-05-21,1,0,3,6,6,4,7,10,10,-4,-4,-4,-4,1,1.0,16.0,-15.0,10
8584,8584,2017-18,2017,2018,Leicester,Arsenal,Loss,Away,2017-08-11,0,1,1,4,7,6,9,12,15,-5,-8,-8,-8,0,12.0,5.0,7.0,1
8585,8585,2017-18,2017,2018,Leicester,Brighton,Win,Home,2017-08-19,3,1,1,1,4,0,0,0,0,1,1,1,4,1,12.0,21.0,-9.0,1
8586,8586,2017-18,2017,2018,Leicester,Man United,Loss,Away,2017-08-26,0,3,4,4,4,6,9,10,10,-3,-5,-6,-6,0,12.0,6.0,6.0,1
8587,8587,2017-18,2017,2018,Leicester,Chelsea,Loss,Home,2017-09-09,0,3,3,4,4,6,6,9,12,-3,-3,-5,-8,1,12.0,1.0,11.0,2
8588,8588,2017-18,2017,2018,Leicester,Huddersfield,Draw,Away,2017-09-16,1,0,3,3,4,1,4,7,7,-1,-1,-4,-3,0,12.0,21.0,-9.0,2
8589,8589,2017-18,2017,2018,Leicester,Liverpool,Loss,Home,2017-09-23,0,1,1,4,4,1,4,7,8,0,-3,-3,-4,1,12.0,4.0,8.0,2
8590,8590,2017-18,2017,2018,Leicester,Bournemouth,Draw,Away,2017-09-30,1,1,1,1,4,3,3,3,3,-2,-2,-2,1,0,12.0,9.0,3.0,2
8591,8591,2017-18,2017,2018,Leicester,West Brom,Draw,Home,2017-10-16,1,1,2,2,2,1,2,2,3,0,0,0,-1,1,12.0,10.0,2.0,3
8592,8592,2017-18,2017,2018,Leicester,Swansea,Win,Away,2017-10-21,3,2,2,3,3,3,3,4,4,-1,-1,-1,-1,0,12.0,15.0,-3.0,3
8593,8593,2017-18,2017,2018,Leicester,Everton,Win,Home,2017-10-29,3,4,5,5,6,1,1,4,4,3,4,1,2,1,12.0,7.0,5.0,3
8594,8594,2017-18,2017,2018,Leicester,Stoke,Draw,Away,2017-11-04,1,6,7,8,8,3,3,6,6,3,4,2,2,0,12.0,13.0,-1.0,4
8595,8595,2017-18,2017,2018,Leicester,Man City,Loss,Home,2017-11-18,0,4,7,8,9,6,9,12,15,-2,-2,-4,-6,1,12.0,3.0,9.0,4
8596,8596,2017-18,2017,2018,Leicester,West Ham,Draw,Away,2017-11-24,1,1,4,7,8,0,1,1,2,1,3,6,6,0,12.0,11.0,1.0,4
8597,8597,2017-18,2017,2018,Leicester,Tottenham,Win,Home,2017-11-28,3,1,2,5,8,1,4,4,7,0,-2,1,1,1,12.0,2.0,10.0,4
8598,8598,2017-18,2017,2018,Leicester,Burnley,Win,Home,2017-12-02,3,4,4,5,8,3,6,9,12,1,-2,-4,-4,1,12.0,16.0,-4.0,5
8599,8599,2017-18,2017,2018,Leicester,Newcastle,Win,Away,2017-12-09,3,6,7,7,8,1,1,1,1,5,6,6,7,0,12.0,21.0,-9.0,5
8600,8600,2017-18,2017,2018,Leicester,Southampton,Win,Away,2017-12-13,3,6,9,10,10,2,2,5,5,4,7,5,5,0,12.0,8.0,4.0,5
8601,8601,2017-18,2017,2018,Leicester,Crystal Palace,Loss,Home,2017-12-16,0,6,9,12,13,4,5,6,9,2,4,6,4,1,12.0,14.0,-2.0,5
8602,8602,2017-18,2017,2018,Leicester,Man United,Draw,Home,2017-12-23,1,3,6,9,12,6,6,9,12,-3,0,0,0,1,12.0,6.0,6.0,5
8603,8603,2017-18,2017,2018,Leicester,Watford,Loss,Away,2017-12-26,0,1,4,7,10,0,0,0,1,1,4,7,9,0,12.0,17.0,-5.0,5
8604,8604,2017-18,2017,2018,Leicester,Liverpool,Loss,Away,2017-12-30,0,1,1,4,7,4,7,8,9,-3,-6,-4,-2,0,12.0,4.0,8.0,5
8605,8605,2017-18,2017,2018,Leicester,Huddersfield,Win,Home,2018-01-01,3,0,1,1,4,2,3,6,6,-2,-2,-5,-2,1,12.0,21.0,-9.0,6
8606,8606,2017-18,2017,2018,Leicester,Chelsea,Draw,Away,2018-01-13,1,3,3,4,4,4,7,8,11,-1,-4,-4,-7,0,12.0,1.0,11.0,6
8607,8607,2017-18,2017,2018,Leicester,Watford,Win,Home,2018-01-20,3,4,4,4,5,1,1,4,4,3,3,0,1,1,12.0,17.0,-5.0,6
8608,8608,2017-18,2017,2018,Leicester,Everton,Loss,Away,2018-01-31,0,4,7,7,7,1,1,1,2,3,6,6,5,0,12.0,7.0,5.0,6
8609,8609,2017-18,2017,2018,Leicester,Swansea,Draw,Home,2018-02-03,1,3,4,7,7,6,7,7,10,-3,-3,0,-3,1,12.0,15.0,-3.0,7
8610,8610,2017-18,2017,2018,Leicester,Man City,Loss,Away,2018-02-10,0,1,4,5,8,4,7,7,10,-3,-3,-2,-2,0,12.0,3.0,9.0,7
8611,8611,2017-18,2017,2018,Leicester,Stoke,Draw,Home,2018-02-24,1,1,1,4,5,1,2,5,5,0,-1,-1,0,1,12.0,13.0,-1.0,7
8612,8612,2017-18,2017,2018,Leicester,Bournemouth,Draw,Home,2018-03-03,1,1,2,2,5,1,4,7,8,0,-2,-5,-3,1,12.0,9.0,3.0,8
8613,8613,2017-18,2017,2018,Leicester,West Brom,Win,Away,2018-03-10,3,2,2,3,3,0,0,0,0,2,2,3,3,0,12.0,10.0,2.0,8
8614,8614,2017-18,2017,2018,Leicester,Brighton,Win,Away,2018-03-31,3,4,5,5,6,3,6,7,10,1,-1,-2,-4,0,12.0,21.0,-9.0,8
8615,8615,2017-18,2017,2018,Leicester,Newcastle,Loss,Home,2018-04-07,0,6,7,8,8,6,6,7,10,0,1,1,-2,1,12.0,21.0,-9.0,9
8616,8616,2017-18,2017,2018,Leicester,Burnley,Loss,Away,2018-04-14,0,3,6,7,8,6,9,12,13,-3,-3,-5,-5,0,12.0,16.0,-4.0,9
8617,8617,2017-18,2017,2018,Leicester,Southampton,Draw,Home,2018-04-19,1,0,3,6,7,0,0,0,1,0,3,6,6,1,12.0,8.0,4.0,9
8618,8618,2017-18,2017,2018,Leicester,Crystal Palace,Loss,Away,2018-04-28,0,1,1,4,7,4,5,5,8,-3,-4,-1,-1,0,12.0,14.0,-2.0,9
8619,8619,2017-18,2017,2018,Leicester,West Ham,Loss,Home,2018-05-05,0,1,1,1,4,0,1,2,5,1,0,-1,-1,1,12.0,11.0,1.0,10
8620,8620,2017-18,2017,2018,Leicester,Arsenal,Win,Home,2018-05-09,3,0,1,1,1,3,6,6,9,-3,-5,-5,-8,1,12.0,5.0,7.0,10
8621,8621,2017-18,2017,2018,Leicester,Tottenham,Loss,Away,2018-05-13,0,3,3,4,4,3,6,7,7,0,-3,-3,-3,0,12.0,2.0,10.0,10
8622,8622,1993-94,1993,1994,Liverpool,Sheffield Weds,Win,Home,1993-08-14,3,0,0,0,0,0,0,0,0,0,0,0,0,1,6.0,7.0,-1.0,1
8623,8623,1993-94,1993,1994,Liverpool,QPR,Win,Away,1993-08-18,3,3,3,3,3,0,0,0,0,3,3,3,3,0,6.0,5.0,1.0,1
8624,8624,1993-94,1993,1994,Liverpool,Swindon,Win,Away,1993-08-22,3,6,6,6,6,0,0,0,0,6,6,6,6,0,6.0,21.0,-15.0,1
8625,8625,1993-94,1993,1994,Liverpool,Tottenham,Loss,Home,1993-08-25,0,6,9,9,9,3,6,6,6,3,3,3,3,1,6.0,8.0,-2.0,1
8626,8626,1993-94,1993,1994,Liverpool,Leeds,Win,Home,1993-08-28,3,3,6,9,9,0,3,4,4,3,3,5,5,1,6.0,17.0,-11.0,1
8627,8627,1993-94,1993,1994,Liverpool,Coventry,Loss,Away,1993-09-01,0,3,6,9,12,2,3,6,9,1,3,3,3,0,6.0,15.0,-9.0,2
8628,8628,1993-94,1993,1994,Liverpool,Blackburn,Loss,Home,1993-09-12,0,3,3,6,9,2,5,8,8,1,-2,-2,1,1,6.0,4.0,2.0,2
8629,8629,1993-94,1993,1994,Liverpool,Everton,Loss,Away,1993-09-18,0,0,3,3,6,3,3,3,6,-3,0,0,0,0,6.0,13.0,-7.0,2
8630,8630,1993-94,1993,1994,Liverpool,Chelsea,Loss,Away,1993-09-25,0,0,0,3,3,4,5,6,9,-4,-5,-3,-6,0,6.0,11.0,-5.0,2
8631,8631,1993-94,1993,1994,Liverpool,Arsenal,Draw,Home,1993-10-02,1,0,0,0,3,3,6,7,10,-3,-6,-7,-7,1,6.0,10.0,-4.0,3
8632,8632,1993-94,1993,1994,Liverpool,Oldham,Win,Home,1993-10-16,3,1,1,1,1,2,2,2,2,-1,-1,-1,-1,1,6.0,19.0,-13.0,3
8633,8633,1993-94,1993,1994,Liverpool,Man City,Draw,Away,1993-10-23,1,4,4,4,4,2,5,5,8,2,-1,-1,-4,0,6.0,9.0,-3.0,3
8634,8634,1993-94,1993,1994,Liverpool,Southampton,Win,Home,1993-10-30,3,4,5,5,5,4,5,5,5,0,0,0,0,1,6.0,18.0,-12.0,3
8635,8635,1993-94,1993,1994,Liverpool,West Ham,Win,Home,1993-11-06,3,4,7,8,8,4,5,8,8,0,2,0,0,1,6.0,21.0,-15.0,4
8636,8636,1993-94,1993,1994,Liverpool,Newcastle,Loss,Away,1993-11-21,0,6,7,10,11,6,6,6,9,0,1,4,2,0,6.0,21.0,-15.0,4
8637,8637,1993-94,1993,1994,Liverpool,Aston Villa,Win,Home,1993-11-28,3,3,6,7,10,3,6,9,12,0,0,-2,-2,1,6.0,2.0,4.0,4
8638,8638,1993-94,1993,1994,Liverpool,Sheffield Weds,Loss,Away,1993-12-04,0,3,6,9,10,6,7,10,11,-3,-1,-1,-1,0,6.0,7.0,-1.0,5
8639,8639,1993-94,1993,1994,Liverpool,QPR,Win,Home,1993-12-08,3,3,3,6,9,2,2,5,8,1,1,1,1,1,6.0,5.0,1.0,5
8640,8640,1993-94,1993,1994,Liverpool,Swindon,Draw,Home,1993-12-11,1,3,6,6,9,1,1,4,5,2,5,2,4,1,6.0,21.0,-15.0,5
8641,8641,1993-94,1993,1994,Liverpool,Tottenham,Draw,Away,1993-12-18,1,4,4,7,7,4,4,5,6,0,0,2,1,0,6.0,8.0,-2.0,5
8642,8642,1993-94,1993,1994,Liverpool,Sheffield United,Draw,Away,1993-12-26,1,2,5,5,8,1,1,2,5,1,4,3,3,0,6.0,14.0,-8.0,5
8643,8643,1993-94,1993,1994,Liverpool,Wimbledon,Draw,Home,1993-12-28,1,2,3,6,6,3,6,6,7,-1,-3,0,-1,1,6.0,12.0,-6.0,5
8644,8644,1993-94,1993,1994,Liverpool,Ipswich,Win,Away,1994-01-01,3,2,3,4,7,4,5,8,9,-2,-2,-4,-2,0,6.0,16.0,-10.0,6
8645,8645,1993-94,1993,1994,Liverpool,Man United,Draw,Home,1994-01-04,1,4,5,6,7,4,5,8,9,0,0,-2,-2,1,6.0,1.0,5.0,6
8646,8646,1993-94,1993,1994,Liverpool,Oldham,Win,Away,1994-01-15,3,4,5,6,7,0,0,1,1,4,5,5,6,0,6.0,19.0,-13.0,6
8647,8647,1993-94,1993,1994,Liverpool,Man City,Win,Home,1994-01-22,3,4,7,8,9,1,2,2,2,3,5,6,7,1,6.0,9.0,-3.0,6
8648,8648,1993-94,1993,1994,Liverpool,Norwich,Draw,Away,1994-02-05,1,6,7,10,11,2,2,5,5,4,5,5,6,0,6.0,3.0,3.0,7
8649,8649,1993-94,1993,1994,Liverpool,Southampton,Loss,Away,1994-02-14,0,4,7,8,11,3,6,6,7,1,1,2,4,0,6.0,18.0,-12.0,7
8650,8650,1993-94,1993,1994,Liverpool,Leeds,Loss,Away,1994-02-19,0,1,4,7,8,0,1,2,3,1,3,5,5,0,6.0,17.0,-11.0,7
8651,8651,1993-94,1993,1994,Liverpool,Coventry,Win,Home,1994-02-26,3,0,1,4,7,3,4,4,7,-3,-3,0,0,1,6.0,15.0,-9.0,7
8652,8652,1993-94,1993,1994,Liverpool,Blackburn,Loss,Away,1994-03-05,0,3,3,4,7,1,4,7,10,2,-1,-3,-3,0,6.0,4.0,2.0,8
8653,8653,1993-94,1993,1994,Liverpool,Everton,Win,Home,1994-03-13,3,3,3,3,4,4,5,8,8,-1,-2,-5,-4,1,6.0,13.0,-7.0,8
8654,8654,1993-94,1993,1994,Liverpool,Chelsea,Win,Home,1994-03-19,3,3,6,6,6,6,9,9,9,-3,-3,-3,-3,1,6.0,11.0,-5.0,8
8655,8655,1993-94,1993,1994,Liverpool,Arsenal,Loss,Away,1994-03-26,0,6,6,9,9,4,7,10,11,2,-1,-1,-2,0,6.0,10.0,-4.0,8
8656,8656,1993-94,1993,1994,Liverpool,Man United,Loss,Away,1994-03-30,0,3,6,6,9,2,5,5,6,1,1,1,3,0,6.0,1.0,5.0,8
8657,8657,1993-94,1993,1994,Liverpool,Sheffield United,Loss,Home,1994-04-02,0,0,3,6,6,4,5,6,7,-4,-2,0,-1,1,6.0,14.0,-8.0,9
8658,8658,1993-94,1993,1994,Liverpool,Wimbledon,Draw,Away,1994-04-04,1,0,0,3,6,6,9,9,9,-6,-9,-6,-3,0,6.0,12.0,-6.0,9
8659,8659,1993-94,1993,1994,Liverpool,Ipswich,Win,Home,1994-04-09,3,1,1,1,4,0,1,1,1,1,0,0,3,1,6.0,16.0,-10.0,9
8660,8660,1993-94,1993,1994,Liverpool,Newcastle,Loss,Home,1994-04-16,0,4,4,4,4,1,2,5,8,3,2,-1,-4,1,6.0,21.0,-15.0,9
8661,8661,1993-94,1993,1994,Liverpool,West Ham,Win,Away,1994-04-23,3,3,4,4,4,3,6,9,9,0,-2,-5,-5,0,6.0,21.0,-15.0,9
8662,8662,1993-94,1993,1994,Liverpool,Norwich,Loss,Home,1994-04-30,0,3,6,7,7,1,1,2,2,2,5,5,5,1,6.0,3.0,3.0,9
8663,8663,1993-94,1993,1994,Liverpool,Aston Villa,Loss,Away,1994-05-07,0,3,3,6,7,0,0,3,3,3,3,3,4,0,6.0,2.0,4.0,10
8664,8664,1994-95,1994,1995,Liverpool,Crystal Palace,Win,Away,1994-08-20,3,0,3,3,6,0,0,0,0,0,3,3,6,0,8.0,21.0,-13.0,1
8665,8665,1994-95,1994,1995,Liverpool,Arsenal,Win,Home,1994-08-28,3,3,3,6,6,3,3,3,4,0,0,3,2,1,8.0,4.0,4.0,1
8666,8666,1994-95,1994,1995,Liverpool,Southampton,Win,Away,1994-08-31,3,6,6,6,9,1,2,3,3,5,4,3,6,0,8.0,18.0,-10.0,1
8667,8667,1994-95,1994,1995,Liverpool,West Ham,Draw,Home,1994-09-10,1,6,9,9,9,0,0,1,2,6,9,8,7,1,8.0,13.0,-5.0,2
8668,8668,1994-95,1994,1995,Liverpool,Man United,Loss,Away,1994-09-17,0,4,7,10,10,3,6,7,10,1,1,3,0,0,8.0,1.0,7.0,2
8669,8669,1994-95,1994,1995,Liverpool,Newcastle,Draw,Away,1994-09-24,1,1,4,7,10,6,9,12,15,-5,-5,-5,-5,0,8.0,3.0,5.0,2
8670,8670,1994-95,1994,1995,Liverpool,Sheffield Weds,Win,Home,1994-10-01,3,1,2,5,8,2,2,3,6,-1,0,2,2,1,8.0,7.0,1.0,3
8671,8671,1994-95,1994,1995,Liverpool,Aston Villa,Win,Home,1994-10-08,3,4,4,5,8,0,0,3,6,4,4,2,2,1,8.0,10.0,-2.0,3
8672,8672,1994-95,1994,1995,Liverpool,Blackburn,Loss,Away,1994-10-15,0,6,7,7,8,1,4,7,10,5,3,0,-2,0,8.0,2.0,6.0,3
8673,8673,1994-95,1994,1995,Liverpool,Wimbledon,Win,Home,1994-10-22,3,3,6,7,7,0,0,3,4,3,6,4,3,1,8.0,6.0,2.0,3
8674,8674,1994-95,1994,1995,Liverpool,Ipswich,Win,Away,1994-10-29,3,3,6,9,10,0,0,0,3,3,6,9,7,0,8.0,19.0,-11.0,3
8675,8675,1994-95,1994,1995,Liverpool,QPR,Loss,Away,1994-10-31,0,6,6,9,12,3,3,4,4,3,3,5,8,0,8.0,9.0,-1.0,3
8676,8676,1994-95,1994,1995,Liverpool,Nott'm Forest,Win,Home,1994-11-05,3,3,6,6,9,3,6,7,10,0,0,-1,-1,1,8.0,21.0,-13.0,4
8677,8677,1994-95,1994,1995,Liverpool,Chelsea,Win,Home,1994-11-09,3,3,6,9,9,2,5,5,8,1,1,4,1,1,8.0,14.0,-6.0,4
8678,8678,1994-95,1994,1995,Liverpool,Everton,Loss,Away,1994-11-21,0,6,6,9,12,4,5,5,5,2,1,4,7,0,8.0,17.0,-9.0,4
8679,8679,1994-95,1994,1995,Liverpool,Tottenham,Draw,Home,1994-11-26,1,3,6,6,9,1,1,4,4,2,5,2,5,1,8.0,15.0,-7.0,4
8680,8680,1994-95,1994,1995,Liverpool,Coventry,Draw,Away,1994-12-03,1,1,4,7,7,6,7,7,10,-5,-3,0,-3,0,8.0,11.0,-3.0,5
8681,8681,1994-95,1994,1995,Liverpool,Crystal Palace,Draw,Home,1994-12-11,1,2,2,5,8,1,1,4,7,1,1,1,1,1,8.0,21.0,-13.0,5
8682,8682,1994-95,1994,1995,Liverpool,Chelsea,Draw,Away,1994-12-18,1,2,3,3,6,3,3,4,7,-1,0,-1,-1,0,8.0,14.0,-6.0,5
8683,8683,1994-95,1994,1995,Liverpool,Leicester,Win,Away,1994-12-26,3,2,3,4,4,1,2,2,5,1,1,2,-1,0,8.0,21.0,-13.0,5
8684,8684,1994-95,1994,1995,Liverpool,Man City,Win,Home,1994-12-28,3,4,5,6,7,0,0,3,6,4,5,3,1,1,8.0,16.0,-8.0,5
8685,8685,1994-95,1994,1995,Liverpool,Leeds,Win,Away,1994-12-31,3,6,7,8,9,4,5,5,8,2,2,3,1,0,8.0,5.0,3.0,5
8686,8686,1994-95,1994,1995,Liverpool,Norwich,Win,Home,1995-01-02,3,6,9,10,11,3,3,6,9,3,6,4,2,1,8.0,12.0,-4.0,6
8687,8687,1994-95,1994,1995,Liverpool,Ipswich,Loss,Home,1995-01-14,0,6,9,12,13,3,3,4,5,3,6,8,8,1,8.0,19.0,-11.0,6
8688,8688,1994-95,1994,1995,Liverpool,Everton,Draw,Home,1995-01-24,1,3,6,9,12,4,4,7,7,-1,2,2,5,1,8.0,17.0,-9.0,6
8689,8689,1994-95,1994,1995,Liverpool,Nott'm Forest,Draw,Away,1995-02-04,1,1,4,7,10,3,3,6,6,-2,1,1,4,0,8.0,21.0,-13.0,7
8690,8690,1994-95,1994,1995,Liverpool,QPR,Draw,Home,1995-02-11,1,2,2,5,8,3,3,6,7,-1,-1,-1,1,1,8.0,9.0,-1.0,7
8691,8691,1994-95,1994,1995,Liverpool,Sheffield Weds,Win,Away,1995-02-25,3,2,3,3,6,0,3,6,7,2,0,-3,-1,0,8.0,7.0,1.0,7
8692,8692,1994-95,1994,1995,Liverpool,Newcastle,Win,Home,1995-03-04,3,4,5,6,6,6,9,9,12,-2,-4,-3,-6,1,8.0,3.0,5.0,8
8693,8693,1994-95,1994,1995,Liverpool,Coventry,Loss,Home,1995-03-14,0,6,7,8,9,2,3,6,9,4,4,2,0,1,8.0,11.0,-3.0,8
8694,8694,1994-95,1994,1995,Liverpool,Man United,Win,Home,1995-03-19,3,3,6,7,8,4,7,7,10,-1,-1,0,-2,1,8.0,1.0,7.0,8
8695,8695,1994-95,1994,1995,Liverpool,Tottenham,Draw,Away,1995-03-22,1,3,6,9,10,4,7,8,8,-1,-1,1,2,0,8.0,15.0,-7.0,8
8696,8696,1994-95,1994,1995,Liverpool,Southampton,Win,Home,1995-04-05,3,4,4,7,10,6,6,7,8,-2,-2,0,2,1,8.0,18.0,-10.0,9
8697,8697,1994-95,1994,1995,Liverpool,Leeds,Loss,Home,1995-04-09,0,4,7,7,10,4,4,7,10,0,3,0,0,1,8.0,5.0,3.0,9
8698,8698,1994-95,1994,1995,Liverpool,Arsenal,Win,Away,1995-04-12,3,3,4,7,7,3,3,3,3,0,1,4,4,0,8.0,4.0,4.0,9
8699,8699,1994-95,1994,1995,Liverpool,Man City,Loss,Away,1995-04-14,0,3,6,7,10,0,0,3,4,3,6,4,6,0,8.0,16.0,-8.0,9
8700,8700,1994-95,1994,1995,Liverpool,Leicester,Win,Home,1995-04-17,3,3,3,6,7,0,3,3,3,3,0,3,4,1,8.0,21.0,-13.0,9
8701,8701,1994-95,1994,1995,Liverpool,Norwich,Win,Away,1995-04-29,3,3,6,6,9,0,0,0,0,3,6,6,9,0,8.0,12.0,-4.0,9
8702,8702,1994-95,1994,1995,Liverpool,Wimbledon,Draw,Away,1995-05-02,1,6,6,9,9,1,1,2,5,5,5,7,4,0,8.0,6.0,2.0,10
8703,8703,1994-95,1994,1995,Liverpool,Aston Villa,Loss,Away,1995-05-06,0,4,7,7,10,1,1,1,2,3,6,6,8,0,8.0,10.0,-2.0,10
8704,8704,1994-95,1994,1995,Liverpool,West Ham,Loss,Away,1995-05-10,0,1,4,7,7,1,4,5,8,0,0,2,-1,0,8.0,13.0,-5.0,10
8705,8705,1994-95,1994,1995,Liverpool,Blackburn,Win,Home,1995-05-14,3,0,1,4,7,3,6,6,7,-3,-5,-2,0,1,8.0,2.0,6.0,10
8706,8706,1995-96,1995,1996,Liverpool,Sheffield Weds,Win,Home,1995-08-19,3,3,3,4,7,3,4,5,5,0,-1,-1,2,1,4.0,13.0,-9.0,1
8707,8707,1995-96,1995,1996,Liverpool,Leeds,Loss,Away,1995-08-21,0,6,6,6,7,4,7,10,13,2,-1,-4,-6,0,4.0,5.0,-1.0,1
8708,8708,1995-96,1995,1996,Liverpool,Tottenham,Win,Away,1995-08-26,3,3,6,6,6,1,2,2,2,2,4,4,4,0,4.0,7.0,-3.0,1
8709,8709,1995-96,1995,1996,Liverpool,QPR,Win,Home,1995-08-30,3,3,6,9,9,3,3,6,9,0,3,3,0,1,4.0,8.0,-4.0,1
8710,8710,1995-96,1995,1996,Liverpool,Wimbledon,Loss,Away,1995-09-09,0,6,6,9,12,1,4,7,8,5,2,2,4,0,4.0,9.0,-5.0,2
8711,8711,1995-96,1995,1996,Liverpool,Blackburn,Win,Home,1995-09-16,3,3,6,6,9,1,1,1,4,2,5,5,5,1,4.0,1.0,3.0,2
8712,8712,1995-96,1995,1996,Liverpool,Bolton,Win,Home,1995-09-23,3,3,6,9,9,1,1,4,4,2,5,5,5,1,4.0,21.0,-17.0,2
8713,8713,1995-96,1995,1996,Liverpool,Man United,Draw,Away,1995-10-01,1,6,6,9,12,4,7,10,13,2,-1,-1,-1,0,4.0,2.0,2.0,3
8714,8714,1995-96,1995,1996,Liverpool,Coventry,Draw,Home,1995-10-14,1,4,7,7,10,0,0,1,2,4,7,6,8,1,4.0,16.0,-12.0,3
8715,8715,1995-96,1995,1996,Liverpool,Southampton,Win,Away,1995-10-22,3,2,5,8,8,1,1,1,2,1,4,7,6,0,4.0,10.0,-6.0,3
8716,8716,1995-96,1995,1996,Liverpool,Man City,Win,Home,1995-10-28,3,4,5,8,11,1,1,1,1,3,4,7,10,1,4.0,17.0,-13.0,3
8717,8717,1995-96,1995,1996,Liverpool,Newcastle,Loss,Away,1995-11-04,0,6,7,8,11,4,7,10,13,2,0,-2,-2,0,4.0,6.0,-2.0,4
8718,8718,1995-96,1995,1996,Liverpool,Everton,Loss,Home,1995-11-18,0,3,6,7,8,3,4,5,5,0,2,2,3,1,4.0,15.0,-11.0,4
8719,8719,1995-96,1995,1996,Liverpool,West Ham,Draw,Away,1995-11-22,1,0,3,6,7,3,6,7,10,-3,-3,-1,-3,0,4.0,14.0,-10.0,4
8720,8720,1995-96,1995,1996,Liverpool,Middlesbrough,Loss,Away,1995-11-25,0,1,1,4,7,1,2,2,5,0,-1,2,2,0,4.0,21.0,-17.0,4
8721,8721,1995-96,1995,1996,Liverpool,Southampton,Draw,Home,1995-12-02,1,1,1,1,4,3,3,6,9,-2,-2,-5,-5,1,4.0,10.0,-6.0,5
8722,8722,1995-96,1995,1996,Liverpool,Bolton,Win,Away,1995-12-09,3,1,2,2,2,1,1,1,1,0,1,1,1,0,4.0,21.0,-17.0,5
8723,8723,1995-96,1995,1996,Liverpool,Man United,Win,Home,1995-12-17,3,4,4,5,5,2,3,6,9,2,1,-1,-4,1,4.0,2.0,2.0,5
8724,8724,1995-96,1995,1996,Liverpool,Arsenal,Win,Home,1995-12-23,3,6,7,7,8,2,3,4,7,4,4,3,1,1,4.0,12.0,-8.0,5
8725,8725,1995-96,1995,1996,Liverpool,Chelsea,Draw,Away,1995-12-30,1,6,9,10,10,3,4,7,8,3,5,3,2,0,4.0,11.0,-7.0,5
8726,8726,1995-96,1995,1996,Liverpool,Nott'm Forest,Win,Home,1996-01-01,3,4,7,10,11,6,6,7,8,-2,1,3,3,1,4.0,3.0,1.0,6
8727,8727,1995-96,1995,1996,Liverpool,Sheffield Weds,Draw,Away,1996-01-13,1,4,7,10,13,3,4,7,8,1,3,3,5,0,4.0,13.0,-9.0,6
8728,8728,1995-96,1995,1996,Liverpool,Leeds,Win,Home,1996-01-20,3,4,5,8,11,4,4,7,10,0,1,1,1,1,4.0,5.0,-1.0,6
8729,8729,1995-96,1995,1996,Liverpool,Aston Villa,Win,Away,1996-01-31,3,4,7,8,11,4,7,7,10,0,0,1,1,0,4.0,18.0,-14.0,6
8730,8730,1995-96,1995,1996,Liverpool,Tottenham,Draw,Home,1996-02-03,1,6,7,10,11,3,6,6,7,3,1,4,4,1,4.0,7.0,-3.0,7
8731,8731,1995-96,1995,1996,Liverpool,QPR,Win,Away,1996-02-11,3,4,7,8,11,0,0,0,0,4,7,8,11,0,4.0,8.0,-4.0,7
8732,8732,1995-96,1995,1996,Liverpool,Blackburn,Win,Away,1996-02-24,3,4,7,10,11,3,6,9,10,1,1,1,1,0,4.0,1.0,3.0,7
8733,8733,1995-96,1995,1996,Liverpool,Aston Villa,Win,Home,1996-03-03,3,6,7,10,13,4,7,10,10,2,0,0,3,1,4.0,18.0,-14.0,8
8734,8734,1995-96,1995,1996,Liverpool,Wimbledon,Draw,Home,1996-03-13,1,6,9,10,13,2,2,2,5,4,7,8,8,1,4.0,9.0,-5.0,8
8735,8735,1995-96,1995,1996,Liverpool,Chelsea,Win,Home,1996-03-16,3,4,7,10,11,2,5,5,5,2,2,5,6,1,4.0,11.0,-7.0,8
8736,8736,1995-96,1995,1996,Liverpool,Nott'm Forest,Loss,Away,1996-03-23,0,4,7,10,13,4,4,4,4,0,3,6,9,0,4.0,3.0,1.0,8
8737,8737,1995-96,1995,1996,Liverpool,Newcastle,Win,Home,1996-04-03,3,3,4,7,10,3,3,4,4,0,1,3,6,1,4.0,6.0,-2.0,9
8738,8738,1995-96,1995,1996,Liverpool,Coventry,Loss,Away,1996-04-06,0,3,6,7,10,0,0,1,2,3,6,6,8,0,4.0,16.0,-12.0,9
8739,8739,1995-96,1995,1996,Liverpool,West Ham,Win,Home,1996-04-08,3,3,3,6,7,4,4,7,8,-1,-1,-1,-1,1,4.0,14.0,-10.0,9
8740,8740,1995-96,1995,1996,Liverpool,Everton,Draw,Away,1996-04-16,1,3,6,6,9,3,6,6,7,0,0,0,2,0,4.0,15.0,-11.0,9
8741,8741,1995-96,1995,1996,Liverpool,Middlesbrough,Win,Home,1996-04-27,3,4,4,7,7,1,4,7,8,3,0,0,-1,1,4.0,21.0,-17.0,9
8742,8742,1995-96,1995,1996,Liverpool,Arsenal,Draw,Away,1996-05-01,1,4,7,7,10,2,2,5,8,2,5,2,2,0,4.0,12.0,-8.0,10
8743,8743,1995-96,1995,1996,Liverpool,Man City,Draw,Away,1996-05-04,1,4,5,8,8,6,6,6,7,-2,-1,2,1,0,4.0,17.0,-13.0,10
8744,8744,1996-97,1996,1997,Liverpool,Middlesbrough,Draw,Away,1996-08-17,1,2,5,6,9,0,0,1,4,2,5,5,5,0,3.0,12.0,-9.0,1
8745,8745,1996-97,1996,1997,Liverpool,Arsenal,Win,Home,1996-08-19,3,2,3,6,7,6,7,8,9,-4,-4,-2,-2,1,3.0,5.0,-2.0,1
8746,8746,1996-97,1996,1997,Liverpool,Sunderland,Draw,Home,1996-08-24,1,4,5,6,9,4,4,4,4,0,1,2,5,1,3.0,21.0,-18.0,1
8747,8747,1996-97,1996,1997,Liverpool,Coventry,Win,Away,1996-09-04,3,4,5,6,7,1,1,2,5,3,4,4,2,0,3.0,16.0,-13.0,2
8748,8748,1996-97,1996,1997,Liverpool,Southampton,Win,Home,1996-09-07,3,4,7,8,9,1,1,2,3,3,6,6,6,1,3.0,17.0,-14.0,2
8749,8749,1996-97,1996,1997,Liverpool,Leicester,Win,Away,1996-09-15,3,6,7,10,11,1,1,4,5,5,6,6,6,0,3.0,21.0,-18.0,2
8750,8750,1996-97,1996,1997,Liverpool,Chelsea,Win,Home,1996-09-21,3,6,9,10,13,4,5,8,11,2,4,2,2,1,3.0,11.0,-8.0,2
8751,8751,1996-97,1996,1997,Liverpool,West Ham,Win,Away,1996-09-29,3,6,9,12,13,3,4,4,7,3,5,8,6,0,3.0,10.0,-7.0,2
8752,8752,1996-97,1996,1997,Liverpool,Man United,Loss,Away,1996-10-12,0,6,9,12,15,4,7,10,11,2,2,2,4,0,3.0,1.0,2.0,3
8753,8753,1996-97,1996,1997,Liverpool,Derby,Win,Home,1996-10-27,3,3,6,9,12,1,1,2,5,2,5,7,7,1,3.0,21.0,-18.0,3
8754,8754,1996-97,1996,1997,Liverpool,Blackburn,Loss,Away,1996-11-03,0,3,6,9,12,1,1,2,3,2,5,7,9,0,3.0,7.0,-4.0,4
8755,8755,1996-97,1996,1997,Liverpool,Leeds,Win,Away,1996-11-16,3,3,3,6,9,3,3,6,6,0,0,0,3,0,3.0,13.0,-10.0,4
8756,8756,1996-97,1996,1997,Liverpool,Everton,Draw,Home,1996-11-20,1,3,6,6,9,4,7,10,13,-1,-1,-4,-4,1,3.0,6.0,-3.0,4
8757,8757,1996-97,1996,1997,Liverpool,Wimbledon,Draw,Home,1996-11-23,1,4,4,7,7,2,3,6,9,2,1,1,-2,1,3.0,14.0,-11.0,4
8758,8758,1996-97,1996,1997,Liverpool,Tottenham,Win,Away,1996-12-02,3,2,5,5,8,3,6,6,9,-1,-1,-1,-1,0,3.0,8.0,-5.0,5
8759,8759,1996-97,1996,1997,Liverpool,Sheffield Weds,Loss,Home,1996-12-07,0,4,5,8,8,2,5,6,7,2,0,2,1,1,3.0,15.0,-12.0,5
8760,8760,1996-97,1996,1997,Liverpool,Middlesbrough,Win,Home,1996-12-14,3,3,4,5,8,1,1,2,2,2,3,3,6,1,3.0,12.0,-9.0,5
8761,8761,1996-97,1996,1997,Liverpool,Nott'm Forest,Win,Home,1996-12-17,3,3,6,7,8,1,2,2,2,2,4,5,6,1,3.0,9.0,-6.0,5
8762,8762,1996-97,1996,1997,Liverpool,Newcastle,Draw,Away,1996-12-23,1,6,6,9,10,1,1,2,3,5,5,7,7,0,3.0,2.0,1.0,5
8763,8763,1996-97,1996,1997,Liverpool,Leicester,Draw,Home,1996-12-26,1,4,7,7,10,1,4,4,4,3,3,3,6,1,3.0,21.0,-18.0,5
8764,8764,1996-97,1996,1997,Liverpool,Southampton,Win,Away,1996-12-29,3,2,5,8,8,3,3,3,3,-1,2,5,5,0,3.0,17.0,-14.0,5
8765,8765,1996-97,1996,1997,Liverpool,Chelsea,Loss,Away,1997-01-01,0,4,5,8,11,4,7,7,8,0,-2,1,3,0,3.0,11.0,-8.0,6
8766,8766,1996-97,1996,1997,Liverpool,West Ham,Draw,Home,1997-01-11,1,3,4,5,8,3,3,4,4,0,1,1,4,1,3.0,10.0,-7.0,6
8767,8767,1996-97,1996,1997,Liverpool,Aston Villa,Win,Home,1997-01-18,3,1,4,5,6,2,3,3,6,-1,1,2,0,1,3.0,4.0,-1.0,6
8768,8768,1996-97,1996,1997,Liverpool,Derby,Win,Away,1997-02-01,3,4,4,7,8,1,2,3,3,3,2,4,5,0,3.0,21.0,-18.0,7
8769,8769,1996-97,1996,1997,Liverpool,Leeds,Win,Home,1997-02-19,3,6,7,7,10,2,5,8,8,4,2,-1,2,1,3.0,13.0,-10.0,7
8770,8770,1996-97,1996,1997,Liverpool,Blackburn,Draw,Home,1997-02-22,1,6,9,10,10,3,4,7,10,3,5,3,0,1,3.0,7.0,-4.0,7
8771,8771,1996-97,1996,1997,Liverpool,Aston Villa,Loss,Away,1997-03-02,0,4,7,10,11,4,7,7,7,0,0,3,4,0,3.0,4.0,-1.0,8
8772,8772,1996-97,1996,1997,Liverpool,Newcastle,Win,Home,1997-03-10,3,1,4,7,10,3,6,9,10,-2,-2,-2,0,1,3.0,2.0,1.0,8
8773,8773,1996-97,1996,1997,Liverpool,Nott'm Forest,Draw,Away,1997-03-15,1,3,4,7,10,1,1,4,5,2,3,3,5,0,3.0,9.0,-6.0,8
8774,8774,1996-97,1996,1997,Liverpool,Arsenal,Win,Away,1997-03-24,3,4,4,5,8,6,9,9,9,-2,-5,-4,-1,0,3.0,5.0,-2.0,8
8775,8775,1996-97,1996,1997,Liverpool,Coventry,Loss,Home,1997-04-06,0,4,7,7,8,0,1,2,2,4,6,5,6,1,3.0,16.0,-13.0,9
8776,8776,1996-97,1996,1997,Liverpool,Sunderland,Win,Away,1997-04-13,3,3,4,7,7,2,2,2,5,1,2,5,2,0,3.0,21.0,-18.0,9
8777,8777,1996-97,1996,1997,Liverpool,Everton,Draw,Away,1997-04-16,1,3,6,7,10,4,4,4,7,-1,2,3,3,0,3.0,6.0,-3.0,9
8778,8778,1996-97,1996,1997,Liverpool,Man United,Loss,Home,1997-04-19,0,4,4,7,8,3,6,9,9,1,-2,-2,-1,1,3.0,1.0,2.0,9
8779,8779,1996-97,1996,1997,Liverpool,Tottenham,Win,Home,1997-05-03,3,1,4,4,7,4,4,4,7,-3,0,0,0,1,3.0,8.0,-5.0,10
8780,8780,1996-97,1996,1997,Liverpool,Wimbledon,Loss,Away,1997-05-06,0,3,4,7,7,1,1,4,4,2,3,3,3,0,3.0,14.0,-11.0,10
8781,8781,1996-97,1996,1997,Liverpool,Sheffield Weds,Draw,Away,1997-05-11,1,3,3,4,7,0,0,3,4,3,3,1,3,0,3.0,15.0,-12.0,10
8782,8782,1997-98,1997,1998,Liverpool,Wimbledon,Draw,Away,1997-08-09,1,1,4,4,5,6,7,7,7,-5,-3,-3,-2,0,4.0,8.0,-4.0,1
8783,8783,1997-98,1997,1998,Liverpool,Leicester,Loss,Home,1997-08-13,0,2,2,5,5,6,9,10,10,-4,-7,-5,-5,1,4.0,9.0,-5.0,1
8784,8784,1997-98,1997,1998,Liverpool,Blackburn,Draw,Away,1997-08-23,1,1,2,2,5,6,6,7,7,-5,-4,-5,-2,0,4.0,13.0,-9.0,1
8785,8785,1997-98,1997,1998,Liverpool,Leeds,Win,Away,1997-08-26,3,1,2,3,3,3,4,5,6,-2,-2,-2,-3,0,4.0,11.0,-7.0,1
8786,8786,1997-98,1997,1998,Liverpool,Sheffield Weds,Win,Home,1997-09-13,3,4,4,5,6,3,4,4,4,1,0,1,2,1,4.0,7.0,-3.0,2
8787,8787,1997-98,1997,1998,Liverpool,Southampton,Draw,Away,1997-09-20,1,6,7,7,8,0,3,3,3,6,4,4,5,0,4.0,16.0,-12.0,2
8788,8788,1997-98,1997,1998,Liverpool,Aston Villa,Win,Home,1997-09-22,3,4,7,8,8,6,9,9,9,-2,-2,-1,-1,1,4.0,5.0,-1.0,2
8789,8789,1997-98,1997,1998,Liverpool,West Ham,Loss,Away,1997-09-27,0,4,7,10,11,0,0,3,4,4,7,7,7,0,4.0,14.0,-10.0,2
8790,8790,1997-98,1997,1998,Liverpool,Chelsea,Win,Home,1997-10-05,3,3,4,7,10,4,4,7,10,-1,0,0,0,1,4.0,6.0,-2.0,3
8791,8791,1997-98,1997,1998,Liverpool,Everton,Loss,Away,1997-10-18,0,3,6,7,10,1,1,4,4,2,5,3,6,0,4.0,15.0,-11.0,3
8792,8792,1997-98,1997,1998,Liverpool,Derby,Win,Home,1997-10-25,3,3,3,6,7,2,5,8,11,1,-2,-2,-4,1,4.0,12.0,-8.0,3
8793,8793,1997-98,1997,1998,Liverpool,Bolton,Draw,Away,1997-11-01,1,3,6,6,9,3,3,4,5,0,3,2,4,0,4.0,21.0,-17.0,4
8794,8794,1997-98,1997,1998,Liverpool,Tottenham,Win,Home,1997-11-08,3,4,4,7,7,0,3,3,4,4,1,4,3,1,4.0,10.0,-6.0,4
8795,8795,1997-98,1997,1998,Liverpool,Barnsley,Loss,Home,1997-11-22,0,4,7,7,10,1,1,4,4,3,6,3,6,1,4.0,21.0,-17.0,4
8796,8796,1997-98,1997,1998,Liverpool,Arsenal,Win,Away,1997-11-30,3,3,4,7,7,3,3,4,5,0,1,3,2,0,4.0,3.0,1.0,4
8797,8797,1997-98,1997,1998,Liverpool,Man United,Loss,Home,1997-12-06,0,3,6,7,10,6,6,9,12,-3,0,-2,-2,1,4.0,1.0,3.0,5
8798,8798,1997-98,1997,1998,Liverpool,Crystal Palace,Win,Away,1997-12-13,3,3,3,6,7,1,1,4,5,2,2,2,2,0,4.0,21.0,-17.0,5
8799,8799,1997-98,1997,1998,Liverpool,Coventry,Win,Home,1997-12-20,3,3,6,6,9,3,3,3,4,0,3,3,5,1,4.0,17.0,-13.0,5
8800,8800,1997-98,1997,1998,Liverpool,Leeds,Win,Home,1997-12-26,3,6,6,9,9,4,5,8,11,2,1,1,-2,1,4.0,11.0,-7.0,5
8801,8801,1997-98,1997,1998,Liverpool,Newcastle,Win,Away,1997-12-28,3,6,9,9,12,0,1,2,2,6,8,7,10,0,4.0,2.0,2.0,5
8802,8802,1997-98,1997,1998,Liverpool,Wimbledon,Win,Home,1998-01-10,3,6,9,12,12,1,2,5,5,5,7,7,7,1,4.0,8.0,-4.0,6
8803,8803,1997-98,1997,1998,Liverpool,Leicester,Draw,Away,1998-01-17,1,6,9,12,15,2,2,2,2,4,7,10,13,0,4.0,9.0,-5.0,6
8804,8804,1997-98,1997,1998,Liverpool,Newcastle,Win,Home,1998-01-20,3,4,7,10,13,3,3,3,3,1,4,7,10,1,4.0,2.0,2.0,6
8805,8805,1997-98,1997,1998,Liverpool,Blackburn,Draw,Home,1998-01-31,1,4,7,10,13,3,4,5,8,1,3,5,5,1,4.0,13.0,-9.0,6
8806,8806,1997-98,1997,1998,Liverpool,Southampton,Loss,Home,1998-02-07,0,4,5,8,11,3,4,7,8,1,1,1,3,1,4.0,16.0,-12.0,7
8807,8807,1997-98,1997,1998,Liverpool,Sheffield Weds,Draw,Away,1998-02-14,1,1,4,5,8,1,4,7,8,0,0,-2,0,0,4.0,7.0,-3.0,7
8808,8808,1997-98,1997,1998,Liverpool,Everton,Draw,Home,1998-02-23,1,1,2,5,6,1,2,5,8,0,0,0,-2,1,4.0,15.0,-11.0,7
8809,8809,1997-98,1997,1998,Liverpool,Aston Villa,Loss,Away,1998-02-28,0,2,2,3,6,0,3,3,3,2,-1,0,3,0,4.0,5.0,-1.0,7
8810,8810,1997-98,1997,1998,Liverpool,Bolton,Win,Home,1998-03-07,3,1,2,2,3,1,2,2,2,0,0,0,1,1,4.0,21.0,-17.0,8
8811,8811,1997-98,1997,1998,Liverpool,Tottenham,Draw,Away,1998-03-14,1,3,4,5,5,3,3,4,7,0,1,1,-2,0,4.0,10.0,-6.0,8
8812,8812,1997-98,1997,1998,Liverpool,Barnsley,Win,Away,1998-03-28,3,4,4,5,6,6,9,9,10,-2,-5,-4,-4,0,4.0,21.0,-17.0,8
8813,8813,1997-98,1997,1998,Liverpool,Man United,Draw,Away,1998-04-10,1,4,7,7,8,6,6,7,7,-2,1,0,1,0,4.0,1.0,3.0,9
8814,8814,1997-98,1997,1998,Liverpool,Crystal Palace,Win,Home,1998-04-13,3,4,5,8,8,0,3,3,3,4,2,5,5,1,4.0,21.0,-17.0,9
8815,8815,1997-98,1997,1998,Liverpool,Coventry,Draw,Away,1998-04-19,1,4,7,8,11,1,2,5,6,3,5,3,5,0,4.0,17.0,-13.0,9
8816,8816,1997-98,1997,1998,Liverpool,Chelsea,Loss,Away,1998-04-25,0,4,5,8,9,6,6,9,9,-2,-1,-1,0,0,4.0,6.0,-2.0,9
8817,8817,1997-98,1997,1998,Liverpool,West Ham,Win,Home,1998-05-02,3,1,4,5,8,3,4,5,5,-2,0,0,3,1,4.0,14.0,-10.0,10
8818,8818,1997-98,1997,1998,Liverpool,Arsenal,Win,Home,1998-05-06,3,3,4,7,8,6,9,12,15,-3,-5,-5,-7,1,4.0,3.0,1.0,10
8819,8819,1997-98,1997,1998,Liverpool,Derby,Loss,Away,1998-05-10,0,6,6,7,10,3,3,3,6,3,3,4,4,0,4.0,12.0,-8.0,10
8820,8820,1998-99,1998,1999,Liverpool,Southampton,Win,Away,1998-08-16,3,3,6,6,7,1,4,4,5,2,2,2,2,0,3.0,12.0,-9.0,1
8821,8821,1998-99,1998,1999,Liverpool,Arsenal,Draw,Home,1998-08-22,1,3,6,9,9,3,3,6,9,0,3,3,0,1,3.0,1.0,2.0,1
8822,8822,1998-99,1998,1999,Liverpool,Newcastle,Win,Away,1998-08-30,3,4,4,7,10,2,2,5,6,2,2,2,4,0,3.0,13.0,-10.0,1
8823,8823,1998-99,1998,1999,Liverpool,Coventry,Win,Home,1998-09-09,3,4,7,7,10,1,4,5,8,3,3,2,2,1,3.0,11.0,-8.0,2
8824,8824,1998-99,1998,1999,Liverpool,West Ham,Loss,Away,1998-09-12,0,6,7,10,10,1,2,5,8,5,5,5,2,0,3.0,8.0,-5.0,2
8825,8825,1998-99,1998,1999,Liverpool,Charlton,Draw,Home,1998-09-19,1,3,6,7,10,0,1,4,5,3,5,3,5,1,3.0,21.0,-18.0,2
8826,8826,1998-99,1998,1999,Liverpool,Man United,Loss,Away,1998-09-24,0,1,4,7,8,3,6,7,8,-2,-2,0,0,0,3.0,2.0,1.0,2
8827,8827,1998-99,1998,1999,Liverpool,Chelsea,Draw,Home,1998-10-04,1,1,1,4,7,6,9,10,11,-5,-8,-6,-4,1,3.0,4.0,-1.0,3
8828,8828,1998-99,1998,1999,Liverpool,Everton,Draw,Away,1998-10-17,1,1,2,2,5,4,5,6,9,-3,-3,-4,-4,0,3.0,17.0,-14.0,3
8829,8829,1998-99,1998,1999,Liverpool,Nott'm Forest,Win,Home,1998-10-24,3,2,2,3,3,1,1,2,2,1,1,1,1,1,3.0,21.0,-18.0,3
8830,8830,1998-99,1998,1999,Liverpool,Leicester,Loss,Away,1998-10-31,0,4,5,5,6,4,7,8,8,0,-2,-3,-2,0,3.0,10.0,-7.0,3
8831,8831,1998-99,1998,1999,Liverpool,Derby,Loss,Home,1998-11-07,0,3,4,5,5,2,2,2,2,1,2,3,3,1,3.0,9.0,-6.0,4
8832,8832,1998-99,1998,1999,Liverpool,Leeds,Loss,Home,1998-11-14,0,0,3,4,5,4,5,6,6,-4,-2,-2,-1,1,3.0,5.0,-2.0,4
8833,8833,1998-99,1998,1999,Liverpool,Aston Villa,Win,Away,1998-11-21,3,0,0,3,4,6,7,8,11,-6,-7,-5,-7,0,3.0,7.0,-4.0,4
8834,8834,1998-99,1998,1999,Liverpool,Blackburn,Win,Home,1998-11-29,3,3,3,3,6,0,0,1,1,3,3,2,5,1,3.0,6.0,-3.0,4
8835,8835,1998-99,1998,1999,Liverpool,Tottenham,Loss,Away,1998-12-05,0,6,6,6,6,3,4,4,5,3,2,2,1,0,3.0,14.0,-11.0,5
8836,8836,1998-99,1998,1999,Liverpool,Wimbledon,Loss,Away,1998-12-13,0,3,6,6,6,3,6,6,9,0,0,0,-3,0,3.0,15.0,-12.0,5
8837,8837,1998-99,1998,1999,Liverpool,Sheffield Weds,Win,Home,1998-12-19,3,0,3,6,6,6,7,10,11,-6,-4,-4,-5,1,3.0,16.0,-13.0,5
8838,8838,1998-99,1998,1999,Liverpool,Middlesbrough,Win,Away,1998-12-26,3,3,3,6,9,6,7,8,11,-3,-4,-2,-2,0,3.0,21.0,-18.0,5
8839,8839,1998-99,1998,1999,Liverpool,Newcastle,Win,Home,1998-12-28,3,6,6,6,9,3,4,5,8,3,2,1,1,1,3.0,13.0,-10.0,5
8840,8840,1998-99,1998,1999,Liverpool,Arsenal,Draw,Away,1999-01-09,1,6,9,9,9,6,9,9,10,0,0,0,-1,0,3.0,1.0,2.0,6
8841,8841,1998-99,1998,1999,Liverpool,Southampton,Win,Home,1999-01-16,3,4,7,10,10,4,4,7,7,0,3,3,3,1,3.0,12.0,-9.0,6
8842,8842,1998-99,1998,1999,Liverpool,Coventry,Loss,Away,1999-01-30,0,4,7,10,13,3,3,4,5,1,4,6,8,0,3.0,11.0,-8.0,6
8843,8843,1998-99,1998,1999,Liverpool,Middlesbrough,Win,Home,1999-02-06,3,3,4,7,10,1,2,2,2,2,2,5,8,1,3.0,21.0,-18.0,7
8844,8844,1998-99,1998,1999,Liverpool,Charlton,Loss,Away,1999-02-13,0,3,6,7,10,3,4,4,4,0,2,3,6,0,3.0,21.0,-18.0,7
8845,8845,1998-99,1998,1999,Liverpool,West Ham,Draw,Home,1999-02-20,1,3,3,6,7,3,4,4,4,0,-1,2,3,1,3.0,8.0,-5.0,7
8846,8846,1998-99,1998,1999,Liverpool,Chelsea,Loss,Away,1999-02-27,0,1,4,4,7,4,7,7,10,-3,-3,-3,-3,0,3.0,4.0,-1.0,7
8847,8847,1998-99,1998,1999,Liverpool,Derby,Loss,Away,1999-03-13,0,1,1,4,4,4,4,7,7,-3,-3,-3,-3,0,3.0,9.0,-6.0,8
8848,8848,1998-99,1998,1999,Liverpool,Everton,Win,Home,1999-04-03,3,0,1,1,4,0,3,4,4,0,-2,-3,0,1,3.0,17.0,-14.0,9
8849,8849,1998-99,1998,1999,Liverpool,Nott'm Forest,Draw,Away,1999-04-05,1,3,3,4,4,0,3,3,4,3,0,1,0,0,3.0,21.0,-18.0,9
8850,8850,1998-99,1998,1999,Liverpool,Leeds,Draw,Away,1999-04-12,1,4,4,4,5,6,9,12,15,-2,-5,-8,-10,0,3.0,5.0,-2.0,9
8851,8851,1998-99,1998,1999,Liverpool,Aston Villa,Loss,Home,1999-04-17,0,2,5,5,5,4,5,5,5,-2,0,0,0,1,3.0,7.0,-4.0,9
8852,8852,1998-99,1998,1999,Liverpool,Leicester,Loss,Home,1999-04-21,0,1,2,5,5,2,3,6,7,-1,-1,-1,-2,1,3.0,10.0,-7.0,9
8853,8853,1998-99,1998,1999,Liverpool,Blackburn,Win,Away,1999-04-24,3,0,1,2,5,1,2,5,6,-1,-1,-3,-1,0,3.0,6.0,-3.0,9
8854,8854,1998-99,1998,1999,Liverpool,Tottenham,Win,Home,1999-05-01,3,3,3,4,5,3,6,7,7,0,-3,-3,-2,1,3.0,14.0,-11.0,10
8855,8855,1998-99,1998,1999,Liverpool,Man United,Draw,Home,1999-05-05,1,6,6,6,7,4,7,8,11,2,-1,-2,-4,1,3.0,2.0,1.0,10
8856,8856,1998-99,1998,1999,Liverpool,Sheffield Weds,Loss,Away,1999-05-08,0,4,7,7,7,1,2,2,5,3,5,5,2,0,3.0,16.0,-13.0,10
8857,8857,1998-99,1998,1999,Liverpool,Wimbledon,Win,Home,1999-05-16,3,1,4,7,7,0,1,1,1,1,3,6,6,1,3.0,15.0,-12.0,10
8858,8858,1999-00,1999,2000,Liverpool,Sheffield Weds,Win,Away,1999-08-07,3,3,4,7,10,6,6,7,8,-3,-2,0,2,0,7.0,12.0,-5.0,1
8859,8859,1999-00,1999,2000,Liverpool,Watford,Loss,Home,1999-08-14,0,6,6,7,10,0,0,0,0,6,6,7,10,1,7.0,21.0,-14.0,1
8860,8860,1999-00,1999,2000,Liverpool,Middlesbrough,Loss,Away,1999-08-21,0,3,6,6,7,6,6,6,6,-3,0,0,1,0,7.0,9.0,-2.0,1
8861,8861,1999-00,1999,2000,Liverpool,Leeds,Win,Away,1999-08-23,3,0,3,6,6,3,6,7,8,-3,-3,-1,-2,0,7.0,4.0,3.0,1
8862,8862,1999-00,1999,2000,Liverpool,Arsenal,Win,Home,1999-08-28,3,3,3,6,9,3,4,7,10,0,-1,-1,-1,1,7.0,2.0,5.0,1
8863,8863,1999-00,1999,2000,Liverpool,Man United,Loss,Home,1999-09-11,0,6,6,6,9,6,9,12,15,0,-3,-6,-6,1,7.0,1.0,6.0,2
8864,8864,1999-00,1999,2000,Liverpool,Leicester,Draw,Away,1999-09-18,1,3,6,6,6,3,6,6,7,0,0,0,-1,0,7.0,10.0,-3.0,2
8865,8865,1999-00,1999,2000,Liverpool,Everton,Loss,Home,1999-09-27,0,1,4,7,7,6,6,9,12,-5,-2,-2,-5,1,7.0,14.0,-7.0,2
8866,8866,1999-00,1999,2000,Liverpool,Aston Villa,Draw,Away,1999-10-02,1,1,1,4,7,3,3,6,9,-2,-2,-2,-2,0,7.0,6.0,1.0,3
8867,8867,1999-00,1999,2000,Liverpool,Chelsea,Win,Home,1999-10-16,3,1,2,2,5,6,6,9,12,-5,-4,-7,-7,1,7.0,3.0,4.0,3
8868,8868,1999-00,1999,2000,Liverpool,Southampton,Draw,Away,1999-10-23,1,4,4,5,5,1,2,2,2,3,2,3,3,0,7.0,17.0,-10.0,3
8869,8869,1999-00,1999,2000,Liverpool,West Ham,Win,Home,1999-10-27,3,4,5,5,6,1,4,4,4,3,1,1,2,1,7.0,5.0,2.0,3
8870,8870,1999-00,1999,2000,Liverpool,Bradford,Win,Home,1999-11-01,3,4,7,8,8,3,3,6,6,1,4,2,2,1,7.0,21.0,-14.0,4
8871,8871,1999-00,1999,2000,Liverpool,Derby,Win,Home,1999-11-06,3,6,7,10,11,3,3,4,4,3,4,6,7,1,7.0,8.0,-1.0,4
8872,8872,1999-00,1999,2000,Liverpool,Sunderland,Win,Away,1999-11-20,3,6,9,10,13,4,5,8,11,2,4,2,2,0,7.0,21.0,-14.0,4
8873,8873,1999-00,1999,2000,Liverpool,West Ham,Loss,Away,1999-11-27,0,6,9,12,13,4,4,4,5,2,5,8,8,0,7.0,5.0,2.0,4
8874,8874,1999-00,1999,2000,Liverpool,Sheffield Weds,Win,Home,1999-12-05,3,3,6,9,12,1,1,2,2,2,5,7,10,1,7.0,12.0,-5.0,5
8875,8875,1999-00,1999,2000,Liverpool,Coventry,Win,Home,1999-12-18,3,3,6,9,12,1,4,5,8,2,2,4,4,1,7.0,15.0,-8.0,5
8876,8876,1999-00,1999,2000,Liverpool,Newcastle,Draw,Away,1999-12-26,1,6,6,9,12,3,6,7,8,3,0,2,4,0,7.0,13.0,-6.0,5
8877,8877,1999-00,1999,2000,Liverpool,Wimbledon,Win,Home,1999-12-28,3,4,7,7,10,2,5,6,6,2,2,1,4,1,7.0,16.0,-9.0,5
8878,8878,1999-00,1999,2000,Liverpool,Tottenham,Loss,Away,2000-01-03,0,4,7,10,10,4,4,5,5,0,3,5,5,0,7.0,11.0,-4.0,6
8879,8879,1999-00,1999,2000,Liverpool,Watford,Win,Away,2000-01-15,3,3,4,7,10,3,3,3,3,0,1,4,7,0,7.0,21.0,-14.0,6
8880,8880,1999-00,1999,2000,Liverpool,Middlesbrough,Draw,Home,2000-01-22,1,3,6,7,10,0,3,4,5,3,3,3,5,1,7.0,9.0,-2.0,6
8881,8881,1999-00,1999,2000,Liverpool,Leeds,Win,Home,2000-02-05,3,4,4,7,8,3,3,6,9,1,1,1,-1,1,7.0,4.0,3.0,7
8882,8882,1999-00,1999,2000,Liverpool,Arsenal,Win,Away,2000-02-13,3,4,7,7,10,1,4,5,8,3,3,2,2,0,7.0,2.0,5.0,7
8883,8883,1999-00,1999,2000,Liverpool,Man United,Draw,Away,2000-03-04,1,6,7,10,10,4,4,7,10,2,3,3,0,0,7.0,1.0,6.0,8
8884,8884,1999-00,1999,2000,Liverpool,Sunderland,Draw,Home,2000-03-11,1,4,7,8,11,1,1,2,2,3,6,6,9,1,7.0,21.0,-14.0,8
8885,8885,1999-00,1999,2000,Liverpool,Aston Villa,Draw,Home,2000-03-15,1,2,5,8,9,4,5,8,11,-2,0,0,-2,1,7.0,6.0,1.0,8
8886,8886,1999-00,1999,2000,Liverpool,Derby,Win,Away,2000-03-18,3,2,3,6,9,3,4,4,5,-1,-1,2,4,0,7.0,8.0,-1.0,8
8887,8887,1999-00,1999,2000,Liverpool,Newcastle,Win,Home,2000-03-25,3,4,5,6,9,6,6,9,12,-2,-1,-3,-3,1,7.0,13.0,-6.0,8
8888,8888,1999-00,1999,2000,Liverpool,Coventry,Win,Away,2000-04-01,3,6,7,8,9,3,6,6,6,3,1,2,3,0,7.0,15.0,-8.0,9
8889,8889,1999-00,1999,2000,Liverpool,Tottenham,Win,Home,2000-04-09,3,6,9,10,11,1,1,4,5,5,8,6,6,1,7.0,11.0,-4.0,9
8890,8890,1999-00,1999,2000,Liverpool,Wimbledon,Win,Away,2000-04-16,3,6,9,12,13,0,0,0,0,6,9,12,13,0,7.0,16.0,-9.0,9
8891,8891,1999-00,1999,2000,Liverpool,Everton,Draw,Away,2000-04-21,1,6,9,12,15,4,7,7,7,2,2,5,8,0,7.0,14.0,-7.0,9
8892,8892,1999-00,1999,2000,Liverpool,Chelsea,Loss,Away,2000-04-29,0,4,7,10,13,1,1,4,7,3,6,6,6,0,7.0,3.0,4.0,9
8893,8893,1999-00,1999,2000,Liverpool,Leicester,Loss,Home,2000-05-03,0,1,4,7,10,4,4,7,8,-3,0,0,2,1,7.0,10.0,-3.0,10
8894,8894,1999-00,1999,2000,Liverpool,Southampton,Draw,Home,2000-05-07,1,0,1,4,7,0,0,3,6,0,1,1,1,1,7.0,17.0,-10.0,10
8895,8895,1999-00,1999,2000,Liverpool,Bradford,Loss,Away,2000-05-14,0,1,1,2,5,3,6,7,7,-2,-5,-5,-2,0,7.0,21.0,-14.0,10
8896,8896,2000-01,2000,2001,Liverpool,Bradford,Win,Home,2000-08-19,3,1,1,1,2,3,6,9,10,-2,-5,-8,-8,1,4.0,17.0,-13.0,1
8897,8897,2000-01,2000,2001,Liverpool,Arsenal,Loss,Away,2000-08-21,0,3,4,4,4,0,1,4,7,3,3,0,-3,0,4.0,2.0,2.0,1
8898,8898,2000-01,2000,2001,Liverpool,Southampton,Draw,Away,2000-08-26,1,3,3,4,4,1,4,5,5,2,-1,-1,-1,0,4.0,15.0,-11.0,1
8899,8899,2000-01,2000,2001,Liverpool,Aston Villa,Win,Home,2000-09-06,3,1,4,4,5,2,2,3,4,-1,2,1,1,1,4.0,6.0,-2.0,2
8900,8900,2000-01,2000,2001,Liverpool,Man City,Win,Home,2000-09-09,3,4,4,7,7,3,6,6,7,1,-2,1,0,1,4.0,21.0,-17.0,2
8901,8901,2000-01,2000,2001,Liverpool,West Ham,Draw,Away,2000-09-17,1,6,7,7,10,1,2,2,2,5,5,5,8,0,4.0,9.0,-5.0,2
8902,8902,2000-01,2000,2001,Liverpool,Sunderland,Draw,Home,2000-09-23,1,4,7,8,8,3,4,4,4,1,3,4,4,1,4.0,7.0,-3.0,2
8903,8903,2000-01,2000,2001,Liverpool,Chelsea,Loss,Away,2000-10-01,0,2,5,8,9,1,2,3,4,1,3,5,5,0,4.0,5.0,-1.0,3
8904,8904,2000-01,2000,2001,Liverpool,Derby,Win,Away,2000-10-15,3,1,2,5,8,1,1,2,3,0,1,3,5,0,4.0,16.0,-12.0,3
8905,8905,2000-01,2000,2001,Liverpool,Leicester,Win,Home,2000-10-21,3,3,4,5,8,1,2,5,8,2,2,0,0,1,4.0,8.0,-4.0,3
8906,8906,2000-01,2000,2001,Liverpool,Everton,Win,Home,2000-10-29,3,6,6,7,8,4,4,5,5,2,2,2,3,1,4.0,13.0,-9.0,3
8907,8907,2000-01,2000,2001,Liverpool,Leeds,Loss,Away,2000-11-04,0,6,9,9,10,1,4,7,8,5,5,2,2,0,4.0,3.0,1.0,4
8908,8908,2000-01,2000,2001,Liverpool,Coventry,Win,Home,2000-11-12,3,3,6,9,9,0,0,3,4,3,6,6,5,1,4.0,14.0,-10.0,4
8909,8909,2000-01,2000,2001,Liverpool,Tottenham,Loss,Away,2000-11-19,0,3,6,9,12,3,3,6,6,0,3,3,6,0,4.0,10.0,-6.0,4
8910,8910,2000-01,2000,2001,Liverpool,Newcastle,Loss,Away,2000-11-26,0,3,3,6,9,1,4,4,4,2,-1,2,5,0,4.0,11.0,-7.0,4
8911,8911,2000-01,2000,2001,Liverpool,Charlton,Win,Home,2000-12-02,3,0,3,3,6,3,3,6,6,-3,0,-3,0,1,4.0,21.0,-17.0,5
8912,8912,2000-01,2000,2001,Liverpool,Ipswich,Loss,Home,2000-12-10,0,3,3,6,6,3,6,9,9,0,-3,-3,-3,1,4.0,21.0,-17.0,5
8913,8913,2000-01,2000,2001,Liverpool,Man United,Win,Away,2000-12-17,3,3,3,3,6,4,7,10,13,-1,-4,-7,-7,0,4.0,1.0,3.0,5
8914,8914,2000-01,2000,2001,Liverpool,Arsenal,Win,Home,2000-12-23,3,3,6,6,6,4,7,7,7,-1,-1,-1,-1,1,4.0,2.0,2.0,5
8915,8915,2000-01,2000,2001,Liverpool,Middlesbrough,Loss,Away,2000-12-26,0,6,6,9,9,4,4,4,5,2,2,5,4,0,4.0,12.0,-8.0,5
8916,8916,2000-01,2000,2001,Liverpool,Southampton,Win,Home,2001-01-01,3,3,6,6,9,6,7,7,10,-3,-1,-1,-1,1,4.0,15.0,-11.0,6
8917,8917,2000-01,2000,2001,Liverpool,Aston Villa,Win,Away,2001-01-13,3,3,6,9,9,0,3,4,5,3,3,5,4,0,4.0,6.0,-2.0,6
8918,8918,2000-01,2000,2001,Liverpool,Middlesbrough,Draw,Home,2001-01-20,1,6,6,9,12,4,5,8,9,2,1,1,3,1,4.0,12.0,-8.0,6
8919,8919,2000-01,2000,2001,Liverpool,Man City,Draw,Away,2001-01-31,1,4,7,7,10,1,2,2,3,3,5,5,7,0,4.0,21.0,-17.0,6
8920,8920,2000-01,2000,2001,Liverpool,West Ham,Win,Home,2001-02-03,3,2,5,8,8,2,2,2,5,0,3,6,3,1,4.0,9.0,-5.0,7
8921,8921,2000-01,2000,2001,Liverpool,Sunderland,Draw,Away,2001-02-10,1,4,5,8,11,0,1,4,7,4,4,4,4,0,4.0,7.0,-3.0,7
8922,8922,2000-01,2000,2001,Liverpool,Leicester,Loss,Away,2001-03-03,0,4,5,6,9,3,6,6,7,1,-1,0,2,0,4.0,8.0,-4.0,8
8923,8923,2000-01,2000,2001,Liverpool,Derby,Draw,Home,2001-03-18,1,1,4,5,6,6,7,10,10,-5,-3,-5,-4,1,4.0,16.0,-12.0,8
8924,8924,2000-01,2000,2001,Liverpool,Man United,Win,Home,2001-03-31,3,1,2,5,6,4,7,8,11,-3,-5,-3,-5,1,4.0,1.0,3.0,8
8925,8925,2000-01,2000,2001,Liverpool,Ipswich,Draw,Away,2001-04-10,1,4,4,5,8,6,6,9,12,-2,-2,-4,-4,0,4.0,21.0,-17.0,9
8926,8926,2000-01,2000,2001,Liverpool,Leeds,Loss,Home,2001-04-13,0,4,5,5,6,6,9,10,13,-2,-4,-5,-7,1,4.0,3.0,1.0,9
8927,8927,2000-01,2000,2001,Liverpool,Everton,Win,Away,2001-04-16,3,1,4,5,5,3,6,6,7,-2,-2,-1,-2,0,4.0,13.0,-9.0,9
8928,8928,2000-01,2000,2001,Liverpool,Tottenham,Win,Home,2001-04-22,3,3,4,7,8,3,6,6,9,0,-2,1,-1,1,4.0,10.0,-6.0,9
8929,8929,2000-01,2000,2001,Liverpool,Coventry,Win,Away,2001-04-28,3,6,6,7,10,3,3,6,9,3,3,1,1,0,4.0,14.0,-10.0,9
8930,8930,2000-01,2000,2001,Liverpool,Bradford,Win,Away,2001-05-01,3,6,9,9,10,3,6,6,7,3,3,3,3,0,4.0,17.0,-13.0,10
8931,8931,2000-01,2000,2001,Liverpool,Newcastle,Win,Home,2001-05-05,3,6,9,12,12,4,5,8,8,2,4,4,4,1,4.0,11.0,-7.0,10
8932,8932,2000-01,2000,2001,Liverpool,Chelsea,Draw,Home,2001-05-08,1,6,9,12,15,3,3,6,9,3,6,6,6,1,4.0,5.0,-1.0,10
8933,8933,2000-01,2000,2001,Liverpool,Charlton,Win,Away,2001-05-19,3,4,7,10,13,3,6,7,7,1,1,3,6,0,4.0,21.0,-17.0,10
8934,8934,2001-02,2001,2002,Liverpool,West Ham,Win,Home,2001-08-18,3,4,7,10,13,3,3,3,3,1,4,7,10,1,3.0,15.0,-12.0,1
8935,8935,2001-02,2001,2002,Liverpool,Bolton,Loss,Away,2001-08-27,0,6,7,10,13,6,6,9,12,0,1,1,1,0,3.0,21.0,-18.0,1
8936,8936,2001-02,2001,2002,Liverpool,Aston Villa,Loss,Home,2001-09-08,0,3,6,7,10,2,2,5,6,1,4,2,4,1,3.0,8.0,-5.0,2
8937,8937,2001-02,2001,2002,Liverpool,Everton,Win,Away,2001-09-15,3,0,3,6,7,3,4,7,8,-3,-1,-1,-1,0,3.0,16.0,-13.0,2
8938,8938,2001-02,2001,2002,Liverpool,Tottenham,Win,Home,2001-09-22,3,3,3,6,9,3,6,6,7,0,-3,0,2,1,3.0,12.0,-9.0,2
8939,8939,2001-02,2001,2002,Liverpool,Newcastle,Win,Away,2001-09-30,3,6,6,6,9,3,6,9,10,3,0,-3,-1,0,3.0,11.0,-8.0,2
8940,8940,2001-02,2001,2002,Liverpool,Leeds,Draw,Home,2001-10-13,1,6,9,9,9,6,9,10,11,0,0,-1,-2,1,3.0,4.0,-1.0,3
8941,8941,2001-02,2001,2002,Liverpool,Leicester,Win,Away,2001-10-20,3,4,7,10,10,0,0,1,1,4,7,9,9,0,3.0,13.0,-10.0,3
8942,8942,2001-02,2001,2002,Liverpool,Charlton,Win,Away,2001-10-27,3,4,7,10,13,1,2,5,6,3,5,5,7,0,3.0,9.0,-6.0,3
8943,8943,2001-02,2001,2002,Liverpool,Man United,Win,Home,2001-11-04,3,6,7,10,13,1,4,7,10,5,3,3,3,1,3.0,1.0,2.0,4
8944,8944,2001-02,2001,2002,Liverpool,Blackburn,Draw,Away,2001-11-17,1,6,9,10,13,4,5,8,8,2,4,2,5,0,3.0,21.0,-18.0,4
8945,8945,2001-02,2001,2002,Liverpool,Sunderland,Win,Home,2001-11-25,3,4,7,10,11,3,4,4,4,1,3,6,7,1,3.0,7.0,-4.0,4
8946,8946,2001-02,2001,2002,Liverpool,Derby,Win,Away,2001-12-01,3,4,7,10,13,3,3,4,5,1,4,6,8,0,3.0,17.0,-14.0,5
8947,8947,2001-02,2001,2002,Liverpool,Middlesbrough,Win,Home,2001-12-08,3,6,7,10,13,4,5,8,8,2,2,2,5,1,3.0,14.0,-11.0,5
8948,8948,2001-02,2001,2002,Liverpool,Fulham,Draw,Home,2001-12-12,1,6,9,10,13,4,5,8,11,2,4,2,2,1,3.0,21.0,-18.0,5
8949,8949,2001-02,2001,2002,Liverpool,Chelsea,Loss,Away,2001-12-16,0,4,7,10,11,1,4,5,6,3,3,5,5,0,3.0,6.0,-3.0,5
8950,8950,2001-02,2001,2002,Liverpool,Arsenal,Loss,Home,2001-12-23,0,1,4,7,10,1,4,7,10,0,0,0,0,1,3.0,2.0,1.0,5
8951,8951,2001-02,2001,2002,Liverpool,Aston Villa,Win,Away,2001-12-26,3,0,1,4,7,3,3,4,4,-3,-2,0,3,0,3.0,8.0,-5.0,5
8952,8952,2001-02,2001,2002,Liverpool,West Ham,Draw,Away,2001-12-29,1,3,3,4,7,4,5,8,9,-1,-2,-4,-2,0,3.0,15.0,-12.0,5
8953,8953,2001-02,2001,2002,Liverpool,Bolton,Draw,Home,2002-01-01,1,4,4,4,5,1,1,2,2,3,3,2,3,1,3.0,21.0,-18.0,6
8954,8954,2001-02,2001,2002,Liverpool,Southampton,Loss,Away,2002-01-09,0,2,5,5,5,3,6,6,9,-1,-1,-1,-4,0,3.0,10.0,-7.0,6
8955,8955,2001-02,2001,2002,Liverpool,Arsenal,Draw,Away,2002-01-13,1,1,2,5,5,6,9,9,10,-5,-7,-4,-5,0,3.0,2.0,1.0,6
8956,8956,2001-02,2001,2002,Liverpool,Southampton,Draw,Home,2002-01-19,1,1,2,3,6,3,6,6,9,-2,-4,-3,-3,1,3.0,10.0,-7.0,6
8957,8957,2001-02,2001,2002,Liverpool,Man United,Win,Away,2002-01-22,3,2,2,3,4,6,9,12,15,-4,-7,-9,-11,0,3.0,1.0,2.0,6
8958,8958,2001-02,2001,2002,Liverpool,Leicester,Win,Home,2002-01-30,3,4,5,5,6,1,1,2,2,3,4,3,4,1,3.0,13.0,-10.0,6
8959,8959,2001-02,2001,2002,Liverpool,Leeds,Win,Away,2002-02-03,3,6,7,8,8,1,1,4,7,5,6,4,1,0,3.0,4.0,-1.0,7
8960,8960,2001-02,2001,2002,Liverpool,Ipswich,Win,Away,2002-02-09,3,6,9,10,11,6,9,12,12,0,0,-2,-1,0,3.0,5.0,-2.0,7
8961,8961,2001-02,2001,2002,Liverpool,Everton,Draw,Home,2002-02-23,1,6,9,12,13,0,1,2,5,6,8,10,8,1,3.0,16.0,-13.0,7
8962,8962,2001-02,2001,2002,Liverpool,Fulham,Win,Away,2002-03-02,3,4,7,10,13,0,3,4,4,4,4,6,9,0,3.0,21.0,-18.0,8
8963,8963,2001-02,2001,2002,Liverpool,Newcastle,Win,Home,2002-03-06,3,4,7,10,13,3,6,9,12,1,1,1,1,1,3.0,11.0,-8.0,8
8964,8964,2001-02,2001,2002,Liverpool,Middlesbrough,Win,Away,2002-03-16,3,6,7,10,13,4,4,7,8,2,3,3,5,0,3.0,14.0,-11.0,8
8965,8965,2001-02,2001,2002,Liverpool,Chelsea,Win,Home,2002-03-24,3,6,9,10,13,6,9,9,10,0,0,1,3,1,3.0,6.0,-3.0,8
8966,8966,2001-02,2001,2002,Liverpool,Charlton,Win,Home,2002-03-30,3,6,9,12,13,3,4,7,8,3,5,5,5,1,3.0,9.0,-6.0,8
8967,8967,2001-02,2001,2002,Liverpool,Sunderland,Win,Away,2002-04-13,3,6,9,12,15,3,3,4,4,3,6,8,11,0,3.0,7.0,-4.0,9
8968,8968,2001-02,2001,2002,Liverpool,Derby,Win,Home,2002-04-20,3,6,9,12,15,0,0,0,0,6,9,12,15,1,3.0,17.0,-14.0,9
8969,8969,2001-02,2001,2002,Liverpool,Tottenham,Loss,Away,2002-04-27,0,6,9,12,15,2,2,5,6,4,7,7,9,0,3.0,12.0,-9.0,9
8970,8970,2001-02,2001,2002,Liverpool,Blackburn,Win,Home,2002-05-08,3,3,6,9,12,4,7,8,11,-1,-1,1,1,1,3.0,21.0,-18.0,10
8971,8971,2001-02,2001,2002,Liverpool,Ipswich,Win,Home,2002-05-11,3,3,6,9,12,3,3,3,4,0,3,6,8,1,3.0,5.0,-2.0,10
8972,8972,2002-03,2002,2003,Liverpool,Aston Villa,Win,Away,2002-08-18,3,6,6,9,12,6,7,7,7,0,-1,2,5,0,2.0,8.0,-6.0,1
8973,8973,2002-03,2002,2003,Liverpool,Southampton,Win,Home,2002-08-24,3,6,9,9,12,4,4,4,5,2,5,5,7,1,2.0,11.0,-9.0,1
8974,8974,2002-03,2002,2003,Liverpool,Blackburn,Draw,Away,2002-08-28,1,6,9,12,12,4,7,7,10,2,2,5,2,0,2.0,10.0,-8.0,1
8975,8975,2002-03,2002,2003,Liverpool,Newcastle,Draw,Home,2002-09-02,1,4,7,10,13,3,3,6,7,1,4,4,6,1,2.0,4.0,-2.0,2
8976,8976,2002-03,2002,2003,Liverpool,Birmingham,Draw,Home,2002-09-11,1,2,5,8,11,4,4,4,4,-2,1,4,7,1,2.0,21.0,-19.0,2
8977,8977,2002-03,2002,2003,Liverpool,Bolton,Win,Away,2002-09-14,3,2,3,6,9,6,6,6,6,-4,-3,0,3,0,2.0,16.0,-14.0,2
8978,8978,2002-03,2002,2003,Liverpool,West Brom,Win,Home,2002-09-21,3,4,5,6,9,6,9,9,9,-2,-4,-3,0,1,2.0,21.0,-19.0,2
8979,8979,2002-03,2002,2003,Liverpool,Man City,Win,Away,2002-09-28,3,6,7,8,9,2,2,5,5,4,5,3,4,0,2.0,21.0,-19.0,2
8980,8980,2002-03,2002,2003,Liverpool,Chelsea,Win,Home,2002-10-06,3,6,9,10,11,1,4,7,8,5,5,3,3,1,2.0,6.0,-4.0,3
8981,8981,2002-03,2002,2003,Liverpool,Leeds,Win,Away,2002-10-19,3,6,9,12,13,1,1,4,7,5,8,8,6,0,2.0,5.0,-3.0,3
8982,8982,2002-03,2002,2003,Liverpool,Tottenham,Win,Home,2002-10-26,3,6,9,12,15,6,6,6,9,0,3,6,6,1,2.0,9.0,-7.0,3
8983,8983,2002-03,2002,2003,Liverpool,West Ham,Win,Home,2002-11-02,3,6,9,12,15,3,6,6,9,3,3,6,6,1,2.0,7.0,-5.0,4
8984,8984,2002-03,2002,2003,Liverpool,Middlesbrough,Loss,Away,2002-11-09,0,6,9,12,15,1,1,4,7,5,8,8,8,0,2.0,12.0,-10.0,4
8985,8985,2002-03,2002,2003,Liverpool,Sunderland,Draw,Home,2002-11-17,1,3,6,9,12,4,5,5,5,-1,1,4,7,1,2.0,17.0,-15.0,4
8986,8986,2002-03,2002,2003,Liverpool,Fulham,Loss,Away,2002-11-23,0,1,4,7,10,1,1,1,1,0,3,6,9,0,2.0,13.0,-11.0,4
8987,8987,2002-03,2002,2003,Liverpool,Man United,Loss,Home,2002-12-01,0,1,1,4,7,4,4,7,8,-3,-3,-3,-1,1,2.0,3.0,-1.0,5
8988,8988,2002-03,2002,2003,Liverpool,Charlton,Loss,Away,2002-12-07,0,0,1,1,4,6,9,9,10,-6,-8,-8,-6,0,2.0,14.0,-12.0,5
8989,8989,2002-03,2002,2003,Liverpool,Sunderland,Loss,Away,2002-12-15,0,0,0,1,1,0,0,1,4,0,0,0,-3,0,2.0,17.0,-15.0,5
8990,8990,2002-03,2002,2003,Liverpool,Everton,Draw,Home,2002-12-22,1,0,0,0,1,3,3,6,9,-3,-3,-6,-8,1,2.0,15.0,-13.0,5
8991,8991,2002-03,2002,2003,Liverpool,Blackburn,Draw,Home,2002-12-26,1,1,1,1,1,3,4,7,7,-2,-3,-6,-6,1,2.0,10.0,-8.0,5
8992,8992,2002-03,2002,2003,Liverpool,Arsenal,Draw,Away,2002-12-29,1,2,2,2,2,6,7,7,10,-4,-5,-5,-8,0,2.0,1.0,1.0,5
8993,8993,2002-03,2002,2003,Liverpool,Newcastle,Loss,Away,2003-01-01,0,2,3,3,3,3,6,7,10,-1,-3,-4,-7,0,2.0,4.0,-2.0,6
8994,8994,2002-03,2002,2003,Liverpool,Aston Villa,Draw,Home,2003-01-11,1,1,2,3,3,6,6,6,9,-5,-4,-3,-6,1,2.0,8.0,-6.0,6
8995,8995,2002-03,2002,2003,Liverpool,Southampton,Win,Away,2003-01-18,3,1,2,3,4,4,7,8,9,-3,-5,-5,-5,0,2.0,11.0,-9.0,6
8996,8996,2002-03,2002,2003,Liverpool,Arsenal,Draw,Home,2003-01-29,1,4,4,5,6,6,9,10,13,-2,-5,-5,-7,1,2.0,1.0,1.0,6
8997,8997,2002-03,2002,2003,Liverpool,West Ham,Win,Away,2003-02-02,3,4,5,5,6,3,3,4,5,1,2,1,1,0,2.0,7.0,-5.0,7
8998,8998,2002-03,2002,2003,Liverpool,Middlesbrough,Draw,Home,2003-02-08,1,4,7,8,8,0,1,1,1,4,6,7,7,1,2.0,12.0,-10.0,7
8999,8999,2002-03,2002,2003,Liverpool,Birmingham,Loss,Away,2003-02-23,0,4,5,8,9,0,0,1,1,4,5,7,8,0,2.0,21.0,-19.0,7
9000,9000,2002-03,2002,2003,Liverpool,Bolton,Win,Home,2003-03-08,3,1,4,5,8,2,5,5,5,-1,-1,0,3,1,2.0,16.0,-14.0,8
9001,9001,2002-03,2002,2003,Liverpool,Tottenham,Win,Away,2003-03-16,3,3,4,7,8,1,4,5,5,2,0,2,3,0,2.0,9.0,-7.0,8
9002,9002,2002-03,2002,2003,Liverpool,Leeds,Win,Home,2003-03-23,3,6,6,7,10,0,0,3,3,6,6,4,7,1,2.0,5.0,-3.0,8
9003,9003,2002-03,2002,2003,Liverpool,Man United,Loss,Away,2003-04-05,0,6,9,9,10,6,9,10,11,0,0,-1,-1,0,2.0,3.0,-1.0,9
9004,9004,2002-03,2002,2003,Liverpool,Fulham,Win,Home,2003-04-12,3,3,6,9,9,0,1,4,5,3,5,5,4,1,2.0,13.0,-11.0,9
9005,9005,2002-03,2002,2003,Liverpool,Everton,Win,Away,2003-04-19,3,3,6,9,12,6,6,7,8,-3,0,2,4,0,2.0,15.0,-13.0,9
9006,9006,2002-03,2002,2003,Liverpool,Charlton,Win,Home,2003-04-21,3,6,6,9,12,0,0,1,1,6,6,8,11,1,2.0,14.0,-12.0,9
9007,9007,2002-03,2002,2003,Liverpool,West Brom,Win,Away,2003-04-26,3,6,9,9,12,3,3,3,3,3,6,6,9,0,2.0,21.0,-19.0,9
9008,9008,2002-03,2002,2003,Liverpool,Man City,Loss,Home,2003-05-03,0,6,9,12,12,3,6,7,7,3,3,5,5,1,2.0,21.0,-19.0,10
9009,9009,2002-03,2002,2003,Liverpool,Chelsea,Loss,Away,2003-05-11,0,3,6,9,12,1,4,4,7,2,2,5,5,0,2.0,6.0,-4.0,10
9010,9010,2003-04,2003,2004,Liverpool,Chelsea,Loss,Home,2003-08-17,0,0,3,6,9,3,4,7,7,-3,-1,-1,2,1,5.0,4.0,1.0,1
9011,9011,2003-04,2003,2004,Liverpool,Aston Villa,Draw,Away,2003-08-24,1,0,0,3,6,0,3,3,4,0,-3,0,2,0,5.0,16.0,-11.0,1
9012,9012,2003-04,2003,2004,Liverpool,Tottenham,Draw,Home,2003-08-27,1,1,1,1,4,3,3,3,3,-2,-2,-2,1,1,5.0,10.0,-5.0,1
9013,9013,2003-04,2003,2004,Liverpool,Everton,Win,Away,2003-08-30,3,2,2,2,2,4,4,4,4,-2,-2,-2,-2,0,5.0,7.0,-2.0,1
9014,9014,2003-04,2003,2004,Liverpool,Blackburn,Win,Away,2003-09-13,3,4,5,5,5,1,2,5,8,3,3,0,-3,0,5.0,6.0,-1.0,2
9015,9015,2003-04,2003,2004,Liverpool,Leicester,Win,Home,2003-09-20,3,6,7,8,8,3,4,4,5,3,3,4,3,1,5.0,21.0,-16.0,2
9016,9016,2003-04,2003,2004,Liverpool,Charlton,Loss,Away,2003-09-28,0,6,9,10,11,0,1,2,5,6,8,8,6,0,5.0,12.0,-7.0,2
9017,9017,2003-04,2003,2004,Liverpool,Arsenal,Loss,Home,2003-10-04,0,3,6,9,10,4,5,8,11,-1,1,1,-1,1,5.0,2.0,3.0,3
9018,9018,2003-04,2003,2004,Liverpool,Portsmouth,Loss,Away,2003-10-18,0,0,3,6,9,0,0,1,2,0,3,5,7,0,5.0,21.0,-16.0,3
9019,9019,2003-04,2003,2004,Liverpool,Leeds,Win,Home,2003-10-25,3,0,0,3,6,3,3,3,3,-3,-3,0,3,1,5.0,15.0,-10.0,3
9020,9020,2003-04,2003,2004,Liverpool,Fulham,Win,Away,2003-11-02,3,3,3,3,6,3,4,7,10,0,-1,-4,-4,0,5.0,14.0,-9.0,4
9021,9021,2003-04,2003,2004,Liverpool,Man United,Loss,Home,2003-11-09,0,6,6,6,6,3,6,9,12,3,0,-3,-6,1,5.0,1.0,4.0,4
9022,9022,2003-04,2003,2004,Liverpool,Middlesbrough,Draw,Away,2003-11-22,1,3,6,6,6,6,7,7,7,-3,-1,-1,-1,0,5.0,11.0,-6.0,4
9023,9023,2003-04,2003,2004,Liverpool,Birmingham,Win,Home,2003-11-30,3,1,4,7,7,1,1,4,5,0,3,3,2,1,5.0,13.0,-8.0,4
9024,9024,2003-04,2003,2004,Liverpool,Newcastle,Draw,Away,2003-12-06,1,4,4,7,10,4,4,5,8,0,0,2,2,0,5.0,3.0,2.0,5
9025,9025,2003-04,2003,2004,Liverpool,Southampton,Loss,Home,2003-12-13,0,4,5,5,8,3,3,4,4,1,2,1,4,1,5.0,8.0,-3.0,5
9026,9026,2003-04,2003,2004,Liverpool,Bolton,Win,Home,2003-12-26,3,1,4,5,5,4,4,7,10,-3,0,-2,-5,1,5.0,17.0,-12.0,5
9027,9027,2003-04,2003,2004,Liverpool,Man City,Draw,Away,2003-12-28,1,3,4,7,8,1,1,2,2,2,3,5,6,0,5.0,9.0,-4.0,5
9028,9028,2003-04,2003,2004,Liverpool,Chelsea,Win,Away,2004-01-07,3,4,4,5,8,3,6,6,7,1,-2,-1,1,0,5.0,4.0,1.0,6
9029,9029,2003-04,2003,2004,Liverpool,Aston Villa,Win,Home,2004-01-10,3,4,7,7,8,6,7,10,13,-2,0,-3,-5,1,5.0,16.0,-11.0,6
9030,9030,2003-04,2003,2004,Liverpool,Tottenham,Loss,Away,2004-01-17,0,6,7,10,10,6,6,6,6,0,1,4,4,0,5.0,10.0,-5.0,6
9031,9031,2003-04,2003,2004,Liverpool,Wolves,Draw,Away,2004-01-21,1,3,6,7,10,3,4,7,7,0,2,0,3,0,5.0,21.0,-16.0,6
9032,9032,2003-04,2003,2004,Liverpool,Everton,Draw,Home,2004-01-31,1,1,4,7,8,0,1,4,4,1,3,3,4,1,5.0,7.0,-2.0,6
9033,9033,2003-04,2003,2004,Liverpool,Bolton,Draw,Away,2004-02-07,1,2,2,5,8,6,9,9,10,-4,-7,-4,-2,0,5.0,17.0,-12.0,7
9034,9034,2003-04,2003,2004,Liverpool,Man City,Win,Home,2004-02-11,3,2,3,3,6,1,2,2,3,1,1,1,3,1,5.0,9.0,-4.0,7
9035,9035,2003-04,2003,2004,Liverpool,Leeds,Draw,Away,2004-02-29,1,4,5,6,6,4,4,4,4,0,1,2,2,0,5.0,15.0,-10.0,7
9036,9036,2003-04,2003,2004,Liverpool,Southampton,Loss,Away,2004-03-14,0,4,5,6,7,2,2,3,3,2,3,3,4,0,5.0,8.0,-3.0,8
9037,9037,2003-04,2003,2004,Liverpool,Portsmouth,Win,Home,2004-03-17,3,1,4,5,6,1,1,1,2,0,3,4,4,1,5.0,21.0,-16.0,8
9038,9038,2003-04,2003,2004,Liverpool,Wolves,Win,Home,2004-03-20,3,3,4,7,8,1,4,4,4,2,0,3,4,1,5.0,21.0,-16.0,8
9039,9039,2003-04,2003,2004,Liverpool,Leicester,Draw,Away,2004-03-28,1,6,6,7,10,4,5,6,7,2,1,1,3,0,5.0,21.0,-16.0,8
9040,9040,2003-04,2003,2004,Liverpool,Blackburn,Win,Home,2004-04-04,3,4,7,7,8,3,3,4,4,1,4,3,4,1,5.0,6.0,-1.0,9
9041,9041,2003-04,2003,2004,Liverpool,Arsenal,Loss,Away,2004-04-09,0,4,7,10,10,4,7,10,13,0,0,0,-3,0,5.0,2.0,3.0,9
9042,9042,2003-04,2003,2004,Liverpool,Charlton,Loss,Home,2004-04-12,0,3,4,7,10,1,1,4,4,2,3,3,6,1,5.0,12.0,-7.0,9
9043,9043,2003-04,2003,2004,Liverpool,Fulham,Draw,Home,2004-04-17,1,0,3,4,7,3,4,5,5,-3,-1,-1,2,1,5.0,14.0,-9.0,9
9044,9044,2003-04,2003,2004,Liverpool,Man United,Win,Away,2004-04-24,3,1,1,4,5,3,6,9,10,-2,-5,-5,-5,0,5.0,1.0,4.0,9
9045,9045,2003-04,2003,2004,Liverpool,Middlesbrough,Win,Home,2004-05-02,3,4,4,4,7,0,3,4,7,4,1,0,0,1,5.0,11.0,-6.0,10
9046,9046,2003-04,2003,2004,Liverpool,Birmingham,Win,Away,2004-05-08,3,6,7,7,7,2,3,3,3,4,4,4,4,0,5.0,13.0,-8.0,10
9047,9047,2003-04,2003,2004,Liverpool,Newcastle,Draw,Home,2004-05-15,1,6,9,10,10,2,2,5,6,4,7,5,4,1,5.0,3.0,2.0,10
9048,9048,2004-05,2004,2005,Liverpool,Tottenham,Draw,Away,2004-08-14,1,4,7,10,11,6,6,7,7,-2,1,3,4,0,4.0,14.0,-10.0,1
9049,9049,2004-05,2004,2005,Liverpool,Man City,Win,Home,2004-08-21,3,2,5,8,11,4,4,7,8,-2,1,1,3,1,4.0,16.0,-12.0,1
9050,9050,2004-05,2004,2005,Liverpool,Bolton,Loss,Away,2004-08-29,0,4,5,8,11,3,6,6,9,1,-1,2,2,0,4.0,8.0,-4.0,1
9051,9051,2004-05,2004,2005,Liverpool,West Brom,Win,Home,2004-09-11,3,3,4,5,8,1,2,3,4,2,2,2,4,1,4.0,21.0,-17.0,2
9052,9052,2004-05,2004,2005,Liverpool,Man United,Loss,Away,2004-09-20,0,3,6,7,8,2,3,6,6,1,3,1,2,0,4.0,3.0,1.0,2
9053,9053,2004-05,2004,2005,Liverpool,Norwich,Win,Home,2004-09-25,3,3,3,6,7,2,2,3,3,1,1,3,4,1,4.0,21.0,-17.0,2
9054,9054,2004-05,2004,2005,Liverpool,Chelsea,Loss,Away,2004-10-03,0,3,6,6,9,4,5,8,11,-1,1,-2,-2,0,4.0,2.0,2.0,3
9055,9055,2004-05,2004,2005,Liverpool,Fulham,Win,Away,2004-10-16,3,3,3,6,6,3,4,4,4,0,-1,2,2,0,4.0,9.0,-5.0,3
9056,9056,2004-05,2004,2005,Liverpool,Charlton,Win,Home,2004-10-23,3,3,6,6,9,1,4,5,6,2,2,1,3,1,4.0,7.0,-3.0,3
9057,9057,2004-05,2004,2005,Liverpool,Blackburn,Draw,Away,2004-10-30,1,6,6,9,9,0,1,1,4,6,5,8,5,0,4.0,15.0,-11.0,3
9058,9058,2004-05,2004,2005,Liverpool,Birmingham,Loss,Home,2004-11-06,0,4,7,7,10,1,2,3,4,3,5,4,6,1,4.0,10.0,-6.0,4
9059,9059,2004-05,2004,2005,Liverpool,Crystal Palace,Win,Home,2004-11-13,3,1,4,7,7,4,7,7,10,-3,-3,0,-3,1,4.0,21.0,-17.0,4
9060,9060,2004-05,2004,2005,Liverpool,Middlesbrough,Loss,Away,2004-11-20,0,3,4,7,10,4,7,8,11,-1,-3,-1,-1,0,4.0,11.0,-7.0,4
9061,9061,2004-05,2004,2005,Liverpool,Arsenal,Win,Home,2004-11-28,3,3,3,4,7,4,5,6,6,-1,-2,-2,1,1,4.0,1.0,3.0,4
9062,9062,2004-05,2004,2005,Liverpool,Aston Villa,Draw,Away,2004-12-04,1,3,6,6,7,3,6,9,10,0,0,-3,-3,0,4.0,6.0,-2.0,5
9063,9063,2004-05,2004,2005,Liverpool,Everton,Loss,Away,2004-12-11,0,4,4,7,7,4,7,10,10,0,-3,-3,-3,0,4.0,17.0,-13.0,5
9064,9064,2004-05,2004,2005,Liverpool,Portsmouth,Draw,Home,2004-12-14,1,1,4,4,7,4,7,7,7,-3,-3,-3,0,1,4.0,13.0,-9.0,5
9065,9065,2004-05,2004,2005,Liverpool,Newcastle,Win,Home,2004-12-19,3,1,2,5,5,1,2,5,5,0,0,0,0,1,4.0,5.0,-1.0,5
9066,9066,2004-05,2004,2005,Liverpool,West Brom,Win,Away,2004-12-26,3,4,4,5,8,0,0,0,1,4,4,5,7,0,4.0,21.0,-17.0,5
9067,9067,2004-05,2004,2005,Liverpool,Southampton,Win,Home,2004-12-28,3,6,7,7,8,1,2,2,3,5,5,5,5,1,4.0,12.0,-8.0,5
9068,9068,2004-05,2004,2005,Liverpool,Chelsea,Loss,Home,2005-01-01,0,6,9,10,10,6,9,10,13,0,0,0,-3,1,4.0,2.0,2.0,6
9069,9069,2004-05,2004,2005,Liverpool,Norwich,Win,Away,2005-01-03,3,3,6,9,10,1,1,1,4,2,5,8,6,0,4.0,21.0,-17.0,6
9070,9070,2004-05,2004,2005,Liverpool,Man United,Loss,Home,2005-01-15,0,3,6,9,12,4,7,10,13,-1,-1,-1,-1,1,4.0,3.0,1.0,6
9071,9071,2004-05,2004,2005,Liverpool,Southampton,Loss,Away,2005-01-22,0,3,3,6,9,1,1,1,2,2,2,5,7,0,4.0,12.0,-8.0,6
9072,9072,2004-05,2004,2005,Liverpool,Charlton,Win,Away,2005-02-01,3,0,3,3,6,6,6,6,9,-6,-3,-3,-3,0,4.0,7.0,-3.0,7
9073,9073,2004-05,2004,2005,Liverpool,Fulham,Win,Home,2005-02-05,3,3,3,6,6,4,7,8,11,-1,-4,-2,-5,1,4.0,9.0,-5.0,7
9074,9074,2004-05,2004,2005,Liverpool,Birmingham,Loss,Away,2005-02-12,0,6,6,6,9,3,3,3,3,3,3,3,6,0,4.0,10.0,-6.0,7
9075,9075,2004-05,2004,2005,Liverpool,Newcastle,Loss,Away,2005-03-05,0,3,6,6,6,4,5,5,8,-1,1,1,-2,0,4.0,5.0,-1.0,8
9076,9076,2004-05,2004,2005,Liverpool,Blackburn,Draw,Home,2005-03-16,1,0,3,6,6,6,6,6,6,-6,-3,0,0,1,4.0,15.0,-11.0,8
9077,9077,2004-05,2004,2005,Liverpool,Everton,Win,Home,2005-03-20,3,1,1,4,7,3,3,4,7,-2,-2,0,0,1,4.0,17.0,-13.0,8
9078,9078,2004-05,2004,2005,Liverpool,Bolton,Win,Home,2005-04-02,3,4,4,4,7,6,6,7,10,-2,-2,-3,-3,1,4.0,8.0,-4.0,9
9079,9079,2004-05,2004,2005,Liverpool,Man City,Loss,Away,2005-04-09,0,6,7,7,7,1,1,4,4,5,6,3,3,0,4.0,16.0,-12.0,9
9080,9080,2004-05,2004,2005,Liverpool,Tottenham,Draw,Home,2005-04-16,1,3,6,7,7,4,7,7,7,-1,-1,0,0,1,4.0,14.0,-10.0,9
9081,9081,2004-05,2004,2005,Liverpool,Portsmouth,Win,Away,2005-04-20,3,1,4,7,8,4,4,5,5,-3,0,2,3,0,4.0,13.0,-9.0,9
9082,9082,2004-05,2004,2005,Liverpool,Crystal Palace,Loss,Away,2005-04-23,0,4,4,7,10,1,1,1,1,3,3,6,9,0,4.0,21.0,-17.0,9
9083,9083,2004-05,2004,2005,Liverpool,Middlesbrough,Draw,Home,2005-04-30,1,3,4,4,7,4,5,5,8,-1,-1,-1,-1,1,4.0,11.0,-7.0,9
9084,9084,2004-05,2004,2005,Liverpool,Arsenal,Loss,Away,2005-05-08,0,1,4,5,5,6,7,10,13,-5,-3,-5,-8,0,4.0,1.0,3.0,10
9085,9085,2004-05,2004,2005,Liverpool,Aston Villa,Win,Home,2005-05-15,3,1,1,4,5,0,1,2,5,1,0,2,0,1,4.0,6.0,-2.0,10
9086,9086,2005-06,2005,2006,Liverpool,Middlesbrough,Draw,Away,2005-08-13,1,3,4,4,7,4,5,6,9,-1,-1,-2,-2,0,5.0,7.0,-2.0,1
9087,9087,2005-06,2005,2006,Liverpool,Sunderland,Win,Home,2005-08-20,3,4,4,5,5,0,0,0,0,4,4,5,5,1,5.0,21.0,-16.0,1
9088,9088,2005-06,2005,2006,Liverpool,Tottenham,Draw,Away,2005-09-10,1,4,7,7,8,1,4,7,8,3,3,0,0,0,5.0,9.0,-4.0,2
9089,9089,2005-06,2005,2006,Liverpool,Man United,Draw,Home,2005-09-18,1,4,5,8,8,4,7,10,13,0,-2,-2,-5,1,5.0,3.0,2.0,2
9090,9090,2005-06,2005,2006,Liverpool,Birmingham,Draw,Away,2005-09-24,1,2,5,6,9,1,4,4,4,1,1,2,5,0,5.0,12.0,-7.0,2
9091,9091,2005-06,2005,2006,Liverpool,Chelsea,Loss,Home,2005-10-02,0,2,3,6,7,6,9,12,15,-4,-6,-6,-8,1,5.0,1.0,4.0,3
9092,9092,2005-06,2005,2006,Liverpool,Blackburn,Win,Home,2005-10-15,3,1,2,3,6,6,6,7,7,-5,-4,-4,-1,1,5.0,15.0,-10.0,3
9093,9093,2005-06,2005,2006,Liverpool,Fulham,Loss,Away,2005-10-22,0,3,4,5,6,1,1,1,2,2,3,4,4,0,5.0,13.0,-8.0,3
9094,9094,2005-06,2005,2006,Liverpool,West Ham,Win,Home,2005-10-29,3,3,3,4,5,3,4,5,8,0,-1,-1,-3,1,5.0,21.0,-16.0,3
9095,9095,2005-06,2005,2006,Liverpool,Aston Villa,Win,Away,2005-11-05,3,3,6,6,7,0,3,3,3,3,3,3,4,0,5.0,10.0,-5.0,4
9096,9096,2005-06,2005,2006,Liverpool,Portsmouth,Win,Home,2005-11-19,3,6,6,9,9,3,3,4,5,3,3,5,4,1,5.0,16.0,-11.0,4
9097,9097,2005-06,2005,2006,Liverpool,Man City,Win,Away,2005-11-26,3,6,9,9,12,1,4,4,7,5,5,5,5,0,5.0,8.0,-3.0,4
9098,9098,2005-06,2005,2006,Liverpool,Sunderland,Win,Away,2005-11-30,3,6,9,12,12,0,0,0,0,6,9,12,12,0,5.0,21.0,-16.0,4
9099,9099,2005-06,2005,2006,Liverpool,Wigan,Win,Home,2005-12-03,3,6,9,12,15,0,3,6,9,6,6,6,6,1,5.0,21.0,-16.0,5
9100,9100,2005-06,2005,2006,Liverpool,Middlesbrough,Win,Home,2005-12-10,3,6,9,12,15,1,4,4,7,5,5,8,8,1,5.0,7.0,-2.0,5
9101,9101,2005-06,2005,2006,Liverpool,Newcastle,Win,Home,2005-12-26,3,6,9,12,15,6,7,7,7,0,2,5,8,1,5.0,14.0,-9.0,5
9102,9102,2005-06,2005,2006,Liverpool,Everton,Win,Away,2005-12-28,3,6,9,12,15,0,0,1,4,6,9,11,11,0,5.0,4.0,1.0,5
9103,9103,2005-06,2005,2006,Liverpool,West Brom,Win,Home,2005-12-31,3,6,9,12,15,3,3,6,7,3,6,6,8,1,5.0,17.0,-12.0,5
9104,9104,2005-06,2005,2006,Liverpool,Bolton,Draw,Away,2006-01-02,1,6,9,12,15,1,4,5,8,5,5,7,7,0,5.0,6.0,-1.0,6
9105,9105,2005-06,2005,2006,Liverpool,Tottenham,Win,Home,2006-01-14,3,4,7,10,13,6,6,9,10,-2,1,1,3,1,5.0,9.0,-4.0,6
9106,9106,2005-06,2005,2006,Liverpool,Man United,Loss,Away,2006-01-22,0,4,7,10,13,1,4,5,8,3,3,5,5,0,5.0,3.0,2.0,6
9107,9107,2005-06,2005,2006,Liverpool,Birmingham,Draw,Home,2006-02-01,1,3,4,7,10,3,6,6,7,0,-2,1,3,1,5.0,12.0,-7.0,7
9108,9108,2005-06,2005,2006,Liverpool,Chelsea,Loss,Away,2006-02-05,0,1,4,5,8,2,5,8,11,-1,-1,-3,-3,0,5.0,1.0,4.0,7
9109,9109,2005-06,2005,2006,Liverpool,Charlton,Loss,Away,2006-02-08,0,1,1,4,5,1,2,5,5,0,-1,-1,0,0,5.0,11.0,-6.0,7
9110,9110,2005-06,2005,2006,Liverpool,Wigan,Win,Away,2006-02-11,3,0,1,1,4,2,5,5,5,-2,-4,-4,-1,0,5.0,21.0,-16.0,7
9111,9111,2005-06,2005,2006,Liverpool,Arsenal,Win,Home,2006-02-14,3,3,3,4,4,4,4,4,7,-1,-1,0,-3,1,5.0,2.0,3.0,7
9112,9112,2005-06,2005,2006,Liverpool,Man City,Win,Home,2006-02-26,3,6,6,6,7,3,6,6,9,3,0,0,-2,1,5.0,8.0,-3.0,7
9113,9113,2005-06,2005,2006,Liverpool,Charlton,Draw,Home,2006-03-04,1,6,9,9,9,2,2,5,5,4,7,4,4,1,5.0,11.0,-6.0,8
9114,9114,2005-06,2005,2006,Liverpool,Arsenal,Loss,Away,2006-03-12,0,4,7,10,10,3,3,4,7,1,4,6,3,0,5.0,2.0,3.0,8
9115,9115,2005-06,2005,2006,Liverpool,Fulham,Win,Home,2006-03-15,3,1,4,7,10,0,0,3,3,1,4,4,7,1,5.0,13.0,-8.0,8
9116,9116,2005-06,2005,2006,Liverpool,Newcastle,Win,Away,2006-03-19,3,3,4,7,10,3,6,7,10,0,-2,0,0,0,5.0,14.0,-9.0,8
9117,9117,2005-06,2005,2006,Liverpool,Everton,Win,Home,2006-03-25,3,6,6,7,10,6,7,7,10,0,-1,0,0,1,5.0,4.0,1.0,8
9118,9118,2005-06,2005,2006,Liverpool,West Brom,Win,Away,2006-04-01,3,6,9,9,10,0,1,1,1,6,8,8,9,0,5.0,17.0,-12.0,9
9119,9119,2005-06,2005,2006,Liverpool,Bolton,Win,Home,2006-04-09,3,6,9,12,12,0,0,3,6,6,9,9,6,1,5.0,6.0,-1.0,9
9120,9120,2005-06,2005,2006,Liverpool,Blackburn,Win,Away,2006-04-16,3,6,9,12,15,2,5,8,11,4,4,4,4,0,5.0,15.0,-10.0,9
9121,9121,2005-06,2005,2006,Liverpool,West Ham,Win,Away,2006-04-26,3,6,9,12,15,3,3,4,4,3,6,8,11,0,5.0,21.0,-16.0,9
9122,9122,2005-06,2005,2006,Liverpool,Aston Villa,Win,Home,2006-04-29,3,6,9,12,15,0,3,4,4,6,6,8,11,1,5.0,10.0,-5.0,9
9123,9123,2005-06,2005,2006,Liverpool,Portsmouth,Win,Away,2006-05-07,3,6,9,12,15,6,6,9,10,0,3,3,5,0,5.0,16.0,-11.0,10
9124,9124,2006-07,2006,2007,Liverpool,Sheffield United,Draw,Away,2006-08-19,1,6,9,12,15,1,4,7,7,5,5,5,8,0,3.0,21.0,-18.0,1
9125,9125,2006-07,2006,2007,Liverpool,West Ham,Win,Home,2006-08-26,3,4,7,10,13,4,7,10,10,0,0,0,3,1,3.0,9.0,-6.0,1
9126,9126,2006-07,2006,2007,Liverpool,Everton,Loss,Away,2006-09-09,0,4,7,10,13,4,7,8,11,0,0,2,2,0,3.0,11.0,-8.0,2
9127,9127,2006-07,2006,2007,Liverpool,Chelsea,Loss,Away,2006-09-17,0,3,4,7,10,6,6,9,9,-3,-2,-2,1,0,3.0,1.0,2.0,2
9128,9128,2006-07,2006,2007,Liverpool,Newcastle,Win,Home,2006-09-20,3,0,3,4,7,3,3,6,9,-3,0,-2,-2,1,3.0,7.0,-4.0,2
9129,9129,2006-07,2006,2007,Liverpool,Tottenham,Win,Home,2006-09-23,3,3,3,6,7,1,1,4,4,2,2,2,3,1,3.0,5.0,-2.0,2
9130,9130,2006-07,2006,2007,Liverpool,Bolton,Loss,Away,2006-09-30,0,6,6,6,9,4,7,7,8,2,-1,-1,1,0,3.0,8.0,-5.0,2
9131,9131,2006-07,2006,2007,Liverpool,Blackburn,Draw,Home,2006-10-14,1,3,6,6,6,6,9,10,10,-3,-3,-4,-4,1,3.0,6.0,-3.0,3
9132,9132,2006-07,2006,2007,Liverpool,Man United,Loss,Away,2006-10-22,0,1,4,7,7,6,7,7,10,-5,-3,0,-3,0,3.0,2.0,1.0,3
9133,9133,2006-07,2006,2007,Liverpool,Aston Villa,Win,Home,2006-10-28,3,1,1,4,7,2,3,6,7,-1,-2,-2,0,1,3.0,16.0,-13.0,3
9134,9134,2006-07,2006,2007,Liverpool,Reading,Win,Home,2006-11-04,3,3,4,4,7,0,0,3,4,3,4,1,3,1,3.0,21.0,-18.0,4
9135,9135,2006-07,2006,2007,Liverpool,Arsenal,Loss,Away,2006-11-12,0,6,6,7,7,1,4,7,10,5,2,0,-3,0,3.0,4.0,-1.0,4
9136,9136,2006-07,2006,2007,Liverpool,Middlesbrough,Draw,Away,2006-11-18,1,3,6,6,7,3,3,6,9,0,3,0,-2,0,3.0,14.0,-11.0,4
9137,9137,2006-07,2006,2007,Liverpool,Man City,Win,Home,2006-11-25,3,1,4,7,7,4,4,7,7,-3,0,0,0,1,3.0,15.0,-12.0,4
9138,9138,2006-07,2006,2007,Liverpool,Portsmouth,Draw,Home,2006-11-29,1,4,4,7,10,3,4,4,7,1,0,3,3,1,3.0,17.0,-14.0,4
9139,9139,2006-07,2006,2007,Liverpool,Wigan,Win,Away,2006-12-02,3,4,5,5,8,1,4,7,10,3,1,-2,-2,0,3.0,10.0,-7.0,5
9140,9140,2006-07,2006,2007,Liverpool,Fulham,Win,Home,2006-12-09,3,4,7,8,8,3,3,3,4,1,4,5,4,1,3.0,12.0,-9.0,5
9141,9141,2006-07,2006,2007,Liverpool,Charlton,Win,Away,2006-12-16,3,6,7,10,11,3,3,4,4,3,4,6,7,0,3.0,13.0,-10.0,5
9142,9142,2006-07,2006,2007,Liverpool,Watford,Win,Home,2006-12-23,3,6,9,10,13,1,2,2,2,5,7,8,11,1,3.0,21.0,-18.0,5
9143,9143,2006-07,2006,2007,Liverpool,Blackburn,Loss,Away,2006-12-26,0,6,9,12,13,3,3,3,6,3,6,9,7,0,3.0,6.0,-3.0,5
9144,9144,2006-07,2006,2007,Liverpool,Tottenham,Win,Away,2006-12-30,3,3,6,9,12,3,6,9,12,0,0,0,0,0,3.0,5.0,-2.0,5
9145,9145,2006-07,2006,2007,Liverpool,Bolton,Win,Home,2007-01-01,3,3,6,9,12,6,9,12,15,-3,-3,-3,-3,1,3.0,8.0,-5.0,6
9146,9146,2006-07,2006,2007,Liverpool,Watford,Win,Away,2007-01-13,3,6,6,9,12,1,1,1,2,5,5,8,10,0,3.0,21.0,-18.0,6
9147,9147,2006-07,2006,2007,Liverpool,Chelsea,Win,Home,2007-01-20,3,6,9,9,12,4,5,6,9,2,4,3,3,1,3.0,1.0,2.0,6
9148,9148,2006-07,2006,2007,Liverpool,West Ham,Win,Away,2007-01-30,3,6,9,12,12,2,2,2,2,4,7,10,10,0,3.0,9.0,-6.0,6
9149,9149,2006-07,2006,2007,Liverpool,Everton,Draw,Home,2007-02-03,1,6,9,12,15,4,4,7,8,2,5,5,7,1,3.0,11.0,-8.0,7
9150,9150,2006-07,2006,2007,Liverpool,Newcastle,Loss,Away,2007-02-10,0,4,7,10,13,3,4,7,8,1,3,3,5,0,3.0,7.0,-4.0,7
9151,9151,2006-07,2006,2007,Liverpool,Sheffield United,Win,Home,2007-02-24,3,1,4,7,10,3,6,6,7,-2,-2,1,3,1,3.0,21.0,-18.0,7
9152,9152,2006-07,2006,2007,Liverpool,Man United,Loss,Home,2007-03-03,0,3,4,7,10,6,9,12,12,-3,-5,-5,-2,1,3.0,2.0,1.0,8
9153,9153,2006-07,2006,2007,Liverpool,Aston Villa,Draw,Away,2007-03-18,1,3,3,4,7,1,1,4,4,2,2,0,3,0,3.0,16.0,-13.0,8
9154,9154,2006-07,2006,2007,Liverpool,Arsenal,Win,Home,2007-03-31,3,1,4,4,5,3,6,9,10,-2,-2,-5,-5,1,3.0,4.0,-1.0,8
9155,9155,2006-07,2006,2007,Liverpool,Reading,Win,Away,2007-04-07,3,4,4,7,7,1,1,1,4,3,3,6,3,0,3.0,21.0,-18.0,9
9156,9156,2006-07,2006,2007,Liverpool,Man City,Draw,Away,2007-04-14,1,6,7,7,10,4,7,10,10,2,0,-3,0,0,3.0,15.0,-12.0,9
9157,9157,2006-07,2006,2007,Liverpool,Middlesbrough,Win,Home,2007-04-18,3,4,7,8,8,3,3,3,4,1,4,5,4,1,3.0,14.0,-11.0,9
9158,9158,2006-07,2006,2007,Liverpool,Wigan,Win,Home,2007-04-21,3,4,7,10,11,2,2,2,3,2,5,8,8,1,3.0,10.0,-7.0,9
9159,9159,2006-07,2006,2007,Liverpool,Portsmouth,Loss,Away,2007-04-28,0,6,7,10,13,4,4,7,8,2,3,3,5,0,3.0,17.0,-14.0,9
9160,9160,2006-07,2006,2007,Liverpool,Fulham,Loss,Away,2007-05-05,0,3,6,7,10,1,1,1,1,2,5,6,9,0,3.0,12.0,-9.0,10
9161,9161,2006-07,2006,2007,Liverpool,Charlton,Draw,Home,2007-05-13,1,0,3,6,7,0,1,1,2,0,2,5,5,1,3.0,13.0,-10.0,10
9162,9162,2007-08,2007,2008,Liverpool,Aston Villa,Win,Away,2007-08-11,3,1,1,4,7,4,7,8,11,-3,-6,-4,-4,0,3.0,11.0,-8.0,1
9163,9163,2007-08,2007,2008,Liverpool,Chelsea,Draw,Home,2007-08-19,1,4,4,4,7,6,7,8,9,-2,-3,-4,-2,1,3.0,2.0,1.0,1
9164,9164,2007-08,2007,2008,Liverpool,Sunderland,Win,Away,2007-08-25,3,4,5,5,5,1,4,4,7,3,1,1,-2,0,3.0,21.0,-18.0,1
9165,9165,2007-08,2007,2008,Liverpool,Derby,Win,Home,2007-09-01,3,4,7,8,8,0,0,1,2,4,7,7,6,1,3.0,21.0,-18.0,2
9166,9166,2007-08,2007,2008,Liverpool,Portsmouth,Draw,Away,2007-09-15,1,6,7,10,11,0,3,4,5,6,4,6,6,0,3.0,9.0,-6.0,2
9167,9167,2007-08,2007,2008,Liverpool,Birmingham,Draw,Home,2007-09-22,1,4,7,8,11,3,6,6,7,1,1,2,4,1,3.0,21.0,-18.0,2
9168,9168,2007-08,2007,2008,Liverpool,Wigan,Win,Away,2007-09-29,3,2,5,8,9,1,1,2,5,1,4,6,4,0,3.0,17.0,-14.0,2
9169,9169,2007-08,2007,2008,Liverpool,Tottenham,Draw,Home,2007-10-07,1,4,5,8,11,2,2,3,3,2,3,5,8,1,3.0,5.0,-2.0,3
9170,9170,2007-08,2007,2008,Liverpool,Everton,Win,Away,2007-10-20,3,4,5,6,9,3,3,3,6,1,2,3,3,0,3.0,6.0,-3.0,3
9171,9171,2007-08,2007,2008,Liverpool,Arsenal,Draw,Home,2007-10-28,1,4,7,8,9,6,9,12,15,-2,-2,-4,-6,1,3.0,4.0,-1.0,3
9172,9172,2007-08,2007,2008,Liverpool,Blackburn,Draw,Away,2007-11-03,1,4,5,8,9,6,9,12,12,-2,-4,-4,-3,0,3.0,10.0,-7.0,4
9173,9173,2007-08,2007,2008,Liverpool,Fulham,Win,Home,2007-11-10,3,2,5,6,9,4,5,5,6,-2,0,1,3,1,3.0,16.0,-13.0,4
9174,9174,2007-08,2007,2008,Liverpool,Newcastle,Win,Away,2007-11-24,3,4,5,8,9,1,1,4,7,3,4,4,2,0,3.0,13.0,-10.0,4
9175,9175,2007-08,2007,2008,Liverpool,Bolton,Win,Home,2007-12-02,3,6,7,8,11,4,5,6,6,2,2,2,5,1,3.0,7.0,-4.0,5
9176,9176,2007-08,2007,2008,Liverpool,Reading,Loss,Away,2007-12-08,0,6,9,10,11,1,1,1,4,5,8,9,7,0,3.0,8.0,-5.0,5
9177,9177,2007-08,2007,2008,Liverpool,Man United,Loss,Home,2007-12-16,0,3,6,9,10,6,6,9,10,-3,0,0,0,1,3.0,1.0,2.0,5
9178,9178,2007-08,2007,2008,Liverpool,Portsmouth,Win,Home,2007-12-22,3,0,3,6,9,3,4,7,8,-3,-1,-1,1,1,3.0,9.0,-6.0,5
9179,9179,2007-08,2007,2008,Liverpool,Derby,Win,Away,2007-12-26,3,3,3,6,9,1,1,1,1,2,2,5,8,0,3.0,21.0,-18.0,5
9180,9180,2007-08,2007,2008,Liverpool,Man City,Draw,Away,2007-12-30,1,6,6,6,9,2,5,5,6,4,1,1,3,0,3.0,14.0,-11.0,5
9181,9181,2007-08,2007,2008,Liverpool,Wigan,Draw,Home,2008-01-02,1,4,7,7,7,3,4,7,7,1,3,0,0,1,3.0,17.0,-14.0,6
9182,9182,2007-08,2007,2008,Liverpool,Middlesbrough,Draw,Away,2008-01-12,1,2,5,8,8,3,3,3,6,-1,2,5,2,0,3.0,12.0,-9.0,6
9183,9183,2007-08,2007,2008,Liverpool,Aston Villa,Draw,Home,2008-01-21,1,2,3,6,9,6,9,10,11,-4,-6,-4,-2,1,3.0,11.0,-8.0,6
9184,9184,2007-08,2007,2008,Liverpool,West Ham,Loss,Away,2008-01-30,0,2,3,4,7,4,4,7,8,-2,-1,-3,-1,0,3.0,15.0,-12.0,6
9185,9185,2007-08,2007,2008,Liverpool,Sunderland,Win,Home,2008-02-02,3,1,2,3,4,3,6,6,9,-2,-4,-3,-5,1,3.0,21.0,-18.0,7
9186,9186,2007-08,2007,2008,Liverpool,Chelsea,Draw,Away,2008-02-10,1,3,4,5,6,4,7,10,13,-1,-3,-5,-7,0,3.0,2.0,1.0,7
9187,9187,2007-08,2007,2008,Liverpool,Middlesbrough,Win,Home,2008-02-23,3,4,4,5,6,4,7,8,9,0,-3,-3,-3,1,3.0,12.0,-9.0,7
9188,9188,2007-08,2007,2008,Liverpool,Bolton,Win,Away,2008-03-02,3,4,7,7,8,0,3,4,5,4,4,3,3,0,3.0,7.0,-4.0,8
9189,9189,2007-08,2007,2008,Liverpool,West Ham,Win,Home,2008-03-05,3,6,7,10,10,3,4,4,7,3,3,6,3,1,3.0,15.0,-12.0,8
9190,9190,2007-08,2007,2008,Liverpool,Newcastle,Win,Home,2008-03-08,3,6,9,10,13,0,0,1,1,6,9,9,12,1,3.0,13.0,-10.0,8
9191,9191,2007-08,2007,2008,Liverpool,Reading,Win,Home,2008-03-15,3,6,9,12,13,6,6,6,6,0,3,6,7,1,3.0,8.0,-5.0,8
9192,9192,2007-08,2007,2008,Liverpool,Man United,Loss,Away,2008-03-23,0,6,9,12,15,6,9,12,12,0,0,0,3,0,3.0,1.0,2.0,8
9193,9193,2007-08,2007,2008,Liverpool,Everton,Win,Home,2008-03-30,3,3,6,9,12,1,4,7,10,2,2,2,2,1,3.0,6.0,-3.0,8
9194,9194,2007-08,2007,2008,Liverpool,Arsenal,Draw,Away,2008-04-05,1,3,6,9,12,3,4,5,6,0,2,4,6,0,3.0,4.0,-1.0,9
9195,9195,2007-08,2007,2008,Liverpool,Blackburn,Win,Home,2008-04-13,3,4,4,7,10,2,5,5,6,2,-1,2,4,1,3.0,10.0,-7.0,9
9196,9196,2007-08,2007,2008,Liverpool,Fulham,Win,Away,2008-04-19,3,4,7,7,10,3,4,4,7,1,3,3,3,0,3.0,16.0,-13.0,9
9197,9197,2007-08,2007,2008,Liverpool,Birmingham,Draw,Away,2008-04-26,1,6,7,10,10,1,1,4,4,5,6,6,6,0,3.0,21.0,-18.0,9
9198,9198,2007-08,2007,2008,Liverpool,Man City,Win,Home,2008-05-04,3,4,7,8,11,3,6,6,6,1,1,2,5,1,3.0,14.0,-11.0,10
9199,9199,2007-08,2007,2008,Liverpool,Tottenham,Win,Away,2008-05-11,3,4,7,10,11,4,5,6,7,0,2,4,4,0,3.0,5.0,-2.0,10
9200,9200,2008-09,2008,2009,Liverpool,Sunderland,Win,Away,2008-08-16,3,6,7,10,13,0,3,3,3,6,4,7,10,0,4.0,15.0,-11.0,1
9201,9201,2008-09,2008,2009,Liverpool,Middlesbrough,Win,Home,2008-08-23,3,6,9,10,13,6,9,9,9,0,0,1,4,1,4.0,13.0,-9.0,1
9202,9202,2008-09,2008,2009,Liverpool,Aston Villa,Draw,Away,2008-08-31,1,6,9,12,13,3,4,4,5,3,5,8,8,0,4.0,6.0,-2.0,1
9203,9203,2008-09,2008,2009,Liverpool,Man United,Win,Home,2008-09-13,3,4,7,10,13,4,7,10,10,0,0,0,3,1,4.0,1.0,3.0,2
9204,9204,2008-09,2008,2009,Liverpool,Stoke,Draw,Home,2008-09-20,1,4,7,10,13,0,3,3,3,4,4,7,10,1,4.0,21.0,-17.0,2
9205,9205,2008-09,2008,2009,Liverpool,Everton,Win,Away,2008-09-27,3,4,5,8,11,4,4,7,7,0,1,1,4,0,4.0,5.0,-1.0,2
9206,9206,2008-09,2008,2009,Liverpool,Man City,Win,Away,2008-10-05,3,4,7,8,11,3,3,6,9,1,4,2,2,0,4.0,9.0,-5.0,3
9207,9207,2008-09,2008,2009,Liverpool,Wigan,Win,Home,2008-10-18,3,6,7,10,11,3,4,5,8,3,3,5,3,1,4.0,14.0,-10.0,3
9208,9208,2008-09,2008,2009,Liverpool,Chelsea,Win,Away,2008-10-26,3,6,9,10,13,6,9,10,13,0,0,0,0,0,4.0,2.0,2.0,3
9209,9209,2008-09,2008,2009,Liverpool,Portsmouth,Win,Home,2008-10-29,3,6,9,12,13,2,5,8,8,4,4,4,5,1,4.0,8.0,-4.0,3
9210,9210,2008-09,2008,2009,Liverpool,Tottenham,Loss,Away,2008-11-01,0,6,9,12,15,4,4,4,4,2,5,8,11,0,4.0,11.0,-7.0,4
9211,9211,2008-09,2008,2009,Liverpool,West Brom,Win,Home,2008-11-08,3,3,6,9,12,1,1,1,4,2,5,8,8,1,4.0,21.0,-17.0,4
9212,9212,2008-09,2008,2009,Liverpool,Bolton,Win,Away,2008-11-15,3,3,6,9,12,6,6,6,7,-3,0,3,5,0,4.0,16.0,-12.0,4
9213,9213,2008-09,2008,2009,Liverpool,Fulham,Draw,Home,2008-11-22,1,6,6,9,12,6,6,9,10,0,0,0,2,1,4.0,17.0,-13.0,4
9214,9214,2008-09,2008,2009,Liverpool,West Ham,Draw,Home,2008-12-01,1,4,7,7,10,4,4,5,5,0,3,2,5,1,4.0,10.0,-6.0,5
9215,9215,2008-09,2008,2009,Liverpool,Blackburn,Win,Away,2008-12-06,3,2,5,8,8,0,0,0,1,2,5,8,7,0,4.0,7.0,-3.0,5
9216,9216,2008-09,2008,2009,Liverpool,Hull,Draw,Home,2008-12-13,1,4,5,8,11,4,5,6,6,0,0,2,5,1,4.0,21.0,-17.0,5
9217,9217,2008-09,2008,2009,Liverpool,Arsenal,Draw,Away,2008-12-21,1,4,5,6,9,4,7,7,7,0,-2,-1,2,0,4.0,3.0,1.0,5
9218,9218,2008-09,2008,2009,Liverpool,Bolton,Win,Home,2008-12-26,3,2,5,6,7,3,3,6,9,-1,2,0,-2,1,4.0,16.0,-12.0,5
9219,9219,2008-09,2008,2009,Liverpool,Newcastle,Win,Away,2008-12-28,3,4,5,8,9,3,6,7,8,1,-1,1,1,0,4.0,12.0,-8.0,5
9220,9220,2008-09,2008,2009,Liverpool,Stoke,Draw,Away,2009-01-10,1,6,7,8,11,0,0,1,2,6,7,7,9,0,4.0,21.0,-17.0,6
9221,9221,2008-09,2008,2009,Liverpool,Everton,Draw,Home,2009-01-19,1,4,7,8,9,6,9,10,13,-2,-2,-2,-4,1,4.0,5.0,-1.0,6
9222,9222,2008-09,2008,2009,Liverpool,Wigan,Draw,Away,2009-01-28,1,2,5,8,9,0,3,6,9,2,2,2,0,0,4.0,14.0,-10.0,6
9223,9223,2008-09,2008,2009,Liverpool,Chelsea,Win,Home,2009-02-01,3,2,3,6,9,6,6,7,10,-4,-3,-1,-1,1,4.0,2.0,2.0,7
9224,9224,2008-09,2008,2009,Liverpool,Portsmouth,Win,Away,2009-02-07,3,4,5,6,9,0,1,1,1,4,4,5,8,0,4.0,8.0,-4.0,7
9225,9225,2008-09,2008,2009,Liverpool,Man City,Draw,Home,2009-02-22,1,6,7,8,9,3,3,6,9,3,4,2,0,1,4.0,9.0,-5.0,7
9226,9226,2008-09,2008,2009,Liverpool,Middlesbrough,Loss,Away,2009-02-28,0,4,7,8,9,1,2,2,2,3,5,6,7,0,4.0,13.0,-9.0,7
9227,9227,2008-09,2008,2009,Liverpool,Sunderland,Win,Home,2009-03-03,3,1,4,7,8,4,5,8,8,-3,-1,-1,0,1,4.0,15.0,-11.0,8
9228,9228,2008-09,2008,2009,Liverpool,Man United,Win,Away,2009-03-14,3,3,4,7,10,6,9,12,15,-3,-5,-5,-5,0,4.0,1.0,3.0,8
9229,9229,2008-09,2008,2009,Liverpool,Aston Villa,Win,Home,2009-03-22,3,6,6,7,10,0,1,1,4,6,5,6,6,1,4.0,6.0,-2.0,8
9230,9230,2008-09,2008,2009,Liverpool,Fulham,Win,Away,2009-04-04,3,6,9,9,10,6,6,6,7,0,3,3,3,0,4.0,17.0,-13.0,9
9231,9231,2008-09,2008,2009,Liverpool,Blackburn,Win,Home,2009-04-11,3,6,9,12,12,4,4,7,8,2,5,5,4,1,4.0,7.0,-3.0,9
9232,9232,2008-09,2008,2009,Liverpool,Arsenal,Draw,Home,2009-04-21,1,6,9,12,15,6,9,12,15,0,0,0,0,1,4.0,3.0,1.0,9
9233,9233,2008-09,2008,2009,Liverpool,Hull,Win,Away,2009-04-25,3,4,7,10,13,0,1,1,2,4,6,9,11,0,4.0,21.0,-17.0,9
9234,9234,2008-09,2008,2009,Liverpool,Newcastle,Win,Home,2009-05-03,3,4,7,10,13,1,2,2,2,3,5,8,11,1,4.0,12.0,-8.0,10
9235,9235,2008-09,2008,2009,Liverpool,West Ham,Win,Away,2009-05-09,3,6,7,10,13,3,4,4,7,3,3,6,6,0,4.0,10.0,-6.0,10
9236,9236,2008-09,2008,2009,Liverpool,West Brom,Win,Away,2009-05-17,3,6,9,10,13,3,6,6,7,3,3,4,6,0,4.0,21.0,-17.0,10
9237,9237,2008-09,2008,2009,Liverpool,Tottenham,Win,Home,2009-05-24,3,6,9,12,13,4,7,7,10,2,2,5,3,1,4.0,11.0,-7.0,10
9238,9238,2009-10,2009,2010,Liverpool,Tottenham,Loss,Away,2009-08-16,0,6,9,12,15,3,4,7,7,3,5,5,8,0,2.0,8.0,-6.0,1
9239,9239,2009-10,2009,2010,Liverpool,Stoke,Win,Home,2009-08-19,3,3,6,9,12,3,6,9,9,0,0,0,3,1,2.0,12.0,-10.0,1
9240,9240,2009-10,2009,2010,Liverpool,Aston Villa,Loss,Home,2009-08-24,0,3,6,9,12,3,4,4,7,0,2,5,5,1,2.0,6.0,-4.0,1
9241,9241,2009-10,2009,2010,Liverpool,Bolton,Win,Away,2009-08-29,3,3,3,6,9,0,0,1,2,3,3,5,7,0,2.0,13.0,-11.0,1
9242,9242,2009-10,2009,2010,Liverpool,Burnley,Win,Home,2009-09-12,3,3,6,6,9,3,6,6,6,0,0,0,3,1,2.0,21.0,-19.0,2
9243,9243,2009-10,2009,2010,Liverpool,West Ham,Win,Away,2009-09-19,3,6,6,9,9,1,1,4,7,5,5,5,2,0,2.0,9.0,-7.0,2
9244,9244,2009-10,2009,2010,Liverpool,Hull,Win,Home,2009-09-26,3,6,9,9,12,0,1,4,4,6,8,5,8,1,2.0,17.0,-15.0,2
9245,9245,2009-10,2009,2010,Liverpool,Chelsea,Loss,Away,2009-10-04,0,6,9,12,12,3,6,9,12,3,3,3,0,0,2.0,3.0,-1.0,3
9246,9246,2009-10,2009,2010,Liverpool,Sunderland,Loss,Away,2009-10-17,0,3,6,9,12,4,4,7,7,-1,2,2,5,0,2.0,16.0,-14.0,3
9247,9247,2009-10,2009,2010,Liverpool,Man United,Win,Home,2009-10-25,3,0,3,6,9,4,7,10,13,-4,-4,-4,-4,1,2.0,1.0,1.0,3
9248,9248,2009-10,2009,2010,Liverpool,Fulham,Loss,Away,2009-10-31,0,3,3,6,9,4,5,5,5,-1,-2,1,4,0,2.0,7.0,-5.0,3
9249,9249,2009-10,2009,2010,Liverpool,Birmingham,Draw,Home,2009-11-09,1,3,3,3,6,4,4,4,4,-1,-1,-1,2,1,2.0,21.0,-19.0,4
9250,9250,2009-10,2009,2010,Liverpool,Man City,Draw,Home,2009-11-21,1,1,4,4,4,2,3,4,5,-1,1,0,-1,1,2.0,10.0,-8.0,4
9251,9251,2009-10,2009,2010,Liverpool,Everton,Win,Away,2009-11-29,3,2,2,5,5,0,3,4,4,2,-1,1,1,0,2.0,5.0,-3.0,4
9252,9252,2009-10,2009,2010,Liverpool,Blackburn,Draw,Away,2009-12-05,1,4,5,5,8,1,4,7,7,3,1,-2,1,0,2.0,15.0,-13.0,5
9253,9253,2009-10,2009,2010,Liverpool,Arsenal,Loss,Home,2009-12-13,0,4,5,6,6,3,3,6,9,1,2,0,-3,1,2.0,4.0,-2.0,5
9254,9254,2009-10,2009,2010,Liverpool,Wigan,Win,Home,2009-12-16,3,1,4,5,6,1,4,4,5,0,0,1,1,1,2.0,11.0,-9.0,5
9255,9255,2009-10,2009,2010,Liverpool,Portsmouth,Loss,Away,2009-12-19,0,3,4,7,8,1,4,4,4,2,0,3,4,0,2.0,14.0,-12.0,5
9256,9256,2009-10,2009,2010,Liverpool,Wolves,Win,Home,2009-12-26,3,3,3,4,7,3,6,9,9,0,-3,-5,-2,1,2.0,21.0,-19.0,5
9257,9257,2009-10,2009,2010,Liverpool,Aston Villa,Win,Away,2009-12-29,3,3,6,6,7,3,6,9,12,0,0,-3,-5,0,2.0,6.0,-4.0,5
9258,9258,2009-10,2009,2010,Liverpool,Stoke,Draw,Away,2010-01-16,1,6,6,9,9,3,3,3,4,3,3,6,5,0,2.0,12.0,-10.0,6
9259,9259,2009-10,2009,2010,Liverpool,Tottenham,Win,Home,2010-01-20,3,4,7,7,10,4,5,8,11,0,2,-1,-1,1,2.0,8.0,-6.0,6
9260,9260,2009-10,2009,2010,Liverpool,Wolves,Draw,Away,2010-01-26,1,4,7,10,10,0,0,3,3,4,7,7,7,0,2.0,21.0,-19.0,6
9261,9261,2009-10,2009,2010,Liverpool,Bolton,Win,Home,2010-01-30,3,4,5,8,11,3,3,4,5,1,2,4,6,1,2.0,13.0,-11.0,6
9262,9262,2009-10,2009,2010,Liverpool,Everton,Win,Home,2010-02-06,3,4,7,8,11,6,9,10,13,-2,-2,-2,-2,1,2.0,5.0,-3.0,7
9263,9263,2009-10,2009,2010,Liverpool,Arsenal,Loss,Away,2010-02-10,0,6,7,10,11,0,1,4,7,6,6,6,4,0,2.0,4.0,-2.0,7
9264,9264,2009-10,2009,2010,Liverpool,Man City,Draw,Away,2010-02-21,1,3,6,7,10,4,4,7,7,-1,2,0,3,0,2.0,10.0,-8.0,7
9265,9265,2009-10,2009,2010,Liverpool,Blackburn,Win,Home,2010-02-28,3,1,4,7,8,6,6,7,10,-5,-2,0,-2,1,2.0,15.0,-13.0,7
9266,9266,2009-10,2009,2010,Liverpool,Wigan,Loss,Away,2010-03-08,0,4,4,7,10,0,1,2,3,4,3,5,7,0,2.0,11.0,-9.0,8
9267,9267,2009-10,2009,2010,Liverpool,Portsmouth,Win,Home,2010-03-15,3,3,4,4,7,3,3,4,4,0,1,0,3,1,2.0,14.0,-12.0,8
9268,9268,2009-10,2009,2010,Liverpool,Man United,Loss,Away,2010-03-21,0,3,6,7,7,6,9,9,10,-3,-3,-2,-3,0,2.0,1.0,1.0,8
9269,9269,2009-10,2009,2010,Liverpool,Sunderland,Win,Home,2010-03-28,3,3,3,6,7,4,5,8,9,-1,-2,-2,-2,1,2.0,16.0,-14.0,8
9270,9270,2009-10,2009,2010,Liverpool,Birmingham,Draw,Away,2010-04-04,1,3,6,6,9,1,1,2,5,2,5,4,4,0,2.0,21.0,-19.0,9
9271,9271,2009-10,2009,2010,Liverpool,Fulham,Draw,Home,2010-04-11,1,4,4,7,7,3,3,3,4,1,1,4,3,1,2.0,7.0,-5.0,9
9272,9272,2009-10,2009,2010,Liverpool,West Ham,Win,Home,2010-04-19,3,2,5,5,8,4,4,4,4,-2,1,1,4,1,2.0,9.0,-7.0,9
9273,9273,2009-10,2009,2010,Liverpool,Burnley,Win,Away,2010-04-25,3,4,5,8,8,3,3,3,3,1,2,5,5,0,2.0,21.0,-19.0,9
9274,9274,2009-10,2009,2010,Liverpool,Chelsea,Loss,Home,2010-05-02,0,6,7,8,11,3,6,9,12,3,1,-1,-1,1,2.0,3.0,-1.0,10
9275,9275,2009-10,2009,2010,Liverpool,Hull,Draw,Away,2010-05-09,1,3,6,7,8,1,1,2,2,2,5,5,6,0,2.0,17.0,-15.0,10
9276,9276,2010-11,2010,2011,Liverpool,Arsenal,Draw,Home,2010-08-15,1,1,4,7,8,3,4,4,4,-2,0,3,4,1,7.0,3.0,4.0,1
9277,9277,2010-11,2010,2011,Liverpool,Man City,Loss,Away,2010-08-23,0,2,2,5,8,2,2,5,6,0,0,0,2,0,7.0,5.0,2.0,1
9278,9278,2010-11,2010,2011,Liverpool,West Brom,Win,Home,2010-08-29,3,1,2,2,5,3,4,4,7,-2,-2,-2,-2,1,7.0,21.0,-14.0,1
9279,9279,2010-11,2010,2011,Liverpool,Birmingham,Draw,Away,2010-09-12,1,3,4,5,5,4,5,5,8,-1,-1,0,-3,0,7.0,9.0,-2.0,2
9280,9280,2010-11,2010,2011,Liverpool,Man United,Loss,Away,2010-09-19,0,4,4,5,6,4,5,8,11,0,-1,-3,-5,0,7.0,2.0,5.0,2
9281,9281,2010-11,2010,2011,Liverpool,Sunderland,Draw,Home,2010-09-25,1,1,4,4,5,2,5,5,6,-1,-1,-1,-1,1,7.0,13.0,-6.0,2
9282,9282,2010-11,2010,2011,Liverpool,Blackpool,Loss,Home,2010-10-03,0,1,2,5,5,0,3,4,4,1,-1,1,1,1,7.0,21.0,-14.0,3
9283,9283,2010-11,2010,2011,Liverpool,Everton,Loss,Away,2010-10-17,0,1,1,2,5,4,4,5,5,-3,-3,-3,0,0,7.0,8.0,-1.0,3
9284,9284,2010-11,2010,2011,Liverpool,Blackburn,Win,Home,2010-10-24,3,0,1,1,2,1,4,5,6,-1,-3,-4,-4,1,7.0,10.0,-3.0,3
9285,9285,2010-11,2010,2011,Liverpool,Bolton,Win,Away,2010-10-31,3,3,3,4,4,4,5,6,7,-1,-2,-2,-3,0,7.0,14.0,-7.0,3
9286,9286,2010-11,2010,2011,Liverpool,Chelsea,Win,Home,2010-11-07,3,6,6,6,7,6,7,10,10,0,-1,-4,-3,1,7.0,1.0,6.0,4
9287,9287,2010-11,2010,2011,Liverpool,Wigan,Draw,Away,2010-11-10,1,6,9,9,9,0,1,2,5,6,8,7,4,0,7.0,16.0,-9.0,4
9288,9288,2010-11,2010,2011,Liverpool,Stoke,Loss,Away,2010-11-13,0,4,7,10,10,3,3,3,3,1,4,7,7,0,7.0,11.0,-4.0,4
9289,9289,2010-11,2010,2011,Liverpool,West Ham,Win,Home,2010-11-20,3,1,4,7,10,2,3,3,3,-1,1,4,7,1,7.0,17.0,-10.0,4
9290,9290,2010-11,2010,2011,Liverpool,Tottenham,Loss,Away,2010-11-28,0,3,4,7,10,6,7,7,7,-3,-3,0,3,0,7.0,4.0,3.0,4
9291,9291,2010-11,2010,2011,Liverpool,Aston Villa,Win,Home,2010-12-06,3,3,3,4,7,0,1,4,5,3,2,0,2,1,7.0,6.0,1.0,5
9292,9292,2010-11,2010,2011,Liverpool,Newcastle,Loss,Away,2010-12-11,0,3,6,6,7,1,1,2,2,2,5,4,5,0,7.0,21.0,-14.0,5
9293,9293,2010-11,2010,2011,Liverpool,Wolves,Loss,Home,2010-12-29,0,3,3,6,6,3,3,6,6,0,0,0,0,1,7.0,15.0,-8.0,5
9294,9294,2010-11,2010,2011,Liverpool,Bolton,Win,Home,2011-01-01,3,0,3,3,6,3,3,6,6,-3,0,-3,0,1,7.0,14.0,-7.0,6
9295,9295,2010-11,2010,2011,Liverpool,Blackburn,Loss,Away,2011-01-05,0,3,3,6,6,3,3,4,4,0,0,2,2,0,7.0,10.0,-3.0,6
9296,9296,2010-11,2010,2011,Liverpool,Blackpool,Loss,Away,2011-01-12,0,3,3,3,6,0,3,6,7,3,0,-3,-1,0,7.0,21.0,-14.0,6
9297,9297,2010-11,2010,2011,Liverpool,Everton,Draw,Home,2011-01-16,1,0,3,3,3,3,4,7,8,-3,-1,-4,-5,1,7.0,8.0,-1.0,6
9298,9298,2010-11,2010,2011,Liverpool,Wolves,Win,Away,2011-01-22,3,1,1,4,4,3,3,6,6,-2,-2,-2,-2,0,7.0,15.0,-8.0,6
9299,9299,2010-11,2010,2011,Liverpool,Fulham,Win,Home,2011-01-26,3,4,4,4,7,4,7,7,10,0,-3,-3,-3,1,7.0,12.0,-5.0,6
9300,9300,2010-11,2010,2011,Liverpool,Stoke,Win,Home,2011-02-02,3,6,7,7,7,3,3,6,6,3,4,1,1,1,7.0,11.0,-4.0,7
9301,9301,2010-11,2010,2011,Liverpool,Chelsea,Win,Away,2011-02-06,3,6,9,10,10,6,9,9,10,0,0,1,0,0,7.0,1.0,6.0,7
9302,9302,2010-11,2010,2011,Liverpool,Wigan,Draw,Home,2011-02-12,1,6,9,12,13,4,4,4,5,2,5,8,8,1,7.0,16.0,-9.0,7
9303,9303,2010-11,2010,2011,Liverpool,West Ham,Loss,Away,2011-02-27,0,4,7,10,13,1,4,5,5,3,3,5,8,0,7.0,17.0,-10.0,7
9304,9304,2010-11,2010,2011,Liverpool,Man United,Win,Home,2011-03-06,3,1,4,7,10,3,6,6,9,-2,-2,1,1,1,7.0,2.0,5.0,8
9305,9305,2010-11,2010,2011,Liverpool,Sunderland,Win,Away,2011-03-20,3,3,4,7,10,1,1,1,1,2,3,6,9,0,7.0,13.0,-6.0,8
9306,9306,2010-11,2010,2011,Liverpool,West Brom,Loss,Away,2011-04-02,0,6,6,7,10,4,5,6,7,2,1,1,3,0,7.0,21.0,-14.0,9
9307,9307,2010-11,2010,2011,Liverpool,Man City,Win,Home,2011-04-11,3,3,6,6,7,3,6,7,7,0,0,-1,0,1,7.0,5.0,2.0,9
9308,9308,2010-11,2010,2011,Liverpool,Arsenal,Draw,Away,2011-04-17,1,3,6,9,9,4,5,6,9,-1,1,3,0,0,7.0,3.0,4.0,9
9309,9309,2010-11,2010,2011,Liverpool,Birmingham,Win,Home,2011-04-23,3,4,4,7,10,3,4,7,7,1,0,0,3,1,7.0,9.0,-2.0,9
9310,9310,2010-11,2010,2011,Liverpool,Newcastle,Win,Home,2011-05-01,3,4,7,7,10,2,2,5,5,2,5,2,5,1,7.0,21.0,-14.0,10
9311,9311,2010-11,2010,2011,Liverpool,Fulham,Win,Away,2011-05-09,3,6,7,10,10,6,7,7,10,0,0,3,0,0,7.0,12.0,-5.0,10
9312,9312,2010-11,2010,2011,Liverpool,Tottenham,Loss,Home,2011-05-15,0,6,9,10,13,1,1,2,3,5,8,8,10,1,7.0,4.0,3.0,10
9313,9313,2010-11,2010,2011,Liverpool,Aston Villa,Loss,Away,2011-05-22,0,3,6,9,10,4,4,5,8,-1,2,4,2,0,7.0,6.0,1.0,10
9314,9314,2011-12,2011,2012,Liverpool,Sunderland,Draw,Home,2011-08-13,1,0,3,6,9,3,6,6,9,-3,-3,0,0,1,6.0,10.0,-4.0,1
9315,9315,2011-12,2011,2012,Liverpool,Arsenal,Win,Away,2011-08-20,3,1,1,4,7,2,2,2,5,-1,-1,2,2,0,6.0,4.0,2.0,1
9316,9316,2011-12,2011,2012,Liverpool,Bolton,Win,Home,2011-08-27,3,4,4,4,7,3,3,3,3,1,1,1,4,1,6.0,14.0,-8.0,1
9317,9317,2011-12,2011,2012,Liverpool,Stoke,Loss,Away,2011-09-10,0,6,7,7,7,4,5,5,5,2,2,2,2,0,6.0,13.0,-7.0,2
9318,9318,2011-12,2011,2012,Liverpool,Tottenham,Loss,Away,2011-09-18,0,3,6,7,7,3,3,6,9,0,3,1,-2,0,6.0,5.0,1.0,2
9319,9319,2011-12,2011,2012,Liverpool,Wolves,Win,Home,2011-09-24,3,0,3,6,7,0,1,4,7,0,2,2,0,1,6.0,17.0,-11.0,2
9320,9320,2011-12,2011,2012,Liverpool,Everton,Win,Away,2011-10-01,3,3,3,6,9,3,4,7,7,0,-1,-1,2,0,6.0,7.0,-1.0,3
9321,9321,2011-12,2011,2012,Liverpool,Man United,Draw,Home,2011-10-15,1,6,6,6,9,4,7,10,13,2,-1,-4,-4,1,6.0,1.0,5.0,3
9322,9322,2011-12,2011,2012,Liverpool,Norwich,Draw,Home,2011-10-22,1,4,7,7,7,3,6,9,9,1,1,-2,-2,1,6.0,21.0,-15.0,3
9323,9323,2011-12,2011,2012,Liverpool,West Brom,Win,Away,2011-10-29,3,2,5,8,8,6,7,8,8,-4,-2,0,0,0,6.0,11.0,-5.0,3
9324,9324,2011-12,2011,2012,Liverpool,Swansea,Draw,Home,2011-11-05,1,4,5,8,11,4,4,7,7,0,1,1,4,1,6.0,21.0,-15.0,4
9325,9325,2011-12,2011,2012,Liverpool,Chelsea,Win,Away,2011-11-20,3,4,5,6,9,3,3,6,9,1,2,0,0,0,6.0,2.0,4.0,4
9326,9326,2011-12,2011,2012,Liverpool,Man City,Draw,Home,2011-11-27,1,4,7,8,9,6,9,12,15,-2,-2,-4,-6,1,6.0,3.0,3.0,4
9327,9327,2011-12,2011,2012,Liverpool,Fulham,Loss,Away,2011-12-05,0,4,5,8,9,2,2,5,5,2,3,3,4,0,6.0,8.0,-2.0,5
9328,9328,2011-12,2011,2012,Liverpool,QPR,Win,Home,2011-12-10,3,1,4,5,8,1,4,4,4,0,0,1,4,1,6.0,21.0,-15.0,5
9329,9329,2011-12,2011,2012,Liverpool,Aston Villa,Win,Away,2011-12-18,3,3,4,7,8,3,4,4,7,0,0,3,1,0,6.0,9.0,-3.0,5
9330,9330,2011-12,2011,2012,Liverpool,Wigan,Draw,Away,2011-12-21,1,6,6,7,10,4,4,7,8,2,2,0,2,0,6.0,16.0,-10.0,5
9331,9331,2011-12,2011,2012,Liverpool,Blackburn,Draw,Home,2011-12-26,1,4,7,7,8,0,0,3,3,4,7,4,5,1,6.0,15.0,-9.0,5
9332,9332,2011-12,2011,2012,Liverpool,Newcastle,Win,Home,2011-12-30,3,2,5,8,8,3,4,4,4,-1,1,4,4,1,6.0,12.0,-6.0,5
9333,9333,2011-12,2011,2012,Liverpool,Man City,Loss,Away,2012-01-03,0,4,5,8,11,1,4,7,7,3,1,1,4,0,6.0,3.0,3.0,6
9334,9334,2011-12,2011,2012,Liverpool,Stoke,Draw,Home,2012-01-14,1,3,4,5,8,4,5,5,8,-1,-1,0,0,1,6.0,13.0,-7.0,6
9335,9335,2011-12,2011,2012,Liverpool,Bolton,Loss,Away,2012-01-21,0,1,4,5,6,3,4,4,7,-2,0,1,-1,0,6.0,14.0,-8.0,6
9336,9336,2011-12,2011,2012,Liverpool,Wolves,Win,Away,2012-01-31,3,1,1,4,5,1,1,2,3,0,0,2,2,0,6.0,17.0,-11.0,6
9337,9337,2011-12,2011,2012,Liverpool,Tottenham,Draw,Home,2012-02-06,1,3,4,4,7,3,4,7,10,0,0,-3,-3,1,6.0,5.0,1.0,7
9338,9338,2011-12,2011,2012,Liverpool,Man United,Loss,Away,2012-02-11,0,4,4,5,5,4,7,10,10,0,-3,-5,-5,0,6.0,1.0,5.0,7
9339,9339,2011-12,2011,2012,Liverpool,Arsenal,Loss,Home,2012-03-03,0,1,4,4,5,6,9,10,10,-5,-5,-6,-5,1,6.0,4.0,2.0,8
9340,9340,2011-12,2011,2012,Liverpool,Sunderland,Loss,Away,2012-03-10,0,0,1,4,4,1,1,4,7,-1,0,0,-3,0,6.0,10.0,-4.0,8
9341,9341,2011-12,2011,2012,Liverpool,Everton,Win,Home,2012-03-13,3,0,0,1,4,4,7,8,11,-4,-7,-7,-7,1,6.0,7.0,-1.0,8
9342,9342,2011-12,2011,2012,Liverpool,QPR,Loss,Away,2012-03-21,0,3,3,3,4,1,1,1,1,2,2,2,3,0,6.0,21.0,-15.0,8
9343,9343,2011-12,2011,2012,Liverpool,Wigan,Loss,Home,2012-03-24,0,3,3,3,3,2,2,3,6,1,1,0,-3,1,6.0,16.0,-10.0,8
9344,9344,2011-12,2011,2012,Liverpool,Newcastle,Loss,Away,2012-04-01,0,0,3,3,3,6,6,7,8,-6,-3,-4,-5,0,6.0,12.0,-6.0,9
9345,9345,2011-12,2011,2012,Liverpool,Aston Villa,Draw,Home,2012-04-07,1,0,0,3,3,0,3,4,5,0,-3,-1,-2,1,6.0,9.0,-3.0,9
9346,9346,2011-12,2011,2012,Liverpool,Blackburn,Win,Away,2012-04-10,3,1,1,1,4,0,0,3,6,1,1,-2,-2,0,6.0,15.0,-9.0,9
9347,9347,2011-12,2011,2012,Liverpool,West Brom,Loss,Home,2012-04-22,0,4,4,4,4,3,6,6,6,1,-2,-2,-2,1,6.0,11.0,-5.0,9
9348,9348,2011-12,2011,2012,Liverpool,Norwich,Win,Away,2012-04-28,3,3,4,4,4,0,3,4,4,3,1,0,0,0,6.0,21.0,-15.0,9
9349,9349,2011-12,2011,2012,Liverpool,Fulham,Loss,Home,2012-05-01,0,3,6,7,7,3,4,7,10,0,2,0,-3,1,6.0,8.0,-2.0,10
9350,9350,2011-12,2011,2012,Liverpool,Chelsea,Win,Home,2012-05-08,3,3,3,6,7,3,4,5,8,0,-1,1,-1,1,6.0,2.0,4.0,10
9351,9351,2011-12,2011,2012,Liverpool,Swansea,Loss,Away,2012-05-13,0,3,6,6,9,1,2,5,5,2,4,1,4,0,6.0,21.0,-15.0,10
9352,9352,2012-13,2012,2013,Liverpool,West Brom,Loss,Away,2012-08-18,0,3,3,6,6,1,2,5,8,2,1,1,-2,0,8.0,10.0,-2.0,1
9353,9353,2012-13,2012,2013,Liverpool,Man City,Draw,Home,2012-08-26,1,0,3,3,6,6,9,12,15,-6,-6,-9,-9,1,8.0,1.0,7.0,1
9354,9354,2012-13,2012,2013,Liverpool,Arsenal,Loss,Home,2012-09-02,0,1,1,4,4,2,5,6,7,-1,-4,-2,-3,1,8.0,3.0,5.0,2
9355,9355,2012-13,2012,2013,Liverpool,Sunderland,Draw,Away,2012-09-15,1,1,1,1,4,2,2,2,3,-1,-1,-1,1,0,8.0,13.0,-5.0,2
9356,9356,2012-13,2012,2013,Liverpool,Man United,Loss,Home,2012-09-23,0,1,2,2,2,6,9,9,12,-5,-7,-7,-10,1,8.0,2.0,6.0,2
9357,9357,2012-13,2012,2013,Liverpool,Norwich,Win,Away,2012-09-29,3,1,1,2,2,1,2,3,3,0,-1,-1,-1,0,8.0,12.0,-4.0,2
9358,9358,2012-13,2012,2013,Liverpool,Stoke,Draw,Home,2012-10-07,1,3,4,4,5,3,4,5,6,0,0,-1,-1,1,8.0,14.0,-6.0,3
9359,9359,2012-13,2012,2013,Liverpool,Reading,Win,Home,2012-10-20,3,4,4,5,5,2,2,2,2,2,2,3,3,1,8.0,21.0,-13.0,3
9360,9360,2012-13,2012,2013,Liverpool,Everton,Draw,Away,2012-10-28,1,4,7,7,8,2,5,8,9,2,2,-1,-1,0,8.0,7.0,1.0,3
9361,9361,2012-13,2012,2013,Liverpool,Newcastle,Draw,Home,2012-11-04,1,4,5,8,8,4,4,5,8,0,1,3,0,1,8.0,5.0,3.0,4
9362,9362,2012-13,2012,2013,Liverpool,Chelsea,Draw,Away,2012-11-11,1,2,5,6,9,1,4,7,10,1,1,-1,-1,0,8.0,6.0,2.0,4
9363,9363,2012-13,2012,2013,Liverpool,Wigan,Win,Home,2012-11-17,3,2,3,6,7,3,6,6,7,-1,-3,0,0,1,8.0,15.0,-7.0,4
9364,9364,2012-13,2012,2013,Liverpool,Swansea,Draw,Away,2012-11-25,1,4,5,6,9,4,5,5,8,0,0,1,1,0,8.0,11.0,-3.0,4
9365,9365,2012-13,2012,2013,Liverpool,Tottenham,Loss,Away,2012-11-28,0,4,5,6,7,3,3,3,6,1,2,3,1,0,8.0,4.0,4.0,4
9366,9366,2012-13,2012,2013,Liverpool,Southampton,Win,Home,2012-12-01,3,1,4,5,6,4,7,8,8,-3,-3,-3,-2,1,8.0,21.0,-13.0,5
9367,9367,2012-13,2012,2013,Liverpool,West Ham,Win,Away,2012-12-09,3,3,4,7,8,3,3,4,7,0,1,3,1,0,8.0,21.0,-13.0,5
9368,9368,2012-13,2012,2013,Liverpool,Aston Villa,Loss,Home,2012-12-15,0,6,6,7,10,2,5,6,6,4,1,1,4,1,8.0,16.0,-8.0,5
9369,9369,2012-13,2012,2013,Liverpool,Fulham,Win,Home,2012-12-22,3,3,6,6,7,3,3,4,4,0,3,2,3,1,8.0,9.0,-1.0,5
9370,9370,2012-13,2012,2013,Liverpool,Stoke,Loss,Away,2012-12-26,0,3,6,9,9,2,3,6,9,1,3,3,0,0,8.0,14.0,-6.0,5
9371,9371,2012-13,2012,2013,Liverpool,QPR,Win,Away,2012-12-30,3,3,3,6,9,0,3,4,5,3,0,2,4,0,8.0,17.0,-9.0,5
9372,9372,2012-13,2012,2013,Liverpool,Sunderland,Win,Home,2013-01-02,3,3,6,6,9,3,6,6,9,0,0,0,0,1,8.0,13.0,-5.0,6
9373,9373,2012-13,2012,2013,Liverpool,Man United,Loss,Away,2013-01-13,0,6,6,9,9,6,9,10,13,0,-3,-1,-4,0,8.0,2.0,6.0,6
9374,9374,2012-13,2012,2013,Liverpool,Norwich,Win,Home,2013-01-19,3,3,6,6,9,1,1,1,1,2,5,5,8,1,8.0,12.0,-4.0,6
9375,9375,2012-13,2012,2013,Liverpool,Arsenal,Draw,Away,2013-01-30,1,3,6,9,9,3,3,4,7,0,3,5,2,0,8.0,3.0,5.0,6
9376,9376,2012-13,2012,2013,Liverpool,Man City,Draw,Away,2013-02-03,1,4,4,7,10,4,7,10,13,0,-3,-3,-3,0,8.0,1.0,7.0,7
9377,9377,2012-13,2012,2013,Liverpool,West Brom,Loss,Home,2013-02-11,0,2,5,5,8,0,1,1,1,2,4,4,7,1,8.0,10.0,-2.0,7
9378,9378,2012-13,2012,2013,Liverpool,Swansea,Win,Home,2013-02-17,3,1,2,5,5,3,4,7,8,-2,-2,-2,-3,1,8.0,11.0,-3.0,7
9379,9379,2012-13,2012,2013,Liverpool,Wigan,Win,Away,2013-03-02,3,3,4,5,8,3,4,5,5,0,0,0,3,0,8.0,15.0,-7.0,8
9380,9380,2012-13,2012,2013,Liverpool,Tottenham,Win,Home,2013-03-10,3,6,6,7,8,6,9,12,13,0,-3,-5,-5,1,8.0,4.0,4.0,8
9381,9381,2012-13,2012,2013,Liverpool,Southampton,Loss,Away,2013-03-16,0,6,9,9,10,1,1,4,5,5,8,5,5,0,8.0,21.0,-13.0,8
9382,9382,2012-13,2012,2013,Liverpool,Aston Villa,Win,Away,2013-03-31,3,3,6,9,9,6,6,6,9,-3,0,3,0,0,8.0,16.0,-8.0,8
9383,9383,2012-13,2012,2013,Liverpool,West Ham,Draw,Home,2013-04-07,1,3,6,9,12,3,6,6,6,0,0,3,6,1,8.0,21.0,-13.0,9
9384,9384,2012-13,2012,2013,Liverpool,Reading,Draw,Away,2013-04-13,1,4,4,7,10,0,0,0,0,4,4,7,10,0,8.0,21.0,-13.0,9
9385,9385,2012-13,2012,2013,Liverpool,Chelsea,Draw,Home,2013-04-21,1,2,5,5,8,6,6,9,12,-4,-1,-4,-4,1,8.0,6.0,2.0,9
9386,9386,2012-13,2012,2013,Liverpool,Newcastle,Win,Away,2013-04-27,3,2,3,6,6,1,4,4,4,1,-1,2,2,0,8.0,5.0,3.0,9
9387,9387,2012-13,2012,2013,Liverpool,Everton,Draw,Home,2013-05-05,1,4,5,6,9,3,4,7,8,1,1,-1,1,1,8.0,7.0,1.0,10
9388,9388,2012-13,2012,2013,Liverpool,Fulham,Win,Away,2013-05-12,3,4,5,6,7,0,0,0,1,4,5,6,6,0,8.0,9.0,-1.0,10
9389,9389,2012-13,2012,2013,Liverpool,QPR,Win,Home,2013-05-19,3,4,7,8,9,0,1,1,1,4,6,7,8,1,8.0,17.0,-9.0,10
9390,9390,2013-14,2013,2014,Liverpool,Stoke,Win,Home,2013-08-17,3,6,7,10,11,1,2,5,8,5,5,5,3,1,7.0,13.0,-6.0,1
9391,9391,2013-14,2013,2014,Liverpool,Aston Villa,Win,Away,2013-08-24,3,6,9,10,13,3,4,4,7,3,5,6,6,0,7.0,15.0,-8.0,1
9392,9392,2013-14,2013,2014,Liverpool,Man United,Win,Home,2013-09-01,3,6,9,12,13,4,5,8,8,2,4,4,5,1,7.0,1.0,6.0,2
9393,9393,2013-14,2013,2014,Liverpool,Swansea,Draw,Away,2013-09-16,1,6,9,12,15,3,3,3,3,3,6,9,12,0,7.0,9.0,-2.0,2
9394,9394,2013-14,2013,2014,Liverpool,Southampton,Loss,Home,2013-09-21,0,4,7,10,13,1,2,5,6,3,5,5,7,1,7.0,14.0,-7.0,2
9395,9395,2013-14,2013,2014,Liverpool,Sunderland,Win,Away,2013-09-29,3,1,4,7,10,0,0,1,1,1,4,6,9,0,7.0,17.0,-10.0,2
9396,9396,2013-14,2013,2014,Liverpool,Crystal Palace,Win,Home,2013-10-05,3,3,4,7,10,0,0,3,3,3,4,4,7,1,7.0,21.0,-14.0,3
9397,9397,2013-14,2013,2014,Liverpool,Newcastle,Draw,Away,2013-10-19,1,6,6,7,10,3,3,6,9,3,3,1,1,0,7.0,16.0,-9.0,3
9398,9398,2013-14,2013,2014,Liverpool,West Brom,Win,Home,2013-10-26,3,4,7,7,8,2,5,8,9,2,2,-1,-1,1,7.0,8.0,-1.0,3
9399,9399,2013-14,2013,2014,Liverpool,Arsenal,Loss,Away,2013-11-02,0,4,7,10,10,6,7,10,13,-2,0,0,-3,0,7.0,4.0,3.0,4
9400,9400,2013-14,2013,2014,Liverpool,Fulham,Win,Home,2013-11-09,3,3,4,7,10,0,3,6,6,3,1,1,4,1,7.0,12.0,-5.0,4
9401,9401,2013-14,2013,2014,Liverpool,Everton,Draw,Away,2013-11-23,1,3,6,7,10,2,5,8,8,1,1,-1,2,0,7.0,6.0,1.0,4
9402,9402,2013-14,2013,2014,Liverpool,Hull,Loss,Away,2013-12-01,0,4,4,7,8,0,3,3,3,4,1,4,5,0,7.0,21.0,-14.0,5
9403,9403,2013-14,2013,2014,Liverpool,Norwich,Win,Home,2013-12-04,3,1,4,4,7,3,6,6,7,-2,-2,-2,0,1,7.0,11.0,-4.0,5
9404,9404,2013-14,2013,2014,Liverpool,West Ham,Win,Home,2013-12-07,3,3,4,7,7,3,3,3,4,0,1,4,3,1,7.0,10.0,-3.0,5
9405,9405,2013-14,2013,2014,Liverpool,Tottenham,Win,Away,2013-12-15,3,6,6,7,10,6,7,7,7,0,-1,0,3,0,7.0,5.0,2.0,5
9406,9406,2013-14,2013,2014,Liverpool,Cardiff,Win,Home,2013-12-21,3,6,9,9,10,3,4,4,5,3,5,5,5,1,7.0,21.0,-14.0,5
9407,9407,2013-14,2013,2014,Liverpool,Man City,Loss,Away,2013-12-26,0,6,9,12,12,6,7,10,13,0,2,2,-1,0,7.0,2.0,5.0,5
9408,9408,2013-14,2013,2014,Liverpool,Chelsea,Loss,Away,2013-12-29,0,3,6,9,12,4,7,7,10,-1,-1,2,2,0,7.0,3.0,4.0,5
9409,9409,2013-14,2013,2014,Liverpool,Hull,Win,Home,2014-01-01,3,0,3,6,9,3,4,5,6,-3,-1,1,3,1,7.0,21.0,-14.0,6
9410,9410,2013-14,2013,2014,Liverpool,Stoke,Win,Away,2014-01-12,3,3,3,6,9,1,1,4,5,2,2,2,4,0,7.0,13.0,-6.0,6
9411,9411,2013-14,2013,2014,Liverpool,Aston Villa,Draw,Home,2014-01-18,1,6,6,6,9,3,4,4,4,3,2,2,5,1,7.0,15.0,-8.0,6
9412,9412,2013-14,2013,2014,Liverpool,Everton,Win,Home,2014-01-28,3,4,7,7,7,4,5,8,8,0,2,-1,-1,1,7.0,6.0,1.0,6
9413,9413,2013-14,2013,2014,Liverpool,West Brom,Draw,Away,2014-02-02,1,4,7,10,10,1,1,4,5,3,6,6,5,0,7.0,8.0,-1.0,7
9414,9414,2013-14,2013,2014,Liverpool,Arsenal,Win,Home,2014-02-08,3,4,5,8,11,4,7,10,13,0,-2,-2,-2,1,7.0,4.0,3.0,7
9415,9415,2013-14,2013,2014,Liverpool,Fulham,Win,Away,2014-02-12,3,4,7,8,11,1,1,1,1,3,6,7,10,0,7.0,12.0,-5.0,7
9416,9416,2013-14,2013,2014,Liverpool,Swansea,Win,Home,2014-02-23,3,6,7,10,11,4,4,7,7,2,3,3,4,1,7.0,9.0,-2.0,7
9417,9417,2013-14,2013,2014,Liverpool,Southampton,Win,Away,2014-03-01,3,6,9,10,13,3,4,7,8,3,5,3,5,0,7.0,14.0,-7.0,8
9418,9418,2013-14,2013,2014,Liverpool,Man United,Win,Away,2014-03-16,3,6,9,12,13,6,7,8,8,0,2,4,5,0,7.0,1.0,6.0,8
9419,9419,2013-14,2013,2014,Liverpool,Cardiff,Win,Away,2014-03-22,3,6,9,12,15,3,3,3,4,3,6,9,11,0,7.0,21.0,-14.0,8
9420,9420,2013-14,2013,2014,Liverpool,Sunderland,Win,Home,2014-03-26,3,6,9,12,15,1,1,1,4,5,8,11,11,1,7.0,17.0,-10.0,8
9421,9421,2013-14,2013,2014,Liverpool,Tottenham,Win,Home,2014-03-30,3,6,9,12,15,3,3,6,6,3,6,6,9,1,7.0,5.0,2.0,8
9422,9422,2013-14,2013,2014,Liverpool,West Ham,Win,Away,2014-04-06,3,6,9,12,15,6,6,6,6,0,3,6,9,0,7.0,10.0,-3.0,9
9423,9423,2013-14,2013,2014,Liverpool,Man City,Win,Home,2014-04-13,3,6,9,12,15,4,7,10,13,2,2,2,2,1,7.0,2.0,5.0,9
9424,9424,2013-14,2013,2014,Liverpool,Norwich,Win,Away,2014-04-20,3,6,9,12,15,0,0,3,3,6,9,9,12,0,7.0,11.0,-4.0,9
9425,9425,2013-14,2013,2014,Liverpool,Chelsea,Loss,Home,2014-04-27,0,6,9,12,15,3,6,6,9,3,3,6,6,1,7.0,3.0,4.0,9
9426,9426,2013-14,2013,2014,Liverpool,Crystal Palace,Draw,Away,2014-05-05,1,3,6,9,12,3,6,9,12,0,0,0,0,0,7.0,21.0,-14.0,10
9427,9427,2013-14,2013,2014,Liverpool,Newcastle,Win,Home,2014-05-11,3,1,4,7,10,3,3,3,3,-2,1,4,7,1,7.0,16.0,-9.0,10
9428,9428,2014-15,2014,2015,Liverpool,Southampton,Win,Home,2014-08-17,3,4,4,7,10,4,7,8,8,0,-3,-1,2,1,2.0,8.0,-6.0,1
9429,9429,2014-15,2014,2015,Liverpool,Man City,Loss,Away,2014-08-25,0,6,7,7,10,6,9,12,15,0,-2,-5,-5,0,2.0,1.0,1.0,1
9430,9430,2014-15,2014,2015,Liverpool,Tottenham,Win,Away,2014-08-31,3,3,6,7,7,6,9,9,12,-3,-3,-2,-5,0,2.0,6.0,-4.0,1
9431,9431,2014-15,2014,2015,Liverpool,Aston Villa,Loss,Home,2014-09-13,0,3,6,9,10,4,7,7,7,-1,-1,2,3,1,2.0,15.0,-13.0,2
9432,9432,2014-15,2014,2015,Liverpool,West Ham,Loss,Away,2014-09-20,0,3,3,6,9,1,4,4,4,2,-1,2,5,0,2.0,13.0,-11.0,2
9433,9433,2014-15,2014,2015,Liverpool,Everton,Draw,Home,2014-09-27,1,0,3,3,6,3,3,4,5,-3,0,-1,1,1,2.0,5.0,-3.0,2
9434,9434,2014-15,2014,2015,Liverpool,West Brom,Win,Home,2014-10-04,3,1,1,4,4,6,6,6,7,-5,-5,-2,-3,1,2.0,17.0,-15.0,3
9435,9435,2014-15,2014,2015,Liverpool,QPR,Win,Away,2014-10-19,3,4,4,4,7,0,1,1,4,4,3,3,3,0,2.0,21.0,-19.0,3
9436,9436,2014-15,2014,2015,Liverpool,Hull,Draw,Home,2014-10-25,1,6,7,7,7,4,4,5,6,2,3,2,1,1,2.0,16.0,-14.0,3
9437,9437,2014-15,2014,2015,Liverpool,Newcastle,Loss,Away,2014-11-01,0,4,7,8,8,6,7,7,8,-2,0,1,0,0,2.0,10.0,-8.0,4
9438,9438,2014-15,2014,2015,Liverpool,Chelsea,Loss,Home,2014-11-08,0,1,4,7,8,4,7,10,13,-3,-3,-3,-5,1,2.0,3.0,-1.0,4
9439,9439,2014-15,2014,2015,Liverpool,Crystal Palace,Loss,Away,2014-11-23,0,0,1,4,7,0,1,1,1,0,0,3,6,0,2.0,11.0,-9.0,4
9440,9440,2014-15,2014,2015,Liverpool,Stoke,Win,Home,2014-11-29,3,0,0,1,4,3,4,4,7,-3,-4,-3,-3,1,2.0,9.0,-7.0,4
9441,9441,2014-15,2014,2015,Liverpool,Leicester,Win,Away,2014-12-02,3,3,3,3,4,1,1,1,1,2,2,2,3,0,2.0,21.0,-19.0,5
9442,9442,2014-15,2014,2015,Liverpool,Sunderland,Draw,Home,2014-12-06,1,6,6,6,6,1,2,3,6,5,4,3,0,1,2.0,14.0,-12.0,5
9443,9443,2014-15,2014,2015,Liverpool,Man United,Loss,Away,2014-12-14,0,4,7,7,7,6,9,12,15,-2,-2,-5,-8,0,2.0,7.0,-5.0,5
9444,9444,2014-15,2014,2015,Liverpool,Arsenal,Draw,Home,2014-12-21,1,1,4,7,7,3,6,9,9,-2,-2,-2,-2,1,2.0,4.0,-2.0,5
9445,9445,2014-15,2014,2015,Liverpool,Burnley,Win,Away,2014-12-26,3,1,2,5,8,3,3,4,5,-2,-1,1,3,0,2.0,21.0,-19.0,5
9446,9446,2014-15,2014,2015,Liverpool,Swansea,Win,Home,2014-12-29,3,4,4,5,8,6,6,6,9,-2,-2,-1,-1,1,2.0,12.0,-10.0,5
9447,9447,2014-15,2014,2015,Liverpool,Leicester,Draw,Home,2015-01-01,1,6,7,7,8,3,3,3,3,3,4,4,5,1,2.0,21.0,-19.0,6
9448,9448,2014-15,2014,2015,Liverpool,Sunderland,Win,Away,2015-01-10,3,4,7,8,8,1,1,4,5,3,6,4,3,0,2.0,14.0,-12.0,6
9449,9449,2014-15,2014,2015,Liverpool,Aston Villa,Win,Away,2015-01-17,3,4,7,10,11,1,2,2,3,3,5,8,8,0,2.0,15.0,-13.0,6
9450,9450,2014-15,2014,2015,Liverpool,West Ham,Win,Home,2015-01-31,3,6,7,10,13,4,5,5,5,2,2,5,8,1,2.0,13.0,-11.0,6
9451,9451,2014-15,2014,2015,Liverpool,Everton,Draw,Away,2015-02-07,1,6,9,10,13,4,5,5,5,2,4,5,8,0,2.0,5.0,-3.0,7
9452,9452,2014-15,2014,2015,Liverpool,Tottenham,Win,Home,2015-02-10,3,4,7,10,11,6,9,9,12,-2,-2,1,-1,1,2.0,6.0,-4.0,7
9453,9453,2014-15,2014,2015,Liverpool,Southampton,Win,Away,2015-02-22,3,4,7,10,13,4,4,7,10,0,3,3,3,0,2.0,8.0,-6.0,7
9454,9454,2014-15,2014,2015,Liverpool,Man City,Win,Home,2015-03-01,3,6,7,10,13,6,7,8,8,0,0,2,5,1,2.0,1.0,1.0,8
9455,9455,2014-15,2014,2015,Liverpool,Burnley,Win,Home,2015-03-04,3,6,9,10,13,1,1,2,2,5,8,8,11,1,2.0,21.0,-19.0,8
9456,9456,2014-15,2014,2015,Liverpool,Swansea,Win,Away,2015-03-16,3,6,9,12,13,3,6,6,7,3,3,6,6,0,2.0,12.0,-10.0,8
9457,9457,2014-15,2014,2015,Liverpool,Man United,Loss,Home,2015-03-22,0,6,9,12,15,6,9,9,12,0,0,3,3,1,2.0,7.0,-5.0,8
9458,9458,2014-15,2014,2015,Liverpool,Arsenal,Loss,Away,2015-04-04,0,3,6,9,12,6,9,12,15,-3,-3,-3,-3,0,2.0,4.0,-2.0,9
9459,9459,2014-15,2014,2015,Liverpool,Newcastle,Win,Home,2015-04-13,3,0,3,6,9,0,0,0,3,0,3,6,6,1,2.0,10.0,-8.0,9
9460,9460,2014-15,2014,2015,Liverpool,West Brom,Draw,Away,2015-04-25,1,3,3,6,9,3,3,3,6,0,0,3,3,0,2.0,17.0,-15.0,9
9461,9461,2014-15,2014,2015,Liverpool,Hull,Loss,Away,2015-04-28,0,4,4,4,7,3,3,3,4,1,1,1,3,0,2.0,16.0,-14.0,9
9462,9462,2014-15,2014,2015,Liverpool,QPR,Win,Home,2015-05-02,3,1,4,4,4,1,2,5,5,0,2,-1,-1,1,2.0,21.0,-19.0,10
9463,9463,2014-15,2014,2015,Liverpool,Chelsea,Draw,Away,2015-05-10,1,3,4,7,7,6,7,10,13,-3,-3,-3,-6,0,2.0,3.0,-1.0,10
9464,9464,2014-15,2014,2015,Liverpool,Crystal Palace,Loss,Home,2015-05-16,0,4,4,5,8,0,0,0,3,4,4,5,5,1,2.0,11.0,-9.0,10
9465,9465,2014-15,2014,2015,Liverpool,Stoke,Loss,Away,2015-05-24,0,1,4,4,5,4,4,5,8,-3,0,-1,-3,0,2.0,9.0,-7.0,10
9466,9466,2015-16,2015,2016,Liverpool,Stoke,Win,Away,2015-08-09,3,0,1,4,4,4,7,7,8,-4,-6,-3,-4,0,6.0,9.0,-3.0,1
9467,9467,2015-16,2015,2016,Liverpool,Bournemouth,Win,Home,2015-08-17,3,3,3,4,7,0,0,0,0,3,3,4,7,1,6.0,21.0,-15.0,1
9468,9468,2015-16,2015,2016,Liverpool,Arsenal,Draw,Away,2015-08-24,1,6,6,6,7,3,6,7,8,3,0,-1,-1,0,6.0,3.0,3.0,1
9469,9469,2015-16,2015,2016,Liverpool,West Ham,Loss,Home,2015-08-29,0,4,7,7,7,0,3,3,3,4,4,4,4,1,6.0,12.0,-6.0,1
9470,9470,2015-16,2015,2016,Liverpool,Man United,Loss,Away,2015-09-12,0,1,4,7,7,1,4,7,8,0,0,0,-1,0,6.0,4.0,2.0,2
9471,9471,2015-16,2015,2016,Liverpool,Norwich,Draw,Home,2015-09-20,1,0,1,4,7,3,4,7,7,-3,-3,-3,0,1,6.0,21.0,-15.0,2
9472,9472,2015-16,2015,2016,Liverpool,Aston Villa,Win,Home,2015-09-26,3,1,1,2,5,0,1,1,1,1,0,1,4,1,6.0,17.0,-11.0,2
9473,9473,2015-16,2015,2016,Liverpool,Everton,Draw,Away,2015-10-04,1,4,4,4,5,4,7,8,8,0,-3,-4,-3,0,6.0,11.0,-5.0,3
9474,9474,2015-16,2015,2016,Liverpool,Tottenham,Draw,Away,2015-10-17,1,4,5,5,5,4,7,10,11,0,-2,-5,-6,0,6.0,5.0,1.0,3
9475,9475,2015-16,2015,2016,Liverpool,Southampton,Draw,Home,2015-10-25,1,2,5,6,6,4,7,7,8,-2,-2,-1,-2,1,6.0,7.0,-1.0,3
9476,9476,2015-16,2015,2016,Liverpool,Chelsea,Win,Away,2015-10-31,3,2,3,6,7,3,3,4,7,-1,0,2,0,0,6.0,1.0,5.0,3
9477,9477,2015-16,2015,2016,Liverpool,Crystal Palace,Loss,Home,2015-11-08,0,4,5,6,9,1,1,4,7,3,4,2,2,1,6.0,10.0,-4.0,4
9478,9478,2015-16,2015,2016,Liverpool,Man City,Win,Away,2015-11-21,3,3,4,5,6,4,5,8,11,-1,-1,-3,-5,0,6.0,2.0,4.0,4
9479,9479,2015-16,2015,2016,Liverpool,Swansea,Win,Home,2015-11-29,3,3,6,7,8,1,1,4,4,2,5,3,4,1,6.0,8.0,-2.0,4
9480,9480,2015-16,2015,2016,Liverpool,Newcastle,Loss,Away,2015-12-06,0,6,6,9,10,0,3,4,4,6,3,5,6,0,6.0,15.0,-9.0,5
9481,9481,2015-16,2015,2016,Liverpool,West Brom,Draw,Home,2015-12-13,1,3,6,6,9,2,5,5,5,1,1,1,4,1,6.0,13.0,-7.0,5
9482,9482,2015-16,2015,2016,Liverpool,Watford,Loss,Away,2015-12-20,0,1,4,7,7,6,9,9,9,-5,-5,-2,-2,0,6.0,21.0,-15.0,5
9483,9483,2015-16,2015,2016,Liverpool,Leicester,Win,Home,2015-12-26,3,1,1,4,7,6,9,10,13,-5,-8,-6,-6,1,6.0,14.0,-8.0,5
9484,9484,2015-16,2015,2016,Liverpool,Sunderland,Win,Away,2015-12-30,3,3,4,4,7,0,0,0,3,3,4,4,4,0,6.0,16.0,-10.0,5
9485,9485,2015-16,2015,2016,Liverpool,West Ham,Loss,Away,2016-01-02,0,6,6,7,7,4,5,6,7,2,1,1,0,0,6.0,12.0,-6.0,6
9486,9486,2015-16,2015,2016,Liverpool,Arsenal,Draw,Home,2016-01-13,1,3,6,6,7,6,6,9,12,-3,0,-3,-5,1,6.0,3.0,3.0,6
9487,9487,2015-16,2015,2016,Liverpool,Man United,Loss,Home,2016-01-17,0,1,4,7,7,4,5,5,5,-3,-1,2,2,1,6.0,4.0,2.0,6
9488,9488,2015-16,2015,2016,Liverpool,Norwich,Win,Away,2016-01-23,3,1,1,4,7,0,3,6,6,1,-2,-2,1,0,6.0,21.0,-15.0,6
9489,9489,2015-16,2015,2016,Liverpool,Leicester,Loss,Away,2016-02-02,0,3,4,4,7,4,7,8,9,-1,-3,-4,-2,0,6.0,14.0,-8.0,7
9490,9490,2015-16,2015,2016,Liverpool,Sunderland,Draw,Home,2016-02-06,1,3,3,4,4,1,1,4,7,2,2,0,-3,1,6.0,16.0,-10.0,7
9491,9491,2015-16,2015,2016,Liverpool,Aston Villa,Win,Away,2016-02-14,3,1,4,4,5,3,4,5,8,-2,0,-1,-3,0,6.0,17.0,-11.0,7
9492,9492,2015-16,2015,2016,Liverpool,Man City,Win,Home,2016-03-02,3,4,4,7,7,0,3,4,7,4,1,3,0,1,6.0,2.0,4.0,8
9493,9493,2015-16,2015,2016,Liverpool,Crystal Palace,Win,Away,2016-03-06,3,6,7,7,10,1,1,2,2,5,6,5,8,0,6.0,10.0,-4.0,8
9494,9494,2015-16,2015,2016,Liverpool,Southampton,Loss,Away,2016-03-20,0,6,9,10,10,4,4,4,7,2,5,6,3,0,6.0,7.0,-1.0,8
9495,9495,2015-16,2015,2016,Liverpool,Tottenham,Draw,Home,2016-04-02,1,3,6,9,10,6,7,7,10,-3,-1,2,0,1,6.0,5.0,1.0,9
9496,9496,2015-16,2015,2016,Liverpool,Stoke,Win,Home,2016-04-10,3,1,4,7,10,4,4,5,8,-3,0,2,2,1,6.0,9.0,-3.0,9
9497,9497,2015-16,2015,2016,Liverpool,Bournemouth,Win,Away,2016-04-17,3,4,4,7,10,3,3,6,9,1,1,1,1,0,6.0,21.0,-15.0,9
9498,9498,2015-16,2015,2016,Liverpool,Everton,Win,Home,2016-04-20,3,6,7,7,10,2,3,3,3,4,4,4,7,1,6.0,11.0,-5.0,9
9499,9499,2015-16,2015,2016,Liverpool,Newcastle,Draw,Home,2016-04-23,1,6,9,10,10,4,4,4,5,2,5,6,5,1,6.0,15.0,-9.0,9
9500,9500,2015-16,2015,2016,Liverpool,Swansea,Loss,Away,2016-05-01,0,4,7,10,11,0,3,4,7,4,4,6,4,0,6.0,8.0,-2.0,10
9501,9501,2015-16,2015,2016,Liverpool,Watford,Win,Home,2016-05-08,3,1,4,7,10,3,6,7,7,-2,-2,0,3,1,6.0,21.0,-15.0,10
9502,9502,2015-16,2015,2016,Liverpool,Chelsea,Draw,Home,2016-05-11,1,3,4,7,10,1,4,4,4,2,0,3,6,1,6.0,1.0,5.0,10
9503,9503,2015-16,2015,2016,Liverpool,West Brom,Draw,Away,2016-05-15,1,4,4,5,8,1,2,2,2,3,2,3,6,0,6.0,13.0,-7.0,10
9504,9504,2016-17,2016,2017,Liverpool,Arsenal,Win,Away,2016-08-14,3,2,5,5,6,4,7,8,11,-2,-2,-3,-5,0,8.0,2.0,6.0,1
9505,9505,2016-17,2016,2017,Liverpool,Burnley,Loss,Away,2016-08-20,0,4,5,8,8,3,4,7,7,1,1,1,1,0,8.0,21.0,-13.0,1
9506,9506,2016-17,2016,2017,Liverpool,Tottenham,Draw,Away,2016-08-27,1,3,4,5,8,4,4,4,5,-1,0,1,3,0,8.0,3.0,5.0,1
9507,9507,2016-17,2016,2017,Liverpool,Leicester,Win,Home,2016-09-10,3,1,4,5,6,4,4,5,8,-3,0,0,-2,1,8.0,1.0,7.0,2
9508,9508,2016-17,2016,2017,Liverpool,Chelsea,Win,Away,2016-09-16,3,4,4,7,8,4,7,10,11,0,-3,-3,-3,0,8.0,10.0,-2.0,2
9509,9509,2016-17,2016,2017,Liverpool,Hull,Win,Home,2016-09-24,3,6,7,7,10,1,1,4,7,5,6,3,3,1,8.0,21.0,-13.0,2
9510,9510,2016-17,2016,2017,Liverpool,Swansea,Win,Away,2016-10-01,3,6,9,10,10,0,1,1,1,6,8,9,9,0,8.0,12.0,-4.0,3
9511,9511,2016-17,2016,2017,Liverpool,Man United,Draw,Home,2016-10-17,1,6,9,12,13,4,4,4,7,2,5,8,6,1,8.0,5.0,3.0,3
9512,9512,2016-17,2016,2017,Liverpool,West Brom,Win,Home,2016-10-22,3,4,7,10,13,2,3,6,6,2,4,4,7,1,8.0,14.0,-6.0,3
9513,9513,2016-17,2016,2017,Liverpool,Crystal Palace,Win,Away,2016-10-29,3,4,7,10,13,0,1,4,7,4,6,6,6,0,8.0,15.0,-7.0,3
9514,9514,2016-17,2016,2017,Liverpool,Watford,Win,Home,2016-11-06,3,6,7,10,13,4,7,8,8,2,0,2,5,1,8.0,13.0,-5.0,4
9515,9515,2016-17,2016,2017,Liverpool,Southampton,Draw,Away,2016-11-19,1,6,9,10,13,0,1,4,5,6,8,6,8,0,8.0,6.0,2.0,4
9516,9516,2016-17,2016,2017,Liverpool,Sunderland,Win,Home,2016-11-26,3,4,7,10,11,6,6,6,6,-2,1,4,5,1,8.0,17.0,-9.0,4
9517,9517,2016-17,2016,2017,Liverpool,Bournemouth,Loss,Away,2016-12-04,0,4,7,10,13,3,3,3,4,1,4,7,9,0,8.0,16.0,-8.0,5
9518,9518,2016-17,2016,2017,Liverpool,West Ham,Draw,Home,2016-12-11,1,3,4,7,10,1,1,2,2,2,3,5,8,1,8.0,7.0,1.0,5
9519,9519,2016-17,2016,2017,Liverpool,Middlesbrough,Win,Away,2016-12-14,3,1,4,5,8,3,4,4,5,-2,0,1,3,0,8.0,21.0,-13.0,5
9520,9520,2016-17,2016,2017,Liverpool,Everton,Win,Away,2016-12-19,3,4,4,7,8,3,4,4,5,1,0,3,3,0,8.0,11.0,-3.0,5
9521,9521,2016-17,2016,2017,Liverpool,Stoke,Win,Home,2016-12-27,3,6,7,7,10,2,2,5,8,4,5,2,2,1,8.0,9.0,-1.0,5
9522,9522,2016-17,2016,2017,Liverpool,Man City,Win,Home,2016-12-31,3,6,9,10,10,6,9,9,9,0,0,1,1,1,8.0,4.0,4.0,5
9523,9523,2016-17,2016,2017,Liverpool,Sunderland,Draw,Away,2017-01-02,1,6,9,12,13,0,3,3,3,6,6,9,10,0,8.0,17.0,-9.0,6
9524,9524,2016-17,2016,2017,Liverpool,Man United,Draw,Away,2017-01-15,1,4,7,10,13,6,9,12,15,-2,-2,-2,-2,0,8.0,5.0,3.0,6
9525,9525,2016-17,2016,2017,Liverpool,Swansea,Loss,Home,2017-01-21,0,2,5,8,11,3,3,3,3,-1,2,5,8,1,8.0,12.0,-4.0,6
9526,9526,2016-17,2016,2017,Liverpool,Chelsea,Draw,Home,2017-01-31,1,1,2,5,8,6,6,9,12,-5,-4,-4,-4,1,8.0,10.0,-2.0,6
9527,9527,2016-17,2016,2017,Liverpool,Hull,Loss,Away,2017-02-04,0,1,2,3,6,1,4,4,5,0,-2,-1,1,0,8.0,21.0,-13.0,7
9528,9528,2016-17,2016,2017,Liverpool,Tottenham,Win,Home,2017-02-11,3,1,1,2,3,4,5,8,11,-3,-4,-6,-8,1,8.0,3.0,5.0,7
9529,9529,2016-17,2016,2017,Liverpool,Leicester,Loss,Away,2017-02-27,0,3,4,4,5,0,0,0,0,3,4,4,5,0,8.0,1.0,7.0,7
9530,9530,2016-17,2016,2017,Liverpool,Arsenal,Win,Home,2017-03-04,3,3,3,4,4,3,3,6,9,0,0,-2,-5,1,8.0,2.0,6.0,8
9531,9531,2016-17,2016,2017,Liverpool,Burnley,Win,Home,2017-03-12,3,3,6,6,7,1,2,2,5,2,4,4,2,1,8.0,21.0,-13.0,8
9532,9532,2016-17,2016,2017,Liverpool,Man City,Draw,Away,2017-03-19,1,6,6,9,9,4,7,10,13,2,-1,-1,-4,0,8.0,4.0,4.0,8
9533,9533,2016-17,2016,2017,Liverpool,Everton,Win,Home,2017-04-01,3,4,7,7,10,6,6,9,10,-2,1,-2,0,1,8.0,11.0,-3.0,9
9534,9534,2016-17,2016,2017,Liverpool,Bournemouth,Draw,Home,2017-04-05,1,4,7,10,10,4,7,8,8,0,0,2,2,1,8.0,16.0,-8.0,9
9535,9535,2016-17,2016,2017,Liverpool,Stoke,Win,Away,2017-04-08,3,4,5,8,11,0,0,1,4,4,5,7,7,0,8.0,9.0,-1.0,9
9536,9536,2016-17,2016,2017,Liverpool,West Brom,Win,Away,2017-04-16,3,4,7,8,11,0,1,4,4,4,6,4,7,0,8.0,14.0,-6.0,9
9537,9537,2016-17,2016,2017,Liverpool,Crystal Palace,Loss,Home,2017-04-23,0,6,7,10,11,4,4,7,10,2,3,3,1,1,8.0,15.0,-7.0,9
9538,9538,2016-17,2016,2017,Liverpool,Watford,Win,Away,2017-05-01,3,3,6,7,10,3,3,6,9,0,3,1,1,0,8.0,13.0,-5.0,10
9539,9539,2016-17,2016,2017,Liverpool,Southampton,Draw,Home,2017-05-07,1,3,6,9,10,1,1,4,7,2,5,5,3,1,8.0,6.0,2.0,10
9540,9540,2016-17,2016,2017,Liverpool,West Ham,Win,Away,2017-05-14,3,4,4,7,10,4,5,6,9,0,-1,1,1,0,8.0,7.0,1.0,10
9541,9541,2016-17,2016,2017,Liverpool,Middlesbrough,Win,Home,2017-05-21,3,4,7,7,10,0,1,4,4,4,6,3,6,1,8.0,21.0,-13.0,10
9542,9542,2017-18,2017,2018,Liverpool,Watford,Draw,Away,2017-08-12,1,6,7,10,10,0,0,0,0,6,7,10,10,0,4.0,17.0,-13.0,1
9543,9543,2017-18,2017,2018,Liverpool,Crystal Palace,Win,Home,2017-08-19,3,4,7,8,11,0,3,3,3,4,4,5,8,1,4.0,14.0,-10.0,1
9544,9544,2017-18,2017,2018,Liverpool,Arsenal,Win,Home,2017-08-27,3,4,7,10,11,3,6,9,12,1,1,1,-1,1,4.0,5.0,-1.0,1
9545,9545,2017-18,2017,2018,Liverpool,Man City,Loss,Away,2017-09-09,0,6,7,10,13,4,7,10,13,2,0,0,0,0,4.0,3.0,1.0,2
9546,9546,2017-18,2017,2018,Liverpool,Burnley,Draw,Home,2017-09-16,1,3,6,7,10,4,4,7,7,-1,2,0,3,1,4.0,16.0,-12.0,2
9547,9547,2017-18,2017,2018,Liverpool,Leicester,Win,Away,2017-09-23,3,1,4,7,8,1,1,4,4,0,3,3,4,0,4.0,12.0,-8.0,2
9548,9548,2017-18,2017,2018,Liverpool,Newcastle,Draw,Away,2017-10-01,1,4,4,7,10,3,6,9,9,1,-2,-2,1,0,4.0,21.0,-17.0,3
9549,9549,2017-18,2017,2018,Liverpool,Man United,Draw,Home,2017-10-14,1,4,5,5,8,6,9,10,13,-2,-4,-5,-5,1,4.0,6.0,-2.0,3
9550,9550,2017-18,2017,2018,Liverpool,Tottenham,Loss,Away,2017-10-22,0,2,5,6,6,6,9,10,13,-4,-4,-4,-7,0,4.0,2.0,2.0,3
9551,9551,2017-18,2017,2018,Liverpool,Huddersfield,Win,Home,2017-10-28,3,1,2,5,6,3,3,4,5,-2,-1,1,1,1,4.0,21.0,-17.0,3
9552,9552,2017-18,2017,2018,Liverpool,West Ham,Win,Away,2017-11-04,3,3,4,5,8,1,2,5,5,2,2,0,3,0,4.0,11.0,-7.0,4
9553,9553,2017-18,2017,2018,Liverpool,Southampton,Win,Home,2017-11-18,3,6,6,7,8,1,4,5,5,5,2,2,3,1,4.0,8.0,-4.0,4
9554,9554,2017-18,2017,2018,Liverpool,Chelsea,Draw,Home,2017-11-25,1,6,9,9,10,6,9,12,12,0,0,-3,-2,1,4.0,1.0,3.0,4
9555,9555,2017-18,2017,2018,Liverpool,Stoke,Win,Away,2017-11-29,3,4,7,10,10,1,2,5,5,3,5,5,5,0,4.0,13.0,-9.0,4
9556,9556,2017-18,2017,2018,Liverpool,Brighton,Win,Away,2017-12-02,3,4,7,10,13,1,2,5,6,3,5,5,7,0,4.0,21.0,-17.0,5
9557,9557,2017-18,2017,2018,Liverpool,Everton,Draw,Home,2017-12-10,1,6,7,10,13,6,6,7,10,0,1,3,3,1,4.0,7.0,-3.0,5
9558,9558,2017-18,2017,2018,Liverpool,West Brom,Draw,Home,2017-12-13,1,4,7,8,11,1,2,3,3,3,5,5,8,1,4.0,10.0,-6.0,5
9559,9559,2017-18,2017,2018,Liverpool,Bournemouth,Win,Away,2017-12-17,3,2,5,8,9,1,2,2,3,1,3,6,6,0,4.0,9.0,-5.0,5
9560,9560,2017-18,2017,2018,Liverpool,Arsenal,Draw,Away,2017-12-22,1,4,5,8,11,4,5,5,8,0,0,3,3,0,4.0,5.0,-1.0,5
9561,9561,2017-18,2017,2018,Liverpool,Swansea,Win,Home,2017-12-26,3,4,5,6,9,1,1,4,4,3,4,2,5,1,4.0,15.0,-11.0,5
9562,9562,2017-18,2017,2018,Liverpool,Leicester,Win,Home,2017-12-30,3,4,7,8,9,1,1,4,7,3,6,4,2,1,4.0,12.0,-8.0,5
9563,9563,2017-18,2017,2018,Liverpool,Burnley,Win,Away,2018-01-01,3,6,7,10,11,2,2,3,6,4,5,7,5,0,4.0,16.0,-12.0,6
9564,9564,2017-18,2017,2018,Liverpool,Man City,Win,Home,2018-01-14,3,6,9,10,13,4,7,10,13,2,2,0,0,1,4.0,3.0,1.0,6
9565,9565,2017-18,2017,2018,Liverpool,Swansea,Loss,Away,2018-01-22,0,6,9,12,13,1,4,4,5,5,5,8,8,0,4.0,15.0,-11.0,6
9566,9566,2017-18,2017,2018,Liverpool,Huddersfield,Win,Away,2018-01-30,3,3,6,9,12,0,0,1,2,3,6,8,10,0,4.0,21.0,-17.0,6
9567,9567,2017-18,2017,2018,Liverpool,Tottenham,Draw,Home,2018-02-04,1,3,6,9,12,4,7,8,11,-1,-1,1,1,1,4.0,2.0,2.0,7
9568,9568,2017-18,2017,2018,Liverpool,Southampton,Win,Away,2018-02-11,3,4,4,7,10,4,5,6,6,0,-1,1,4,0,4.0,8.0,-4.0,7
9569,9569,2017-18,2017,2018,Liverpool,West Ham,Win,Home,2018-02-24,3,4,7,7,10,3,4,5,8,1,3,2,2,1,4.0,11.0,-7.0,7
9570,9570,2017-18,2017,2018,Liverpool,Newcastle,Win,Home,2018-03-03,3,6,7,10,10,4,5,6,6,2,2,4,4,1,4.0,21.0,-17.0,8
9571,9571,2017-18,2017,2018,Liverpool,Man United,Loss,Away,2018-03-10,0,6,9,10,13,6,6,9,9,0,3,1,4,0,4.0,6.0,-2.0,8
9572,9572,2017-18,2017,2018,Liverpool,Watford,Win,Home,2018-03-17,3,3,6,9,10,3,6,6,9,0,0,3,1,1,4.0,17.0,-13.0,8
9573,9573,2017-18,2017,2018,Liverpool,Crystal Palace,Win,Away,2018-03-31,3,3,6,9,12,3,3,3,3,0,3,6,9,0,4.0,14.0,-10.0,8
9574,9574,2017-18,2017,2018,Liverpool,Everton,Draw,Away,2018-04-07,1,6,6,9,12,3,6,6,6,3,0,3,6,0,4.0,7.0,-3.0,9
9575,9575,2017-18,2017,2018,Liverpool,Bournemouth,Win,Home,2018-04-14,3,4,7,7,10,2,5,5,6,2,2,2,4,1,4.0,9.0,-5.0,9
9576,9576,2017-18,2017,2018,Liverpool,West Brom,Draw,Away,2018-04-21,1,4,7,10,10,4,4,4,4,0,3,6,6,0,4.0,10.0,-6.0,9
9577,9577,2017-18,2017,2018,Liverpool,Stoke,Draw,Home,2018-04-28,1,4,5,8,11,2,2,2,2,2,3,6,9,1,4.0,13.0,-9.0,9
9578,9578,2017-18,2017,2018,Liverpool,Chelsea,Loss,Away,2018-05-06,0,2,5,6,9,6,9,10,10,-4,-4,-4,-1,0,4.0,1.0,3.0,10
9579,9579,2017-18,2017,2018,Liverpool,Brighton,Win,Home,2018-05-13,3,1,2,5,6,3,4,5,5,-2,-2,0,1,1,4.0,21.0,-17.0,10
9580,9580,1993-94,1993,1994,Man City,Leeds,Draw,Home,1993-08-14,1,0,0,0,0,0,0,0,0,0,0,0,0,1,9.0,17.0,-8.0,1
9581,9581,1993-94,1993,1994,Man City,Everton,Loss,Away,1993-08-17,0,1,1,1,1,3,3,3,3,-2,-2,-2,-2,0,9.0,13.0,-4.0,1
9582,9582,1993-94,1993,1994,Man City,Tottenham,Loss,Away,1993-08-21,0,1,1,1,1,3,3,3,3,-2,-2,-2,-2,0,9.0,8.0,1.0,1
9583,9583,1993-94,1993,1994,Man City,Blackburn,Loss,Home,1993-08-24,0,0,1,1,1,3,6,6,6,-3,-5,-5,-5,1,9.0,4.0,5.0,1
9584,9584,1993-94,1993,1994,Man City,Coventry,Draw,Home,1993-08-27,1,0,0,1,1,2,5,8,8,-2,-5,-7,-7,1,9.0,15.0,-6.0,1
9585,9585,1993-94,1993,1994,Man City,Swindon,Win,Away,1993-09-01,3,1,1,1,2,1,1,1,1,0,0,0,1,0,9.0,21.0,-12.0,2
9586,9586,1993-94,1993,1994,Man City,QPR,Win,Home,1993-09-11,3,4,4,4,4,6,6,9,9,-2,-2,-5,-5,1,9.0,5.0,4.0,2
9587,9587,1993-94,1993,1994,Man City,Wimbledon,Loss,Away,1993-09-20,0,6,7,7,7,6,7,7,8,0,0,0,-1,0,9.0,12.0,-3.0,2
9588,9588,1993-94,1993,1994,Man City,Sheffield United,Win,Away,1993-09-25,3,3,6,7,7,1,1,2,5,2,5,5,2,0,9.0,14.0,-5.0,2
9589,9589,1993-94,1993,1994,Man City,Oldham,Draw,Home,1993-10-04,1,3,6,9,10,1,1,1,2,2,5,8,8,1,9.0,19.0,-10.0,3
9590,9590,1993-94,1993,1994,Man City,Arsenal,Draw,Away,1993-10-16,1,4,4,7,10,4,4,7,8,0,0,0,2,0,9.0,10.0,-1.0,3
9591,9591,1993-94,1993,1994,Man City,Liverpool,Draw,Home,1993-10-23,1,2,5,5,8,4,4,4,4,-2,1,1,4,1,9.0,6.0,3.0,3
9592,9592,1993-94,1993,1994,Man City,West Ham,Loss,Away,1993-11-01,0,2,3,6,6,2,5,5,8,0,-2,1,-2,0,9.0,21.0,-12.0,4
9593,9593,1993-94,1993,1994,Man City,Man United,Loss,Home,1993-11-07,0,1,2,3,6,6,9,12,15,-5,-7,-9,-9,1,9.0,1.0,8.0,4
9594,9594,1993-94,1993,1994,Man City,Norwich,Draw,Away,1993-11-20,1,0,1,2,3,4,5,8,11,-4,-4,-6,-8,0,9.0,3.0,6.0,4
9595,9595,1993-94,1993,1994,Man City,Chelsea,Draw,Away,1993-11-22,1,1,1,2,3,0,0,0,0,1,1,2,3,0,9.0,11.0,-2.0,4
9596,9596,1993-94,1993,1994,Man City,Sheffield Weds,Loss,Home,1993-11-27,0,2,2,2,3,4,7,8,9,-2,-5,-6,-6,1,9.0,7.0,2.0,4
9597,9597,1993-94,1993,1994,Man City,Leeds,Loss,Away,1993-12-04,0,1,2,2,2,4,5,8,9,-3,-3,-6,-7,0,9.0,17.0,-8.0,5
9598,9598,1993-94,1993,1994,Man City,Everton,Win,Home,1993-12-08,3,0,1,2,2,4,5,5,5,-4,-4,-3,-3,1,9.0,13.0,-4.0,5
9599,9599,1993-94,1993,1994,Man City,Tottenham,Loss,Home,1993-12-11,0,3,3,4,5,1,2,3,4,2,1,1,1,1,9.0,8.0,1.0,5
9600,9600,1993-94,1993,1994,Man City,Blackburn,Loss,Away,1993-12-18,0,3,3,3,4,6,6,9,12,-3,-3,-6,-8,0,9.0,4.0,5.0,5
9601,9601,1993-94,1993,1994,Man City,Southampton,Draw,Home,1993-12-28,1,0,3,3,3,3,3,3,3,-3,0,0,0,1,9.0,18.0,-9.0,5
9602,9602,1993-94,1993,1994,Man City,Newcastle,Loss,Away,1994-01-01,0,1,1,4,4,1,4,5,8,0,-3,-1,-4,0,9.0,21.0,-12.0,6
9603,9603,1993-94,1993,1994,Man City,Arsenal,Draw,Home,1994-01-15,1,1,1,1,4,4,7,10,10,-3,-6,-9,-6,1,9.0,10.0,-1.0,6
9604,9604,1993-94,1993,1994,Man City,Liverpool,Loss,Away,1994-01-22,0,1,2,2,2,4,7,8,9,-3,-5,-6,-7,0,9.0,6.0,3.0,6
9605,9605,1993-94,1993,1994,Man City,Ipswich,Win,Home,1994-02-05,3,1,1,2,2,1,2,2,3,0,-1,0,-1,1,9.0,16.0,-7.0,7
9606,9606,1993-94,1993,1994,Man City,West Ham,Draw,Home,1994-02-12,1,3,4,4,5,1,2,5,5,2,2,-1,0,1,9.0,21.0,-12.0,7
9607,9607,1993-94,1993,1994,Man City,Coventry,Loss,Away,1994-02-19,0,4,4,5,5,1,4,4,4,3,0,1,1,0,9.0,15.0,-6.0,7
9608,9608,1993-94,1993,1994,Man City,Aston Villa,Draw,Away,1994-02-22,1,1,4,4,5,6,7,10,10,-5,-3,-6,-5,0,9.0,2.0,7.0,7
9609,9609,1993-94,1993,1994,Man City,Swindon,Win,Home,1994-02-26,3,1,2,5,5,1,4,7,7,0,-2,-2,-2,1,9.0,21.0,-12.0,7
9610,9610,1993-94,1993,1994,Man City,QPR,Draw,Away,1994-03-05,1,4,4,5,8,3,3,4,4,1,1,1,4,0,9.0,5.0,4.0,8
9611,9611,1993-94,1993,1994,Man City,Wimbledon,Loss,Home,1994-03-12,0,4,5,5,6,3,6,6,7,1,-1,-1,-1,1,9.0,12.0,-3.0,8
9612,9612,1993-94,1993,1994,Man City,Sheffield United,Draw,Home,1994-03-19,1,1,4,5,5,2,3,3,4,-1,1,2,1,1,9.0,14.0,-5.0,8
9613,9613,1993-94,1993,1994,Man City,Oldham,Draw,Away,1994-03-26,1,1,2,5,6,3,4,7,10,-2,-2,-2,-4,0,9.0,19.0,-10.0,8
9614,9614,1993-94,1993,1994,Man City,Ipswich,Draw,Away,1994-03-29,1,2,2,3,6,0,1,4,4,2,1,-1,2,0,9.0,16.0,-7.0,8
9615,9615,1993-94,1993,1994,Man City,Aston Villa,Win,Home,1994-04-02,3,2,3,3,4,1,1,1,4,1,2,2,0,1,9.0,2.0,7.0,9
9616,9616,1993-94,1993,1994,Man City,Southampton,Win,Away,1994-04-04,3,4,5,6,6,0,1,1,2,4,4,5,4,0,9.0,18.0,-9.0,9
9617,9617,1993-94,1993,1994,Man City,Newcastle,Win,Home,1994-04-09,3,6,7,8,9,2,5,8,11,4,2,0,-2,1,9.0,21.0,-12.0,9
9618,9618,1993-94,1993,1994,Man City,Norwich,Draw,Home,1994-04-16,1,6,9,10,11,1,1,1,1,5,8,9,10,1,9.0,3.0,6.0,9
9619,9619,1993-94,1993,1994,Man City,Man United,Loss,Away,1994-04-23,0,4,7,10,11,3,3,6,7,1,4,4,4,0,9.0,1.0,8.0,9
9620,9620,1993-94,1993,1994,Man City,Chelsea,Draw,Home,1994-04-30,1,1,4,7,10,4,4,5,6,-3,0,2,4,1,9.0,11.0,-2.0,9
9621,9621,1993-94,1993,1994,Man City,Sheffield Weds,Draw,Away,1994-05-07,1,1,2,5,8,2,5,6,9,-1,-3,-1,-1,0,9.0,7.0,2.0,10
9622,9622,1994-95,1994,1995,Man City,Arsenal,Loss,Away,1994-08-20,0,2,2,3,6,0,1,4,5,2,1,-1,1,0,16.0,4.0,12.0,1
9623,9623,1994-95,1994,1995,Man City,West Ham,Win,Home,1994-08-24,3,1,2,2,3,2,3,6,6,-1,-1,-4,-3,1,16.0,13.0,3.0,1
9624,9624,1994-95,1994,1995,Man City,Everton,Win,Home,1994-08-27,3,3,4,5,5,1,4,4,5,2,0,1,0,1,16.0,17.0,-1.0,1
9625,9625,1994-95,1994,1995,Man City,Chelsea,Loss,Away,1994-08-31,0,6,6,7,8,6,9,9,10,0,-3,-2,-2,0,16.0,14.0,2.0,1
9626,9626,1994-95,1994,1995,Man City,Crystal Palace,Draw,Home,1994-09-10,1,3,6,6,7,1,2,2,2,2,4,4,5,1,16.0,21.0,-5.0,2
9627,9627,1994-95,1994,1995,Man City,Sheffield Weds,Draw,Away,1994-09-17,1,1,4,7,7,1,4,4,4,0,0,3,3,0,16.0,7.0,9.0,2
9628,9628,1994-95,1994,1995,Man City,Norwich,Win,Home,1994-09-24,3,2,2,5,8,4,5,8,9,-2,-3,-3,-1,1,16.0,12.0,4.0,2
9629,9629,1994-95,1994,1995,Man City,Leeds,Loss,Away,1994-10-01,0,4,5,5,8,1,4,7,7,3,1,-2,1,0,16.0,5.0,11.0,3
9630,9630,1994-95,1994,1995,Man City,Nott'm Forest,Draw,Home,1994-10-08,1,3,4,5,5,6,7,10,13,-3,-3,-5,-8,1,16.0,21.0,-5.0,3
9631,9631,1994-95,1994,1995,Man City,QPR,Win,Away,1994-10-15,3,1,4,5,6,1,1,2,3,0,3,3,3,0,16.0,9.0,7.0,3
9632,9632,1994-95,1994,1995,Man City,Tottenham,Win,Home,1994-10-22,3,4,4,7,8,2,5,5,5,2,-1,2,3,1,16.0,15.0,1.0,3
9633,9633,1994-95,1994,1995,Man City,Coventry,Loss,Away,1994-10-29,0,6,7,7,10,3,6,7,7,3,1,0,3,0,16.0,11.0,5.0,3
9634,9634,1994-95,1994,1995,Man City,Southampton,Draw,Home,1994-11-05,1,3,6,7,7,1,1,1,4,2,5,6,3,1,16.0,18.0,-2.0,4
9635,9635,1994-95,1994,1995,Man City,Man United,Loss,Away,1994-11-10,0,1,4,7,8,6,9,12,12,-5,-5,-5,-4,0,16.0,1.0,15.0,4
9636,9636,1994-95,1994,1995,Man City,Leicester,Win,Away,1994-11-20,3,1,1,4,7,0,0,3,3,1,1,1,4,0,16.0,21.0,-5.0,4
9637,9637,1994-95,1994,1995,Man City,Wimbledon,Win,Home,1994-11-26,3,3,4,4,7,6,6,9,9,-3,-2,-5,-2,1,16.0,6.0,10.0,4
9638,9638,1994-95,1994,1995,Man City,Ipswich,Win,Away,1994-12-03,3,6,6,7,7,1,1,4,4,5,5,3,3,0,16.0,19.0,-3.0,5
9639,9639,1994-95,1994,1995,Man City,Arsenal,Loss,Home,1994-12-12,0,6,9,9,10,2,2,2,3,4,7,7,7,1,16.0,4.0,12.0,5
9640,9640,1994-95,1994,1995,Man City,West Ham,Loss,Away,1994-12-17,0,3,6,9,9,1,1,1,4,2,5,8,5,0,16.0,13.0,3.0,5
9641,9641,1994-95,1994,1995,Man City,Blackburn,Loss,Home,1994-12-26,0,0,3,6,9,4,7,10,13,-4,-4,-4,-4,1,16.0,2.0,14.0,5
9642,9642,1994-95,1994,1995,Man City,Liverpool,Loss,Away,1994-12-28,0,0,0,3,6,4,5,6,7,-4,-5,-3,-1,0,16.0,8.0,8.0,5
9643,9643,1994-95,1994,1995,Man City,Aston Villa,Draw,Home,1994-12-31,1,0,0,0,3,4,4,5,6,-4,-4,-5,-3,1,16.0,10.0,6.0,5
9644,9644,1994-95,1994,1995,Man City,Newcastle,Draw,Away,1995-01-02,1,1,1,1,1,1,2,5,5,0,-1,-4,-4,0,16.0,3.0,13.0,6
9645,9645,1994-95,1994,1995,Man City,Coventry,Draw,Home,1995-01-14,1,2,2,2,2,0,0,1,2,2,2,1,0,1,16.0,11.0,5.0,6
9646,9646,1994-95,1994,1995,Man City,Leicester,Loss,Home,1995-01-25,0,2,3,3,3,0,0,1,1,2,3,2,2,1,16.0,21.0,-5.0,6
9647,9647,1994-95,1994,1995,Man City,Southampton,Draw,Away,1995-02-04,1,1,2,3,3,2,3,4,5,-1,-1,-1,-2,0,16.0,18.0,-2.0,7
9648,9648,1994-95,1994,1995,Man City,Man United,Loss,Home,1995-02-11,0,1,2,3,4,4,7,8,11,-3,-5,-5,-7,1,16.0,1.0,15.0,7
9649,9649,1994-95,1994,1995,Man City,Ipswich,Win,Home,1995-02-22,3,1,1,2,3,0,1,4,7,1,0,-2,-4,1,16.0,19.0,-3.0,7
9650,9650,1994-95,1994,1995,Man City,Leeds,Draw,Home,1995-02-25,1,3,4,4,5,4,5,8,9,-1,-1,-4,-4,1,16.0,5.0,11.0,7
9651,9651,1994-95,1994,1995,Man City,Norwich,Draw,Away,1995-03-04,1,4,4,5,5,1,2,2,3,3,2,3,2,0,16.0,12.0,4.0,8
9652,9652,1994-95,1994,1995,Man City,Chelsea,Loss,Home,1995-03-08,0,2,5,5,6,4,5,6,6,-2,0,-1,0,1,16.0,14.0,2.0,8
9653,9653,1994-95,1994,1995,Man City,Everton,Draw,Away,1995-03-15,1,1,2,5,5,1,4,4,5,0,-2,1,0,0,16.0,17.0,-1.0,8
9654,9654,1994-95,1994,1995,Man City,Sheffield Weds,Win,Home,1995-03-18,3,1,2,3,6,0,1,4,4,1,1,-1,2,1,16.0,7.0,9.0,8
9655,9655,1994-95,1994,1995,Man City,Wimbledon,Loss,Away,1995-03-21,0,4,4,5,6,6,6,6,9,-2,-2,-1,-3,0,16.0,6.0,10.0,8
9656,9656,1994-95,1994,1995,Man City,Crystal Palace,Loss,Away,1995-04-01,0,3,4,4,5,3,4,4,4,0,0,0,1,0,16.0,21.0,-5.0,9
9657,9657,1994-95,1994,1995,Man City,Tottenham,Loss,Away,1995-04-11,0,0,3,4,4,1,4,5,8,-1,-1,-1,-4,0,16.0,15.0,1.0,9
9658,9658,1994-95,1994,1995,Man City,Liverpool,Win,Home,1995-04-14,3,0,0,3,4,3,6,7,10,-3,-6,-4,-6,1,16.0,8.0,8.0,9
9659,9659,1994-95,1994,1995,Man City,Blackburn,Win,Away,1995-04-17,3,3,3,3,6,4,7,10,11,-1,-4,-7,-5,0,16.0,2.0,14.0,9
9660,9660,1994-95,1994,1995,Man City,Newcastle,Draw,Home,1995-04-29,1,6,6,6,6,0,3,4,4,6,3,2,2,1,16.0,3.0,13.0,9
9661,9661,1994-95,1994,1995,Man City,Aston Villa,Draw,Away,1995-05-03,1,4,7,7,7,0,0,1,4,4,7,6,3,0,16.0,10.0,6.0,10
9662,9662,1994-95,1994,1995,Man City,Nott'm Forest,Loss,Away,1995-05-06,0,2,5,8,8,6,9,10,13,-4,-4,-2,-5,0,16.0,21.0,-5.0,10
9663,9663,1994-95,1994,1995,Man City,QPR,Loss,Home,1995-05-14,0,1,2,5,8,4,4,4,4,-3,-2,1,4,1,16.0,9.0,7.0,10
9664,9664,1995-96,1995,1996,Man City,Tottenham,Draw,Home,1995-08-19,1,0,1,2,5,1,1,2,3,-1,0,0,2,1,17.0,7.0,10.0,1
9665,9665,1995-96,1995,1996,Man City,Coventry,Loss,Away,1995-08-23,0,1,1,2,3,1,4,4,4,0,-3,-2,-1,0,17.0,16.0,1.0,1
9666,9666,1995-96,1995,1996,Man City,QPR,Loss,Away,1995-08-26,0,1,1,1,2,0,3,6,7,1,-2,-5,-5,0,17.0,8.0,9.0,1
9667,9667,1995-96,1995,1996,Man City,Everton,Loss,Home,1995-08-30,0,0,1,1,1,3,4,5,8,-3,-3,-4,-7,1,17.0,15.0,2.0,1
9668,9668,1995-96,1995,1996,Man City,Arsenal,Loss,Home,1995-09-10,0,0,0,1,1,2,5,6,6,-2,-5,-5,-5,1,17.0,12.0,5.0,2
9669,9669,1995-96,1995,1996,Man City,Newcastle,Loss,Away,1995-09-16,0,0,0,0,1,3,6,9,12,-3,-6,-9,-11,0,17.0,6.0,11.0,2
9670,9670,1995-96,1995,1996,Man City,Middlesbrough,Loss,Home,1995-09-23,0,0,0,0,0,4,5,5,8,-4,-5,-5,-8,1,17.0,21.0,-4.0,2
9671,9671,1995-96,1995,1996,Man City,Nott'm Forest,Loss,Away,1995-09-30,0,0,0,0,0,4,5,6,7,-4,-5,-6,-7,0,17.0,3.0,14.0,2
9672,9672,1995-96,1995,1996,Man City,Man United,Loss,Away,1995-10-14,0,0,0,0,0,2,5,8,11,-2,-5,-8,-11,0,17.0,2.0,15.0,3
9673,9673,1995-96,1995,1996,Man City,Leeds,Draw,Home,1995-10-21,1,0,0,0,0,3,6,6,6,-3,-6,-6,-6,1,17.0,5.0,12.0,3
9674,9674,1995-96,1995,1996,Man City,Liverpool,Loss,Away,1995-10-28,0,1,1,1,1,4,5,8,11,-3,-4,-7,-10,0,17.0,4.0,13.0,3
9675,9675,1995-96,1995,1996,Man City,Bolton,Win,Home,1995-11-04,3,1,1,1,1,3,4,4,4,-2,-3,-3,-3,1,17.0,21.0,-4.0,4
9676,9676,1995-96,1995,1996,Man City,Sheffield Weds,Draw,Away,1995-11-18,1,3,4,4,4,1,4,4,4,2,0,0,0,0,17.0,13.0,4.0,4
9677,9677,1995-96,1995,1996,Man City,Wimbledon,Win,Home,1995-11-22,3,4,4,5,5,1,1,1,1,3,3,4,4,1,17.0,9.0,8.0,4
9678,9678,1995-96,1995,1996,Man City,Aston Villa,Win,Home,1995-11-25,3,4,7,7,8,4,7,10,10,0,0,-3,-2,1,17.0,18.0,-1.0,4
9679,9679,1995-96,1995,1996,Man City,Leeds,Win,Away,1995-12-02,3,6,7,10,10,3,4,7,8,3,3,3,2,0,17.0,5.0,12.0,5
9680,9680,1995-96,1995,1996,Man City,Middlesbrough,Loss,Away,1995-12-09,0,6,9,10,13,4,4,5,6,2,5,5,7,0,17.0,21.0,-4.0,5
9681,9681,1995-96,1995,1996,Man City,Nott'm Forest,Draw,Home,1995-12-18,1,3,6,9,10,2,3,3,6,1,3,6,4,1,17.0,3.0,14.0,5
9682,9682,1995-96,1995,1996,Man City,Chelsea,Loss,Home,1995-12-23,0,1,4,7,10,4,5,6,9,-3,-1,1,1,1,17.0,11.0,6.0,5
9683,9683,1995-96,1995,1996,Man City,Blackburn,Loss,Away,1995-12-26,0,1,1,4,7,4,4,7,8,-3,-3,-3,-1,0,17.0,1.0,16.0,5
9684,9684,1995-96,1995,1996,Man City,West Ham,Win,Home,1996-01-01,3,0,1,1,4,3,3,3,6,-3,-2,-2,-2,1,17.0,14.0,3.0,6
9685,9685,1995-96,1995,1996,Man City,Tottenham,Loss,Away,1996-01-13,0,3,3,4,4,3,4,5,8,0,-1,-1,-4,0,17.0,7.0,10.0,6
9686,9686,1995-96,1995,1996,Man City,Coventry,Draw,Home,1996-01-20,1,3,3,3,4,1,4,7,7,2,-1,-4,-3,1,17.0,16.0,1.0,6
9687,9687,1995-96,1995,1996,Man City,Southampton,Draw,Away,1996-01-31,1,1,4,4,4,3,4,5,6,-2,0,-1,-2,0,17.0,10.0,7.0,6
9688,9688,1995-96,1995,1996,Man City,QPR,Win,Home,1996-02-03,3,2,2,5,5,0,0,0,0,2,2,5,5,1,17.0,8.0,9.0,7
9689,9689,1995-96,1995,1996,Man City,Everton,Loss,Away,1996-02-10,0,4,5,5,8,4,5,8,11,0,0,-3,-3,0,17.0,15.0,2.0,7
9690,9690,1995-96,1995,1996,Man City,Newcastle,Draw,Home,1996-02-24,1,3,4,5,5,3,6,9,12,0,-2,-4,-7,1,17.0,6.0,11.0,7
9691,9691,1995-96,1995,1996,Man City,Blackburn,Draw,Home,1996-03-02,1,1,4,5,6,0,0,3,6,1,4,2,0,1,17.0,1.0,16.0,8
9692,9692,1995-96,1995,1996,Man City,Arsenal,Loss,Away,1996-03-05,0,2,2,5,6,4,7,8,8,-2,-5,-3,-2,0,17.0,12.0,5.0,8
9693,9693,1995-96,1995,1996,Man City,Chelsea,Draw,Away,1996-03-12,1,1,2,2,5,4,4,4,7,-3,-2,-2,-2,0,17.0,11.0,6.0,8
9694,9694,1995-96,1995,1996,Man City,Southampton,Win,Home,1996-03-16,3,1,2,3,3,0,1,2,5,1,1,1,-2,1,17.0,10.0,7.0,8
9695,9695,1995-96,1995,1996,Man City,West Ham,Loss,Away,1996-03-23,0,4,4,5,6,3,4,4,7,1,0,1,-1,0,17.0,14.0,3.0,8
9696,9696,1995-96,1995,1996,Man City,Bolton,Draw,Away,1996-03-30,1,3,4,4,5,3,6,9,9,0,-2,-5,-4,0,17.0,21.0,-4.0,8
9697,9697,1995-96,1995,1996,Man City,Man United,Loss,Home,1996-04-06,0,1,4,5,5,6,7,10,13,-5,-3,-5,-8,1,17.0,2.0,15.0,9
9698,9698,1995-96,1995,1996,Man City,Wimbledon,Loss,Away,1996-04-08,0,1,1,4,5,4,7,7,8,-3,-6,-3,-3,0,17.0,9.0,8.0,9
9699,9699,1995-96,1995,1996,Man City,Sheffield Weds,Win,Home,1996-04-13,3,0,1,1,4,3,3,6,9,-3,-2,-5,-5,1,17.0,13.0,4.0,9
9700,9700,1995-96,1995,1996,Man City,Aston Villa,Win,Away,1996-04-27,3,3,3,4,4,1,4,7,8,2,-1,-3,-4,0,17.0,18.0,-1.0,9
9701,9701,1995-96,1995,1996,Man City,Liverpool,Draw,Home,1996-05-04,1,6,6,6,7,4,5,8,8,2,1,-2,-1,1,17.0,4.0,13.0,10
9702,9702,2000-01,2000,2001,Man City,Charlton,Loss,Away,2000-08-19,0,4,7,7,7,3,4,4,4,1,3,3,3,0,21.0,21.0,0.0,1
9703,9703,2000-01,2000,2001,Man City,Sunderland,Win,Home,2000-08-23,3,1,4,7,7,3,6,7,7,-2,-2,0,0,1,21.0,7.0,14.0,1
9704,9704,2000-01,2000,2001,Man City,Coventry,Loss,Home,2000-08-26,0,3,4,7,10,3,3,6,6,0,1,1,4,1,21.0,14.0,7.0,1
9705,9705,2000-01,2000,2001,Man City,Leeds,Win,Away,2000-09-05,3,3,3,4,7,6,7,8,11,-3,-4,-4,-4,0,21.0,3.0,18.0,2
9706,9706,2000-01,2000,2001,Man City,Liverpool,Loss,Away,2000-09-09,0,3,6,6,7,4,4,7,7,-1,2,-1,0,0,21.0,4.0,17.0,2
9707,9707,2000-01,2000,2001,Man City,Middlesbrough,Draw,Home,2000-09-17,1,3,3,6,6,1,1,2,5,2,2,4,1,1,21.0,12.0,9.0,2
9708,9708,2000-01,2000,2001,Man City,Tottenham,Draw,Away,2000-09-23,1,1,4,4,7,3,6,6,7,-2,-2,-2,0,0,21.0,10.0,11.0,2
9709,9709,2000-01,2000,2001,Man City,Newcastle,Loss,Home,2000-09-30,0,2,2,5,5,0,1,4,7,2,1,1,-2,1,21.0,11.0,10.0,2
9710,9710,2000-01,2000,2001,Man City,Bradford,Win,Home,2000-10-14,3,1,2,2,5,1,1,2,2,0,1,0,3,1,21.0,17.0,4.0,3
9711,9711,2000-01,2000,2001,Man City,Southampton,Win,Away,2000-10-23,3,3,4,5,5,1,4,7,7,2,0,-2,-2,0,21.0,15.0,6.0,3
9712,9712,2000-01,2000,2001,Man City,Arsenal,Loss,Away,2000-10-28,0,6,6,7,8,6,9,10,13,0,-3,-3,-5,0,21.0,2.0,19.0,3
9713,9713,2000-01,2000,2001,Man City,Leicester,Loss,Home,2000-11-04,0,3,6,6,7,3,3,4,5,0,3,2,2,1,21.0,8.0,13.0,4
9714,9714,2000-01,2000,2001,Man City,West Ham,Loss,Away,2000-11-11,0,0,3,6,6,4,4,5,6,-4,-1,1,0,0,21.0,9.0,12.0,4
9715,9715,2000-01,2000,2001,Man City,Man United,Loss,Home,2000-11-18,0,0,0,3,6,6,9,12,15,-6,-9,-9,-9,1,21.0,1.0,20.0,4
9716,9716,2000-01,2000,2001,Man City,Ipswich,Loss,Home,2000-11-25,0,0,0,0,3,6,6,9,12,-6,-6,-9,-9,1,21.0,21.0,0.0,4
9717,9717,2000-01,2000,2001,Man City,Chelsea,Loss,Away,2000-12-03,0,0,0,0,0,0,1,1,4,0,-1,-1,-4,0,21.0,5.0,16.0,5
9718,9718,2000-01,2000,2001,Man City,Everton,Win,Home,2000-12-09,3,0,0,0,0,3,6,9,9,-3,-6,-9,-9,1,21.0,13.0,8.0,5
9719,9719,2000-01,2000,2001,Man City,Aston Villa,Draw,Away,2000-12-16,1,3,3,3,3,2,3,3,6,1,0,0,-3,0,21.0,6.0,15.0,5
9720,9720,2000-01,2000,2001,Man City,Sunderland,Loss,Away,2000-12-23,0,4,4,4,4,3,6,9,12,1,-2,-5,-8,0,21.0,7.0,14.0,5
9721,9721,2000-01,2000,2001,Man City,Derby,Draw,Home,2000-12-26,1,1,4,4,4,6,6,9,9,-5,-2,-5,-5,1,21.0,16.0,5.0,5
9722,9722,2000-01,2000,2001,Man City,Charlton,Loss,Home,2000-12-30,0,1,2,5,5,3,3,4,4,-2,-1,1,1,1,21.0,21.0,0.0,5
9723,9723,2000-01,2000,2001,Man City,Coventry,Draw,Away,2001-01-01,1,1,1,2,5,4,5,5,8,-3,-4,-3,-3,0,21.0,14.0,7.0,6
9724,9724,2000-01,2000,2001,Man City,Leeds,Loss,Home,2001-01-13,0,1,2,2,3,1,1,4,4,0,1,-2,-1,1,21.0,3.0,18.0,6
9725,9725,2000-01,2000,2001,Man City,Derby,Draw,Away,2001-01-20,1,1,1,2,2,3,3,4,7,-2,-2,-2,-5,0,21.0,16.0,5.0,6
9726,9726,2000-01,2000,2001,Man City,Liverpool,Draw,Home,2001-01-31,1,1,2,2,3,4,7,7,10,-3,-5,-5,-7,1,21.0,4.0,17.0,6
9727,9727,2000-01,2000,2001,Man City,Middlesbrough,Draw,Away,2001-02-03,1,2,2,3,3,2,5,6,7,0,-3,-3,-4,0,21.0,12.0,9.0,7
9728,9728,2000-01,2000,2001,Man City,Tottenham,Loss,Home,2001-02-10,0,2,3,3,4,2,3,4,7,0,0,-1,-3,1,21.0,10.0,11.0,7
9729,9729,2000-01,2000,2001,Man City,Newcastle,Win,Away,2001-02-24,3,1,2,3,3,0,3,6,6,1,-1,-3,-3,0,21.0,11.0,10.0,7
9730,9730,2000-01,2000,2001,Man City,Southampton,Loss,Home,2001-03-03,0,3,4,5,6,6,9,10,11,-3,-5,-5,-5,1,21.0,15.0,6.0,8
9731,9731,2000-01,2000,2001,Man City,Bradford,Draw,Away,2001-03-17,1,3,3,4,5,0,0,0,0,3,3,4,5,0,21.0,17.0,4.0,8
9732,9732,2000-01,2000,2001,Man City,Aston Villa,Loss,Home,2001-03-31,0,1,4,4,5,4,5,5,6,-3,-1,-1,-1,1,21.0,6.0,15.0,8
9733,9733,2000-01,2000,2001,Man City,Everton,Loss,Away,2001-04-08,0,1,1,4,4,3,4,4,7,-2,-3,0,-3,0,21.0,13.0,8.0,9
9734,9734,2000-01,2000,2001,Man City,Arsenal,Loss,Home,2001-04-11,0,0,1,1,4,4,7,7,10,-4,-6,-6,-6,1,21.0,2.0,19.0,9
9735,9735,2000-01,2000,2001,Man City,Leicester,Win,Away,2001-04-14,3,0,0,1,1,0,0,0,3,0,0,1,-2,0,21.0,8.0,13.0,9
9736,9736,2000-01,2000,2001,Man City,Man United,Draw,Away,2001-04-21,1,3,3,3,4,6,6,9,10,-3,-3,-6,-6,0,21.0,1.0,20.0,9
9737,9737,2000-01,2000,2001,Man City,West Ham,Win,Home,2001-04-28,3,4,4,4,4,0,3,4,4,4,1,0,0,1,21.0,9.0,12.0,9
9738,9738,2000-01,2000,2001,Man City,Ipswich,Loss,Away,2001-05-07,0,4,7,7,7,3,6,9,10,1,1,-2,-3,0,21.0,21.0,0.0,10
9739,9739,2000-01,2000,2001,Man City,Chelsea,Loss,Home,2001-05-19,0,3,4,7,7,4,4,4,7,-1,0,3,0,1,21.0,5.0,16.0,10
9740,9740,2002-03,2002,2003,Man City,Leeds,Loss,Away,2002-08-17,0,0,3,4,7,6,6,9,12,-6,-3,-5,-5,0,21.0,5.0,16.0,1
9741,9741,2002-03,2002,2003,Man City,Newcastle,Win,Home,2002-08-24,3,0,0,3,4,3,6,7,10,-3,-6,-4,-6,1,21.0,4.0,17.0,1
9742,9742,2002-03,2002,2003,Man City,Aston Villa,Loss,Away,2002-08-28,0,3,3,3,6,0,3,6,7,3,0,-3,-1,0,21.0,8.0,13.0,1
9743,9743,2002-03,2002,2003,Man City,Everton,Win,Home,2002-08-31,3,3,3,3,3,4,5,5,5,-1,-2,-2,-2,1,21.0,15.0,6.0,1
9744,9744,2002-03,2002,2003,Man City,Arsenal,Loss,Away,2002-09-10,0,3,6,6,6,4,5,8,11,-1,1,-2,-5,0,21.0,1.0,20.0,2
9745,9745,2002-03,2002,2003,Man City,Blackburn,Draw,Home,2002-09-15,1,3,3,6,6,0,1,4,5,3,2,2,1,1,21.0,10.0,11.0,2
9746,9746,2002-03,2002,2003,Man City,West Ham,Draw,Away,2002-09-21,1,1,4,4,7,0,0,1,1,1,4,3,6,0,21.0,7.0,14.0,2
9747,9747,2002-03,2002,2003,Man City,Liverpool,Loss,Home,2002-09-28,0,2,2,5,5,6,7,8,9,-4,-5,-3,-4,1,21.0,2.0,19.0,2
9748,9748,2002-03,2002,2003,Man City,Southampton,Loss,Away,2002-10-05,0,1,2,2,5,2,2,5,5,-1,0,-3,0,0,21.0,11.0,10.0,3
9749,9749,2002-03,2002,2003,Man City,Chelsea,Loss,Home,2002-10-19,0,0,1,2,2,0,1,4,7,0,0,-2,-5,1,21.0,6.0,15.0,3
9750,9750,2002-03,2002,2003,Man City,Birmingham,Win,Away,2002-10-26,3,0,0,1,2,4,4,4,7,-4,-4,-3,-5,0,21.0,21.0,0.0,3
9751,9751,2002-03,2002,2003,Man City,West Brom,Win,Away,2002-11-02,3,3,3,3,4,1,1,1,1,2,2,2,3,0,21.0,21.0,0.0,4
9752,9752,2002-03,2002,2003,Man City,Man United,Win,Home,2002-11-09,3,6,6,6,6,4,5,8,11,2,1,-2,-5,1,21.0,3.0,18.0,4
9753,9753,2002-03,2002,2003,Man City,Charlton,Loss,Home,2002-11-16,0,6,9,9,9,1,1,4,4,5,8,5,5,1,21.0,14.0,7.0,4
9754,9754,2002-03,2002,2003,Man City,Middlesbrough,Loss,Away,2002-11-23,0,3,6,9,9,3,3,4,4,0,3,5,5,0,21.0,12.0,9.0,4
9755,9755,2002-03,2002,2003,Man City,Bolton,Win,Home,2002-11-30,3,0,3,6,9,4,5,5,6,-4,-2,1,3,1,21.0,16.0,5.0,4
9756,9756,2002-03,2002,2003,Man City,Sunderland,Win,Away,2002-12-09,3,3,3,6,9,0,1,4,5,3,2,2,4,0,21.0,17.0,4.0,5
9757,9757,2002-03,2002,2003,Man City,Charlton,Draw,Away,2002-12-14,1,6,6,6,9,6,9,12,12,0,-3,-6,-3,0,21.0,14.0,7.0,5
9758,9758,2002-03,2002,2003,Man City,Tottenham,Loss,Home,2002-12-23,0,4,7,7,7,4,5,8,8,0,2,-1,-1,1,21.0,9.0,12.0,5
9759,9759,2002-03,2002,2003,Man City,Aston Villa,Win,Home,2002-12-26,3,1,4,7,7,3,3,3,6,-2,1,4,1,1,21.0,8.0,13.0,5
9760,9760,2002-03,2002,2003,Man City,Fulham,Win,Away,2002-12-28,3,3,4,7,10,1,1,4,4,2,3,3,6,0,21.0,13.0,8.0,5
9761,9761,2002-03,2002,2003,Man City,Everton,Draw,Away,2003-01-01,1,6,6,7,10,2,3,6,6,4,3,1,4,0,21.0,15.0,6.0,6
9762,9762,2002-03,2002,2003,Man City,Leeds,Win,Home,2003-01-11,3,4,7,7,8,6,9,10,13,-2,-2,-3,-5,1,21.0,5.0,16.0,6
9763,9763,2002-03,2002,2003,Man City,Newcastle,Loss,Away,2003-01-18,0,4,7,10,10,4,7,7,10,0,0,3,0,0,21.0,4.0,17.0,6
9764,9764,2002-03,2002,2003,Man City,Fulham,Win,Home,2003-01-29,3,3,4,7,10,4,4,5,5,-1,0,2,5,1,21.0,13.0,8.0,6
9765,9765,2002-03,2002,2003,Man City,West Brom,Loss,Home,2003-02-01,0,3,6,7,10,1,1,1,1,2,5,6,9,1,21.0,21.0,0.0,7
9766,9766,2002-03,2002,2003,Man City,Man United,Draw,Away,2003-02-09,1,3,3,6,7,6,9,12,15,-3,-6,-6,-8,0,21.0,3.0,18.0,7
9767,9767,2002-03,2002,2003,Man City,Arsenal,Loss,Home,2003-02-22,0,1,4,4,7,4,5,8,11,-3,-1,-4,-4,1,21.0,1.0,20.0,7
9768,9768,2002-03,2002,2003,Man City,Blackburn,Loss,Away,2003-03-01,0,1,1,4,4,6,6,6,7,-5,-5,-2,-3,0,21.0,10.0,11.0,8
9769,9769,2002-03,2002,2003,Man City,Birmingham,Win,Home,2003-03-16,3,0,1,1,4,6,6,6,6,-6,-5,-5,-2,1,21.0,21.0,0.0,8
9770,9770,2002-03,2002,2003,Man City,Chelsea,Loss,Away,2003-03-22,0,3,3,4,4,3,3,6,7,0,0,-2,-3,0,21.0,6.0,15.0,8
9771,9771,2002-03,2002,2003,Man City,Bolton,Loss,Away,2003-04-05,0,3,3,3,4,6,6,7,8,-3,-3,-4,-4,0,21.0,16.0,5.0,9
9772,9772,2002-03,2002,2003,Man City,Middlesbrough,Draw,Home,2003-04-12,1,0,3,3,3,4,7,10,11,-4,-4,-7,-8,1,21.0,12.0,9.0,9
9773,9773,2002-03,2002,2003,Man City,Tottenham,Win,Away,2003-04-18,3,1,1,4,4,4,4,4,4,-3,-3,0,0,0,21.0,9.0,12.0,9
9774,9774,2002-03,2002,2003,Man City,Sunderland,Win,Home,2003-04-21,3,4,4,4,7,0,0,0,0,4,4,4,7,1,21.0,17.0,4.0,9
9775,9775,2002-03,2002,2003,Man City,West Ham,Loss,Home,2003-04-27,0,6,7,7,7,3,4,5,8,3,3,2,-1,1,21.0,7.0,14.0,9
9776,9776,2002-03,2002,2003,Man City,Liverpool,Win,Away,2003-05-03,3,3,6,7,7,6,9,12,12,-3,-3,-5,-5,0,21.0,2.0,19.0,10
9777,9777,2002-03,2002,2003,Man City,Southampton,Loss,Home,2003-05-11,0,3,6,9,10,1,1,1,4,2,5,8,6,1,21.0,11.0,10.0,10
9778,9778,2003-04,2003,2004,Man City,Charlton,Win,Away,2003-08-17,3,3,3,6,9,0,3,3,3,3,0,3,6,0,9.0,12.0,-3.0,1
9779,9779,2003-04,2003,2004,Man City,Portsmouth,Draw,Home,2003-08-23,1,3,6,6,9,3,3,3,3,0,3,3,6,1,9.0,21.0,-12.0,1
9780,9780,2003-04,2003,2004,Man City,Blackburn,Win,Away,2003-08-25,3,4,4,7,7,4,7,8,11,0,-3,-1,-4,0,9.0,6.0,3.0,1
9781,9781,2003-04,2003,2004,Man City,Arsenal,Loss,Home,2003-08-31,0,4,7,7,10,6,9,12,15,-2,-2,-5,-5,1,9.0,2.0,7.0,1
9782,9782,2003-04,2003,2004,Man City,Aston Villa,Win,Home,2003-09-14,3,3,4,7,7,3,4,4,4,0,0,3,3,1,9.0,16.0,-7.0,2
9783,9783,2003-04,2003,2004,Man City,Fulham,Draw,Away,2003-09-20,1,3,6,7,10,4,4,7,10,-1,2,0,0,0,9.0,14.0,-5.0,2
9784,9784,2003-04,2003,2004,Man City,Tottenham,Draw,Home,2003-09-28,1,4,4,7,8,0,0,1,4,4,4,6,4,1,9.0,10.0,-1.0,2
9785,9785,2003-04,2003,2004,Man City,Wolves,Loss,Away,2003-10-04,0,2,5,5,8,1,1,2,2,1,4,3,6,0,9.0,21.0,-12.0,3
9786,9786,2003-04,2003,2004,Man City,Bolton,Win,Home,2003-10-18,3,1,2,5,5,2,3,6,7,-1,-1,-1,-2,1,9.0,17.0,-8.0,3
9787,9787,2003-04,2003,2004,Man City,Chelsea,Loss,Away,2003-10-25,0,3,4,5,8,1,4,7,10,2,0,-2,-2,0,9.0,4.0,5.0,3
9788,9788,2003-04,2003,2004,Man City,Southampton,Win,Away,2003-11-01,3,3,3,4,5,4,4,4,7,-1,-1,0,-2,0,9.0,8.0,1.0,4
9789,9789,2003-04,2003,2004,Man City,Leicester,Loss,Home,2003-11-09,0,3,6,6,7,3,3,3,3,0,3,3,4,1,9.0,21.0,-12.0,4
9790,9790,2003-04,2003,2004,Man City,Newcastle,Loss,Away,2003-11-22,0,3,3,6,6,1,4,7,10,2,-1,-1,-4,0,9.0,3.0,6.0,4
9791,9791,2003-04,2003,2004,Man City,Middlesbrough,Loss,Home,2003-11-30,0,0,3,3,6,4,7,8,8,-4,-4,-5,-2,1,9.0,11.0,-2.0,4
9792,9792,2003-04,2003,2004,Man City,Everton,Draw,Away,2003-12-07,1,0,0,3,3,3,3,3,4,-3,-3,0,-1,0,9.0,7.0,2.0,5
9793,9793,2003-04,2003,2004,Man City,Man United,Loss,Away,2003-12-13,0,1,1,1,4,3,6,9,12,-2,-5,-8,-8,0,9.0,1.0,8.0,5
9794,9794,2003-04,2003,2004,Man City,Leeds,Draw,Home,2003-12-22,1,1,1,1,1,4,7,7,7,-3,-6,-6,-6,1,9.0,15.0,-6.0,5
9795,9795,2003-04,2003,2004,Man City,Birmingham,Loss,Away,2003-12-26,0,1,2,2,2,3,3,3,4,-2,-1,-1,-2,0,9.0,13.0,-4.0,5
9796,9796,2003-04,2003,2004,Man City,Liverpool,Draw,Home,2003-12-28,1,1,1,2,2,3,4,7,8,-2,-3,-5,-6,1,9.0,5.0,4.0,5
9797,9797,2003-04,2003,2004,Man City,Charlton,Draw,Home,2004-01-07,1,1,2,2,3,6,7,8,8,-5,-5,-6,-5,1,9.0,12.0,-3.0,6
9798,9798,2003-04,2003,2004,Man City,Portsmouth,Loss,Away,2004-01-10,0,2,2,3,3,0,3,3,3,2,-1,0,0,0,9.0,21.0,-12.0,6
9799,9799,2003-04,2003,2004,Man City,Blackburn,Draw,Home,2004-01-17,1,1,2,2,3,1,4,5,5,0,-2,-3,-2,1,9.0,6.0,3.0,6
9800,9800,2003-04,2003,2004,Man City,Arsenal,Loss,Away,2004-02-01,0,1,2,3,3,6,7,10,13,-5,-5,-7,-10,0,9.0,2.0,7.0,7
9801,9801,2003-04,2003,2004,Man City,Birmingham,Draw,Home,2004-02-08,1,1,1,2,3,2,5,5,5,-1,-4,-3,-2,1,9.0,13.0,-4.0,7
9802,9802,2003-04,2003,2004,Man City,Liverpool,Loss,Away,2004-02-11,0,1,2,2,3,2,3,3,6,-1,-1,-1,-3,0,9.0,5.0,4.0,7
9803,9803,2003-04,2003,2004,Man City,Bolton,Win,Away,2004-02-21,3,1,1,2,2,2,5,8,11,-1,-4,-6,-9,0,9.0,17.0,-8.0,7
9804,9804,2003-04,2003,2004,Man City,Chelsea,Loss,Home,2004-02-28,0,3,4,4,5,3,6,9,10,0,-2,-5,-5,1,9.0,4.0,5.0,7
9805,9805,2003-04,2003,2004,Man City,Man United,Win,Home,2004-03-14,3,3,3,4,4,2,2,5,8,1,1,-1,-4,1,9.0,1.0,8.0,8
9806,9806,2003-04,2003,2004,Man City,Leeds,Loss,Away,2004-03-22,0,3,6,6,7,1,2,5,5,2,4,1,2,0,9.0,15.0,-6.0,8
9807,9807,2003-04,2003,2004,Man City,Fulham,Draw,Home,2004-03-27,1,3,3,6,6,3,4,4,4,0,-1,2,2,1,9.0,14.0,-5.0,8
9808,9808,2003-04,2003,2004,Man City,Aston Villa,Draw,Away,2004-04-04,1,1,4,4,7,3,6,6,7,-2,-2,-2,0,0,9.0,16.0,-7.0,9
9809,9809,2003-04,2003,2004,Man City,Wolves,Draw,Home,2004-04-10,1,2,2,5,5,0,0,0,1,2,2,5,4,1,9.0,21.0,-12.0,9
9810,9810,2003-04,2003,2004,Man City,Tottenham,Draw,Away,2004-04-12,1,2,3,3,6,0,0,0,3,2,3,3,3,0,9.0,10.0,-1.0,9
9811,9811,2003-04,2003,2004,Man City,Southampton,Loss,Home,2004-04-17,0,2,3,4,4,3,6,6,9,-1,-3,-2,-5,1,9.0,8.0,1.0,9
9812,9812,2003-04,2003,2004,Man City,Leicester,Draw,Away,2004-04-24,1,1,2,3,4,0,0,0,1,1,2,3,3,0,9.0,21.0,-12.0,9
9813,9813,2003-04,2003,2004,Man City,Newcastle,Win,Home,2004-05-01,3,1,2,3,4,4,5,8,8,-3,-3,-5,-4,1,9.0,3.0,6.0,10
9814,9814,2003-04,2003,2004,Man City,Middlesbrough,Loss,Away,2004-05-08,0,4,4,5,6,0,0,3,4,4,4,2,2,0,9.0,11.0,-2.0,10
9815,9815,2003-04,2003,2004,Man City,Everton,Win,Home,2004-05-15,3,3,4,4,5,0,0,1,2,3,4,3,3,1,9.0,7.0,2.0,10
9816,9816,2004-05,2004,2005,Man City,Fulham,Draw,Home,2004-08-14,1,3,6,7,7,3,4,7,8,0,2,0,-1,1,16.0,9.0,7.0,1
9817,9817,2004-05,2004,2005,Man City,Liverpool,Loss,Away,2004-08-21,0,4,4,7,8,2,5,8,11,2,-1,-1,-3,0,16.0,4.0,12.0,1
9818,9818,2004-05,2004,2005,Man City,Birmingham,Loss,Away,2004-08-24,0,1,4,4,7,1,2,2,3,0,2,2,4,0,16.0,10.0,6.0,1
9819,9819,2004-05,2004,2005,Man City,Charlton,Win,Home,2004-08-28,3,0,1,4,4,6,6,9,10,-6,-5,-5,-6,1,16.0,7.0,9.0,1
9820,9820,2004-05,2004,2005,Man City,Everton,Loss,Home,2004-09-11,0,3,3,4,7,4,7,7,7,-1,-4,-3,0,1,16.0,17.0,-1.0,2
9821,9821,2004-05,2004,2005,Man City,Crystal Palace,Win,Away,2004-09-18,3,3,3,3,4,0,0,0,1,3,3,3,3,0,16.0,21.0,-5.0,2
9822,9822,2004-05,2004,2005,Man City,Arsenal,Loss,Home,2004-09-25,0,3,6,6,6,4,7,10,13,-1,-1,-4,-7,1,16.0,1.0,15.0,2
9823,9823,2004-05,2004,2005,Man City,Southampton,Draw,Away,2004-10-02,1,3,3,6,6,0,1,1,1,3,2,5,5,0,16.0,12.0,4.0,3
9824,9824,2004-05,2004,2005,Man City,Chelsea,Win,Home,2004-10-16,3,1,4,4,7,6,7,8,11,-5,-3,-4,-4,1,16.0,2.0,14.0,3
9825,9825,2004-05,2004,2005,Man City,Newcastle,Loss,Away,2004-10-24,0,4,4,7,7,2,5,8,11,2,-1,-1,-4,0,16.0,5.0,11.0,3
9826,9826,2004-05,2004,2005,Man City,Norwich,Draw,Home,2004-11-01,1,3,4,4,7,1,2,2,3,2,2,2,4,1,16.0,21.0,-5.0,4
9827,9827,2004-05,2004,2005,Man City,Man United,Draw,Away,2004-11-07,1,1,4,5,5,3,4,5,8,-2,0,0,-3,0,16.0,3.0,13.0,4
9828,9828,2004-05,2004,2005,Man City,Blackburn,Draw,Home,2004-11-13,1,2,2,5,6,2,2,2,3,0,0,3,3,1,16.0,15.0,1.0,4
9829,9829,2004-05,2004,2005,Man City,Portsmouth,Win,Away,2004-11-20,3,2,3,3,6,0,3,4,7,2,0,-1,-1,0,16.0,13.0,3.0,4
9830,9830,2004-05,2004,2005,Man City,Aston Villa,Win,Home,2004-11-27,3,4,5,6,6,6,9,10,13,-2,-4,-4,-7,1,16.0,6.0,10.0,4
9831,9831,2004-05,2004,2005,Man City,Middlesbrough,Loss,Away,2004-12-06,0,6,7,8,9,3,6,7,10,3,1,1,-1,0,16.0,11.0,5.0,5
9832,9832,2004-05,2004,2005,Man City,Tottenham,Loss,Home,2004-12-11,0,3,6,7,8,6,6,6,6,-3,0,1,2,1,16.0,14.0,2.0,5
9833,9833,2004-05,2004,2005,Man City,Bolton,Win,Away,2004-12-18,3,0,3,6,7,0,0,1,1,0,3,5,6,0,16.0,8.0,8.0,5
9834,9834,2004-05,2004,2005,Man City,Everton,Loss,Away,2004-12-26,0,3,3,6,9,4,7,8,11,-1,-4,-2,-2,0,16.0,17.0,-1.0,5
9835,9835,2004-05,2004,2005,Man City,West Brom,Draw,Home,2004-12-28,1,3,3,3,6,0,0,0,0,3,3,3,6,1,16.0,21.0,-5.0,5
9836,9836,2004-05,2004,2005,Man City,Southampton,Win,Home,2005-01-01,3,1,4,4,4,1,1,2,2,0,3,2,2,1,16.0,12.0,4.0,6
9837,9837,2004-05,2004,2005,Man City,Arsenal,Draw,Away,2005-01-04,1,4,4,7,7,6,9,12,13,-2,-5,-5,-6,0,16.0,1.0,15.0,6
9838,9838,2004-05,2004,2005,Man City,Crystal Palace,Win,Home,2005-01-15,3,4,5,5,8,3,4,4,4,1,1,1,4,1,16.0,21.0,-5.0,6
9839,9839,2004-05,2004,2005,Man City,West Brom,Loss,Away,2005-01-22,0,4,7,8,8,1,2,3,3,3,5,5,5,0,16.0,21.0,-5.0,6
9840,9840,2004-05,2004,2005,Man City,Newcastle,Draw,Home,2005-02-02,1,3,4,7,8,3,4,7,7,0,0,0,1,1,16.0,5.0,11.0,7
9841,9841,2004-05,2004,2005,Man City,Chelsea,Draw,Away,2005-02-06,1,1,4,5,8,6,9,12,15,-5,-5,-7,-7,0,16.0,2.0,14.0,7
9842,9842,2004-05,2004,2005,Man City,Man United,Loss,Home,2005-02-13,0,2,2,5,6,6,9,12,13,-4,-7,-7,-7,1,16.0,3.0,13.0,7
9843,9843,2004-05,2004,2005,Man City,Norwich,Win,Away,2005-02-28,3,1,2,2,5,3,3,4,4,-2,-1,-2,1,0,16.0,21.0,-5.0,7
9844,9844,2004-05,2004,2005,Man City,Bolton,Loss,Home,2005-03-07,0,3,4,5,5,1,4,7,10,2,0,-2,-5,1,16.0,8.0,8.0,8
9845,9845,2004-05,2004,2005,Man City,Tottenham,Loss,Away,2005-03-19,0,3,3,4,5,0,3,6,6,3,0,-2,-1,0,16.0,14.0,2.0,8
9846,9846,2004-05,2004,2005,Man City,Charlton,Draw,Away,2005-04-02,1,0,3,3,4,3,4,5,6,-3,-1,-2,-2,0,16.0,7.0,9.0,9
9847,9847,2004-05,2004,2005,Man City,Liverpool,Win,Home,2005-04-09,3,1,1,4,4,6,7,7,7,-5,-6,-3,-3,1,16.0,4.0,12.0,9
9848,9848,2004-05,2004,2005,Man City,Fulham,Draw,Away,2005-04-16,1,4,4,4,7,3,3,4,4,1,1,0,3,0,16.0,9.0,7.0,9
9849,9849,2004-05,2004,2005,Man City,Birmingham,Win,Home,2005-04-20,3,4,5,5,5,2,3,6,6,2,2,-1,-1,1,16.0,10.0,6.0,9
9850,9850,2004-05,2004,2005,Man City,Blackburn,Draw,Away,2005-04-23,1,4,7,8,8,6,7,7,8,-2,0,1,0,0,16.0,15.0,1.0,9
9851,9851,2004-05,2004,2005,Man City,Portsmouth,Win,Home,2005-04-30,3,4,5,8,9,3,4,7,7,1,1,1,2,1,16.0,13.0,3.0,9
9852,9852,2004-05,2004,2005,Man City,Aston Villa,Win,Away,2005-05-07,3,4,7,8,11,1,2,5,6,3,5,3,5,0,16.0,6.0,10.0,10
9853,9853,2004-05,2004,2005,Man City,Middlesbrough,Draw,Home,2005-05-15,1,6,7,10,11,4,5,8,9,2,2,2,2,1,16.0,11.0,5.0,10
9854,9854,2005-06,2005,2006,Man City,West Brom,Draw,Home,2005-08-13,1,4,7,8,11,4,4,5,5,0,3,3,6,1,8.0,17.0,-9.0,1
9855,9855,2005-06,2005,2006,Man City,Birmingham,Win,Away,2005-08-20,3,2,5,8,9,4,4,7,8,-2,1,1,1,0,8.0,12.0,-4.0,1
9856,9856,2005-06,2005,2006,Man City,Sunderland,Win,Away,2005-08-23,3,4,5,8,11,0,0,0,0,4,5,8,11,0,8.0,21.0,-13.0,1
9857,9857,2005-06,2005,2006,Man City,Portsmouth,Win,Home,2005-08-27,3,6,7,8,11,1,1,1,2,5,6,7,9,1,8.0,16.0,-8.0,1
9858,9858,2005-06,2005,2006,Man City,Man United,Draw,Away,2005-09-10,1,6,9,10,11,6,9,12,12,0,0,-2,-1,0,8.0,3.0,5.0,2
9859,9859,2005-06,2005,2006,Man City,Bolton,Loss,Home,2005-09-18,0,4,7,10,11,4,7,7,8,0,0,3,3,1,8.0,6.0,2.0,2
9860,9860,2005-06,2005,2006,Man City,Newcastle,Loss,Away,2005-09-24,0,1,4,7,10,4,4,4,5,-3,0,3,5,0,8.0,14.0,-6.0,2
9861,9861,2005-06,2005,2006,Man City,Everton,Win,Home,2005-10-02,3,0,1,4,7,0,0,0,3,0,1,4,4,1,8.0,4.0,4.0,3
9862,9862,2005-06,2005,2006,Man City,West Ham,Win,Home,2005-10-16,3,3,3,4,7,2,5,8,8,1,-2,-4,-1,1,8.0,21.0,-13.0,3
9863,9863,2005-06,2005,2006,Man City,Arsenal,Loss,Away,2005-10-22,0,6,6,6,7,3,4,7,7,3,2,-1,0,0,8.0,2.0,6.0,3
9864,9864,2005-06,2005,2006,Man City,Aston Villa,Win,Home,2005-10-31,3,3,6,6,6,3,3,3,4,0,3,3,2,1,8.0,10.0,-2.0,3
9865,9865,2005-06,2005,2006,Man City,Fulham,Loss,Away,2005-11-05,0,3,6,9,9,3,4,4,4,0,2,5,5,0,8.0,13.0,-5.0,4
9866,9866,2005-06,2005,2006,Man City,Blackburn,Draw,Home,2005-11-19,1,3,3,6,9,3,6,6,9,0,-3,0,0,1,8.0,15.0,-7.0,4
9867,9867,2005-06,2005,2006,Man City,Liverpool,Loss,Home,2005-11-26,0,1,4,4,7,6,9,9,12,-5,-5,-5,-5,1,8.0,5.0,3.0,4
9868,9868,2005-06,2005,2006,Man City,Charlton,Win,Away,2005-12-04,3,1,1,4,4,0,0,0,3,1,1,4,1,0,8.0,11.0,-3.0,5
9869,9869,2005-06,2005,2006,Man City,West Brom,Loss,Away,2005-12-10,0,3,4,4,7,2,5,5,5,1,-1,-1,2,0,8.0,17.0,-9.0,5
9870,9870,2005-06,2005,2006,Man City,Birmingham,Win,Home,2005-12-17,3,3,3,4,4,3,6,6,6,0,-3,-2,-2,1,8.0,12.0,-4.0,5
9871,9871,2005-06,2005,2006,Man City,Wigan,Loss,Away,2005-12-26,0,3,6,6,7,3,3,3,3,0,3,3,4,0,8.0,21.0,-13.0,5
9872,9872,2005-06,2005,2006,Man City,Chelsea,Loss,Home,2005-12-28,0,3,3,6,6,6,9,12,15,-3,-6,-6,-9,1,8.0,1.0,7.0,5
9873,9873,2005-06,2005,2006,Man City,Middlesbrough,Draw,Away,2005-12-31,1,0,3,3,6,1,1,1,2,-1,2,2,4,0,8.0,7.0,1.0,5
9874,9874,2005-06,2005,2006,Man City,Tottenham,Loss,Home,2006-01-04,0,1,1,4,4,3,6,7,10,-2,-5,-3,-6,1,8.0,9.0,-1.0,6
9875,9875,2005-06,2005,2006,Man City,Man United,Win,Home,2006-01-14,3,1,1,1,4,4,5,8,11,-3,-4,-7,-7,1,8.0,3.0,5.0,6
9876,9876,2005-06,2005,2006,Man City,Bolton,Loss,Away,2006-01-21,0,3,4,4,4,2,2,3,6,1,2,1,-2,0,8.0,6.0,2.0,6
9877,9877,2005-06,2005,2006,Man City,Newcastle,Win,Home,2006-02-01,3,3,3,4,4,0,1,1,1,3,2,3,3,1,8.0,14.0,-6.0,7
9878,9878,2005-06,2005,2006,Man City,Everton,Loss,Away,2006-02-04,0,3,6,6,7,4,7,10,13,-1,-1,-4,-6,0,8.0,4.0,4.0,7
9879,9879,2005-06,2005,2006,Man City,Charlton,Win,Home,2006-02-12,3,3,3,6,6,3,4,5,8,0,-1,1,-2,1,8.0,11.0,-3.0,7
9880,9880,2005-06,2005,2006,Man City,Liverpool,Loss,Away,2006-02-26,0,3,6,6,9,6,6,6,7,-3,0,0,2,0,8.0,5.0,3.0,7
9881,9881,2005-06,2005,2006,Man City,Sunderland,Win,Home,2006-03-05,3,3,3,6,6,0,1,1,1,3,2,5,5,1,8.0,21.0,-13.0,8
9882,9882,2005-06,2005,2006,Man City,Portsmouth,Loss,Away,2006-03-11,0,3,6,6,9,0,0,0,1,3,6,6,8,0,8.0,16.0,-8.0,8
9883,9883,2005-06,2005,2006,Man City,Wigan,Loss,Home,2006-03-18,0,3,3,6,6,3,4,4,5,0,-1,2,1,1,8.0,21.0,-13.0,8
9884,9884,2005-06,2005,2006,Man City,Chelsea,Loss,Away,2006-03-25,0,0,3,3,6,3,6,9,9,-3,-3,-6,-3,0,8.0,1.0,7.0,8
9885,9885,2005-06,2005,2006,Man City,Middlesbrough,Loss,Home,2006-04-02,0,0,0,3,3,3,3,6,9,-3,-3,-3,-6,1,8.0,7.0,1.0,9
9886,9886,2005-06,2005,2006,Man City,Tottenham,Loss,Away,2006-04-08,0,0,0,0,3,3,6,6,9,-3,-6,-6,-6,0,8.0,9.0,-1.0,9
9887,9887,2005-06,2005,2006,Man City,West Ham,Loss,Away,2006-04-15,0,0,0,0,0,1,1,4,4,-1,-1,-4,-4,0,8.0,21.0,-13.0,9
9888,9888,2005-06,2005,2006,Man City,Aston Villa,Win,Away,2006-04-25,3,0,0,0,0,3,4,4,5,-3,-4,-4,-5,0,8.0,10.0,-2.0,9
9889,9889,2005-06,2005,2006,Man City,Fulham,Loss,Home,2006-04-29,0,3,3,3,3,6,6,7,10,-3,-3,-4,-7,1,8.0,13.0,-5.0,9
9890,9890,2005-06,2005,2006,Man City,Arsenal,Loss,Home,2006-05-04,0,3,3,3,3,4,7,8,8,-1,-4,-5,-5,1,8.0,2.0,6.0,10
9891,9891,2005-06,2005,2006,Man City,Blackburn,Loss,Away,2006-05-07,0,0,3,3,3,6,6,6,7,-6,-3,-3,-4,0,8.0,15.0,-7.0,10
9892,9892,2006-07,2006,2007,Man City,Chelsea,Loss,Away,2006-08-20,0,0,0,3,3,0,3,6,9,0,-3,-3,-6,0,15.0,1.0,14.0,1
9893,9893,2006-07,2006,2007,Man City,Portsmouth,Draw,Home,2006-08-23,1,0,0,0,3,3,6,9,9,-3,-6,-9,-6,1,15.0,17.0,-2.0,1
9894,9894,2006-07,2006,2007,Man City,Arsenal,Win,Home,2006-08-26,3,1,1,1,1,4,7,10,11,-3,-6,-9,-10,1,15.0,4.0,11.0,1
9895,9895,2006-07,2006,2007,Man City,Reading,Loss,Away,2006-09-11,0,4,4,4,4,0,3,3,3,4,1,1,1,0,15.0,21.0,-6.0,2
9896,9896,2006-07,2006,2007,Man City,Blackburn,Loss,Away,2006-09-17,0,3,4,4,4,1,2,2,5,2,2,2,-1,0,15.0,6.0,9.0,2
9897,9897,2006-07,2006,2007,Man City,West Ham,Win,Home,2006-09-23,3,0,3,4,4,1,1,2,5,-1,2,2,-1,1,15.0,9.0,6.0,2
9898,9898,2006-07,2006,2007,Man City,Everton,Draw,Away,2006-09-30,1,3,3,6,7,2,5,8,9,1,-2,-2,-2,0,15.0,11.0,4.0,2
9899,9899,2006-07,2006,2007,Man City,Sheffield United,Draw,Home,2006-10-14,1,4,4,4,7,3,3,4,4,1,1,0,3,1,15.0,21.0,-6.0,3
9900,9900,2006-07,2006,2007,Man City,Wigan,Loss,Away,2006-10-21,0,2,5,5,5,0,1,2,2,2,4,3,3,0,15.0,10.0,5.0,3
9901,9901,2006-07,2006,2007,Man City,Middlesbrough,Win,Home,2006-10-30,3,1,2,5,5,6,6,6,7,-5,-4,-1,-2,1,15.0,14.0,1.0,3
9902,9902,2006-07,2006,2007,Man City,Charlton,Loss,Away,2006-11-04,0,3,4,5,8,2,2,2,2,1,2,3,6,0,15.0,13.0,2.0,4
9903,9903,2006-07,2006,2007,Man City,Newcastle,Draw,Home,2006-11-11,1,3,3,4,5,1,1,1,1,2,2,3,4,1,15.0,7.0,8.0,4
9904,9904,2006-07,2006,2007,Man City,Fulham,Win,Home,2006-11-18,3,1,4,4,5,4,4,5,8,-3,0,-1,-3,1,15.0,12.0,3.0,4
9905,9905,2006-07,2006,2007,Man City,Liverpool,Loss,Away,2006-11-25,0,4,4,7,7,1,4,7,7,3,0,0,0,0,15.0,3.0,12.0,4
9906,9906,2006-07,2006,2007,Man City,Aston Villa,Win,Away,2006-11-29,3,3,4,4,7,2,5,8,8,1,-1,-4,-1,0,15.0,16.0,-1.0,4
9907,9907,2006-07,2006,2007,Man City,Watford,Draw,Home,2006-12-04,1,3,6,7,7,0,0,3,4,3,6,4,3,1,15.0,21.0,-6.0,5
9908,9908,2006-07,2006,2007,Man City,Man United,Loss,Away,2006-12-09,0,4,4,7,8,6,7,10,13,-2,-3,-3,-5,0,15.0,2.0,13.0,5
9909,9909,2006-07,2006,2007,Man City,Tottenham,Loss,Home,2006-12-17,0,1,4,4,7,6,6,9,10,-5,-2,-5,-3,1,15.0,5.0,10.0,5
9910,9910,2006-07,2006,2007,Man City,Bolton,Loss,Home,2006-12-23,0,0,1,4,4,6,6,6,9,-6,-5,-2,-5,1,15.0,8.0,7.0,5
9911,9911,2006-07,2006,2007,Man City,Sheffield United,Win,Away,2006-12-26,3,0,0,1,4,3,4,7,10,-3,-4,-6,-6,0,15.0,21.0,-6.0,5
9912,9912,2006-07,2006,2007,Man City,West Ham,Win,Away,2006-12-30,3,3,3,3,4,1,4,4,4,2,-1,-1,0,0,15.0,9.0,6.0,5
9913,9913,2006-07,2006,2007,Man City,Everton,Win,Home,2007-01-01,3,6,6,6,6,4,7,7,7,2,-1,-1,-1,1,15.0,11.0,4.0,6
9914,9914,2006-07,2006,2007,Man City,Bolton,Draw,Away,2007-01-13,1,6,9,9,9,3,6,9,12,3,3,0,-3,0,15.0,8.0,7.0,6
9915,9915,2006-07,2006,2007,Man City,Blackburn,Loss,Home,2007-01-20,0,4,7,10,10,3,6,9,9,1,1,1,1,1,15.0,6.0,9.0,6
9916,9916,2006-07,2006,2007,Man City,Reading,Loss,Home,2007-02-03,0,1,4,7,10,6,7,10,10,-5,-3,-3,0,1,15.0,21.0,-6.0,7
9917,9917,2006-07,2006,2007,Man City,Portsmouth,Loss,Away,2007-02-10,0,0,1,4,7,1,1,2,3,-1,0,2,4,0,15.0,17.0,-2.0,7
9918,9918,2006-07,2006,2007,Man City,Wigan,Loss,Home,2007-03-03,0,0,0,1,4,4,4,7,7,-4,-4,-6,-3,1,15.0,10.0,5.0,8
9919,9919,2006-07,2006,2007,Man City,Chelsea,Loss,Home,2007-03-14,0,0,0,0,1,6,9,12,12,-6,-9,-12,-11,1,15.0,1.0,14.0,8
9920,9920,2006-07,2006,2007,Man City,Middlesbrough,Win,Away,2007-03-17,3,0,0,0,0,4,4,5,6,-4,-4,-5,-6,0,15.0,14.0,1.0,8
9921,9921,2006-07,2006,2007,Man City,Newcastle,Win,Away,2007-03-31,3,3,3,3,3,1,1,4,4,2,2,-1,-1,0,15.0,7.0,8.0,8
9922,9922,2006-07,2006,2007,Man City,Charlton,Draw,Home,2007-04-06,1,6,6,6,6,6,7,10,10,0,-1,-4,-4,1,15.0,13.0,2.0,9
9923,9923,2006-07,2006,2007,Man City,Fulham,Win,Away,2007-04-09,3,4,7,7,7,1,2,3,3,3,5,4,4,0,15.0,12.0,3.0,9
9924,9924,2006-07,2006,2007,Man City,Liverpool,Draw,Home,2007-04-14,1,4,7,10,10,6,7,7,10,-2,0,3,0,1,15.0,3.0,12.0,9
9925,9925,2006-07,2006,2007,Man City,Arsenal,Loss,Away,2007-04-17,0,4,5,8,11,4,4,4,4,0,1,4,7,0,15.0,4.0,11.0,9
9926,9926,2006-07,2006,2007,Man City,Watford,Draw,Away,2007-04-21,1,1,4,5,8,3,3,3,3,-2,1,2,5,0,15.0,21.0,-6.0,9
9927,9927,2006-07,2006,2007,Man City,Aston Villa,Loss,Home,2007-04-28,0,1,2,5,6,4,5,8,9,-3,-3,-3,-3,1,15.0,16.0,-1.0,9
9928,9928,2006-07,2006,2007,Man City,Man United,Loss,Home,2007-05-05,0,1,1,2,5,4,7,7,10,-3,-6,-5,-5,1,15.0,2.0,13.0,10
9929,9929,2006-07,2006,2007,Man City,Tottenham,Loss,Away,2007-05-13,0,0,1,1,2,4,7,8,9,-4,-6,-7,-7,0,15.0,5.0,10.0,10
9930,9930,2007-08,2007,2008,Man City,West Ham,Win,Away,2007-08-11,3,0,0,1,1,6,9,12,12,-6,-9,-11,-11,0,14.0,15.0,-1.0,1
9931,9931,2007-08,2007,2008,Man City,Derby,Win,Home,2007-08-15,3,3,3,3,4,2,2,2,2,1,1,1,2,1,14.0,21.0,-7.0,1
9932,9932,2007-08,2007,2008,Man City,Man United,Win,Home,2007-08-19,3,6,6,6,6,2,2,3,6,4,4,3,0,1,14.0,1.0,13.0,1
9933,9933,2007-08,2007,2008,Man City,Arsenal,Loss,Away,2007-08-25,0,6,9,9,9,4,5,6,9,2,4,3,0,0,14.0,4.0,10.0,1
9934,9934,2007-08,2007,2008,Man City,Blackburn,Loss,Away,2007-09-02,0,3,6,9,9,2,5,6,7,1,1,3,2,0,14.0,10.0,4.0,2
9935,9935,2007-08,2007,2008,Man City,Aston Villa,Win,Home,2007-09-16,3,0,3,6,9,6,7,7,8,-6,-4,-1,1,1,14.0,11.0,3.0,2
9936,9936,2007-08,2007,2008,Man City,Fulham,Draw,Away,2007-09-22,1,3,3,6,9,2,2,2,5,1,1,4,4,0,14.0,16.0,-2.0,2
9937,9937,2007-08,2007,2008,Man City,Newcastle,Win,Home,2007-09-29,3,4,4,4,7,3,6,7,8,1,-2,-3,-1,1,14.0,13.0,1.0,2
9938,9938,2007-08,2007,2008,Man City,Middlesbrough,Win,Home,2007-10-07,3,4,7,7,7,1,1,4,5,3,6,3,2,1,14.0,12.0,2.0,3
9939,9939,2007-08,2007,2008,Man City,Birmingham,Win,Home,2007-10-20,3,6,7,10,10,0,1,4,4,6,6,6,6,1,14.0,21.0,-7.0,3
9940,9940,2007-08,2007,2008,Man City,Chelsea,Loss,Away,2007-10-27,0,6,9,10,13,6,7,7,8,0,2,3,5,0,14.0,2.0,12.0,3
9941,9941,2007-08,2007,2008,Man City,Sunderland,Win,Home,2007-11-05,3,3,6,9,10,1,1,1,2,2,5,8,8,1,14.0,21.0,-7.0,4
9942,9942,2007-08,2007,2008,Man City,Portsmouth,Draw,Away,2007-11-11,1,3,6,9,12,4,7,10,13,-1,-1,-1,-1,0,14.0,9.0,5.0,4
9943,9943,2007-08,2007,2008,Man City,Reading,Win,Home,2007-11-24,3,4,4,7,10,0,3,3,6,4,1,4,4,1,14.0,8.0,6.0,4
9944,9944,2007-08,2007,2008,Man City,Wigan,Draw,Away,2007-12-01,1,4,7,7,10,0,0,0,0,4,7,7,10,0,14.0,17.0,-3.0,5
9945,9945,2007-08,2007,2008,Man City,Tottenham,Loss,Away,2007-12-09,0,4,5,8,8,1,4,5,5,3,1,3,3,0,14.0,5.0,9.0,5
9946,9946,2007-08,2007,2008,Man City,Bolton,Win,Home,2007-12-15,3,1,4,5,8,3,6,7,8,-2,-2,-2,0,1,14.0,7.0,7.0,5
9947,9947,2007-08,2007,2008,Man City,Aston Villa,Draw,Away,2007-12-22,1,3,4,7,8,1,1,4,7,2,3,3,1,0,14.0,11.0,3.0,5
9948,9948,2007-08,2007,2008,Man City,Blackburn,Draw,Home,2007-12-27,1,4,4,5,8,0,0,3,3,4,4,2,5,1,14.0,10.0,4.0,5
9949,9949,2007-08,2007,2008,Man City,Liverpool,Draw,Home,2007-12-30,1,2,5,5,6,6,6,6,9,-4,-1,-1,-3,1,14.0,3.0,11.0,5
9950,9950,2007-08,2007,2008,Man City,Newcastle,Win,Away,2008-01-02,3,2,3,6,6,0,1,4,7,2,2,2,-1,0,14.0,13.0,1.0,6
9951,9951,2007-08,2007,2008,Man City,Everton,Loss,Away,2008-01-12,0,4,5,6,9,3,6,6,9,1,-1,0,0,0,14.0,6.0,8.0,6
9952,9952,2007-08,2007,2008,Man City,West Ham,Draw,Home,2008-01-20,1,3,4,5,6,3,6,7,10,0,-2,-2,-4,1,14.0,15.0,-1.0,6
9953,9953,2007-08,2007,2008,Man City,Derby,Draw,Away,2008-01-30,1,1,4,5,6,0,0,0,0,1,4,5,6,0,14.0,21.0,-7.0,6
9954,9954,2007-08,2007,2008,Man City,Arsenal,Loss,Home,2008-02-02,0,2,2,5,6,6,7,10,13,-4,-5,-5,-7,1,14.0,4.0,10.0,7
9955,9955,2007-08,2007,2008,Man City,Man United,Win,Away,2008-02-10,3,1,2,2,5,4,7,10,13,-3,-5,-8,-8,0,14.0,1.0,13.0,7
9956,9956,2007-08,2007,2008,Man City,Everton,Loss,Home,2008-02-25,0,3,4,5,5,4,5,8,11,-1,-1,-3,-6,1,14.0,6.0,8.0,7
9957,9957,2007-08,2007,2008,Man City,Wigan,Draw,Home,2008-03-01,1,3,3,4,5,3,6,6,6,0,-3,-2,-1,1,14.0,17.0,-3.0,8
9958,9958,2007-08,2007,2008,Man City,Reading,Loss,Away,2008-03-08,0,1,4,4,5,3,3,3,3,-2,1,1,2,0,14.0,8.0,6.0,8
9959,9959,2007-08,2007,2008,Man City,Tottenham,Win,Home,2008-03-16,3,1,1,4,4,3,6,7,8,-2,-5,-3,-4,1,14.0,5.0,9.0,8
9960,9960,2007-08,2007,2008,Man City,Bolton,Draw,Away,2008-03-22,1,3,4,4,7,0,0,0,0,3,4,4,7,0,14.0,7.0,7.0,8
9961,9961,2007-08,2007,2008,Man City,Birmingham,Loss,Away,2008-03-29,0,4,4,5,5,1,1,4,5,3,3,1,0,0,14.0,21.0,-7.0,8
9962,9962,2007-08,2007,2008,Man City,Chelsea,Loss,Home,2008-04-05,0,1,4,4,5,6,7,10,13,-5,-3,-6,-8,1,14.0,2.0,12.0,9
9963,9963,2007-08,2007,2008,Man City,Sunderland,Win,Away,2008-04-12,3,0,1,4,4,6,9,9,9,-6,-8,-5,-5,0,14.0,21.0,-7.0,9
9964,9964,2007-08,2007,2008,Man City,Portsmouth,Win,Home,2008-04-20,3,3,3,4,7,4,7,7,10,-1,-4,-3,-3,1,14.0,9.0,5.0,9
9965,9965,2007-08,2007,2008,Man City,Fulham,Loss,Home,2008-04-26,0,6,6,6,7,3,3,4,4,3,3,2,3,1,14.0,16.0,-2.0,9
9966,9966,2007-08,2007,2008,Man City,Liverpool,Loss,Away,2008-05-04,0,3,6,6,6,4,7,8,11,-1,-1,-2,-5,0,14.0,3.0,11.0,10
9967,9967,2007-08,2007,2008,Man City,Middlesbrough,Loss,Away,2008-05-11,0,0,3,6,6,3,3,4,5,-3,0,2,1,0,14.0,12.0,2.0,10
9968,9968,2008-09,2008,2009,Man City,Aston Villa,Loss,Away,2008-08-17,0,0,0,3,6,1,2,5,8,-1,-2,-2,-2,0,9.0,6.0,3.0,1
9969,9969,2008-09,2008,2009,Man City,West Ham,Win,Home,2008-08-24,3,0,0,0,3,4,4,5,8,-4,-4,-5,-5,1,9.0,10.0,-1.0,1
9970,9970,2008-09,2008,2009,Man City,Sunderland,Win,Away,2008-08-31,3,3,3,3,3,3,3,3,6,0,0,0,-3,0,9.0,15.0,-6.0,1
9971,9971,2008-09,2008,2009,Man City,Chelsea,Loss,Home,2008-09-13,0,6,6,6,6,4,7,8,11,2,-1,-2,-5,1,9.0,2.0,7.0,2
9972,9972,2008-09,2008,2009,Man City,Portsmouth,Win,Home,2008-09-21,3,3,6,6,6,6,6,6,6,-3,0,0,0,1,9.0,8.0,1.0,2
9973,9973,2008-09,2008,2009,Man City,Wigan,Loss,Away,2008-09-28,0,3,6,9,9,2,5,5,5,1,1,4,4,0,9.0,14.0,-5.0,2
9974,9974,2008-09,2008,2009,Man City,Liverpool,Loss,Home,2008-10-05,0,3,3,6,9,4,7,8,11,-1,-4,-2,-2,1,9.0,4.0,5.0,3
9975,9975,2008-09,2008,2009,Man City,Newcastle,Draw,Away,2008-10-20,1,0,3,3,6,1,1,1,1,-1,2,2,5,0,9.0,12.0,-3.0,3
9976,9976,2008-09,2008,2009,Man City,Stoke,Win,Home,2008-10-26,3,1,1,4,4,3,3,4,4,-2,-2,0,0,1,9.0,21.0,-12.0,3
9977,9977,2008-09,2008,2009,Man City,Middlesbrough,Loss,Away,2008-10-29,0,4,4,4,7,1,4,4,4,3,0,0,3,0,9.0,13.0,-4.0,3
9978,9978,2008-09,2008,2009,Man City,Bolton,Loss,Away,2008-11-02,0,3,4,4,4,0,1,4,4,3,3,0,0,0,9.0,16.0,-7.0,4
9979,9979,2008-09,2008,2009,Man City,Tottenham,Loss,Home,2008-11-09,0,0,3,4,4,4,7,7,7,-4,-4,-3,-3,1,9.0,11.0,-2.0,4
9980,9980,2008-09,2008,2009,Man City,Hull,Draw,Away,2008-11-16,1,0,0,3,4,0,0,3,6,0,0,0,-2,0,9.0,21.0,-12.0,4
9981,9981,2008-09,2008,2009,Man City,Arsenal,Win,Home,2008-11-22,3,1,1,1,4,3,3,4,7,-2,-2,-3,-3,1,9.0,3.0,6.0,4
9982,9982,2008-09,2008,2009,Man City,Man United,Loss,Home,2008-11-30,0,4,4,4,4,4,4,7,10,0,0,-3,-6,1,9.0,1.0,8.0,4
9983,9983,2008-09,2008,2009,Man City,Fulham,Draw,Away,2008-12-06,1,3,4,4,4,2,5,8,8,1,-1,-4,-4,0,9.0,17.0,-8.0,5
9984,9984,2008-09,2008,2009,Man City,Everton,Loss,Home,2008-12-13,0,1,4,5,5,3,3,4,7,-2,1,1,-2,1,9.0,5.0,4.0,5
9985,9985,2008-09,2008,2009,Man City,West Brom,Loss,Away,2008-12-21,0,1,1,4,5,1,1,1,1,0,0,3,4,0,9.0,21.0,-12.0,5
9986,9986,2008-09,2008,2009,Man City,Hull,Win,Home,2008-12-26,3,0,1,1,4,1,4,5,6,-1,-3,-4,-2,1,9.0,21.0,-12.0,5
9987,9987,2008-09,2008,2009,Man City,Blackburn,Draw,Away,2008-12-28,1,3,3,4,4,4,4,4,4,-1,-1,0,0,0,9.0,7.0,2.0,5
9988,9988,2008-09,2008,2009,Man City,Wigan,Win,Home,2009-01-17,3,4,4,4,5,3,6,9,12,1,-2,-5,-7,1,9.0,14.0,-5.0,6
9989,9989,2008-09,2008,2009,Man City,Newcastle,Win,Home,2009-01-28,3,4,7,7,7,1,1,1,4,3,6,6,3,1,9.0,12.0,-3.0,6
9990,9990,2008-09,2008,2009,Man City,Stoke,Loss,Away,2009-01-31,0,6,7,10,10,0,1,1,1,6,6,9,9,0,9.0,21.0,-12.0,6
9991,9991,2008-09,2008,2009,Man City,Middlesbrough,Win,Home,2009-02-07,3,3,6,7,10,1,1,2,2,2,5,5,8,1,9.0,13.0,-4.0,7
9992,9992,2008-09,2008,2009,Man City,Portsmouth,Loss,Away,2009-02-14,0,3,6,9,10,0,0,1,1,3,6,8,9,0,9.0,8.0,1.0,7
9993,9993,2008-09,2008,2009,Man City,Liverpool,Draw,Away,2009-02-22,1,3,3,6,9,6,7,8,9,-3,-4,-2,0,0,9.0,4.0,5.0,7
9994,9994,2008-09,2008,2009,Man City,West Ham,Loss,Away,2009-03-01,0,1,4,4,7,0,1,4,7,1,3,0,0,0,9.0,10.0,-1.0,8
9995,9995,2008-09,2008,2009,Man City,Aston Villa,Win,Home,2009-03-04,3,1,1,4,4,1,4,5,8,0,-3,-1,-4,1,9.0,6.0,3.0,8
9996,9996,2008-09,2008,2009,Man City,Chelsea,Loss,Away,2009-03-15,0,3,4,4,7,6,9,10,10,-3,-5,-6,-3,0,9.0,2.0,7.0,8
9997,9997,2008-09,2008,2009,Man City,Sunderland,Win,Home,2009-03-22,3,3,3,4,4,1,1,2,5,2,2,2,-1,1,9.0,15.0,-6.0,8
9998,9998,2008-09,2008,2009,Man City,Arsenal,Loss,Away,2009-04-04,0,3,6,6,7,6,9,10,11,-3,-3,-4,-4,0,9.0,3.0,6.0,9
9999,9999,2008-09,2008,2009,Man City,Fulham,Loss,Home,2009-04-12,0,3,3,6,6,3,6,6,6,0,-3,0,0,1,9.0,17.0,-8.0,9
10000,10000,2008-09,2008,2009,Man City,West Brom,Win,Home,2009-04-19,3,0,3,3,6,1,2,3,3,-1,1,0,3,1,9.0,21.0,-12.0,9
10001,10001,2008-09,2008,2009,Man City,Everton,Win,Away,2009-04-25,3,3,3,6,6,2,5,5,8,1,-2,1,-2,0,9.0,5.0,4.0,9
10002,10002,2008-09,2008,2009,Man City,Blackburn,Win,Home,2009-05-02,3,6,6,6,9,3,3,6,7,3,3,0,2,1,9.0,7.0,2.0,10
10003,10003,2008-09,2008,2009,Man City,Man United,Loss,Away,2009-05-10,0,6,9,9,9,6,9,12,15,0,0,-3,-6,0,9.0,1.0,8.0,10
10004,10004,2008-09,2008,2009,Man City,Tottenham,Loss,Away,2009-05-16,0,3,6,9,9,4,4,7,10,-1,2,2,-1,0,9.0,11.0,-2.0,10
10005,10005,2008-09,2008,2009,Man City,Bolton,Win,Home,2009-05-24,3,0,3,6,9,2,3,4,4,-2,0,2,5,1,9.0,16.0,-7.0,10
10006,10006,2009-10,2009,2010,Man City,Blackburn,Win,Away,2009-08-15,3,3,3,6,9,1,4,4,7,2,-1,2,2,0,10.0,15.0,-5.0,1
10007,10007,2009-10,2009,2010,Man City,Wolves,Win,Home,2009-08-22,3,6,6,6,9,3,3,4,7,3,3,2,2,1,10.0,21.0,-11.0,1
10008,10008,2009-10,2009,2010,Man City,Portsmouth,Win,Away,2009-08-30,3,6,9,9,9,0,0,0,3,6,9,9,6,0,10.0,14.0,-4.0,1
10009,10009,2009-10,2009,2010,Man City,Arsenal,Win,Home,2009-09-12,3,6,9,12,12,3,6,9,10,3,3,3,2,1,10.0,4.0,6.0,2
10010,10010,2009-10,2009,2010,Man City,Man United,Loss,Away,2009-09-20,0,6,9,12,15,6,9,9,12,0,0,3,3,0,10.0,1.0,9.0,2
10011,10011,2009-10,2009,2010,Man City,West Ham,Win,Home,2009-09-28,3,3,6,9,12,0,1,1,4,3,5,8,8,1,10.0,9.0,1.0,2
10012,10012,2009-10,2009,2010,Man City,Aston Villa,Draw,Away,2009-10-05,1,3,6,9,12,3,6,9,12,0,0,0,0,0,10.0,6.0,4.0,3
10013,10013,2009-10,2009,2010,Man City,Wigan,Draw,Away,2009-10-18,1,4,4,7,10,3,3,6,6,1,1,1,4,0,10.0,11.0,-1.0,3
10014,10014,2009-10,2009,2010,Man City,Fulham,Draw,Home,2009-10-25,1,2,5,5,8,4,4,4,7,-2,1,1,1,1,10.0,7.0,3.0,3
10015,10015,2009-10,2009,2010,Man City,Birmingham,Draw,Away,2009-11-01,1,2,3,6,6,3,3,3,6,-1,0,3,0,0,10.0,21.0,-11.0,4
10016,10016,2009-10,2009,2010,Man City,Burnley,Draw,Home,2009-11-07,1,2,3,4,7,3,3,6,6,-1,0,-2,1,1,10.0,21.0,-11.0,4
10017,10017,2009-10,2009,2010,Man City,Liverpool,Draw,Away,2009-11-21,1,2,3,4,5,1,4,4,4,1,-1,0,1,0,10.0,2.0,8.0,4
10018,10018,2009-10,2009,2010,Man City,Hull,Draw,Home,2009-11-28,1,2,3,4,5,4,7,7,8,-2,-4,-3,-3,1,10.0,17.0,-7.0,4
10019,10019,2009-10,2009,2010,Man City,Chelsea,Win,Home,2009-12-05,3,2,3,4,5,6,9,12,15,-4,-6,-8,-10,1,10.0,3.0,7.0,5
10020,10020,2009-10,2009,2010,Man City,Bolton,Draw,Away,2009-12-12,1,4,5,6,7,1,1,1,1,3,4,5,6,0,10.0,13.0,-3.0,5
10021,10021,2009-10,2009,2010,Man City,Tottenham,Loss,Away,2009-12-16,0,4,5,6,7,1,2,5,8,3,3,1,-1,0,10.0,8.0,2.0,5
10022,10022,2009-10,2009,2010,Man City,Sunderland,Win,Home,2009-12-19,3,1,4,5,6,1,1,1,4,0,3,4,2,1,10.0,16.0,-6.0,5
10023,10023,2009-10,2009,2010,Man City,Stoke,Win,Home,2009-12-26,3,3,4,7,8,1,1,2,5,2,3,5,3,1,10.0,12.0,-2.0,5
10024,10024,2009-10,2009,2010,Man City,Wolves,Win,Away,2009-12-28,3,6,6,7,10,3,3,6,9,3,3,1,1,0,10.0,21.0,-11.0,5
10025,10025,2009-10,2009,2010,Man City,Blackburn,Win,Home,2010-01-11,3,6,9,9,10,2,2,2,3,4,7,7,7,1,10.0,15.0,-5.0,6
10026,10026,2009-10,2009,2010,Man City,Everton,Loss,Away,2010-01-16,0,6,9,12,12,4,5,6,7,2,4,6,5,0,10.0,5.0,5.0,6
10027,10027,2009-10,2009,2010,Man City,Portsmouth,Win,Home,2010-01-31,3,3,6,9,12,1,1,4,4,2,5,5,8,1,10.0,14.0,-4.0,6
10028,10028,2009-10,2009,2010,Man City,Hull,Loss,Away,2010-02-06,0,3,6,9,12,2,2,3,4,1,4,6,8,0,10.0,17.0,-7.0,7
10029,10029,2009-10,2009,2010,Man City,Bolton,Win,Home,2010-02-09,3,3,3,6,9,1,4,4,4,2,-1,2,5,1,10.0,13.0,-3.0,7
10030,10030,2009-10,2009,2010,Man City,Stoke,Draw,Away,2010-02-16,1,3,6,6,9,4,5,6,9,-1,1,0,0,0,10.0,12.0,-2.0,7
10031,10031,2009-10,2009,2010,Man City,Liverpool,Draw,Home,2010-02-21,1,4,4,7,7,3,6,7,10,1,-2,0,-3,1,10.0,2.0,8.0,7
10032,10032,2009-10,2009,2010,Man City,Chelsea,Win,Away,2010-02-27,3,2,5,5,8,3,6,7,10,-1,-1,-2,-2,0,10.0,3.0,7.0,7
10033,10033,2009-10,2009,2010,Man City,Sunderland,Draw,Away,2010-03-14,1,4,5,8,8,4,4,5,6,0,1,3,2,0,10.0,16.0,-6.0,8
10034,10034,2009-10,2009,2010,Man City,Fulham,Win,Away,2010-03-21,3,4,5,6,9,1,4,7,8,3,1,-1,1,0,10.0,7.0,3.0,8
10035,10035,2009-10,2009,2010,Man City,Everton,Loss,Home,2010-03-24,0,4,7,8,9,4,7,7,10,0,0,1,-1,1,10.0,5.0,5.0,8
10036,10036,2009-10,2009,2010,Man City,Wigan,Win,Home,2010-03-29,3,3,4,7,8,3,3,6,6,0,1,1,2,1,10.0,11.0,-1.0,8
10037,10037,2009-10,2009,2010,Man City,Burnley,Win,Away,2010-04-03,3,3,6,7,10,0,0,1,1,3,6,6,9,0,10.0,21.0,-11.0,9
10038,10038,2009-10,2009,2010,Man City,Birmingham,Win,Home,2010-04-11,3,6,6,9,10,2,2,2,3,4,4,7,7,1,10.0,21.0,-11.0,9
10039,10039,2009-10,2009,2010,Man City,Man United,Loss,Home,2010-04-17,0,6,9,9,12,1,4,7,10,5,5,2,2,1,10.0,1.0,9.0,9
10040,10040,2009-10,2009,2010,Man City,Arsenal,Draw,Away,2010-04-24,1,3,6,9,9,0,3,4,7,3,3,5,2,0,10.0,4.0,6.0,9
10041,10041,2009-10,2009,2010,Man City,Aston Villa,Win,Home,2010-05-01,3,1,4,7,10,6,9,10,13,-5,-5,-3,-3,1,10.0,6.0,4.0,10
10042,10042,2009-10,2009,2010,Man City,Tottenham,Loss,Home,2010-05-05,0,4,4,7,10,3,6,9,9,1,-2,-2,1,1,10.0,8.0,2.0,10
10043,10043,2009-10,2009,2010,Man City,West Ham,Draw,Away,2010-05-09,1,3,4,4,7,3,3,6,7,0,1,-2,0,0,10.0,9.0,1.0,10
10044,10044,2010-11,2010,2011,Man City,Tottenham,Draw,Away,2010-08-14,1,1,4,5,5,3,6,6,9,-2,-2,-1,-4,0,5.0,4.0,1.0,1
10045,10045,2010-11,2010,2011,Man City,Liverpool,Win,Home,2010-08-23,3,2,2,5,6,2,2,5,8,0,0,0,-2,1,5.0,7.0,-2.0,1
10046,10046,2010-11,2010,2011,Man City,Sunderland,Loss,Away,2010-08-29,0,4,5,5,8,1,1,1,4,3,4,4,4,0,5.0,13.0,-8.0,1
10047,10047,2010-11,2010,2011,Man City,Blackburn,Draw,Home,2010-09-11,1,3,4,5,5,0,3,6,9,3,1,-1,-4,1,5.0,10.0,-5.0,2
10048,10048,2010-11,2010,2011,Man City,Wigan,Win,Away,2010-09-19,3,1,4,5,6,4,4,4,4,-3,0,1,2,0,5.0,16.0,-11.0,2
10049,10049,2010-11,2010,2011,Man City,Chelsea,Win,Home,2010-09-25,3,4,4,7,8,6,9,12,15,-2,-5,-5,-7,1,5.0,1.0,4.0,2
10050,10050,2010-11,2010,2011,Man City,Newcastle,Win,Home,2010-10-03,3,6,7,7,10,3,3,4,7,3,4,3,3,1,5.0,21.0,-16.0,3
10051,10051,2010-11,2010,2011,Man City,Blackpool,Win,Away,2010-10-17,3,6,9,10,10,3,3,6,7,3,6,4,3,0,5.0,21.0,-16.0,3
10052,10052,2010-11,2010,2011,Man City,Arsenal,Loss,Home,2010-10-24,0,6,9,12,13,3,3,4,7,3,6,8,6,1,5.0,3.0,2.0,3
10053,10053,2010-11,2010,2011,Man City,Wolves,Loss,Away,2010-10-30,0,3,6,9,12,1,1,1,1,2,5,8,11,0,5.0,15.0,-10.0,3
10054,10054,2010-11,2010,2011,Man City,West Brom,Win,Away,2010-11-07,3,0,3,6,9,3,4,5,8,-3,-1,1,1,0,5.0,21.0,-16.0,4
10055,10055,2010-11,2010,2011,Man City,Man United,Draw,Home,2010-11-10,1,3,3,6,9,6,9,10,11,-3,-6,-4,-2,1,5.0,2.0,3.0,4
10056,10056,2010-11,2010,2011,Man City,Birmingham,Draw,Home,2010-11-13,1,4,4,4,7,1,2,5,5,3,2,-1,2,1,5.0,9.0,-4.0,4
10057,10057,2010-11,2010,2011,Man City,Fulham,Win,Away,2010-11-21,3,2,5,5,5,1,2,5,5,1,3,0,0,0,5.0,12.0,-7.0,4
10058,10058,2010-11,2010,2011,Man City,Stoke,Draw,Away,2010-11-27,1,4,5,8,8,6,9,9,9,-2,-4,-1,-1,0,5.0,11.0,-6.0,4
10059,10059,2010-11,2010,2011,Man City,Bolton,Win,Home,2010-12-04,3,4,5,6,9,4,7,8,11,0,-2,-2,-2,1,5.0,14.0,-9.0,5
10060,10060,2010-11,2010,2011,Man City,West Ham,Win,Away,2010-12-11,3,4,7,8,9,3,3,4,5,1,4,4,4,0,5.0,17.0,-12.0,5
10061,10061,2010-11,2010,2011,Man City,Everton,Loss,Home,2010-12-20,0,6,7,10,11,2,2,3,3,4,5,7,8,1,5.0,8.0,-3.0,5
10062,10062,2010-11,2010,2011,Man City,Newcastle,Win,Away,2010-12-26,3,3,6,7,10,3,4,4,5,0,2,3,5,0,5.0,21.0,-16.0,5
10063,10063,2010-11,2010,2011,Man City,Aston Villa,Win,Home,2010-12-28,3,3,6,9,10,3,3,3,3,0,3,6,7,1,5.0,6.0,-1.0,5
10064,10064,2010-11,2010,2011,Man City,Blackpool,Win,Home,2011-01-01,3,6,6,9,12,6,7,10,11,0,-1,-1,1,1,5.0,21.0,-16.0,6
10065,10065,2010-11,2010,2011,Man City,Arsenal,Draw,Away,2011-01-05,1,6,9,9,12,4,7,7,10,2,2,2,2,0,5.0,3.0,2.0,6
10066,10066,2010-11,2010,2011,Man City,Wolves,Win,Home,2011-01-15,3,4,7,10,10,3,6,6,9,1,1,4,1,1,5.0,15.0,-10.0,6
10067,10067,2010-11,2010,2011,Man City,Aston Villa,Loss,Away,2011-01-22,0,4,7,10,13,1,2,2,2,3,5,8,11,0,5.0,6.0,-1.0,6
10068,10068,2010-11,2010,2011,Man City,Birmingham,Draw,Away,2011-02-02,1,3,4,7,10,1,4,4,5,2,0,3,5,0,5.0,9.0,-4.0,7
10069,10069,2010-11,2010,2011,Man City,West Brom,Win,Home,2011-02-05,3,1,4,5,8,1,4,4,4,0,0,1,4,1,5.0,21.0,-16.0,7
10070,10070,2010-11,2010,2011,Man City,Man United,Loss,Away,2011-02-12,0,4,4,7,8,3,6,9,10,1,-2,-2,-2,0,5.0,2.0,3.0,7
10071,10071,2010-11,2010,2011,Man City,Fulham,Draw,Home,2011-02-27,1,3,4,4,7,2,5,5,8,1,-1,-1,-1,1,5.0,12.0,-7.0,7
10072,10072,2010-11,2010,2011,Man City,Wigan,Win,Home,2011-03-05,3,1,4,5,5,1,4,5,5,0,0,0,0,1,5.0,16.0,-11.0,8
10073,10073,2010-11,2010,2011,Man City,Chelsea,Loss,Away,2011-03-20,0,4,4,7,8,6,7,7,10,-2,-3,0,-2,0,5.0,1.0,4.0,8
10074,10074,2010-11,2010,2011,Man City,Sunderland,Win,Home,2011-04-03,3,3,4,4,7,1,1,1,1,2,3,3,6,1,5.0,13.0,-8.0,9
10075,10075,2010-11,2010,2011,Man City,Liverpool,Loss,Away,2011-04-11,0,3,6,7,7,3,6,6,7,0,0,1,0,0,5.0,7.0,-2.0,9
10076,10076,2010-11,2010,2011,Man City,Blackburn,Win,Away,2011-04-25,3,3,3,6,7,1,2,3,3,2,1,3,4,0,5.0,10.0,-5.0,9
10077,10077,2010-11,2010,2011,Man City,West Ham,Win,Home,2011-05-01,3,3,6,6,9,0,0,0,1,3,6,6,8,1,5.0,17.0,-12.0,10
10078,10078,2010-11,2010,2011,Man City,Everton,Loss,Away,2011-05-07,0,6,6,9,9,1,4,7,8,5,2,2,1,0,5.0,8.0,-3.0,10
10079,10079,2010-11,2010,2011,Man City,Tottenham,Win,Home,2011-05-10,3,3,6,6,9,1,2,3,6,2,4,3,3,1,5.0,4.0,1.0,10
10080,10080,2010-11,2010,2011,Man City,Stoke,Win,Home,2011-05-17,3,3,6,9,9,4,7,8,8,-1,-1,1,1,1,5.0,11.0,-6.0,10
10081,10081,2010-11,2010,2011,Man City,Bolton,Win,Away,2011-05-22,3,6,6,9,12,0,0,0,3,6,6,9,9,0,5.0,14.0,-9.0,10
10082,10082,2011-12,2011,2012,Man City,Swansea,Win,Home,2011-08-15,3,6,9,9,12,0,0,0,0,6,9,9,12,1,3.0,21.0,-18.0,1
10083,10083,2011-12,2011,2012,Man City,Bolton,Win,Away,2011-08-21,3,6,9,12,12,3,3,3,3,3,6,9,9,0,3.0,14.0,-11.0,1
10084,10084,2011-12,2011,2012,Man City,Tottenham,Win,Away,2011-08-28,3,6,9,12,15,3,6,6,7,3,3,6,8,0,3.0,5.0,-2.0,1
10085,10085,2011-12,2011,2012,Man City,Wigan,Win,Home,2011-09-10,3,6,9,12,15,4,5,8,11,2,4,4,4,1,3.0,16.0,-13.0,2
10086,10086,2011-12,2011,2012,Man City,Fulham,Draw,Away,2011-09-18,1,6,9,12,15,1,1,2,3,5,8,10,12,0,3.0,8.0,-5.0,2
10087,10087,2011-12,2011,2012,Man City,Everton,Win,Home,2011-09-24,3,4,7,10,13,4,7,7,10,0,0,3,3,1,3.0,7.0,-4.0,2
10088,10088,2011-12,2011,2012,Man City,Blackburn,Win,Away,2011-10-01,3,4,7,10,13,3,4,4,4,1,3,6,9,0,3.0,15.0,-12.0,3
10089,10089,2011-12,2011,2012,Man City,Aston Villa,Win,Home,2011-10-15,3,6,7,10,13,4,5,6,7,2,2,4,6,1,3.0,9.0,-6.0,3
10090,10090,2011-12,2011,2012,Man City,Man United,Win,Away,2011-10-23,3,6,9,10,13,4,5,8,11,2,4,2,2,0,3.0,1.0,2.0,3
10091,10091,2011-12,2011,2012,Man City,Wolves,Win,Home,2011-10-29,3,6,9,12,13,1,1,1,1,5,8,11,12,1,3.0,17.0,-14.0,3
10092,10092,2011-12,2011,2012,Man City,QPR,Win,Away,2011-11-05,3,6,9,12,15,3,4,4,5,3,5,8,10,0,3.0,21.0,-18.0,4
10093,10093,2011-12,2011,2012,Man City,Newcastle,Win,Home,2011-11-19,3,6,9,12,15,6,9,10,13,0,0,2,2,1,3.0,12.0,-9.0,4
10094,10094,2011-12,2011,2012,Man City,Liverpool,Draw,Away,2011-11-27,1,6,9,12,15,4,7,8,9,2,2,4,6,0,3.0,6.0,-3.0,4
10095,10095,2011-12,2011,2012,Man City,Norwich,Win,Home,2011-12-03,3,4,7,10,13,3,3,4,5,1,4,6,8,1,3.0,21.0,-18.0,5
10096,10096,2011-12,2011,2012,Man City,Chelsea,Loss,Away,2011-12-12,0,4,7,10,13,6,6,9,9,-2,1,1,4,0,3.0,2.0,1.0,5
10097,10097,2011-12,2011,2012,Man City,Arsenal,Win,Home,2011-12-18,3,3,4,7,10,6,7,10,13,-3,-3,-3,-3,1,3.0,4.0,-1.0,5
10098,10098,2011-12,2011,2012,Man City,Stoke,Win,Home,2011-12-21,3,3,6,7,10,6,9,12,12,-3,-3,-5,-2,1,3.0,13.0,-10.0,5
10099,10099,2011-12,2011,2012,Man City,West Brom,Draw,Away,2011-12-26,1,6,6,9,10,6,6,7,7,0,0,2,3,0,3.0,11.0,-8.0,5
10100,10100,2011-12,2011,2012,Man City,Sunderland,Loss,Away,2012-01-01,0,4,7,7,10,4,4,7,7,0,3,0,3,0,3.0,10.0,-7.0,6
10101,10101,2011-12,2011,2012,Man City,Liverpool,Win,Home,2012-01-03,3,1,4,7,7,4,5,8,11,-3,-1,-1,-4,1,3.0,6.0,-3.0,6
10102,10102,2011-12,2011,2012,Man City,Wigan,Win,Away,2012-01-16,3,3,4,7,10,1,1,2,3,2,3,5,7,0,3.0,16.0,-13.0,6
10103,10103,2011-12,2011,2012,Man City,Tottenham,Win,Home,2012-01-22,3,6,6,7,10,4,7,8,11,2,-1,-1,-1,1,3.0,5.0,-2.0,6
10104,10104,2011-12,2011,2012,Man City,Everton,Loss,Away,2012-01-31,0,6,9,9,10,2,2,2,5,4,7,7,5,0,3.0,7.0,-4.0,6
10105,10105,2011-12,2011,2012,Man City,Fulham,Win,Home,2012-02-04,3,3,6,9,9,4,4,7,8,-1,2,2,1,1,3.0,8.0,-5.0,7
10106,10106,2011-12,2011,2012,Man City,Aston Villa,Win,Away,2012-02-12,3,3,6,9,12,1,4,5,5,2,2,4,7,0,3.0,9.0,-6.0,7
10107,10107,2011-12,2011,2012,Man City,Blackburn,Win,Home,2012-02-25,3,6,6,9,12,3,3,4,7,3,3,5,5,1,3.0,15.0,-12.0,7
10108,10108,2011-12,2011,2012,Man City,Bolton,Win,Home,2012-03-03,3,6,9,9,12,0,0,1,4,6,9,8,8,1,3.0,14.0,-11.0,8
10109,10109,2011-12,2011,2012,Man City,Swansea,Loss,Away,2012-03-11,0,6,9,12,12,3,3,6,7,3,6,6,5,0,3.0,21.0,-18.0,8
10110,10110,2011-12,2011,2012,Man City,Chelsea,Win,Home,2012-03-21,3,3,6,9,12,3,6,6,7,0,0,3,5,1,3.0,2.0,1.0,8
10111,10111,2011-12,2011,2012,Man City,Stoke,Draw,Away,2012-03-24,1,3,6,9,12,1,4,7,7,2,2,2,5,0,3.0,13.0,-10.0,8
10112,10112,2011-12,2011,2012,Man City,Sunderland,Draw,Home,2012-03-31,1,4,4,7,10,3,6,7,7,1,-2,0,3,1,3.0,10.0,-7.0,8
10113,10113,2011-12,2011,2012,Man City,Arsenal,Loss,Away,2012-04-08,0,2,5,5,8,3,6,9,12,-1,-1,-4,-4,0,3.0,4.0,-1.0,9
10114,10114,2011-12,2011,2012,Man City,West Brom,Win,Home,2012-04-11,3,1,2,5,5,3,3,4,4,-2,-1,1,1,1,3.0,11.0,-8.0,9
10115,10115,2011-12,2011,2012,Man City,Norwich,Win,Away,2012-04-14,3,3,4,5,8,4,4,7,7,-1,0,-2,1,0,3.0,21.0,-18.0,9
10116,10116,2011-12,2011,2012,Man City,Wolves,Win,Away,2012-04-22,3,6,6,7,8,1,1,1,1,5,5,6,7,0,3.0,17.0,-14.0,9
10117,10117,2011-12,2011,2012,Man City,Man United,Win,Home,2012-04-30,3,6,9,9,10,4,4,7,10,2,5,2,0,1,3.0,1.0,2.0,9
10118,10118,2011-12,2011,2012,Man City,Newcastle,Win,Away,2012-05-06,3,6,9,12,12,3,6,9,12,3,3,3,0,0,3.0,12.0,-9.0,10
10119,10119,2011-12,2011,2012,Man City,QPR,Win,Home,2012-05-13,3,6,9,12,15,3,6,6,9,3,3,6,6,1,3.0,21.0,-18.0,10
10120,10120,2012-13,2012,2013,Man City,Southampton,Win,Home,2012-08-19,3,6,9,12,15,1,4,4,5,5,5,8,10,1,1.0,21.0,-20.0,1
10121,10121,2012-13,2012,2013,Man City,Liverpool,Draw,Away,2012-08-26,1,6,9,12,15,0,3,3,6,6,6,9,9,0,1.0,8.0,-7.0,1
10122,10122,2012-13,2012,2013,Man City,QPR,Win,Home,2012-09-01,3,4,7,10,13,1,1,4,4,3,6,6,9,1,1.0,17.0,-16.0,2
10123,10123,2012-13,2012,2013,Man City,Stoke,Draw,Away,2012-09-15,1,4,7,10,13,2,3,4,4,2,4,6,9,0,1.0,14.0,-13.0,2
10124,10124,2012-13,2012,2013,Man City,Arsenal,Draw,Home,2012-09-23,1,4,5,8,11,6,7,8,11,-2,-2,0,0,1,1.0,3.0,-2.0,2
10125,10125,2012-13,2012,2013,Man City,Fulham,Win,Away,2012-09-29,3,2,5,6,9,6,6,6,9,-4,-1,0,0,0,1.0,9.0,-8.0,2
10126,10126,2012-13,2012,2013,Man City,Sunderland,Win,Home,2012-10-06,3,4,5,8,9,4,5,6,7,0,0,2,2,1,1.0,13.0,-12.0,3
10127,10127,2012-13,2012,2013,Man City,West Brom,Win,Away,2012-10-20,3,6,7,8,11,4,7,7,10,2,0,1,1,0,1.0,10.0,-9.0,3
10128,10128,2012-13,2012,2013,Man City,Swansea,Win,Home,2012-10-27,3,6,9,10,11,4,4,4,4,2,5,6,7,1,1.0,11.0,-10.0,3
10129,10129,2012-13,2012,2013,Man City,West Ham,Draw,Away,2012-11-03,1,6,9,12,13,3,3,6,7,3,6,6,6,0,1.0,21.0,-20.0,4
10130,10130,2012-13,2012,2013,Man City,Tottenham,Win,Home,2012-11-11,3,4,7,10,13,3,3,6,9,1,4,4,4,1,1.0,4.0,-3.0,4
10131,10131,2012-13,2012,2013,Man City,Aston Villa,Win,Home,2012-11-17,3,4,7,10,13,3,4,4,4,1,3,6,9,1,1.0,16.0,-15.0,4
10132,10132,2012-13,2012,2013,Man City,Chelsea,Draw,Away,2012-11-25,1,6,7,10,13,1,2,2,5,5,5,8,8,0,1.0,6.0,-5.0,4
10133,10133,2012-13,2012,2013,Man City,Wigan,Win,Away,2012-11-28,3,4,7,8,11,3,3,6,9,1,4,2,2,0,1.0,15.0,-14.0,4
10134,10134,2012-13,2012,2013,Man City,Everton,Draw,Home,2012-12-01,1,4,7,10,11,2,2,5,6,2,5,5,5,1,1.0,7.0,-6.0,5
10135,10135,2012-13,2012,2013,Man City,Man United,Loss,Home,2012-12-09,0,4,5,8,11,6,9,9,12,-2,-4,-1,-1,1,1.0,2.0,-1.0,5
10136,10136,2012-13,2012,2013,Man City,Newcastle,Win,Away,2012-12-15,3,1,4,5,8,3,3,3,3,-2,1,2,5,0,1.0,5.0,-4.0,5
10137,10137,2012-13,2012,2013,Man City,Reading,Win,Home,2012-12-22,3,3,4,7,8,0,0,0,0,3,4,7,8,1,1.0,21.0,-20.0,5
10138,10138,2012-13,2012,2013,Man City,Sunderland,Loss,Away,2012-12-26,0,6,6,7,10,3,6,6,6,3,0,1,4,0,1.0,13.0,-12.0,5
10139,10139,2012-13,2012,2013,Man City,Norwich,Win,Away,2012-12-29,3,3,6,6,7,0,3,6,9,3,3,0,-2,0,1.0,12.0,-11.0,5
10140,10140,2012-13,2012,2013,Man City,Stoke,Win,Home,2013-01-01,3,3,6,9,9,4,5,6,7,-1,1,3,2,1,1.0,14.0,-13.0,6
10141,10141,2012-13,2012,2013,Man City,Arsenal,Win,Away,2013-01-13,3,6,6,9,12,4,7,10,13,2,-1,-1,-1,0,1.0,3.0,-2.0,6
10142,10142,2012-13,2012,2013,Man City,Fulham,Win,Home,2013-01-19,3,6,9,9,12,4,4,5,5,2,5,4,7,1,1.0,9.0,-8.0,6
10143,10143,2012-13,2012,2013,Man City,QPR,Draw,Away,2013-01-29,1,6,9,12,12,2,5,5,5,4,4,7,7,0,1.0,17.0,-16.0,6
10144,10144,2012-13,2012,2013,Man City,Liverpool,Draw,Home,2013-02-03,1,4,7,10,13,4,4,7,10,0,3,3,3,1,1.0,8.0,-7.0,7
10145,10145,2012-13,2012,2013,Man City,Southampton,Loss,Away,2013-02-09,0,2,5,8,11,1,2,3,6,1,3,5,5,0,1.0,21.0,-20.0,7
10146,10146,2012-13,2012,2013,Man City,Chelsea,Win,Home,2013-02-24,3,1,2,5,8,3,4,7,8,-2,-2,-2,0,1,1.0,6.0,-5.0,7
10147,10147,2012-13,2012,2013,Man City,Aston Villa,Win,Away,2013-03-04,3,3,4,5,8,3,4,4,5,0,0,1,3,0,1.0,16.0,-15.0,8
10148,10148,2012-13,2012,2013,Man City,Everton,Loss,Away,2013-03-16,0,6,6,7,8,3,3,4,7,3,3,3,1,0,1.0,7.0,-6.0,8
10149,10149,2012-13,2012,2013,Man City,Newcastle,Win,Home,2013-03-30,3,3,6,6,7,3,3,6,6,0,3,0,1,1,1.0,5.0,-4.0,8
10150,10150,2012-13,2012,2013,Man City,Man United,Win,Away,2013-04-08,3,3,6,9,9,6,9,12,15,-3,-3,-3,-6,0,1.0,2.0,-1.0,9
10151,10151,2012-13,2012,2013,Man City,Wigan,Win,Home,2013-04-17,3,6,6,9,12,4,7,7,10,2,-1,2,2,1,1.0,15.0,-14.0,9
10152,10152,2012-13,2012,2013,Man City,Tottenham,Loss,Away,2013-04-21,0,6,9,9,12,4,4,4,7,2,5,5,5,0,1.0,4.0,-3.0,9
10153,10153,2012-13,2012,2013,Man City,West Ham,Win,Home,2013-04-27,3,3,6,9,9,4,5,6,9,-1,1,3,0,1,1.0,21.0,-20.0,9
10154,10154,2012-13,2012,2013,Man City,Swansea,Draw,Away,2013-05-04,1,3,6,9,12,1,2,2,2,2,4,7,10,0,1.0,11.0,-10.0,10
10155,10155,2012-13,2012,2013,Man City,West Brom,Win,Home,2013-05-07,3,4,4,7,10,3,4,4,4,1,0,3,6,1,1.0,10.0,-9.0,10
10156,10156,2012-13,2012,2013,Man City,Reading,Win,Away,2013-05-14,3,4,7,7,10,4,4,5,5,0,3,2,5,0,1.0,21.0,-20.0,10
10157,10157,2012-13,2012,2013,Man City,Norwich,Loss,Home,2013-05-19,0,6,7,10,10,3,3,6,6,3,4,4,4,1,1.0,12.0,-11.0,10
10158,10158,2013-14,2013,2014,Man City,Newcastle,Win,Home,2013-08-19,3,3,6,7,10,3,4,4,5,0,2,3,5,1,2.0,16.0,-14.0,1
10159,10159,2013-14,2013,2014,Man City,Cardiff,Loss,Away,2013-08-25,0,3,6,9,10,0,0,0,0,3,6,9,10,0,2.0,21.0,-19.0,1
10160,10160,2013-14,2013,2014,Man City,Hull,Win,Home,2013-08-31,3,3,3,6,9,3,4,5,5,0,-1,1,4,1,2.0,21.0,-19.0,1
10161,10161,2013-14,2013,2014,Man City,Stoke,Draw,Away,2013-09-14,1,3,6,6,9,6,6,7,7,-3,0,-1,2,0,2.0,13.0,-11.0,2
10162,10162,2013-14,2013,2014,Man City,Man United,Win,Home,2013-09-22,3,4,4,7,7,3,4,7,8,1,0,0,-1,1,2.0,1.0,1.0,2
10163,10163,2013-14,2013,2014,Man City,Aston Villa,Loss,Away,2013-09-28,0,4,7,7,10,3,3,3,6,1,4,4,4,0,2.0,15.0,-13.0,2
10164,10164,2013-14,2013,2014,Man City,Everton,Win,Home,2013-10-05,3,3,4,7,7,6,9,10,11,-3,-5,-3,-4,1,2.0,6.0,-4.0,3
10165,10165,2013-14,2013,2014,Man City,West Ham,Win,Away,2013-10-19,3,3,6,7,10,3,3,4,4,0,3,3,6,0,2.0,10.0,-8.0,3
10166,10166,2013-14,2013,2014,Man City,Chelsea,Loss,Away,2013-10-27,0,6,6,9,10,6,7,10,10,0,-1,-1,0,0,2.0,3.0,-1.0,3
10167,10167,2013-14,2013,2014,Man City,Norwich,Win,Home,2013-11-02,3,3,6,6,9,1,1,4,4,2,5,2,5,1,2.0,11.0,-9.0,4
10168,10168,2013-14,2013,2014,Man City,Sunderland,Loss,Away,2013-11-10,0,3,6,9,9,3,3,3,3,0,3,6,6,0,2.0,17.0,-15.0,4
10169,10169,2013-14,2013,2014,Man City,Tottenham,Win,Home,2013-11-24,3,3,3,6,9,1,4,7,7,2,-1,-1,2,1,2.0,5.0,-3.0,4
10170,10170,2013-14,2013,2014,Man City,Swansea,Win,Home,2013-12-01,3,3,6,6,9,4,4,5,8,-1,2,1,1,1,2.0,9.0,-7.0,5
10171,10171,2013-14,2013,2014,Man City,West Brom,Win,Away,2013-12-04,3,6,6,9,9,1,2,5,5,5,4,4,4,0,2.0,8.0,-6.0,5
10172,10172,2013-14,2013,2014,Man City,Southampton,Draw,Away,2013-12-07,1,6,9,9,12,0,0,3,4,6,9,6,8,0,2.0,14.0,-12.0,5
10173,10173,2013-14,2013,2014,Man City,Arsenal,Win,Home,2013-12-14,3,4,7,10,10,4,7,10,10,0,0,0,0,1,2.0,4.0,-2.0,5
10174,10174,2013-14,2013,2014,Man City,Fulham,Win,Away,2013-12-21,3,4,7,10,13,3,3,3,3,1,4,7,10,0,2.0,12.0,-10.0,5
10175,10175,2013-14,2013,2014,Man City,Liverpool,Win,Home,2013-12-26,3,6,7,10,13,6,9,12,12,0,-2,-2,1,1,2.0,7.0,-5.0,5
10176,10176,2013-14,2013,2014,Man City,Crystal Palace,Win,Home,2013-12-28,3,6,9,10,13,3,3,6,9,3,6,4,4,1,2.0,21.0,-19.0,5
10177,10177,2013-14,2013,2014,Man City,Swansea,Win,Away,2014-01-01,3,6,9,12,13,1,1,2,3,5,8,10,10,0,2.0,9.0,-7.0,6
10178,10178,2013-14,2013,2014,Man City,Newcastle,Win,Away,2014-01-12,3,6,9,12,15,0,3,6,7,6,6,6,8,0,2.0,16.0,-14.0,6
10179,10179,2013-14,2013,2014,Man City,Cardiff,Win,Home,2014-01-18,3,6,9,12,15,0,1,1,1,6,8,11,14,1,2.0,21.0,-19.0,6
10180,10180,2013-14,2013,2014,Man City,Tottenham,Win,Away,2014-01-29,3,6,9,12,15,6,9,12,13,0,0,0,2,0,2.0,5.0,-3.0,6
10181,10181,2013-14,2013,2014,Man City,Chelsea,Loss,Home,2014-02-03,0,6,9,12,15,4,7,10,13,2,2,2,2,1,2.0,3.0,-1.0,7
10182,10182,2013-14,2013,2014,Man City,Norwich,Draw,Away,2014-02-08,1,3,6,9,12,1,4,4,5,2,2,5,7,0,2.0,11.0,-9.0,7
10183,10183,2013-14,2013,2014,Man City,Stoke,Win,Home,2014-02-22,3,1,4,7,10,2,5,5,5,-1,-1,2,5,1,2.0,13.0,-11.0,7
10184,10184,2013-14,2013,2014,Man City,Hull,Win,Away,2014-03-15,3,4,4,7,10,3,3,6,7,1,1,1,3,0,2.0,21.0,-19.0,8
10185,10185,2013-14,2013,2014,Man City,Fulham,Win,Home,2014-03-22,3,6,7,7,10,3,3,4,4,3,4,3,6,1,2.0,12.0,-10.0,8
10186,10186,2013-14,2013,2014,Man City,Man United,Win,Away,2014-03-25,3,6,9,10,10,3,6,9,10,3,3,1,0,0,2.0,1.0,1.0,8
10187,10187,2013-14,2013,2014,Man City,Arsenal,Draw,Away,2014-03-29,1,6,9,12,13,1,4,4,7,5,5,8,6,0,2.0,4.0,-2.0,8
10188,10188,2013-14,2013,2014,Man City,Southampton,Win,Home,2014-04-05,3,4,7,10,13,3,6,9,9,1,1,1,4,1,2.0,14.0,-12.0,9
10189,10189,2013-14,2013,2014,Man City,Liverpool,Loss,Away,2014-04-13,0,4,7,10,13,6,9,12,15,-2,-2,-2,-2,0,2.0,7.0,-5.0,9
10190,10190,2013-14,2013,2014,Man City,Sunderland,Draw,Home,2014-04-16,1,3,4,7,10,0,0,0,0,3,4,7,10,1,2.0,17.0,-15.0,9
10191,10191,2013-14,2013,2014,Man City,West Brom,Win,Home,2014-04-21,3,1,4,5,8,4,5,5,8,-3,-1,0,0,1,2.0,8.0,-6.0,9
10192,10192,2013-14,2013,2014,Man City,Crystal Palace,Win,Away,2014-04-27,3,4,4,7,8,6,9,12,15,-2,-5,-5,-7,0,2.0,21.0,-19.0,9
10193,10193,2013-14,2013,2014,Man City,Everton,Win,Away,2014-05-03,3,6,7,7,10,3,3,6,9,3,4,1,1,0,2.0,6.0,-4.0,10
10194,10194,2013-14,2013,2014,Man City,Aston Villa,Win,Home,2014-05-07,3,6,9,10,10,3,4,4,4,3,5,6,6,1,2.0,15.0,-13.0,10
10195,10195,2013-14,2013,2014,Man City,West Ham,Win,Home,2014-05-11,3,6,9,12,13,3,3,3,3,3,6,9,10,1,2.0,10.0,-8.0,10
10196,10196,2014-15,2014,2015,Man City,Newcastle,Win,Away,2014-08-17,3,6,9,12,15,3,3,3,3,3,6,9,12,0,1.0,10.0,-9.0,1
10197,10197,2014-15,2014,2015,Man City,Liverpool,Win,Home,2014-08-25,3,6,9,12,15,6,7,7,10,0,2,5,5,1,1.0,2.0,-1.0,1
10198,10198,2014-15,2014,2015,Man City,Stoke,Loss,Home,2014-08-30,0,6,9,12,15,1,4,7,7,5,5,5,8,1,1.0,9.0,-8.0,1
10199,10199,2014-15,2014,2015,Man City,Arsenal,Draw,Away,2014-09-13,1,3,6,9,12,2,5,8,11,1,1,1,1,0,1.0,4.0,-3.0,2
10200,10200,2014-15,2014,2015,Man City,Chelsea,Draw,Home,2014-09-21,1,1,4,7,10,6,9,12,15,-5,-5,-5,-5,1,1.0,3.0,-2.0,2
10201,10201,2014-15,2014,2015,Man City,Hull,Win,Away,2014-09-27,3,2,2,5,8,2,2,3,6,0,0,2,2,0,1.0,16.0,-15.0,2
10202,10202,2014-15,2014,2015,Man City,Aston Villa,Win,Away,2014-10-04,3,4,5,5,8,0,3,6,7,4,2,-1,1,0,1.0,15.0,-14.0,3
10203,10203,2014-15,2014,2015,Man City,Tottenham,Win,Home,2014-10-18,3,6,7,8,8,4,4,5,5,2,3,3,3,1,1.0,6.0,-5.0,3
10204,10204,2014-15,2014,2015,Man City,West Ham,Loss,Away,2014-10-25,0,6,9,10,11,6,6,9,10,0,3,1,1,0,1.0,13.0,-12.0,3
10205,10205,2014-15,2014,2015,Man City,Man United,Win,Home,2014-11-02,3,3,6,9,10,2,5,8,8,1,1,1,2,1,1.0,7.0,-6.0,4
10206,10206,2014-15,2014,2015,Man City,QPR,Draw,Away,2014-11-08,1,3,6,9,12,3,3,3,3,0,3,6,9,0,1.0,21.0,-20.0,4
10207,10207,2014-15,2014,2015,Man City,Swansea,Win,Home,2014-11-22,3,4,4,7,10,4,7,7,8,0,-3,0,2,1,1.0,12.0,-11.0,4
10208,10208,2014-15,2014,2015,Man City,Southampton,Win,Away,2014-11-30,3,4,7,7,10,4,7,10,13,0,0,-3,-3,0,1.0,8.0,-7.0,4
10209,10209,2014-15,2014,2015,Man City,Sunderland,Win,Away,2014-12-03,3,6,7,10,10,2,3,6,6,4,4,4,4,0,1.0,14.0,-13.0,5
10210,10210,2014-15,2014,2015,Man City,Everton,Win,Home,2014-12-06,3,6,9,10,13,1,4,5,6,5,5,5,7,1,1.0,5.0,-4.0,5
10211,10211,2014-15,2014,2015,Man City,Leicester,Win,Away,2014-12-13,3,6,9,12,13,0,0,1,1,6,9,11,12,0,1.0,21.0,-20.0,5
10212,10212,2014-15,2014,2015,Man City,Crystal Palace,Win,Home,2014-12-20,3,6,9,12,15,2,2,3,6,4,7,9,9,1,1.0,11.0,-10.0,5
10213,10213,2014-15,2014,2015,Man City,West Brom,Win,Away,2014-12-26,3,6,9,12,15,3,4,4,4,3,5,8,11,0,1.0,17.0,-16.0,5
10214,10214,2014-15,2014,2015,Man City,Burnley,Draw,Home,2014-12-28,1,6,9,12,15,0,3,3,4,6,6,9,11,1,1.0,21.0,-20.0,5
10215,10215,2014-15,2014,2015,Man City,Sunderland,Win,Home,2015-01-01,3,4,7,10,13,1,4,5,6,3,3,5,7,1,1.0,14.0,-13.0,6
10216,10216,2014-15,2014,2015,Man City,Everton,Draw,Away,2015-01-10,1,4,7,10,13,0,0,0,3,4,7,10,10,0,1.0,5.0,-4.0,6
10217,10217,2014-15,2014,2015,Man City,Arsenal,Loss,Home,2015-01-18,0,4,5,8,11,3,6,9,10,1,-1,-1,1,1,1.0,4.0,-3.0,6
10218,10218,2014-15,2014,2015,Man City,Chelsea,Draw,Away,2015-01-31,1,1,4,5,8,6,6,7,10,-5,-2,-2,-2,0,1.0,3.0,-2.0,6
10219,10219,2014-15,2014,2015,Man City,Hull,Draw,Home,2015-02-07,1,1,2,5,6,0,0,3,3,1,2,2,3,1,1.0,16.0,-15.0,7
10220,10220,2014-15,2014,2015,Man City,Stoke,Win,Away,2015-02-11,3,2,2,3,6,4,7,7,8,-2,-5,-4,-2,0,1.0,9.0,-8.0,7
10221,10221,2014-15,2014,2015,Man City,Newcastle,Win,Home,2015-02-21,3,4,5,5,6,2,5,5,5,2,0,0,1,1,1.0,10.0,-9.0,7
10222,10222,2014-15,2014,2015,Man City,Liverpool,Loss,Away,2015-03-01,0,6,7,8,8,6,7,10,13,0,0,-2,-5,0,1.0,2.0,-1.0,8
10223,10223,2014-15,2014,2015,Man City,Leicester,Win,Home,2015-03-04,3,3,6,7,8,1,1,1,1,2,5,6,7,1,1.0,21.0,-20.0,8
10224,10224,2014-15,2014,2015,Man City,Burnley,Loss,Away,2015-03-14,0,3,6,9,10,0,1,1,2,3,5,8,8,0,1.0,21.0,-20.0,8
10225,10225,2014-15,2014,2015,Man City,West Brom,Win,Home,2015-03-21,3,3,3,6,9,3,6,7,10,0,-3,-1,-1,1,1.0,17.0,-16.0,8
10226,10226,2014-15,2014,2015,Man City,Crystal Palace,Loss,Away,2015-04-06,0,3,6,6,9,6,6,9,9,-3,0,-3,0,0,1.0,11.0,-10.0,9
10227,10227,2014-15,2014,2015,Man City,Man United,Loss,Away,2015-04-12,0,3,3,6,6,6,9,12,15,-3,-6,-6,-9,0,1.0,7.0,-6.0,9
10228,10228,2014-15,2014,2015,Man City,West Ham,Win,Home,2015-04-19,3,0,3,3,6,1,4,4,4,-1,-1,-1,2,1,1.0,13.0,-12.0,9
10229,10229,2014-15,2014,2015,Man City,Aston Villa,Win,Home,2015-04-25,3,3,3,6,6,4,4,4,7,-1,-1,2,-1,1,1.0,15.0,-14.0,9
10230,10230,2014-15,2014,2015,Man City,Tottenham,Win,Away,2015-05-03,3,6,6,6,9,4,4,5,8,2,2,1,1,0,1.0,6.0,-5.0,10
10231,10231,2014-15,2014,2015,Man City,QPR,Win,Home,2015-05-10,3,6,9,9,9,1,1,2,5,5,8,7,4,1,1.0,21.0,-20.0,10
10232,10232,2014-15,2014,2015,Man City,Swansea,Win,Away,2015-05-17,3,6,9,12,12,6,9,9,10,0,0,3,2,0,1.0,12.0,-11.0,10
10233,10233,2014-15,2014,2015,Man City,Southampton,Win,Home,2015-05-24,3,6,9,12,15,3,3,4,4,3,6,8,11,1,1.0,8.0,-7.0,10
10234,10234,2015-16,2015,2016,Man City,West Brom,Win,Away,2015-08-10,3,6,9,12,15,3,4,7,8,3,5,5,7,0,2.0,13.0,-11.0,1
10235,10235,2015-16,2015,2016,Man City,Chelsea,Win,Home,2015-08-16,3,6,9,12,15,4,4,5,8,2,5,7,7,1,2.0,1.0,1.0,1
10236,10236,2015-16,2015,2016,Man City,Everton,Win,Away,2015-08-23,3,6,9,12,15,4,4,7,7,2,5,5,8,0,2.0,11.0,-9.0,1
10237,10237,2015-16,2015,2016,Man City,Watford,Win,Home,2015-08-29,3,6,9,12,15,2,3,4,7,4,6,8,8,1,2.0,21.0,-19.0,1
10238,10238,2015-16,2015,2016,Man City,Crystal Palace,Win,Away,2015-09-12,3,6,9,12,15,6,6,9,12,0,3,3,3,0,2.0,10.0,-8.0,2
10239,10239,2015-16,2015,2016,Man City,West Ham,Loss,Home,2015-09-19,0,6,9,12,15,6,6,6,9,0,3,6,6,1,2.0,12.0,-10.0,2
10240,10240,2015-16,2015,2016,Man City,Tottenham,Loss,Away,2015-09-26,0,3,6,9,12,6,7,8,9,-3,-1,1,3,0,2.0,5.0,-3.0,2
10241,10241,2015-16,2015,2016,Man City,Newcastle,Win,Home,2015-10-03,3,0,3,6,9,1,1,1,2,-1,2,5,7,1,2.0,15.0,-13.0,3
10242,10242,2015-16,2015,2016,Man City,Bournemouth,Win,Home,2015-10-17,3,3,3,6,9,1,4,4,5,2,-1,2,4,1,2.0,21.0,-19.0,3
10243,10243,2015-16,2015,2016,Man City,Man United,Draw,Away,2015-10-25,1,6,6,6,9,3,6,9,12,3,0,-3,-3,0,2.0,4.0,-2.0,3
10244,10244,2015-16,2015,2016,Man City,Norwich,Win,Home,2015-10-31,3,4,7,7,7,0,0,1,2,4,7,6,5,1,2.0,21.0,-19.0,3
10245,10245,2015-16,2015,2016,Man City,Aston Villa,Draw,Away,2015-11-08,1,4,7,10,10,0,0,0,0,4,7,10,10,0,2.0,17.0,-15.0,4
10246,10246,2015-16,2015,2016,Man City,Liverpool,Loss,Home,2015-11-21,0,4,5,8,11,3,4,5,6,1,1,3,5,1,2.0,6.0,-4.0,4
10247,10247,2015-16,2015,2016,Man City,Southampton,Win,Home,2015-11-28,3,1,4,5,8,3,6,7,8,-2,-2,-2,0,1,2.0,7.0,-5.0,4
10248,10248,2015-16,2015,2016,Man City,Stoke,Loss,Away,2015-12-05,0,3,4,7,8,3,6,7,7,0,-2,0,1,0,2.0,9.0,-7.0,5
10249,10249,2015-16,2015,2016,Man City,Swansea,Win,Home,2015-12-12,3,3,3,4,7,0,1,1,1,3,2,3,6,1,2.0,8.0,-6.0,5
10250,10250,2015-16,2015,2016,Man City,Arsenal,Loss,Away,2015-12-21,0,3,6,6,7,6,7,7,8,-3,-1,-1,-1,0,2.0,3.0,-1.0,5
10251,10251,2015-16,2015,2016,Man City,Sunderland,Win,Home,2015-12-26,3,3,3,6,6,0,0,3,6,3,3,3,0,1,2.0,16.0,-14.0,5
10252,10252,2015-16,2015,2016,Man City,Leicester,Draw,Away,2015-12-29,1,3,6,6,9,3,6,9,10,0,0,-3,-1,0,2.0,14.0,-12.0,5
10253,10253,2015-16,2015,2016,Man City,Watford,Win,Away,2016-01-02,3,4,4,7,7,1,4,7,10,3,0,0,-3,0,2.0,21.0,-19.0,6
10254,10254,2015-16,2015,2016,Man City,Everton,Draw,Home,2016-01-13,1,4,7,7,10,1,4,4,5,3,3,3,5,1,2.0,11.0,-9.0,6
10255,10255,2015-16,2015,2016,Man City,Crystal Palace,Win,Home,2016-01-16,3,4,5,8,8,0,1,2,5,4,4,6,3,1,2.0,10.0,-8.0,6
10256,10256,2015-16,2015,2016,Man City,West Ham,Draw,Away,2016-01-23,1,4,7,8,11,3,6,9,10,1,1,-1,1,0,2.0,12.0,-10.0,6
10257,10257,2015-16,2015,2016,Man City,Sunderland,Win,Away,2016-02-02,3,4,5,8,9,1,4,7,7,3,1,1,2,0,2.0,16.0,-14.0,7
10258,10258,2015-16,2015,2016,Man City,Leicester,Loss,Home,2016-02-06,0,4,7,8,11,6,7,10,11,-2,0,-2,0,1,2.0,14.0,-12.0,7
10259,10259,2015-16,2015,2016,Man City,Tottenham,Loss,Home,2016-02-14,0,3,4,7,8,6,9,12,12,-3,-5,-5,-4,1,2.0,5.0,-3.0,7
10260,10260,2015-16,2015,2016,Man City,Liverpool,Loss,Away,2016-03-02,0,0,3,4,7,4,4,7,7,-4,-1,-3,0,0,2.0,6.0,-4.0,8
10261,10261,2015-16,2015,2016,Man City,Aston Villa,Win,Home,2016-03-05,3,0,0,3,4,0,0,3,3,0,0,0,1,1,2.0,17.0,-15.0,8
10262,10262,2015-16,2015,2016,Man City,Norwich,Draw,Away,2016-03-12,1,3,3,3,6,0,0,1,1,3,3,2,5,0,2.0,21.0,-19.0,8
10263,10263,2015-16,2015,2016,Man City,Man United,Loss,Home,2016-03-20,0,4,4,4,4,3,6,6,7,1,-2,-2,-3,1,2.0,4.0,-2.0,8
10264,10264,2015-16,2015,2016,Man City,Bournemouth,Win,Away,2016-04-02,3,1,4,4,4,3,6,9,10,-2,-2,-5,-6,0,2.0,21.0,-19.0,9
10265,10265,2015-16,2015,2016,Man City,West Brom,Win,Home,2016-04-09,3,3,4,7,7,1,4,5,8,2,0,2,-1,1,2.0,13.0,-11.0,9
10266,10266,2015-16,2015,2016,Man City,Chelsea,Win,Away,2016-04-16,3,6,6,7,10,3,4,5,8,3,2,2,2,0,2.0,1.0,1.0,9
10267,10267,2015-16,2015,2016,Man City,Newcastle,Draw,Away,2016-04-19,1,6,9,9,10,3,3,4,4,3,6,5,6,0,2.0,15.0,-13.0,9
10268,10268,2015-16,2015,2016,Man City,Stoke,Win,Home,2016-04-23,3,4,7,10,10,0,1,4,4,4,6,6,6,1,2.0,9.0,-7.0,9
10269,10269,2015-16,2015,2016,Man City,Southampton,Loss,Away,2016-05-01,0,4,7,10,13,4,7,7,10,0,0,3,3,0,2.0,7.0,-5.0,10
10270,10270,2015-16,2015,2016,Man City,Arsenal,Draw,Home,2016-05-08,1,3,4,7,10,4,7,8,9,-1,-3,-1,1,1,2.0,3.0,-1.0,10
10271,10271,2015-16,2015,2016,Man City,Swansea,Draw,Away,2016-05-15,1,1,4,5,8,6,6,6,9,-5,-2,-1,-1,0,2.0,8.0,-6.0,10
10272,10272,2016-17,2016,2017,Man City,Sunderland,Win,Home,2016-08-13,3,2,2,5,6,4,7,8,9,-2,-5,-3,-3,1,4.0,17.0,-13.0,1
10273,10273,2016-17,2016,2017,Man City,Stoke,Win,Away,2016-08-20,3,4,5,5,8,4,4,5,5,0,1,0,3,0,4.0,9.0,-5.0,1
10274,10274,2016-17,2016,2017,Man City,West Ham,Win,Home,2016-08-28,3,6,7,8,8,3,3,6,6,3,4,2,2,1,4.0,7.0,-3.0,1
10275,10275,2016-17,2016,2017,Man City,Man United,Win,Away,2016-09-10,3,6,9,10,11,6,9,12,12,0,0,-2,-1,0,4.0,5.0,-1.0,2
10276,10276,2016-17,2016,2017,Man City,Bournemouth,Win,Home,2016-09-17,3,6,9,12,13,4,4,4,4,2,5,8,9,1,4.0,16.0,-12.0,2
10277,10277,2016-17,2016,2017,Man City,Swansea,Win,Away,2016-09-24,3,6,9,12,15,1,1,1,4,5,8,11,11,0,4.0,12.0,-8.0,2
10278,10278,2016-17,2016,2017,Man City,Tottenham,Loss,Away,2016-10-02,0,6,9,12,15,6,9,10,13,0,0,2,2,0,4.0,3.0,1.0,3
10279,10279,2016-17,2016,2017,Man City,Everton,Draw,Home,2016-10-15,1,3,6,9,12,1,4,7,10,2,2,2,2,1,4.0,11.0,-7.0,3
10280,10280,2016-17,2016,2017,Man City,Southampton,Draw,Home,2016-10-23,1,1,4,7,10,4,7,10,10,-3,-3,-3,0,1,4.0,6.0,-2.0,3
10281,10281,2016-17,2016,2017,Man City,West Brom,Win,Away,2016-10-29,3,2,2,5,8,1,2,3,6,1,0,2,2,0,4.0,14.0,-10.0,3
10282,10282,2016-17,2016,2017,Man City,Middlesbrough,Draw,Home,2016-11-05,1,4,5,5,8,4,4,5,5,0,1,0,3,1,4.0,21.0,-17.0,4
10283,10283,2016-17,2016,2017,Man City,Crystal Palace,Win,Away,2016-11-19,3,4,5,6,6,0,0,0,1,4,5,6,5,0,4.0,15.0,-11.0,4
10284,10284,2016-17,2016,2017,Man City,Burnley,Win,Away,2016-11-26,3,4,7,8,9,3,4,7,7,1,3,1,2,0,4.0,21.0,-17.0,4
10285,10285,2016-17,2016,2017,Man City,Chelsea,Loss,Home,2016-12-03,0,6,7,10,11,6,9,12,15,0,-2,-2,-4,1,4.0,10.0,-6.0,5
10286,10286,2016-17,2016,2017,Man City,Leicester,Loss,Away,2016-12-10,0,3,6,7,10,1,1,1,2,2,5,6,8,0,4.0,1.0,3.0,5
10287,10287,2016-17,2016,2017,Man City,Watford,Win,Home,2016-12-14,3,0,3,6,7,3,3,6,6,-3,0,0,1,1,4.0,13.0,-9.0,5
10288,10288,2016-17,2016,2017,Man City,Arsenal,Win,Home,2016-12-18,3,3,3,6,9,3,6,9,10,0,-3,-3,-1,1,4.0,2.0,2.0,5
10289,10289,2016-17,2016,2017,Man City,Hull,Win,Away,2016-12-26,3,6,6,6,9,0,1,1,2,6,5,5,7,0,4.0,21.0,-17.0,5
10290,10290,2016-17,2016,2017,Man City,Liverpool,Loss,Away,2016-12-31,0,6,9,9,9,6,9,10,10,0,0,-1,-1,0,4.0,8.0,-4.0,5
10291,10291,2016-17,2016,2017,Man City,Burnley,Win,Home,2017-01-02,3,3,6,9,9,6,6,6,9,-3,0,3,0,1,4.0,21.0,-17.0,6
10292,10292,2016-17,2016,2017,Man City,Everton,Loss,Away,2017-01-15,0,3,6,9,12,4,7,7,10,-1,-1,2,2,0,4.0,11.0,-7.0,6
10293,10293,2016-17,2016,2017,Man City,Tottenham,Draw,Home,2017-01-21,1,3,3,6,9,6,9,12,15,-3,-6,-6,-6,1,4.0,3.0,1.0,6
10294,10294,2016-17,2016,2017,Man City,West Ham,Win,Away,2017-02-01,3,1,4,4,7,6,6,6,9,-5,-2,-2,-2,0,4.0,7.0,-3.0,7
10295,10295,2016-17,2016,2017,Man City,Swansea,Win,Home,2017-02-05,3,4,4,7,7,6,6,9,9,-2,-2,-2,-2,1,4.0,12.0,-8.0,7
10296,10296,2016-17,2016,2017,Man City,Bournemouth,Win,Away,2017-02-13,3,6,7,7,10,0,1,1,2,6,6,6,8,0,4.0,16.0,-12.0,7
10297,10297,2016-17,2016,2017,Man City,Sunderland,Win,Away,2017-03-05,3,6,9,10,10,0,3,4,4,6,6,6,6,0,4.0,17.0,-13.0,8
10298,10298,2016-17,2016,2017,Man City,Stoke,Draw,Home,2017-03-08,1,6,9,12,13,3,6,6,7,3,3,6,6,1,4.0,9.0,-5.0,8
10299,10299,2016-17,2016,2017,Man City,Liverpool,Draw,Home,2017-03-19,1,4,7,10,13,6,6,9,9,-2,1,1,4,1,4.0,8.0,-4.0,8
10300,10300,2016-17,2016,2017,Man City,Arsenal,Draw,Away,2017-04-02,1,2,5,8,11,0,3,3,3,2,2,5,8,0,4.0,2.0,2.0,9
10301,10301,2016-17,2016,2017,Man City,Chelsea,Loss,Away,2017-04-05,0,2,3,6,9,3,6,9,10,-1,-3,-3,-1,0,4.0,10.0,-6.0,9
10302,10302,2016-17,2016,2017,Man City,Hull,Win,Home,2017-04-08,3,1,2,3,6,6,6,9,9,-5,-4,-6,-3,1,4.0,21.0,-17.0,9
10303,10303,2016-17,2016,2017,Man City,Southampton,Win,Away,2017-04-15,3,3,4,5,6,6,7,7,10,-3,-3,-2,-4,0,4.0,6.0,-2.0,9
10304,10304,2016-17,2016,2017,Man City,Man United,Draw,Home,2017-04-27,1,6,6,7,8,6,9,10,11,0,-3,-3,-3,1,4.0,5.0,-1.0,9
10305,10305,2016-17,2016,2017,Man City,Middlesbrough,Draw,Away,2017-04-30,1,4,7,7,8,3,3,4,4,1,4,3,4,0,4.0,21.0,-17.0,9
10306,10306,2016-17,2016,2017,Man City,Crystal Palace,Win,Home,2017-05-06,3,2,5,8,8,0,3,4,7,2,2,4,1,1,4.0,15.0,-11.0,10
10307,10307,2016-17,2016,2017,Man City,Leicester,Win,Home,2017-05-13,3,4,5,8,11,6,6,7,7,-2,-1,1,4,1,4.0,1.0,3.0,10
10308,10308,2016-17,2016,2017,Man City,West Brom,Win,Home,2017-05-16,3,6,7,8,11,1,1,1,1,5,6,7,10,1,4.0,14.0,-10.0,10
10309,10309,2016-17,2016,2017,Man City,Watford,Win,Away,2017-05-21,3,6,9,10,11,0,0,0,0,6,9,10,11,0,4.0,13.0,-9.0,10
10310,10310,2017-18,2017,2018,Man City,Brighton,Win,Away,2017-08-12,3,6,9,12,13,0,0,0,0,6,9,12,13,0,3.0,21.0,-18.0,1
10311,10311,2017-18,2017,2018,Man City,Everton,Draw,Home,2017-08-21,1,6,9,12,15,3,6,6,6,3,3,6,9,1,3.0,7.0,-4.0,1
10312,10312,2017-18,2017,2018,Man City,Bournemouth,Win,Away,2017-08-26,3,4,7,10,13,0,1,4,5,4,6,6,8,0,3.0,9.0,-6.0,1
10313,10313,2017-18,2017,2018,Man City,Liverpool,Win,Home,2017-09-09,3,4,7,10,13,6,7,10,13,-2,0,0,0,1,3.0,4.0,-1.0,2
10314,10314,2017-18,2017,2018,Man City,Watford,Win,Away,2017-09-16,3,6,7,10,13,4,7,8,8,2,0,2,5,0,3.0,17.0,-14.0,2
10315,10315,2017-18,2017,2018,Man City,Crystal Palace,Win,Home,2017-09-23,3,6,9,10,13,0,0,0,0,6,9,10,13,1,3.0,14.0,-11.0,2
10316,10316,2017-18,2017,2018,Man City,Chelsea,Win,Away,2017-09-30,3,6,9,12,13,4,7,10,13,2,2,2,0,0,3.0,1.0,2.0,2
10317,10317,2017-18,2017,2018,Man City,Stoke,Win,Home,2017-10-14,3,6,9,12,15,3,3,4,5,3,6,8,10,1,3.0,13.0,-10.0,3
10318,10318,2017-18,2017,2018,Man City,Burnley,Win,Home,2017-10-21,3,6,9,12,15,4,5,6,9,2,4,6,6,1,3.0,16.0,-13.0,3
10319,10319,2017-18,2017,2018,Man City,West Brom,Win,Away,2017-10-28,3,6,9,12,15,1,2,2,3,5,7,10,12,0,3.0,10.0,-7.0,3
10320,10320,2017-18,2017,2018,Man City,Arsenal,Win,Home,2017-11-05,3,6,9,12,15,6,6,9,12,0,3,3,3,1,3.0,5.0,-2.0,4
10321,10321,2017-18,2017,2018,Man City,Leicester,Win,Away,2017-11-18,3,6,9,12,15,4,7,8,9,2,2,4,6,0,3.0,12.0,-9.0,4
10322,10322,2017-18,2017,2018,Man City,Huddersfield,Win,Away,2017-11-26,3,6,9,12,15,3,3,6,6,3,6,6,9,0,3.0,21.0,-18.0,4
10323,10323,2017-18,2017,2018,Man City,Southampton,Win,Home,2017-11-29,3,6,9,12,15,3,3,4,7,3,6,8,8,1,3.0,8.0,-5.0,4
10324,10324,2017-18,2017,2018,Man City,West Ham,Win,Home,2017-12-03,3,6,9,12,15,1,1,1,2,5,8,11,13,1,3.0,11.0,-8.0,5
10325,10325,2017-18,2017,2018,Man City,Man United,Win,Away,2017-12-10,3,6,9,12,15,6,9,12,12,0,0,0,3,0,3.0,6.0,-3.0,5
10326,10326,2017-18,2017,2018,Man City,Swansea,Win,Away,2017-12-13,3,6,9,12,15,3,3,4,4,3,6,8,11,0,3.0,15.0,-12.0,5
10327,10327,2017-18,2017,2018,Man City,Tottenham,Win,Home,2017-12-16,3,6,9,12,15,6,7,7,8,0,2,5,7,1,3.0,2.0,1.0,5
10328,10328,2017-18,2017,2018,Man City,Bournemouth,Win,Home,2017-12-23,3,6,9,12,15,0,1,2,2,6,8,10,13,1,3.0,9.0,-6.0,5
10329,10329,2017-18,2017,2018,Man City,Newcastle,Win,Away,2017-12-27,3,6,9,12,15,3,3,3,3,3,6,9,12,0,3.0,21.0,-18.0,5
10330,10330,2017-18,2017,2018,Man City,Crystal Palace,Draw,Away,2017-12-31,1,6,9,12,15,1,4,7,8,5,5,5,7,0,3.0,14.0,-11.0,5
10331,10331,2017-18,2017,2018,Man City,Watford,Win,Home,2018-01-02,3,4,7,10,13,3,3,3,3,1,4,7,10,1,3.0,17.0,-14.0,6
10332,10332,2017-18,2017,2018,Man City,Liverpool,Loss,Away,2018-01-14,0,4,7,10,13,6,9,10,13,-2,-2,0,0,0,3.0,4.0,-1.0,6
10333,10333,2017-18,2017,2018,Man City,Newcastle,Win,Home,2018-01-20,3,3,4,7,10,4,5,5,8,-1,-1,2,2,1,3.0,21.0,-18.0,6
10334,10334,2017-18,2017,2018,Man City,West Brom,Win,Home,2018-01-31,3,3,6,7,10,4,4,5,6,-1,2,2,4,1,3.0,10.0,-7.0,6
10335,10335,2017-18,2017,2018,Man City,Burnley,Draw,Away,2018-02-03,1,6,6,9,10,1,1,1,2,5,5,8,8,0,3.0,16.0,-13.0,7
10336,10336,2017-18,2017,2018,Man City,Leicester,Win,Home,2018-02-10,3,4,7,7,10,1,4,5,8,3,3,2,2,1,3.0,12.0,-9.0,7
10337,10337,2017-18,2017,2018,Man City,Arsenal,Win,Away,2018-03-01,3,4,7,10,10,3,3,6,6,1,4,4,4,0,3.0,5.0,-2.0,8
10338,10338,2017-18,2017,2018,Man City,Chelsea,Win,Home,2018-03-04,3,6,7,10,13,3,3,3,6,3,4,7,7,1,3.0,1.0,2.0,8
10339,10339,2017-18,2017,2018,Man City,Stoke,Win,Away,2018-03-12,3,6,9,10,13,2,3,3,4,4,6,7,9,0,3.0,13.0,-10.0,8
10340,10340,2017-18,2017,2018,Man City,Everton,Win,Away,2018-03-31,3,6,9,12,13,6,6,6,9,0,3,6,4,0,3.0,7.0,-4.0,8
10341,10341,2017-18,2017,2018,Man City,Man United,Loss,Home,2018-04-07,0,6,9,12,15,6,9,12,12,0,0,0,3,1,3.0,6.0,-3.0,9
10342,10342,2017-18,2017,2018,Man City,Tottenham,Win,Away,2018-04-14,3,3,6,9,12,6,9,12,15,-3,-3,-3,-3,0,3.0,2.0,1.0,9
10343,10343,2017-18,2017,2018,Man City,Swansea,Win,Home,2018-04-22,3,3,6,9,12,2,2,3,6,1,4,6,6,1,3.0,15.0,-12.0,9
10344,10344,2017-18,2017,2018,Man City,West Ham,Win,Away,2018-04-29,3,6,6,9,12,1,2,5,5,5,4,4,7,0,3.0,11.0,-8.0,9
10345,10345,2017-18,2017,2018,Man City,Huddersfield,Draw,Home,2018-05-06,1,6,9,9,12,3,4,4,4,3,5,5,8,1,3.0,21.0,-18.0,10
10346,10346,2017-18,2017,2018,Man City,Brighton,Win,Home,2018-05-09,3,4,7,10,10,4,5,5,6,0,2,5,4,1,3.0,21.0,-18.0,10
10347,10347,2017-18,2017,2018,Man City,Southampton,Win,Away,2018-05-13,3,4,7,10,13,4,7,8,8,0,0,2,5,0,3.0,8.0,-5.0,10
10348,10348,1993-94,1993,1994,Man United,Norwich,Win,Away,1993-08-15,3,0,0,0,0,0,0,0,0,0,0,0,0,0,1.0,3.0,-2.0,1
10349,10349,1993-94,1993,1994,Man United,Sheffield United,Win,Home,1993-08-18,3,3,3,3,3,3,3,3,3,0,0,0,0,1,1.0,14.0,-13.0,1
10350,10350,1993-94,1993,1994,Man United,Newcastle,Draw,Home,1993-08-21,1,6,6,6,6,0,0,0,0,6,6,6,6,1,1.0,21.0,-20.0,1
10351,10351,1993-94,1993,1994,Man United,Aston Villa,Win,Away,1993-08-23,3,4,7,7,7,2,5,5,5,2,2,2,2,0,1.0,2.0,-1.0,1
10352,10352,1993-94,1993,1994,Man United,Southampton,Win,Away,1993-08-28,3,4,7,10,10,3,3,3,3,1,4,7,7,0,1.0,18.0,-17.0,1
10353,10353,1993-94,1993,1994,Man United,West Ham,Win,Home,1993-09-01,3,6,7,10,13,3,4,4,4,3,3,6,9,1,1.0,21.0,-20.0,2
10354,10354,1993-94,1993,1994,Man United,Chelsea,Loss,Away,1993-09-11,0,6,9,10,13,2,5,5,6,4,4,5,7,0,1.0,11.0,-10.0,2
10355,10355,1993-94,1993,1994,Man United,Arsenal,Win,Home,1993-09-19,3,3,6,9,10,4,7,10,13,-1,-1,-1,-3,1,1.0,10.0,-9.0,2
10356,10356,1993-94,1993,1994,Man United,Swindon,Win,Home,1993-09-25,3,3,6,9,12,2,2,3,3,1,4,6,9,1,1.0,21.0,-20.0,2
10357,10357,1993-94,1993,1994,Man United,Sheffield Weds,Win,Away,1993-10-02,3,6,6,9,12,4,4,5,6,2,2,4,6,0,1.0,7.0,-6.0,3
10358,10358,1993-94,1993,1994,Man United,Tottenham,Win,Home,1993-10-16,3,6,9,9,12,4,7,8,9,2,2,1,3,1,1.0,8.0,-7.0,3
10359,10359,1993-94,1993,1994,Man United,Everton,Win,Away,1993-10-23,3,6,9,12,12,1,1,4,7,5,8,8,5,0,1.0,13.0,-12.0,3
10360,10360,1993-94,1993,1994,Man United,QPR,Win,Home,1993-10-30,3,6,9,12,15,6,9,10,11,0,0,2,4,1,1.0,5.0,-4.0,3
10361,10361,1993-94,1993,1994,Man United,Man City,Win,Away,1993-11-07,3,6,9,12,15,1,2,3,6,5,7,9,9,0,1.0,9.0,-8.0,4
10362,10362,1993-94,1993,1994,Man United,Wimbledon,Win,Home,1993-11-20,3,6,9,12,15,3,3,4,4,3,6,8,11,1,1.0,12.0,-11.0,4
10363,10363,1993-94,1993,1994,Man United,Ipswich,Draw,Home,1993-11-24,1,6,9,12,15,1,1,4,5,5,8,8,10,1,1.0,16.0,-15.0,4
10364,10364,1993-94,1993,1994,Man United,Coventry,Win,Away,1993-11-27,3,4,7,10,13,1,4,5,5,3,3,5,8,0,1.0,15.0,-14.0,4
10365,10365,1993-94,1993,1994,Man United,Norwich,Draw,Home,1993-12-04,1,4,7,10,13,1,4,5,6,3,3,5,7,1,1.0,3.0,-2.0,5
10366,10366,1993-94,1993,1994,Man United,Sheffield United,Win,Away,1993-12-07,3,4,5,8,11,4,4,4,4,0,1,4,7,0,1.0,14.0,-13.0,5
10367,10367,1993-94,1993,1994,Man United,Newcastle,Draw,Away,1993-12-11,1,4,7,8,11,3,6,9,12,1,1,-1,-1,0,1.0,21.0,-20.0,5
10368,10368,1993-94,1993,1994,Man United,Aston Villa,Win,Home,1993-12-19,3,4,5,8,9,1,2,2,2,3,3,6,7,1,1.0,2.0,-1.0,5
10369,10369,1993-94,1993,1994,Man United,Blackburn,Draw,Home,1993-12-26,1,4,7,8,11,6,9,9,12,-2,-2,-1,-1,1,1.0,4.0,-3.0,5
10370,10370,1993-94,1993,1994,Man United,Oldham,Win,Away,1993-12-29,3,4,5,8,9,1,1,4,5,3,4,4,4,0,1.0,19.0,-18.0,5
10371,10371,1993-94,1993,1994,Man United,Leeds,Draw,Home,1994-01-01,1,4,7,8,11,2,5,5,8,2,2,3,3,1,1.0,17.0,-16.0,6
10372,10372,1993-94,1993,1994,Man United,Liverpool,Draw,Away,1994-01-04,1,4,5,8,9,4,5,6,7,0,0,2,2,0,1.0,6.0,-5.0,6
10373,10373,1993-94,1993,1994,Man United,Tottenham,Win,Away,1994-01-15,3,2,5,6,9,0,3,3,4,2,2,3,5,0,1.0,8.0,-7.0,6
10374,10374,1993-94,1993,1994,Man United,Everton,Win,Home,1994-01-22,3,4,5,8,9,3,3,3,3,1,2,5,6,1,1.0,13.0,-12.0,6
10375,10375,1993-94,1993,1994,Man United,QPR,Win,Away,1994-02-05,3,6,7,8,11,3,4,4,5,3,3,4,6,0,1.0,5.0,-4.0,7
10376,10376,1993-94,1993,1994,Man United,West Ham,Draw,Away,1994-02-26,1,6,9,10,11,2,2,3,6,4,7,7,5,0,1.0,21.0,-20.0,7
10377,10377,1993-94,1993,1994,Man United,Chelsea,Loss,Home,1994-03-05,0,4,7,10,11,3,3,4,5,1,4,6,6,1,1.0,11.0,-10.0,8
10378,10378,1993-94,1993,1994,Man United,Sheffield Weds,Win,Home,1994-03-16,3,1,4,7,10,1,2,5,8,0,2,2,2,1,1.0,7.0,-6.0,8
10379,10379,1993-94,1993,1994,Man United,Swindon,Draw,Away,1994-03-19,1,3,4,7,10,1,1,2,2,2,3,5,8,0,1.0,21.0,-20.0,8
10380,10380,1993-94,1993,1994,Man United,Arsenal,Draw,Away,1994-03-22,1,4,4,5,8,6,9,10,11,-2,-5,-5,-3,0,1.0,10.0,-9.0,8
10381,10381,1993-94,1993,1994,Man United,Liverpool,Win,Home,1994-03-30,3,2,5,5,6,3,6,6,9,-1,-1,-1,-3,1,1.0,6.0,-5.0,8
10382,10382,1993-94,1993,1994,Man United,Blackburn,Loss,Away,1994-04-02,0,4,5,8,8,3,6,9,9,1,-1,-1,-1,0,1.0,4.0,-3.0,9
10383,10383,1993-94,1993,1994,Man United,Oldham,Win,Home,1994-04-04,3,3,4,5,8,6,7,10,10,-3,-3,-5,-2,1,1.0,19.0,-18.0,9
10384,10384,1993-94,1993,1994,Man United,Wimbledon,Loss,Away,1994-04-16,0,3,6,7,8,4,7,10,10,-1,-1,-3,-2,0,1.0,12.0,-11.0,9
10385,10385,1993-94,1993,1994,Man United,Man City,Win,Home,1994-04-23,3,3,3,6,7,4,7,10,11,-1,-4,-4,-4,1,1.0,9.0,-8.0,9
10386,10386,1993-94,1993,1994,Man United,Leeds,Win,Away,1994-04-27,3,3,6,6,9,4,7,8,8,-1,-1,-2,1,0,1.0,17.0,-16.0,9
10387,10387,1993-94,1993,1994,Man United,Ipswich,Win,Away,1994-05-01,3,6,6,9,9,1,1,1,1,5,5,8,8,0,1.0,16.0,-15.0,10
10388,10388,1993-94,1993,1994,Man United,Southampton,Win,Home,1994-05-04,3,6,9,9,12,3,6,9,9,3,3,0,3,1,1.0,18.0,-17.0,10
10389,10389,1993-94,1993,1994,Man United,Coventry,Draw,Home,1994-05-08,1,6,9,12,12,6,7,8,11,0,2,4,1,1,1.0,15.0,-14.0,10
10390,10390,1994-95,1994,1995,Man United,QPR,Win,Home,1994-08-20,3,4,7,10,13,4,4,5,6,0,3,5,7,1,1.0,9.0,-8.0,1
10391,10391,1994-95,1994,1995,Man United,Nott'm Forest,Draw,Away,1994-08-22,1,4,7,10,13,3,3,3,3,1,4,7,10,0,1.0,21.0,-20.0,1
10392,10392,1994-95,1994,1995,Man United,Tottenham,Win,Away,1994-08-27,3,4,5,8,11,6,6,9,9,-2,-1,-1,2,0,1.0,15.0,-14.0,1
10393,10393,1994-95,1994,1995,Man United,Wimbledon,Win,Home,1994-08-31,3,4,7,8,11,1,2,2,5,3,5,6,6,1,1.0,6.0,-5.0,1
10394,10394,1994-95,1994,1995,Man United,Leeds,Loss,Away,1994-09-11,0,6,7,10,11,3,6,7,10,3,1,3,1,0,1.0,5.0,-4.0,2
10395,10395,1994-95,1994,1995,Man United,Liverpool,Win,Home,1994-09-17,3,3,6,7,10,4,7,10,10,-1,-1,-3,0,1,1.0,8.0,-7.0,2
10396,10396,1994-95,1994,1995,Man United,Ipswich,Loss,Away,1994-09-24,0,3,6,9,10,0,0,3,4,3,6,6,6,0,1.0,19.0,-18.0,2
10397,10397,1994-95,1994,1995,Man United,Everton,Win,Home,1994-10-01,3,3,3,6,9,2,2,2,2,1,1,4,7,1,1.0,17.0,-16.0,3
10398,10398,1994-95,1994,1995,Man United,Sheffield Weds,Loss,Away,1994-10-08,0,3,6,6,9,1,2,2,3,2,4,4,6,0,1.0,7.0,-6.0,3
10399,10399,1994-95,1994,1995,Man United,West Ham,Win,Home,1994-10-15,3,3,3,6,6,6,6,9,10,-3,-3,-3,-4,1,1.0,13.0,-12.0,3
10400,10400,1994-95,1994,1995,Man United,Blackburn,Win,Away,1994-10-23,3,3,6,6,9,4,4,7,10,-1,2,-1,-1,0,1.0,2.0,-1.0,3
10401,10401,1994-95,1994,1995,Man United,Newcastle,Win,Home,1994-10-29,3,6,6,9,9,6,7,10,11,0,-1,-1,-2,1,1.0,3.0,-2.0,3
10402,10402,1994-95,1994,1995,Man United,Aston Villa,Win,Away,1994-11-06,3,6,9,9,12,0,1,1,1,6,8,8,11,0,1.0,10.0,-9.0,4
10403,10403,1994-95,1994,1995,Man United,Man City,Win,Home,1994-11-10,3,6,9,12,12,1,4,7,8,5,5,5,4,1,1.0,16.0,-15.0,4
10404,10404,1994-95,1994,1995,Man United,Crystal Palace,Win,Home,1994-11-19,3,6,9,12,15,6,9,12,12,0,0,0,3,1,1.0,21.0,-20.0,4
10405,10405,1994-95,1994,1995,Man United,Arsenal,Draw,Away,1994-11-26,1,6,9,12,15,0,1,2,5,6,8,10,10,0,1.0,4.0,-3.0,4
10406,10406,1994-95,1994,1995,Man United,Norwich,Win,Home,1994-12-03,3,4,7,10,13,3,4,5,5,1,3,5,8,1,1.0,12.0,-11.0,5
10407,10407,1994-95,1994,1995,Man United,QPR,Win,Away,1994-12-10,3,4,7,10,13,3,6,6,9,1,1,4,4,0,1.0,9.0,-8.0,5
10408,10408,1994-95,1994,1995,Man United,Nott'm Forest,Loss,Home,1994-12-17,0,6,7,10,13,4,4,4,5,2,3,6,8,1,1.0,21.0,-20.0,5
10409,10409,1994-95,1994,1995,Man United,Chelsea,Win,Away,1994-12-26,3,3,6,7,10,1,4,4,5,2,2,3,5,0,1.0,14.0,-13.0,5
10410,10410,1994-95,1994,1995,Man United,Leicester,Draw,Home,1994-12-28,1,3,6,9,10,1,1,2,2,2,5,7,8,1,1.0,21.0,-20.0,5
10411,10411,1994-95,1994,1995,Man United,Southampton,Draw,Away,1994-12-31,1,4,4,7,10,1,4,4,4,3,0,3,6,0,1.0,18.0,-17.0,5
10412,10412,1994-95,1994,1995,Man United,Coventry,Win,Home,1995-01-03,3,2,5,5,8,0,1,2,2,2,4,3,6,1,1.0,11.0,-10.0,6
10413,10413,1994-95,1994,1995,Man United,Newcastle,Draw,Away,1995-01-15,1,4,5,8,8,1,2,3,6,3,3,5,2,0,1.0,3.0,-2.0,6
10414,10414,1994-95,1994,1995,Man United,Blackburn,Win,Home,1995-01-22,3,4,5,6,9,6,9,12,13,-2,-4,-6,-4,1,1.0,2.0,-1.0,6
10415,10415,1994-95,1994,1995,Man United,Crystal Palace,Draw,Away,1995-01-25,1,4,7,8,9,3,3,3,4,1,4,5,5,0,1.0,21.0,-20.0,6
10416,10416,1994-95,1994,1995,Man United,Aston Villa,Win,Home,1995-02-04,3,4,5,8,9,6,9,10,11,-2,-4,-2,-2,1,1.0,10.0,-9.0,7
10417,10417,1994-95,1994,1995,Man United,Man City,Win,Away,1995-02-11,3,4,7,8,11,1,2,3,4,3,5,5,7,0,1.0,16.0,-15.0,7
10418,10418,1994-95,1994,1995,Man United,Norwich,Win,Away,1995-02-22,3,6,7,10,11,1,2,2,2,5,5,8,9,0,1.0,12.0,-11.0,7
10419,10419,1994-95,1994,1995,Man United,Everton,Loss,Away,1995-02-25,0,6,9,10,13,1,4,4,5,5,5,6,8,0,1.0,17.0,-16.0,7
10420,10420,1994-95,1994,1995,Man United,Ipswich,Win,Home,1995-03-04,3,3,6,9,10,3,3,3,3,0,3,6,7,1,1.0,19.0,-18.0,8
10421,10421,1994-95,1994,1995,Man United,Wimbledon,Win,Away,1995-03-07,3,3,6,9,12,3,3,3,4,0,3,6,8,0,1.0,6.0,-5.0,8
10422,10422,1994-95,1994,1995,Man United,Tottenham,Draw,Home,1995-03-15,1,6,6,9,12,4,4,5,8,2,2,4,4,1,1.0,15.0,-14.0,8
10423,10423,1994-95,1994,1995,Man United,Liverpool,Loss,Away,1995-03-19,0,4,7,7,10,3,6,7,8,1,1,0,2,0,1.0,8.0,-7.0,8
10424,10424,1994-95,1994,1995,Man United,Arsenal,Win,Home,1995-03-22,3,1,4,7,7,0,0,3,6,1,4,4,1,1,1.0,4.0,-3.0,8
10425,10425,1994-95,1994,1995,Man United,Leeds,Draw,Home,1995-04-02,1,3,4,7,10,3,6,9,9,0,-2,-2,1,1,1.0,5.0,-4.0,9
10426,10426,1994-95,1994,1995,Man United,Leicester,Win,Away,1995-04-15,3,4,4,5,8,3,3,3,3,1,1,2,5,0,1.0,21.0,-20.0,9
10427,10427,1994-95,1994,1995,Man United,Chelsea,Draw,Home,1995-04-17,1,4,7,7,8,3,4,5,5,1,3,2,3,1,1.0,14.0,-13.0,9
10428,10428,1994-95,1994,1995,Man United,Coventry,Win,Away,1995-05-01,3,4,5,8,8,3,3,3,6,1,2,5,2,0,1.0,11.0,-10.0,10
10429,10429,1994-95,1994,1995,Man United,Sheffield Weds,Win,Home,1995-05-07,3,4,7,8,11,2,2,5,5,2,5,3,6,1,1.0,7.0,-6.0,10
10430,10430,1994-95,1994,1995,Man United,Southampton,Win,Home,1995-05-10,3,6,7,10,11,4,5,8,11,2,2,2,0,1,1.0,18.0,-17.0,10
10431,10431,1994-95,1994,1995,Man United,West Ham,Draw,Away,1995-05-14,1,6,9,10,13,3,4,7,8,3,5,3,5,0,1.0,13.0,-12.0,10
10432,10432,1995-96,1995,1996,Man United,Aston Villa,Loss,Away,1995-08-19,0,4,7,10,11,4,5,5,5,0,2,5,6,0,2.0,18.0,-16.0,1
10433,10433,1995-96,1995,1996,Man United,West Ham,Win,Home,1995-08-23,3,1,4,7,10,1,4,4,5,0,0,3,5,1,2.0,14.0,-12.0,1
10434,10434,1995-96,1995,1996,Man United,Wimbledon,Win,Home,1995-08-26,3,3,4,7,10,6,7,8,9,-3,-3,-1,1,1,2.0,9.0,-7.0,1
10435,10435,1995-96,1995,1996,Man United,Blackburn,Win,Away,1995-08-28,3,6,6,7,10,0,3,3,6,6,3,4,4,0,2.0,1.0,1.0,1
10436,10436,1995-96,1995,1996,Man United,Everton,Win,Away,1995-09-09,3,6,9,9,10,6,6,7,8,0,3,2,2,0,2.0,15.0,-13.0,2
10437,10437,1995-96,1995,1996,Man United,Bolton,Win,Home,1995-09-16,3,6,9,12,12,1,4,4,4,5,5,8,8,1,2.0,21.0,-19.0,2
10438,10438,1995-96,1995,1996,Man United,Sheffield Weds,Draw,Away,1995-09-23,1,6,9,12,15,3,4,4,7,3,5,8,8,0,2.0,13.0,-11.0,2
10439,10439,1995-96,1995,1996,Man United,Liverpool,Draw,Home,1995-10-01,1,4,7,10,13,6,6,9,12,-2,1,1,1,1,2.0,4.0,-2.0,3
10440,10440,1995-96,1995,1996,Man United,Man City,Win,Home,1995-10-14,3,2,5,8,11,0,0,0,0,2,5,8,11,1,2.0,17.0,-15.0,3
10441,10441,1995-96,1995,1996,Man United,Chelsea,Win,Away,1995-10-21,3,4,5,8,11,6,6,9,12,-2,-1,-1,-1,0,2.0,11.0,-9.0,3
10442,10442,1995-96,1995,1996,Man United,Middlesbrough,Win,Home,1995-10-28,3,6,7,8,11,6,9,12,15,0,-2,-4,-4,1,2.0,21.0,-19.0,3
10443,10443,1995-96,1995,1996,Man United,Arsenal,Loss,Away,1995-11-04,0,6,9,10,11,3,6,6,9,3,3,4,2,0,2.0,12.0,-10.0,4
10444,10444,1995-96,1995,1996,Man United,Southampton,Win,Home,1995-11-18,3,3,6,9,10,6,6,6,7,-3,0,3,3,1,2.0,10.0,-8.0,4
10445,10445,1995-96,1995,1996,Man United,Coventry,Win,Away,1995-11-22,3,3,6,9,12,1,1,1,2,2,5,8,10,0,2.0,16.0,-14.0,4
10446,10446,1995-96,1995,1996,Man United,Nott'm Forest,Draw,Away,1995-11-27,1,6,6,9,12,3,4,7,10,3,2,2,2,0,2.0,3.0,-1.0,4
10447,10447,1995-96,1995,1996,Man United,Chelsea,Draw,Home,1995-12-02,1,4,7,7,10,4,4,5,5,0,3,2,5,1,2.0,11.0,-9.0,5
10448,10448,1995-96,1995,1996,Man United,Sheffield Weds,Draw,Home,1995-12-09,1,2,5,8,8,4,4,5,6,-2,1,3,2,1,2.0,13.0,-11.0,5
10449,10449,1995-96,1995,1996,Man United,Liverpool,Loss,Away,1995-12-17,0,2,3,6,9,4,4,5,5,-2,-1,1,4,0,2.0,4.0,-2.0,5
10450,10450,1995-96,1995,1996,Man United,Leeds,Loss,Away,1995-12-24,0,1,2,3,6,1,1,1,4,0,1,2,2,0,2.0,5.0,-3.0,5
10451,10451,1995-96,1995,1996,Man United,Newcastle,Win,Home,1995-12-27,3,0,1,2,3,6,6,7,10,-6,-5,-5,-7,1,2.0,6.0,-4.0,5
10452,10452,1995-96,1995,1996,Man United,QPR,Win,Home,1995-12-30,3,3,3,4,5,3,6,6,7,0,-3,-2,-2,1,2.0,8.0,-6.0,5
10453,10453,1995-96,1995,1996,Man United,Tottenham,Loss,Away,1996-01-01,0,6,6,6,7,1,2,5,8,5,4,1,-1,0,2.0,7.0,-5.0,6
10454,10454,1995-96,1995,1996,Man United,Aston Villa,Draw,Home,1996-01-13,1,3,6,6,6,3,6,7,8,0,0,-1,-2,1,2.0,18.0,-16.0,6
10455,10455,1995-96,1995,1996,Man United,West Ham,Win,Away,1996-01-23,3,1,4,7,7,0,0,3,3,1,4,4,4,0,2.0,14.0,-12.0,6
10456,10456,1995-96,1995,1996,Man United,Wimbledon,Win,Away,1996-02-03,3,4,4,7,10,3,3,6,9,1,1,1,1,0,2.0,9.0,-7.0,7
10457,10457,1995-96,1995,1996,Man United,Blackburn,Win,Home,1996-02-10,3,6,7,7,10,6,9,10,13,0,-2,-3,-3,1,2.0,1.0,1.0,7
10458,10458,1995-96,1995,1996,Man United,Everton,Win,Home,1996-02-21,3,6,9,10,10,4,7,8,11,2,2,2,-1,1,2.0,15.0,-13.0,7
10459,10459,1995-96,1995,1996,Man United,Bolton,Win,Away,1996-02-25,3,6,9,12,13,3,3,3,6,3,6,9,7,0,2.0,21.0,-19.0,7
10460,10460,1995-96,1995,1996,Man United,Newcastle,Win,Away,1996-03-04,3,6,9,12,15,1,4,7,10,5,5,5,5,0,2.0,6.0,-4.0,8
10461,10461,1995-96,1995,1996,Man United,QPR,Draw,Away,1996-03-16,1,6,9,12,15,0,1,4,4,6,8,8,11,0,2.0,8.0,-6.0,8
10462,10462,1995-96,1995,1996,Man United,Arsenal,Win,Home,1996-03-20,3,4,7,10,13,6,7,10,13,-2,0,0,0,1,2.0,12.0,-10.0,8
10463,10463,1995-96,1995,1996,Man United,Tottenham,Win,Home,1996-03-24,3,4,7,10,13,3,6,9,9,1,1,1,4,1,2.0,7.0,-5.0,8
10464,10464,1995-96,1995,1996,Man United,Man City,Win,Away,1996-04-06,3,6,7,10,13,1,4,5,5,5,3,5,8,0,2.0,17.0,-15.0,9
10465,10465,1995-96,1995,1996,Man United,Coventry,Win,Home,1996-04-08,3,6,9,10,13,3,3,3,4,3,6,7,9,1,2.0,16.0,-14.0,9
10466,10466,1995-96,1995,1996,Man United,Southampton,Loss,Away,1996-04-13,0,6,9,12,13,3,3,3,6,3,6,9,7,0,2.0,10.0,-8.0,9
10467,10467,1995-96,1995,1996,Man United,Leeds,Win,Home,1996-04-17,3,3,6,9,12,0,0,3,3,3,6,6,9,1,2.0,5.0,-3.0,9
10468,10468,1995-96,1995,1996,Man United,Nott'm Forest,Win,Home,1996-04-28,3,3,6,9,12,1,4,7,7,2,2,2,5,1,2.0,3.0,-1.0,9
10469,10469,1995-96,1995,1996,Man United,Middlesbrough,Win,Away,1996-05-04,3,6,6,9,12,0,1,4,7,6,5,5,5,0,2.0,21.0,-19.0,10
10470,10470,1996-97,1996,1997,Man United,Wimbledon,Win,Away,1996-08-17,3,6,9,9,12,1,1,4,7,5,8,5,5,0,1.0,14.0,-13.0,1
10471,10471,1996-97,1996,1997,Man United,Everton,Draw,Home,1996-08-21,1,6,9,12,12,6,9,10,10,0,0,2,2,1,1.0,6.0,-5.0,1
10472,10472,1996-97,1996,1997,Man United,Blackburn,Draw,Home,1996-08-25,1,4,7,10,13,0,3,4,7,4,4,6,6,1,1.0,7.0,-6.0,1
10473,10473,1996-97,1996,1997,Man United,Derby,Draw,Away,1996-09-04,1,2,5,8,11,1,2,2,2,1,3,6,9,0,1.0,21.0,-20.0,2
10474,10474,1996-97,1996,1997,Man United,Leeds,Win,Away,1996-09-07,3,2,3,6,9,6,6,7,8,-4,-3,-1,1,0,1.0,13.0,-12.0,2
10475,10475,1996-97,1996,1997,Man United,Nott'm Forest,Win,Home,1996-09-14,3,4,5,6,9,2,3,3,6,2,2,3,3,1,1.0,9.0,-8.0,2
10476,10476,1996-97,1996,1997,Man United,Aston Villa,Draw,Away,1996-09-21,1,6,7,8,9,2,5,8,11,4,2,0,-2,0,1.0,4.0,-3.0,2
10477,10477,1996-97,1996,1997,Man United,Tottenham,Win,Home,1996-09-29,3,4,7,8,9,3,3,3,4,1,4,5,5,1,1.0,8.0,-7.0,2
10478,10478,1996-97,1996,1997,Man United,Liverpool,Win,Home,1996-10-12,3,4,7,10,11,6,9,12,15,-2,-2,-2,-4,1,1.0,3.0,-2.0,3
10479,10479,1996-97,1996,1997,Man United,Newcastle,Loss,Away,1996-10-20,0,6,7,10,13,6,9,12,15,0,-2,-2,-2,0,1.0,2.0,-1.0,3
10480,10480,1996-97,1996,1997,Man United,Southampton,Loss,Away,1996-10-26,0,3,6,7,10,4,7,7,7,-1,-1,0,3,0,1.0,17.0,-16.0,3
10481,10481,1996-97,1996,1997,Man United,Chelsea,Loss,Home,1996-11-02,0,0,3,6,7,3,6,7,7,-3,-3,-1,0,1,1.0,11.0,-10.0,4
10482,10482,1996-97,1996,1997,Man United,Arsenal,Win,Home,1996-11-16,3,0,0,3,6,4,5,8,11,-4,-5,-5,-5,1,1.0,5.0,-4.0,4
10483,10483,1996-97,1996,1997,Man United,Middlesbrough,Draw,Away,1996-11-23,1,3,3,3,6,0,1,1,2,3,2,2,4,0,1.0,12.0,-11.0,4
10484,10484,1996-97,1996,1997,Man United,Leicester,Win,Home,1996-11-30,3,4,4,4,4,3,3,6,6,1,1,-2,-2,1,1.0,21.0,-20.0,4
10485,10485,1996-97,1996,1997,Man United,West Ham,Draw,Away,1996-12-08,1,4,7,7,7,1,2,3,3,3,5,4,4,0,1.0,10.0,-9.0,5
10486,10486,1996-97,1996,1997,Man United,Sheffield Weds,Draw,Away,1996-12-18,1,4,5,8,8,4,5,8,9,0,0,0,-1,0,1.0,15.0,-14.0,5
10487,10487,1996-97,1996,1997,Man United,Sunderland,Win,Home,1996-12-21,3,2,5,6,9,3,6,7,7,-1,-1,-1,2,1,1.0,21.0,-20.0,5
10488,10488,1996-97,1996,1997,Man United,Nott'm Forest,Win,Away,1996-12-26,3,4,5,8,9,3,4,4,5,1,1,4,4,0,1.0,9.0,-8.0,5
10489,10489,1996-97,1996,1997,Man United,Leeds,Win,Home,1996-12-28,3,6,7,8,11,1,2,3,6,5,5,5,5,1,1.0,13.0,-12.0,5
10490,10490,1996-97,1996,1997,Man United,Aston Villa,Draw,Home,1997-01-01,1,6,9,10,11,1,4,7,10,5,5,3,1,1,1.0,4.0,-3.0,6
10491,10491,1996-97,1996,1997,Man United,Tottenham,Win,Away,1997-01-12,3,4,7,10,11,3,4,5,8,1,3,5,3,0,1.0,8.0,-7.0,6
10492,10492,1996-97,1996,1997,Man United,Coventry,Win,Away,1997-01-18,3,4,7,10,13,1,4,7,10,3,3,3,3,0,1.0,16.0,-15.0,6
10493,10493,1996-97,1996,1997,Man United,Wimbledon,Win,Home,1997-01-29,3,6,7,10,13,1,4,4,7,5,3,6,6,1,1.0,14.0,-13.0,6
10494,10494,1996-97,1996,1997,Man United,Southampton,Win,Home,1997-02-01,3,6,9,10,13,4,4,4,7,2,5,6,6,1,1.0,17.0,-16.0,7
10495,10495,1996-97,1996,1997,Man United,Arsenal,Win,Away,1997-02-19,3,6,9,12,13,2,5,8,8,4,4,4,5,0,1.0,5.0,-4.0,7
10496,10496,1996-97,1996,1997,Man United,Chelsea,Draw,Away,1997-02-22,1,6,9,12,15,6,6,9,10,0,3,3,5,0,1.0,11.0,-10.0,7
10497,10497,1996-97,1996,1997,Man United,Coventry,Win,Home,1997-03-01,3,4,7,10,13,1,2,5,5,3,5,5,8,1,1.0,16.0,-15.0,8
10498,10498,1996-97,1996,1997,Man United,Sunderland,Loss,Away,1997-03-08,0,4,7,10,13,0,0,0,1,4,7,10,12,0,1.0,21.0,-20.0,8
10499,10499,1996-97,1996,1997,Man United,Sheffield Weds,Win,Home,1997-03-15,3,3,4,7,10,6,9,12,13,-3,-5,-5,-3,1,1.0,15.0,-14.0,8
10500,10500,1996-97,1996,1997,Man United,Everton,Win,Away,1997-03-22,3,3,6,7,10,3,4,4,5,0,2,3,5,0,1.0,6.0,-5.0,8
10501,10501,1996-97,1996,1997,Man United,Derby,Loss,Home,1997-04-05,0,6,6,9,10,3,3,6,6,3,3,3,4,1,1.0,21.0,-20.0,9
10502,10502,1996-97,1996,1997,Man United,Blackburn,Win,Away,1997-04-12,3,3,6,6,9,1,1,4,5,2,5,2,4,0,1.0,7.0,-6.0,9
10503,10503,1996-97,1996,1997,Man United,Liverpool,Win,Away,1997-04-19,3,3,6,9,9,4,4,7,8,-1,2,2,1,0,1.0,3.0,-2.0,9
10504,10504,1996-97,1996,1997,Man United,Leicester,Draw,Away,1997-05-03,1,6,6,9,12,0,0,1,2,6,6,8,10,0,1.0,21.0,-20.0,10
10505,10505,1996-97,1996,1997,Man United,Middlesbrough,Draw,Home,1997-05-05,1,4,7,7,10,3,3,4,5,1,4,3,5,1,1.0,12.0,-11.0,10
10506,10506,1996-97,1996,1997,Man United,Newcastle,Draw,Home,1997-05-08,1,2,5,8,8,4,7,10,11,-2,-2,-2,-3,1,1.0,2.0,-1.0,10
10507,10507,1996-97,1996,1997,Man United,West Ham,Win,Home,1997-05-11,3,2,3,6,9,4,7,8,8,-2,-4,-2,1,1,1.0,10.0,-9.0,10
10508,10508,1997-98,1997,1998,Man United,Tottenham,Win,Away,1997-08-10,3,4,5,6,9,0,3,4,4,4,2,2,5,0,1.0,10.0,-9.0,1
10509,10509,1997-98,1997,1998,Man United,Southampton,Win,Home,1997-08-13,3,6,7,8,9,0,3,6,7,6,4,2,2,1,1.0,16.0,-15.0,1
10510,10510,1997-98,1997,1998,Man United,Leicester,Draw,Away,1997-08-23,1,6,9,10,11,6,9,12,13,0,0,-2,-2,0,1.0,9.0,-8.0,1
10511,10511,1997-98,1997,1998,Man United,Everton,Win,Away,1997-08-27,3,4,7,10,11,3,3,3,4,1,4,7,7,0,1.0,15.0,-14.0,1
10512,10512,1997-98,1997,1998,Man United,Coventry,Win,Home,1997-08-30,3,4,7,10,13,2,2,5,8,2,5,5,5,1,1.0,17.0,-16.0,1
10513,10513,1997-98,1997,1998,Man United,West Ham,Win,Home,1997-09-13,3,6,7,10,13,4,4,7,10,2,3,3,3,1,1.0,14.0,-13.0,2
10514,10514,1997-98,1997,1998,Man United,Bolton,Draw,Away,1997-09-20,1,6,9,10,13,1,1,2,5,5,8,8,8,0,1.0,21.0,-20.0,2
10515,10515,1997-98,1997,1998,Man United,Chelsea,Draw,Home,1997-09-24,1,4,7,10,11,3,6,9,12,1,1,1,-1,1,1.0,6.0,-5.0,2
10516,10516,1997-98,1997,1998,Man United,Leeds,Loss,Away,1997-09-27,0,2,5,8,11,3,6,6,6,-1,-1,2,5,0,1.0,11.0,-10.0,2
10517,10517,1997-98,1997,1998,Man United,Crystal Palace,Win,Home,1997-10-04,3,1,2,5,8,2,5,5,5,-1,-3,0,3,1,1.0,21.0,-20.0,3
10518,10518,1997-98,1997,1998,Man United,Derby,Draw,Away,1997-10-18,1,3,4,5,8,6,9,9,12,-3,-5,-4,-4,0,1.0,12.0,-11.0,3
10519,10519,1997-98,1997,1998,Man United,Barnsley,Win,Home,1997-10-25,3,4,4,5,6,3,3,3,3,1,1,2,3,1,1.0,21.0,-20.0,3
10520,10520,1997-98,1997,1998,Man United,Sheffield Weds,Win,Home,1997-11-01,3,4,7,7,8,0,3,4,4,4,4,3,4,1,1.0,7.0,-6.0,4
10521,10521,1997-98,1997,1998,Man United,Arsenal,Loss,Away,1997-11-09,0,6,7,10,10,1,2,5,6,5,5,5,4,0,1.0,3.0,-2.0,4
10522,10522,1997-98,1997,1998,Man United,Wimbledon,Win,Away,1997-11-22,3,3,6,7,10,3,6,7,10,0,0,0,0,0,1.0,8.0,-7.0,4
10523,10523,1997-98,1997,1998,Man United,Blackburn,Win,Home,1997-11-30,3,3,6,9,10,6,7,8,11,-3,-1,1,-1,1,1.0,13.0,-12.0,4
10524,10524,1997-98,1997,1998,Man United,Liverpool,Win,Away,1997-12-06,3,6,6,9,12,3,6,7,10,3,0,2,2,0,1.0,4.0,-3.0,5
10525,10525,1997-98,1997,1998,Man United,Aston Villa,Win,Home,1997-12-15,3,6,9,9,12,3,6,7,7,3,3,2,5,1,1.0,5.0,-4.0,5
10526,10526,1997-98,1997,1998,Man United,Newcastle,Win,Away,1997-12-21,3,6,9,12,12,2,2,2,5,4,7,10,7,0,1.0,2.0,-1.0,5
10527,10527,1997-98,1997,1998,Man United,Everton,Win,Home,1997-12-26,3,6,9,12,15,4,5,5,5,2,4,7,10,1,1.0,15.0,-14.0,5
10528,10528,1997-98,1997,1998,Man United,Coventry,Loss,Away,1997-12-28,0,6,9,12,15,0,3,3,3,6,6,9,12,0,1.0,17.0,-16.0,5
10529,10529,1997-98,1997,1998,Man United,Tottenham,Win,Home,1998-01-10,3,3,6,9,12,1,4,4,4,2,2,5,8,1,1.0,10.0,-9.0,6
10530,10530,1997-98,1997,1998,Man United,Southampton,Loss,Away,1998-01-19,0,3,6,9,12,4,5,6,9,-1,1,3,3,0,1.0,16.0,-15.0,6
10531,10531,1997-98,1997,1998,Man United,Leicester,Loss,Home,1998-01-31,0,3,3,6,9,2,3,3,3,1,0,3,6,1,1.0,9.0,-8.0,6
10532,10532,1997-98,1997,1998,Man United,Bolton,Draw,Home,1998-02-07,1,0,3,3,6,0,1,1,2,0,2,2,4,1,1.0,21.0,-20.0,7
10533,10533,1997-98,1997,1998,Man United,Aston Villa,Win,Away,1998-02-18,3,1,1,4,4,3,3,4,5,-2,-2,0,-1,0,1.0,5.0,-4.0,7
10534,10534,1997-98,1997,1998,Man United,Derby,Win,Home,1998-02-21,3,4,4,4,7,3,6,7,10,1,-2,-3,-3,1,1.0,12.0,-11.0,7
10535,10535,1997-98,1997,1998,Man United,Chelsea,Win,Away,1998-02-28,3,6,7,7,7,0,3,3,6,6,4,4,1,0,1.0,6.0,-5.0,7
10536,10536,1997-98,1997,1998,Man United,Sheffield Weds,Loss,Away,1998-03-07,0,6,9,10,10,3,4,4,5,3,5,6,5,0,1.0,7.0,-6.0,8
10537,10537,1997-98,1997,1998,Man United,West Ham,Draw,Away,1998-03-11,1,3,6,9,10,2,5,6,6,1,1,3,4,0,1.0,14.0,-13.0,8
10538,10538,1997-98,1997,1998,Man United,Arsenal,Loss,Home,1998-03-14,0,1,4,7,10,4,7,10,13,-3,-3,-3,-3,1,1.0,3.0,-2.0,8
10539,10539,1997-98,1997,1998,Man United,Wimbledon,Win,Home,1998-03-28,3,1,1,4,7,3,3,6,9,-2,-2,-2,-2,1,1.0,8.0,-7.0,8
10540,10540,1997-98,1997,1998,Man United,Blackburn,Win,Away,1998-04-06,3,3,4,4,7,3,3,6,6,0,1,-2,1,0,1.0,13.0,-12.0,9
10541,10541,1997-98,1997,1998,Man United,Liverpool,Draw,Home,1998-04-10,1,6,6,7,7,4,7,7,8,2,-1,0,-1,1,1.0,4.0,-3.0,9
10542,10542,1997-98,1997,1998,Man United,Newcastle,Draw,Home,1998-04-18,1,4,7,7,8,3,4,4,4,1,3,3,4,1,1.0,2.0,-1.0,9
10543,10543,1997-98,1997,1998,Man United,Crystal Palace,Win,Away,1998-04-27,3,2,5,8,8,3,3,3,6,-1,2,5,2,0,1.0,21.0,-20.0,9
10544,10544,1997-98,1997,1998,Man United,Leeds,Win,Home,1998-05-04,3,4,5,8,11,4,4,7,10,0,1,1,1,1,1.0,11.0,-10.0,10
10545,10545,1997-98,1997,1998,Man United,Barnsley,Win,Away,1998-05-10,3,6,7,8,11,0,1,1,4,6,6,7,7,0,1.0,21.0,-20.0,10
10546,10546,1998-99,1998,1999,Man United,Leicester,Draw,Home,1998-08-15,1,6,9,10,11,3,4,7,8,3,5,3,3,1,2.0,10.0,-8.0,1
10547,10547,1998-99,1998,1999,Man United,West Ham,Draw,Away,1998-08-22,1,4,7,10,11,6,7,7,7,-2,0,3,4,0,2.0,8.0,-6.0,1
10548,10548,1998-99,1998,1999,Man United,Charlton,Win,Home,1998-09-09,3,2,5,8,11,4,5,5,5,-2,0,3,6,1,2.0,21.0,-19.0,2
10549,10549,1998-99,1998,1999,Man United,Coventry,Win,Home,1998-09-12,3,4,5,8,11,1,1,4,5,3,4,4,6,1,2.0,11.0,-9.0,2
10550,10550,1998-99,1998,1999,Man United,Arsenal,Loss,Away,1998-09-20,0,6,7,8,11,2,3,4,7,4,4,4,4,0,2.0,1.0,1.0,2
10551,10551,1998-99,1998,1999,Man United,Liverpool,Win,Home,1998-09-24,3,3,6,7,8,1,4,7,8,2,2,0,0,1,2.0,3.0,-1.0,2
10552,10552,1998-99,1998,1999,Man United,Southampton,Win,Away,1998-10-03,3,3,6,9,10,1,1,1,1,2,5,8,9,0,2.0,12.0,-10.0,3
10553,10553,1998-99,1998,1999,Man United,Wimbledon,Win,Home,1998-10-17,3,6,6,9,12,1,4,4,7,5,2,5,5,1,2.0,15.0,-13.0,3
10554,10554,1998-99,1998,1999,Man United,Derby,Draw,Away,1998-10-24,1,6,9,9,12,0,0,3,6,6,9,6,6,0,2.0,9.0,-7.0,3
10555,10555,1998-99,1998,1999,Man United,Everton,Win,Away,1998-10-31,3,4,7,10,10,2,5,6,7,2,2,4,3,0,2.0,17.0,-15.0,3
10556,10556,1998-99,1998,1999,Man United,Newcastle,Draw,Home,1998-11-08,1,4,7,10,13,0,3,3,6,4,4,7,7,1,2.0,13.0,-11.0,4
10557,10557,1998-99,1998,1999,Man United,Blackburn,Win,Home,1998-11-14,3,4,5,8,11,1,1,1,4,3,4,7,7,1,2.0,6.0,-4.0,4
10558,10558,1998-99,1998,1999,Man United,Sheffield Weds,Loss,Away,1998-11-21,0,4,7,8,11,1,2,3,3,3,5,5,8,0,2.0,16.0,-14.0,4
10559,10559,1998-99,1998,1999,Man United,Leeds,Win,Home,1998-11-29,3,3,4,7,8,6,9,10,11,-3,-5,-3,-3,1,2.0,5.0,-3.0,4
10560,10560,1998-99,1998,1999,Man United,Aston Villa,Draw,Away,1998-12-05,1,3,6,7,10,1,4,7,8,2,2,0,2,0,2.0,7.0,-5.0,5
10561,10561,1998-99,1998,1999,Man United,Tottenham,Draw,Away,1998-12-12,1,4,4,7,8,3,6,7,7,1,-2,0,1,0,2.0,14.0,-12.0,5
10562,10562,1998-99,1998,1999,Man United,Chelsea,Draw,Home,1998-12-16,1,2,5,5,8,4,5,6,9,-2,0,-1,-1,1,2.0,4.0,-2.0,5
10563,10563,1998-99,1998,1999,Man United,Middlesbrough,Loss,Home,1998-12-19,0,2,3,6,6,4,5,8,9,-2,-2,-2,-3,1,2.0,21.0,-19.0,5
10564,10564,1998-99,1998,1999,Man United,Nott'm Forest,Win,Home,1998-12-26,3,1,2,3,6,1,1,2,2,0,1,1,4,1,2.0,21.0,-19.0,5
10565,10565,1998-99,1998,1999,Man United,Chelsea,Draw,Away,1998-12-29,1,3,4,5,6,6,7,8,11,-3,-3,-3,-5,0,2.0,4.0,-2.0,5
10566,10566,1998-99,1998,1999,Man United,West Ham,Win,Home,1999-01-10,3,4,4,5,6,3,6,6,6,1,-2,-1,0,1,2.0,8.0,-6.0,6
10567,10567,1998-99,1998,1999,Man United,Leicester,Win,Away,1999-01-16,3,4,7,7,8,2,5,5,8,2,2,2,0,0,2.0,10.0,-8.0,6
10568,10568,1998-99,1998,1999,Man United,Charlton,Win,Away,1999-01-31,3,6,7,10,10,1,1,1,1,5,6,9,9,0,2.0,21.0,-19.0,6
10569,10569,1998-99,1998,1999,Man United,Derby,Win,Home,1999-02-02,3,6,9,10,13,6,6,9,10,0,3,1,3,1,2.0,9.0,-7.0,7
10570,10570,1998-99,1998,1999,Man United,Nott'm Forest,Win,Away,1999-02-06,3,6,9,12,13,3,3,4,4,3,6,8,9,0,2.0,21.0,-19.0,7
10571,10571,1998-99,1998,1999,Man United,Arsenal,Draw,Home,1999-02-17,1,6,9,12,15,6,9,10,13,0,0,2,2,1,2.0,1.0,1.0,7
10572,10572,1998-99,1998,1999,Man United,Coventry,Win,Away,1999-02-20,3,4,7,10,13,1,4,4,7,3,3,6,6,0,2.0,11.0,-9.0,7
10573,10573,1998-99,1998,1999,Man United,Southampton,Win,Home,1999-02-27,3,4,7,10,13,3,6,6,9,1,1,4,4,1,2.0,12.0,-10.0,7
10574,10574,1998-99,1998,1999,Man United,Newcastle,Win,Away,1999-03-13,3,6,7,10,13,4,4,7,10,2,3,3,3,0,2.0,13.0,-11.0,8
10575,10575,1998-99,1998,1999,Man United,Everton,Win,Home,1999-03-21,3,6,9,10,13,3,4,4,7,3,5,6,6,1,2.0,17.0,-15.0,8
10576,10576,1998-99,1998,1999,Man United,Wimbledon,Draw,Away,1999-04-03,1,6,9,12,13,0,0,3,4,6,9,9,9,0,2.0,15.0,-13.0,9
10577,10577,1998-99,1998,1999,Man United,Sheffield Weds,Win,Home,1999-04-17,3,4,7,10,13,3,3,3,3,1,4,7,10,1,2.0,16.0,-14.0,9
10578,10578,1998-99,1998,1999,Man United,Leeds,Draw,Away,1999-04-25,1,4,7,10,13,2,5,8,11,2,2,2,2,0,2.0,5.0,-3.0,9
10579,10579,1998-99,1998,1999,Man United,Aston Villa,Win,Home,1999-05-01,3,4,5,8,11,6,9,10,11,-2,-4,-2,0,1,2.0,7.0,-5.0,10
10580,10580,1998-99,1998,1999,Man United,Liverpool,Draw,Away,1999-05-05,1,4,7,8,11,6,6,6,7,-2,1,2,4,0,2.0,3.0,-1.0,10
10581,10581,1998-99,1998,1999,Man United,Middlesbrough,Win,Away,1999-05-09,3,4,5,8,9,1,4,5,8,3,1,3,1,0,2.0,21.0,-19.0,10
10582,10582,1998-99,1998,1999,Man United,Blackburn,Draw,Away,1999-05-12,1,4,7,8,11,1,1,2,2,3,6,6,9,0,2.0,6.0,-4.0,10
10583,10583,1998-99,1998,1999,Man United,Tottenham,Win,Home,1999-05-16,3,4,5,8,9,1,1,1,4,3,4,7,5,1,2.0,14.0,-12.0,10
10584,10584,1999-00,1999,2000,Man United,Everton,Draw,Away,1999-08-08,1,4,7,8,11,3,3,6,9,1,4,2,2,0,1.0,14.0,-13.0,1
10585,10585,1999-00,1999,2000,Man United,Sheffield Weds,Win,Home,1999-08-11,3,4,5,8,9,3,6,6,7,1,-1,2,2,1,1.0,12.0,-11.0,1
10586,10586,1999-00,1999,2000,Man United,Leeds,Win,Home,1999-08-14,3,4,7,8,11,4,5,8,8,0,2,0,3,1,1.0,4.0,-3.0,1
10587,10587,1999-00,1999,2000,Man United,Arsenal,Win,Away,1999-08-22,3,6,7,10,11,4,7,10,10,2,0,0,1,0,1.0,2.0,-1.0,1
10588,10588,1999-00,1999,2000,Man United,Coventry,Win,Away,1999-08-25,3,6,9,10,13,4,4,4,5,2,5,6,8,0,1.0,15.0,-14.0,1
10589,10589,1999-00,1999,2000,Man United,Newcastle,Win,Home,1999-08-30,3,6,9,12,13,1,1,1,1,5,8,11,12,1,1.0,13.0,-12.0,1
10590,10590,1999-00,1999,2000,Man United,Liverpool,Win,Away,1999-09-11,3,6,9,12,15,6,6,6,9,0,3,6,6,0,1.0,7.0,-6.0,2
10591,10591,1999-00,1999,2000,Man United,Wimbledon,Draw,Home,1999-09-18,1,6,9,12,15,1,1,2,3,5,8,10,12,1,1.0,16.0,-15.0,2
10592,10592,1999-00,1999,2000,Man United,Southampton,Draw,Home,1999-09-25,1,4,7,10,13,0,3,3,6,4,4,7,7,1,1.0,17.0,-16.0,2
10593,10593,1999-00,1999,2000,Man United,Chelsea,Loss,Away,1999-10-03,0,2,5,8,11,3,6,9,12,-1,-1,-1,-1,0,1.0,3.0,-2.0,3
10594,10594,1999-00,1999,2000,Man United,Watford,Win,Home,1999-10-16,3,1,2,5,8,0,3,3,3,1,-1,2,5,1,1.0,21.0,-20.0,3
10595,10595,1999-00,1999,2000,Man United,Tottenham,Loss,Away,1999-10-23,0,3,4,5,8,3,4,7,8,0,0,-2,0,0,1.0,11.0,-10.0,3
10596,10596,1999-00,1999,2000,Man United,Aston Villa,Win,Home,1999-10-30,3,3,3,4,5,1,2,2,5,2,1,2,0,1,1.0,6.0,-5.0,3
10597,10597,1999-00,1999,2000,Man United,Leicester,Win,Home,1999-11-06,3,3,6,6,7,3,6,9,12,0,0,-3,-5,1,1.0,10.0,-9.0,4
10598,10598,1999-00,1999,2000,Man United,Derby,Win,Away,1999-11-20,3,6,6,9,9,3,3,3,4,3,3,6,5,0,1.0,8.0,-7.0,4
10599,10599,1999-00,1999,2000,Man United,Everton,Win,Home,1999-12-04,3,6,9,9,12,2,3,3,4,4,6,6,8,1,1.0,14.0,-13.0,5
10600,10600,1999-00,1999,2000,Man United,West Ham,Win,Away,1999-12-18,3,6,9,12,12,4,7,8,8,2,2,4,4,0,1.0,5.0,-4.0,5
10601,10601,1999-00,1999,2000,Man United,Bradford,Win,Home,1999-12-26,3,6,9,12,15,4,4,4,5,2,5,8,10,1,1.0,21.0,-20.0,5
10602,10602,1999-00,1999,2000,Man United,Sunderland,Draw,Away,1999-12-28,1,6,9,12,15,3,6,9,9,3,3,3,6,0,1.0,21.0,-20.0,5
10603,10603,1999-00,1999,2000,Man United,Arsenal,Draw,Home,2000-01-24,1,4,7,10,13,4,7,7,8,0,0,3,5,1,1.0,2.0,-1.0,6
10604,10604,1999-00,1999,2000,Man United,Middlesbrough,Win,Home,2000-01-29,3,2,5,8,11,1,1,4,5,1,4,4,6,1,1.0,9.0,-8.0,6
10605,10605,1999-00,1999,2000,Man United,Sheffield Weds,Win,Away,2000-02-02,3,4,5,8,11,6,7,7,10,-2,-2,1,1,0,1.0,12.0,-11.0,7
10606,10606,1999-00,1999,2000,Man United,Coventry,Win,Home,2000-02-05,3,6,7,8,11,4,5,8,8,2,2,0,3,1,1.0,15.0,-14.0,7
10607,10607,1999-00,1999,2000,Man United,Newcastle,Loss,Away,2000-02-12,0,6,9,10,11,1,4,5,8,5,5,5,3,0,1.0,13.0,-12.0,7
10608,10608,1999-00,1999,2000,Man United,Leeds,Win,Away,2000-02-20,3,3,6,9,10,3,6,6,6,0,0,3,4,0,1.0,4.0,-3.0,7
10609,10609,1999-00,1999,2000,Man United,Wimbledon,Draw,Away,2000-02-26,1,3,6,9,12,0,3,3,6,3,3,6,6,0,1.0,16.0,-15.0,7
10610,10610,1999-00,1999,2000,Man United,Liverpool,Draw,Home,2000-03-04,1,4,4,7,10,6,7,10,10,-2,-3,-3,0,1,1.0,7.0,-6.0,8
10611,10611,1999-00,1999,2000,Man United,Derby,Win,Home,2000-03-11,3,2,5,5,8,4,4,5,6,-2,1,0,2,1,1.0,8.0,-7.0,8
10612,10612,1999-00,1999,2000,Man United,Leicester,Win,Away,2000-03-18,3,4,5,8,8,3,4,7,7,1,1,1,1,0,1.0,10.0,-9.0,8
10613,10613,1999-00,1999,2000,Man United,Bradford,Win,Away,2000-03-25,3,6,7,8,11,0,1,2,2,6,6,6,9,0,1.0,21.0,-20.0,8
10614,10614,1999-00,1999,2000,Man United,West Ham,Win,Home,2000-04-01,3,6,9,10,11,4,4,7,10,2,5,3,1,1,1.0,5.0,-4.0,9
10615,10615,1999-00,1999,2000,Man United,Middlesbrough,Win,Away,2000-04-10,3,6,9,12,13,6,7,10,11,0,2,2,2,0,1.0,9.0,-8.0,9
10616,10616,1999-00,1999,2000,Man United,Sunderland,Win,Home,2000-04-15,3,6,9,12,15,6,9,10,11,0,0,2,4,1,1.0,21.0,-20.0,9
10617,10617,1999-00,1999,2000,Man United,Southampton,Win,Away,2000-04-22,3,6,9,12,15,6,6,7,10,0,3,5,5,0,1.0,17.0,-16.0,9
10618,10618,1999-00,1999,2000,Man United,Chelsea,Win,Home,2000-04-24,3,6,9,12,15,1,4,7,8,5,5,5,7,1,1.0,3.0,-2.0,9
10619,10619,1999-00,1999,2000,Man United,Watford,Win,Away,2000-04-29,3,6,9,12,15,0,1,1,2,6,8,11,13,0,1.0,21.0,-20.0,9
10620,10620,1999-00,1999,2000,Man United,Tottenham,Win,Home,2000-05-06,3,6,9,12,15,4,7,7,7,2,2,5,8,1,1.0,11.0,-10.0,10
10621,10621,1999-00,1999,2000,Man United,Aston Villa,Win,Away,2000-05-14,3,6,9,12,15,2,3,6,9,4,6,6,6,0,1.0,6.0,-5.0,10
10622,10622,2000-01,2000,2001,Man United,Newcastle,Win,Home,2000-08-20,3,6,9,12,15,4,5,8,9,2,4,4,6,1,1.0,11.0,-10.0,1
10623,10623,2000-01,2000,2001,Man United,Ipswich,Draw,Away,2000-08-22,1,6,9,12,15,0,0,3,3,6,9,9,12,0,1.0,21.0,-20.0,1
10624,10624,2000-01,2000,2001,Man United,West Ham,Draw,Away,2000-08-26,1,4,7,10,13,0,1,1,1,4,6,9,12,0,1.0,9.0,-8.0,1
10625,10625,2000-01,2000,2001,Man United,Bradford,Win,Home,2000-09-05,3,2,5,8,11,4,4,7,7,-2,1,1,4,1,1.0,17.0,-16.0,2
10626,10626,2000-01,2000,2001,Man United,Sunderland,Win,Home,2000-09-09,3,4,5,8,11,1,1,4,4,3,4,4,7,1,1.0,7.0,-6.0,2
10627,10627,2000-01,2000,2001,Man United,Everton,Win,Away,2000-09-16,3,6,7,8,11,3,4,7,7,3,3,1,4,0,1.0,13.0,-12.0,2
10628,10628,2000-01,2000,2001,Man United,Chelsea,Draw,Home,2000-09-23,1,6,9,10,11,1,2,3,3,5,7,7,8,1,1.0,5.0,-4.0,2
10629,10629,2000-01,2000,2001,Man United,Arsenal,Loss,Away,2000-10-01,0,4,7,10,11,4,5,6,9,0,2,4,2,0,1.0,2.0,-1.0,3
10630,10630,2000-01,2000,2001,Man United,Leicester,Win,Away,2000-10-14,3,1,4,7,10,2,5,8,11,-1,-1,-1,-1,0,1.0,8.0,-7.0,3
10631,10631,2000-01,2000,2001,Man United,Leeds,Win,Home,2000-10-21,3,3,4,7,10,6,7,7,8,-3,-3,0,2,1,1.0,3.0,-2.0,3
10632,10632,2000-01,2000,2001,Man United,Southampton,Win,Home,2000-10-28,3,6,6,7,10,1,1,4,7,5,5,3,3,1,1.0,15.0,-14.0,3
10633,10633,2000-01,2000,2001,Man United,Coventry,Win,Away,2000-11-04,3,6,9,9,10,0,3,4,4,6,6,5,6,0,1.0,14.0,-13.0,4
10634,10634,2000-01,2000,2001,Man United,Middlesbrough,Win,Home,2000-11-11,3,6,9,12,12,0,0,0,3,6,9,12,9,1,1.0,12.0,-11.0,4
10635,10635,2000-01,2000,2001,Man United,Man City,Win,Away,2000-11-18,3,6,9,12,15,0,0,3,6,6,9,9,9,0,1.0,21.0,-20.0,4
10636,10636,2000-01,2000,2001,Man United,Derby,Win,Away,2000-11-25,3,6,9,12,15,4,5,5,5,2,4,7,10,0,1.0,16.0,-15.0,4
10637,10637,2000-01,2000,2001,Man United,Tottenham,Win,Home,2000-12-02,3,6,9,12,15,6,6,9,9,0,3,3,6,1,1.0,10.0,-9.0,5
10638,10638,2000-01,2000,2001,Man United,Charlton,Draw,Away,2000-12-09,1,6,9,12,15,0,3,3,6,6,6,9,9,0,1.0,21.0,-20.0,5
10639,10639,2000-01,2000,2001,Man United,Liverpool,Loss,Home,2000-12-17,0,4,7,10,13,3,3,3,6,1,4,7,7,1,1.0,4.0,-3.0,5
10640,10640,2000-01,2000,2001,Man United,Ipswich,Win,Home,2000-12-23,3,1,4,7,10,6,6,9,12,-5,-2,-2,-2,1,1.0,21.0,-20.0,5
10641,10641,2000-01,2000,2001,Man United,Aston Villa,Win,Away,2000-12-26,3,3,4,7,10,4,5,6,7,-1,-1,1,3,0,1.0,6.0,-5.0,5
10642,10642,2000-01,2000,2001,Man United,Newcastle,Draw,Away,2000-12-30,1,6,6,7,10,3,6,6,7,3,0,1,3,0,1.0,11.0,-10.0,5
10643,10643,2000-01,2000,2001,Man United,West Ham,Win,Home,2001-01-01,3,4,7,7,8,3,4,5,8,1,3,2,0,1,1.0,9.0,-8.0,6
10644,10644,2000-01,2000,2001,Man United,Bradford,Win,Away,2001-01-13,3,4,7,10,10,3,3,3,4,1,4,7,6,0,1.0,17.0,-16.0,6
10645,10645,2000-01,2000,2001,Man United,Aston Villa,Win,Home,2001-01-20,3,6,7,10,13,0,0,3,4,6,7,7,9,1,1.0,6.0,-5.0,6
10646,10646,2000-01,2000,2001,Man United,Sunderland,Win,Away,2001-01-31,3,6,9,10,13,4,7,8,11,2,2,2,2,0,1.0,7.0,-6.0,6
10647,10647,2000-01,2000,2001,Man United,Everton,Win,Home,2001-02-03,3,6,9,12,13,4,5,5,5,2,4,7,8,1,1.0,13.0,-12.0,7
10648,10648,2000-01,2000,2001,Man United,Chelsea,Draw,Away,2001-02-10,1,6,9,12,15,3,6,7,10,3,3,5,5,0,1.0,5.0,-4.0,7
10649,10649,2000-01,2000,2001,Man United,Arsenal,Win,Home,2001-02-25,3,4,7,10,13,6,9,10,11,-2,-2,0,2,1,1.0,2.0,-1.0,7
10650,10650,2000-01,2000,2001,Man United,Leeds,Draw,Away,2001-03-03,1,4,7,10,13,4,5,8,11,0,2,2,2,0,1.0,3.0,-2.0,8
10651,10651,2000-01,2000,2001,Man United,Leicester,Win,Home,2001-03-17,3,4,5,8,11,6,6,9,9,-2,-1,-1,2,1,1.0,8.0,-7.0,8
10652,10652,2000-01,2000,2001,Man United,Liverpool,Loss,Away,2001-03-31,0,4,7,8,11,1,2,5,6,3,5,3,5,0,1.0,4.0,-3.0,8
10653,10653,2000-01,2000,2001,Man United,Charlton,Win,Home,2001-04-10,3,3,4,7,8,3,4,5,8,0,0,2,0,1,1.0,21.0,-20.0,9
10654,10654,2000-01,2000,2001,Man United,Coventry,Win,Home,2001-04-14,3,3,6,7,10,6,6,7,8,-3,0,0,2,1,1.0,14.0,-13.0,9
10655,10655,2000-01,2000,2001,Man United,Man City,Draw,Home,2001-04-21,1,6,6,9,10,3,3,3,4,3,3,6,6,1,1.0,21.0,-20.0,9
10656,10656,2000-01,2000,2001,Man United,Middlesbrough,Win,Away,2001-04-28,3,4,7,7,10,3,6,7,7,1,1,0,3,0,1.0,12.0,-11.0,9
10657,10657,2000-01,2000,2001,Man United,Derby,Loss,Home,2001-05-05,0,4,7,10,10,0,3,3,3,4,4,7,7,1,1.0,16.0,-15.0,10
10658,10658,2000-01,2000,2001,Man United,Southampton,Loss,Away,2001-05-13,0,3,4,7,10,1,1,2,2,2,3,5,8,0,1.0,15.0,-14.0,10
10659,10659,2000-01,2000,2001,Man United,Tottenham,Loss,Away,2001-05-19,0,0,3,4,7,1,1,1,4,-1,2,3,3,0,1.0,10.0,-9.0,10
10660,10660,2001-02,2001,2002,Man United,Fulham,Win,Home,2001-08-19,3,0,0,3,4,0,0,0,0,0,0,3,4,1,1.0,21.0,-20.0,1
10661,10661,2001-02,2001,2002,Man United,Blackburn,Draw,Away,2001-08-22,1,3,3,3,6,1,2,2,3,2,1,1,3,0,1.0,21.0,-20.0,1
10662,10662,2001-02,2001,2002,Man United,Aston Villa,Draw,Away,2001-08-26,1,4,4,4,4,1,4,5,6,3,0,-1,-2,0,1.0,8.0,-7.0,1
10663,10663,2001-02,2001,2002,Man United,Everton,Win,Home,2001-09-08,3,2,5,5,5,4,7,8,8,-2,-2,-3,-3,1,1.0,16.0,-15.0,2
10664,10664,2001-02,2001,2002,Man United,Newcastle,Loss,Away,2001-09-15,0,4,5,8,8,4,5,8,9,0,0,0,-1,0,1.0,11.0,-10.0,2
10665,10665,2001-02,2001,2002,Man United,Ipswich,Win,Home,2001-09-22,3,3,4,5,8,2,2,5,5,1,2,0,3,1,1.0,5.0,-4.0,2
10666,10666,2001-02,2001,2002,Man United,Tottenham,Win,Away,2001-09-29,3,3,6,7,8,3,3,6,6,0,3,1,2,0,1.0,12.0,-11.0,2
10667,10667,2001-02,2001,2002,Man United,Sunderland,Win,Away,2001-10-13,3,6,6,9,10,4,4,5,8,2,2,4,2,0,1.0,7.0,-6.0,3
10668,10668,2001-02,2001,2002,Man United,Bolton,Loss,Home,2001-10-20,0,6,9,9,12,0,1,2,2,6,8,7,10,1,1.0,21.0,-20.0,3
10669,10669,2001-02,2001,2002,Man United,Leeds,Draw,Home,2001-10-27,1,3,6,9,9,2,5,8,11,1,1,1,-2,1,1.0,4.0,-3.0,3
10670,10670,2001-02,2001,2002,Man United,Liverpool,Loss,Away,2001-11-04,0,1,4,7,10,6,7,10,13,-5,-3,-3,-3,0,1.0,3.0,-2.0,4
10671,10671,2001-02,2001,2002,Man United,Leicester,Win,Home,2001-11-17,3,1,1,4,7,4,4,4,4,-3,-3,0,3,1,1.0,13.0,-12.0,4
10672,10672,2001-02,2001,2002,Man United,Arsenal,Loss,Away,2001-11-25,0,3,4,4,7,1,2,3,6,2,2,1,1,0,1.0,2.0,-1.0,4
10673,10673,2001-02,2001,2002,Man United,Chelsea,Loss,Home,2001-12-01,0,3,3,4,4,2,5,6,6,1,-2,-2,-2,1,1.0,6.0,-5.0,5
10674,10674,2001-02,2001,2002,Man United,West Ham,Loss,Home,2001-12-08,0,0,3,3,4,1,1,2,2,-1,2,1,2,1,1.0,15.0,-14.0,5
10675,10675,2001-02,2001,2002,Man United,Derby,Win,Home,2001-12-12,3,0,0,3,3,3,3,6,6,-3,-3,-3,-3,1,1.0,17.0,-16.0,5
10676,10676,2001-02,2001,2002,Man United,Middlesbrough,Win,Away,2001-12-15,3,3,3,3,6,3,4,5,8,0,-1,-2,-2,0,1.0,14.0,-13.0,5
10677,10677,2001-02,2001,2002,Man United,Southampton,Win,Home,2001-12-22,3,6,6,6,6,6,6,9,9,0,0,-3,-3,1,1.0,10.0,-9.0,5
10678,10678,2001-02,2001,2002,Man United,Everton,Win,Away,2001-12-26,3,6,9,9,9,0,3,3,6,6,6,6,3,0,1.0,16.0,-15.0,5
10679,10679,2001-02,2001,2002,Man United,Fulham,Win,Away,2001-12-30,3,6,9,12,12,1,2,5,6,5,7,7,6,0,1.0,21.0,-20.0,5
10680,10680,2001-02,2001,2002,Man United,Newcastle,Win,Home,2002-01-02,3,6,9,12,15,3,6,9,12,3,3,3,3,1,1.0,11.0,-10.0,6
10681,10681,2001-02,2001,2002,Man United,Southampton,Win,Away,2002-01-13,3,6,9,12,15,6,6,9,9,0,3,3,6,0,1.0,10.0,-9.0,6
10682,10682,2001-02,2001,2002,Man United,Blackburn,Win,Home,2002-01-19,3,6,9,12,15,3,3,3,6,3,6,9,9,1,1.0,21.0,-20.0,6
10683,10683,2001-02,2001,2002,Man United,Liverpool,Loss,Home,2002-01-22,0,6,9,12,15,2,2,3,4,4,7,9,11,1,1.0,3.0,-2.0,6
10684,10684,2001-02,2001,2002,Man United,Bolton,Win,Away,2002-01-29,3,3,6,9,12,2,3,4,4,1,3,5,8,0,1.0,21.0,-20.0,6
10685,10685,2001-02,2001,2002,Man United,Sunderland,Win,Home,2002-02-02,3,3,6,9,12,1,1,2,2,2,5,7,10,1,1.0,7.0,-6.0,7
10686,10686,2001-02,2001,2002,Man United,Charlton,Win,Away,2002-02-10,3,6,6,9,12,4,4,4,7,2,2,5,5,0,1.0,9.0,-8.0,7
10687,10687,2001-02,2001,2002,Man United,Aston Villa,Win,Home,2002-02-23,3,6,9,9,12,2,3,6,9,4,6,3,3,1,1.0,8.0,-7.0,7
10688,10688,2001-02,2001,2002,Man United,Derby,Draw,Away,2002-03-03,1,6,9,12,12,3,6,6,6,3,3,6,6,0,1.0,17.0,-16.0,8
10689,10689,2001-02,2001,2002,Man United,Tottenham,Win,Home,2002-03-06,3,4,7,10,13,6,6,6,7,-2,1,4,6,1,1.0,12.0,-11.0,8
10690,10690,2001-02,2001,2002,Man United,West Ham,Win,Away,2002-03-16,3,4,7,10,13,3,6,6,9,1,1,4,4,0,1.0,15.0,-14.0,8
10691,10691,2001-02,2001,2002,Man United,Middlesbrough,Loss,Home,2002-03-23,0,6,7,10,13,1,4,4,7,5,3,6,6,1,1.0,14.0,-13.0,8
10692,10692,2001-02,2001,2002,Man United,Leeds,Win,Away,2002-03-30,3,3,6,7,10,6,9,10,11,-3,-3,-3,-1,0,1.0,4.0,-3.0,8
10693,10693,2001-02,2001,2002,Man United,Leicester,Win,Away,2002-04-06,3,3,6,9,10,3,3,4,5,0,3,5,5,0,1.0,13.0,-12.0,9
10694,10694,2001-02,2001,2002,Man United,Chelsea,Win,Away,2002-04-20,3,6,6,9,12,4,5,8,8,2,1,1,4,0,1.0,6.0,-5.0,9
10695,10695,2001-02,2001,2002,Man United,Ipswich,Win,Away,2002-04-27,3,6,9,9,12,3,3,4,4,3,6,5,8,0,1.0,5.0,-4.0,9
10696,10696,2001-02,2001,2002,Man United,Arsenal,Loss,Home,2002-05-08,0,6,9,12,12,6,9,12,15,0,0,0,-3,1,1.0,2.0,-1.0,10
10697,10697,2001-02,2001,2002,Man United,Charlton,Draw,Home,2002-05-11,1,3,6,9,12,1,2,2,2,2,4,7,10,1,1.0,9.0,-8.0,10
10698,10698,2002-03,2002,2003,Man United,West Brom,Win,Home,2002-08-17,3,1,4,7,10,0,0,0,0,1,4,7,10,1,3.0,21.0,-18.0,1
10699,10699,2002-03,2002,2003,Man United,Chelsea,Draw,Away,2002-08-23,1,4,4,7,10,3,6,6,7,1,-2,1,3,0,3.0,6.0,-3.0,1
10700,10700,2002-03,2002,2003,Man United,Sunderland,Draw,Away,2002-08-31,1,4,5,5,8,3,4,5,6,1,1,0,2,0,3.0,17.0,-14.0,1
10701,10701,2002-03,2002,2003,Man United,Middlesbrough,Win,Home,2002-09-03,3,2,5,6,6,4,5,5,5,-2,0,1,1,1,3.0,12.0,-9.0,2
10702,10702,2002-03,2002,2003,Man United,Bolton,Loss,Home,2002-09-11,0,4,5,8,9,3,3,3,3,1,2,5,6,1,3.0,16.0,-13.0,2
10703,10703,2002-03,2002,2003,Man United,Leeds,Loss,Away,2002-09-14,0,3,4,5,8,3,3,6,9,0,1,-1,-1,0,3.0,5.0,-2.0,2
10704,10704,2002-03,2002,2003,Man United,Tottenham,Win,Home,2002-09-21,3,0,3,4,5,3,6,9,12,-3,-3,-5,-7,1,3.0,9.0,-6.0,2
10705,10705,2002-03,2002,2003,Man United,Charlton,Win,Away,2002-09-28,3,3,3,6,7,1,1,4,4,2,2,2,3,0,3.0,14.0,-11.0,2
10706,10706,2002-03,2002,2003,Man United,Everton,Win,Home,2002-10-07,3,6,6,6,9,3,6,6,6,3,0,0,3,1,3.0,15.0,-12.0,3
10707,10707,2002-03,2002,2003,Man United,Fulham,Draw,Away,2002-10-19,1,6,9,9,9,3,4,7,10,3,5,2,-1,0,3.0,13.0,-10.0,3
10708,10708,2002-03,2002,2003,Man United,Aston Villa,Draw,Home,2002-10-26,1,4,7,10,10,1,1,4,4,3,6,6,6,1,3.0,8.0,-5.0,3
10709,10709,2002-03,2002,2003,Man United,Southampton,Win,Home,2002-11-02,3,2,5,8,11,6,9,10,11,-4,-4,-2,0,1,3.0,11.0,-8.0,4
10710,10710,2002-03,2002,2003,Man United,Man City,Loss,Away,2002-11-09,0,4,5,8,11,6,6,6,6,-2,-1,2,5,0,3.0,21.0,-18.0,4
10711,10711,2002-03,2002,2003,Man United,West Ham,Draw,Away,2002-11-17,1,3,4,5,8,0,0,3,6,3,4,2,2,0,3.0,7.0,-4.0,4
10712,10712,2002-03,2002,2003,Man United,Newcastle,Win,Home,2002-11-23,3,1,4,5,6,3,6,9,9,-2,-2,-4,-3,1,3.0,4.0,-1.0,4
10713,10713,2002-03,2002,2003,Man United,Liverpool,Win,Away,2002-12-01,3,4,4,7,8,1,1,4,7,3,3,3,1,0,3.0,2.0,1.0,5
10714,10714,2002-03,2002,2003,Man United,Arsenal,Win,Home,2002-12-07,3,6,7,7,10,3,6,9,12,3,1,-2,-2,1,3.0,1.0,2.0,5
10715,10715,2002-03,2002,2003,Man United,West Ham,Win,Home,2002-12-14,3,6,9,10,10,1,1,2,2,5,8,8,8,1,3.0,7.0,-4.0,5
10716,10716,2002-03,2002,2003,Man United,Blackburn,Loss,Away,2002-12-22,0,6,9,12,13,1,4,4,4,5,5,8,9,0,3.0,10.0,-7.0,5
10717,10717,2002-03,2002,2003,Man United,Middlesbrough,Loss,Away,2002-12-26,0,3,6,9,12,1,2,2,5,2,4,7,7,0,3.0,12.0,-9.0,5
10718,10718,2002-03,2002,2003,Man United,Birmingham,Win,Home,2002-12-28,3,0,3,6,9,2,5,5,6,-2,-2,1,3,1,3.0,21.0,-18.0,5
10719,10719,2002-03,2002,2003,Man United,Sunderland,Win,Home,2003-01-01,3,3,3,6,9,0,1,4,4,3,2,2,5,1,3.0,17.0,-14.0,6
10720,10720,2002-03,2002,2003,Man United,West Brom,Win,Away,2003-01-11,3,6,6,6,9,0,1,1,1,6,5,5,8,0,3.0,21.0,-18.0,6
10721,10721,2002-03,2002,2003,Man United,Chelsea,Win,Home,2003-01-18,3,6,9,9,9,3,3,4,7,3,6,5,2,1,3.0,6.0,-3.0,6
10722,10722,2002-03,2002,2003,Man United,Southampton,Win,Away,2003-02-01,3,6,9,12,12,3,4,7,10,3,5,5,2,0,3.0,11.0,-8.0,7
10723,10723,2002-03,2002,2003,Man United,Birmingham,Win,Away,2003-02-04,3,6,9,12,15,1,1,1,1,5,8,11,14,0,3.0,21.0,-18.0,7
10724,10724,2002-03,2002,2003,Man United,Man City,Draw,Home,2003-02-09,1,6,9,12,15,3,3,6,7,3,6,6,8,1,3.0,21.0,-18.0,7
10725,10725,2002-03,2002,2003,Man United,Bolton,Draw,Away,2003-02-22,1,4,7,10,13,4,4,4,5,0,3,6,8,0,3.0,16.0,-13.0,7
10726,10726,2002-03,2002,2003,Man United,Leeds,Win,Home,2003-03-05,3,2,5,8,11,3,3,3,4,-1,2,5,7,1,3.0,5.0,-2.0,8
10727,10727,2002-03,2002,2003,Man United,Aston Villa,Win,Away,2003-03-15,3,4,5,8,11,0,0,3,6,4,5,5,5,0,3.0,8.0,-5.0,8
10728,10728,2002-03,2002,2003,Man United,Fulham,Win,Home,2003-03-22,3,6,7,8,11,4,5,8,11,2,2,0,0,1,3.0,13.0,-10.0,8
10729,10729,2002-03,2002,2003,Man United,Liverpool,Win,Home,2003-04-05,3,6,9,10,11,6,9,9,10,0,0,1,1,1,3.0,2.0,1.0,9
10730,10730,2002-03,2002,2003,Man United,Newcastle,Win,Away,2003-04-12,3,6,9,12,13,3,6,6,9,3,3,6,4,0,3.0,4.0,-1.0,9
10731,10731,2002-03,2002,2003,Man United,Arsenal,Draw,Away,2003-04-16,1,6,9,12,15,4,4,7,10,2,5,5,5,0,3.0,1.0,2.0,9
10732,10732,2002-03,2002,2003,Man United,Blackburn,Win,Home,2003-04-19,3,4,7,10,13,6,6,9,12,-2,1,1,1,1,3.0,10.0,-7.0,9
10733,10733,2002-03,2002,2003,Man United,Tottenham,Win,Away,2003-04-27,3,4,7,10,13,3,4,7,7,1,3,3,6,0,3.0,9.0,-6.0,9
10734,10734,2002-03,2002,2003,Man United,Charlton,Win,Home,2003-05-03,3,6,7,10,13,3,3,3,3,3,4,7,10,1,3.0,14.0,-11.0,10
10735,10735,2002-03,2002,2003,Man United,Everton,Win,Away,2003-05-11,3,6,9,10,13,3,3,3,6,3,6,7,7,0,3.0,15.0,-12.0,10
10736,10736,2003-04,2003,2004,Man United,Bolton,Win,Home,2003-08-16,3,6,9,12,13,4,5,6,9,2,4,6,4,1,1.0,17.0,-16.0,1
10737,10737,2003-04,2003,2004,Man United,Newcastle,Win,Away,2003-08-23,3,6,9,12,15,2,5,8,9,4,4,4,6,0,1.0,3.0,-2.0,1
10738,10738,2003-04,2003,2004,Man United,Wolves,Win,Home,2003-08-27,3,6,9,12,15,0,0,0,0,6,9,12,15,1,1.0,21.0,-20.0,1
10739,10739,2003-04,2003,2004,Man United,Southampton,Loss,Away,2003-08-31,0,6,9,12,15,2,3,6,6,4,6,6,9,0,1.0,8.0,-7.0,1
10740,10740,2003-04,2003,2004,Man United,Charlton,Win,Away,2003-09-13,3,3,6,9,12,2,5,5,5,1,1,4,7,0,1.0,12.0,-11.0,2
10741,10741,2003-04,2003,2004,Man United,Arsenal,Draw,Home,2003-09-21,1,3,6,9,12,4,7,10,13,-1,-1,-1,-1,1,1.0,2.0,-1.0,2
10742,10742,2003-04,2003,2004,Man United,Leicester,Win,Away,2003-09-27,3,4,4,7,10,3,3,4,4,1,1,3,6,0,1.0,21.0,-20.0,2
10743,10743,2003-04,2003,2004,Man United,Birmingham,Win,Home,2003-10-04,3,4,7,7,10,6,7,10,11,-2,0,-3,-1,1,1.0,13.0,-12.0,3
10744,10744,2003-04,2003,2004,Man United,Leeds,Win,Away,2003-10-18,3,6,7,10,10,3,3,3,6,3,4,7,4,0,1.0,15.0,-14.0,3
10745,10745,2003-04,2003,2004,Man United,Fulham,Loss,Home,2003-10-25,0,6,9,10,13,1,4,7,8,5,5,3,5,1,1.0,14.0,-13.0,3
10746,10746,2003-04,2003,2004,Man United,Portsmouth,Win,Home,2003-11-01,3,3,6,9,10,3,3,3,3,0,3,6,7,1,1.0,21.0,-20.0,4
10747,10747,2003-04,2003,2004,Man United,Liverpool,Win,Away,2003-11-09,3,3,6,9,12,6,6,6,6,-3,0,3,6,0,1.0,5.0,-4.0,4
10748,10748,2003-04,2003,2004,Man United,Blackburn,Win,Home,2003-11-22,3,6,6,9,12,3,3,3,3,3,3,6,9,1,1.0,6.0,-5.0,4
10749,10749,2003-04,2003,2004,Man United,Chelsea,Loss,Away,2003-11-30,0,6,9,9,12,6,9,12,12,0,0,-3,0,0,1.0,4.0,-3.0,4
10750,10750,2003-04,2003,2004,Man United,Aston Villa,Win,Home,2003-12-06,3,3,6,9,9,3,3,4,5,0,3,5,4,1,1.0,16.0,-15.0,5
10751,10751,2003-04,2003,2004,Man United,Man City,Win,Home,2003-12-13,3,3,6,9,12,1,1,1,4,2,5,8,8,1,1.0,9.0,-8.0,5
10752,10752,2003-04,2003,2004,Man United,Tottenham,Win,Away,2003-12-21,3,6,6,9,12,3,3,6,6,3,3,3,6,0,1.0,10.0,-9.0,5
10753,10753,2003-04,2003,2004,Man United,Everton,Win,Home,2003-12-26,3,6,9,9,12,6,7,7,10,0,2,2,2,1,1.0,7.0,-6.0,5
10754,10754,2003-04,2003,2004,Man United,Middlesbrough,Win,Away,2003-12-28,3,6,9,12,12,2,3,6,7,4,6,6,5,0,1.0,11.0,-10.0,5
10755,10755,2003-04,2003,2004,Man United,Bolton,Win,Away,2004-01-07,3,6,9,12,15,1,2,5,5,5,7,7,10,0,1.0,17.0,-16.0,6
10756,10756,2003-04,2003,2004,Man United,Newcastle,Draw,Home,2004-01-11,1,6,9,12,15,3,4,5,8,3,5,7,7,1,1.0,3.0,-2.0,6
10757,10757,2003-04,2003,2004,Man United,Wolves,Loss,Away,2004-01-17,0,4,7,10,13,1,4,4,4,3,3,6,9,0,1.0,21.0,-20.0,6
10758,10758,2003-04,2003,2004,Man United,Southampton,Win,Home,2004-01-31,3,1,4,7,10,3,4,4,4,-2,0,3,6,1,1.0,8.0,-7.0,6
10759,10759,2003-04,2003,2004,Man United,Everton,Win,Away,2004-02-07,3,3,4,7,10,1,1,2,5,2,3,5,5,0,1.0,7.0,-6.0,7
10760,10760,2003-04,2003,2004,Man United,Middlesbrough,Loss,Home,2004-02-11,0,6,6,7,10,3,4,4,7,3,2,3,3,1,1.0,11.0,-10.0,7
10761,10761,2003-04,2003,2004,Man United,Leeds,Draw,Home,2004-02-21,1,3,6,6,7,3,3,3,3,0,3,3,4,1,1.0,15.0,-14.0,7
10762,10762,2003-04,2003,2004,Man United,Fulham,Draw,Away,2004-02-28,1,1,4,7,7,0,1,4,4,1,3,3,3,0,1.0,14.0,-13.0,7
10763,10763,2003-04,2003,2004,Man United,Man City,Loss,Away,2004-03-14,0,2,2,5,8,3,3,4,4,-1,-1,1,4,0,1.0,9.0,-8.0,8
10764,10764,2003-04,2003,2004,Man United,Tottenham,Win,Home,2004-03-20,3,1,2,2,5,3,4,7,10,-2,-2,-5,-5,1,1.0,10.0,-9.0,8
10765,10765,2003-04,2003,2004,Man United,Arsenal,Draw,Away,2004-03-28,1,3,4,5,5,6,9,12,15,-3,-5,-7,-10,0,1.0,2.0,-1.0,8
10766,10766,2003-04,2003,2004,Man United,Birmingham,Win,Away,2004-04-10,3,4,4,5,6,4,4,4,7,0,0,1,-1,0,1.0,13.0,-12.0,9
10767,10767,2003-04,2003,2004,Man United,Leicester,Win,Home,2004-04-13,3,4,7,7,8,0,1,2,5,4,6,5,3,1,1.0,21.0,-20.0,9
10768,10768,2003-04,2003,2004,Man United,Portsmouth,Loss,Away,2004-04-17,0,6,7,10,10,4,7,10,10,2,0,0,0,0,1.0,21.0,-20.0,9
10769,10769,2003-04,2003,2004,Man United,Charlton,Win,Home,2004-04-20,3,3,6,7,10,4,5,5,5,-1,1,2,5,1,1.0,12.0,-11.0,9
10770,10770,2003-04,2003,2004,Man United,Liverpool,Loss,Home,2004-04-24,0,3,6,9,10,1,1,4,5,2,5,5,5,1,1.0,5.0,-4.0,9
10771,10771,2003-04,2003,2004,Man United,Blackburn,Loss,Away,2004-05-01,0,3,3,6,9,6,9,9,9,-3,-6,-3,0,0,1.0,6.0,-5.0,10
10772,10772,2003-04,2003,2004,Man United,Chelsea,Draw,Home,2004-05-08,1,0,3,3,6,3,4,4,5,-3,-1,-1,1,1,1.0,4.0,-3.0,10
10773,10773,2003-04,2003,2004,Man United,Aston Villa,Win,Away,2004-05-15,3,1,1,4,4,4,7,8,11,-3,-6,-4,-7,0,1.0,16.0,-15.0,10
10774,10774,2004-05,2004,2005,Man United,Chelsea,Loss,Away,2004-08-15,0,4,4,4,7,4,7,7,8,0,-3,-3,-1,0,3.0,2.0,1.0,1
10775,10775,2004-05,2004,2005,Man United,Norwich,Win,Home,2004-08-21,3,3,4,4,4,2,2,2,2,1,2,2,2,1,3.0,21.0,-18.0,1
10776,10776,2004-05,2004,2005,Man United,Blackburn,Draw,Away,2004-08-28,1,3,6,7,7,0,1,2,2,3,5,5,5,0,3.0,15.0,-12.0,1
10777,10777,2004-05,2004,2005,Man United,Everton,Draw,Home,2004-08-30,1,4,4,7,8,6,6,6,6,-2,-2,1,2,1,3.0,17.0,-14.0,1
10778,10778,2004-05,2004,2005,Man United,Bolton,Draw,Away,2004-09-11,1,2,5,5,8,6,6,9,9,-4,-1,-4,-1,0,3.0,8.0,-5.0,2
10779,10779,2004-05,2004,2005,Man United,Liverpool,Win,Home,2004-09-20,3,2,3,6,6,3,6,7,8,-1,-3,-1,-2,1,3.0,4.0,-1.0,2
10780,10780,2004-05,2004,2005,Man United,Tottenham,Win,Away,2004-09-25,3,4,5,6,9,2,5,6,9,2,0,0,0,0,3.0,14.0,-11.0,2
10781,10781,2004-05,2004,2005,Man United,Middlesbrough,Draw,Home,2004-10-03,1,6,7,8,9,0,3,6,9,6,4,2,0,1,3.0,11.0,-8.0,3
10782,10782,2004-05,2004,2005,Man United,Birmingham,Draw,Away,2004-10-16,1,4,7,8,9,2,3,3,3,2,4,5,6,0,3.0,10.0,-7.0,3
10783,10783,2004-05,2004,2005,Man United,Arsenal,Win,Home,2004-10-24,3,2,5,8,9,6,9,10,13,-4,-4,-2,-4,1,3.0,1.0,2.0,3
10784,10784,2004-05,2004,2005,Man United,Portsmouth,Loss,Away,2004-10-30,0,4,5,8,11,4,5,5,5,0,0,3,6,0,3.0,13.0,-10.0,3
10785,10785,2004-05,2004,2005,Man United,Man City,Draw,Home,2004-11-07,1,3,4,5,8,1,4,5,5,2,0,0,3,1,3.0,16.0,-13.0,4
10786,10786,2004-05,2004,2005,Man United,Newcastle,Win,Away,2004-11-14,3,1,4,5,6,0,3,4,5,1,1,1,1,0,3.0,5.0,-2.0,4
10787,10787,2004-05,2004,2005,Man United,Charlton,Win,Home,2004-11-20,3,4,4,7,8,6,6,6,7,-2,-2,1,1,1,3.0,7.0,-4.0,4
10788,10788,2004-05,2004,2005,Man United,West Brom,Win,Away,2004-11-27,3,6,7,7,10,1,2,2,2,5,5,5,8,0,3.0,21.0,-18.0,4
10789,10789,2004-05,2004,2005,Man United,Southampton,Win,Home,2004-12-04,3,6,9,10,10,1,4,5,6,5,5,5,4,1,3.0,12.0,-9.0,5
10790,10790,2004-05,2004,2005,Man United,Fulham,Draw,Away,2004-12-13,1,6,9,12,13,3,3,3,6,3,6,9,7,0,3.0,9.0,-6.0,5
10791,10791,2004-05,2004,2005,Man United,Crystal Palace,Win,Home,2004-12-18,3,4,7,10,13,1,2,2,2,3,5,8,11,1,3.0,21.0,-18.0,5
10792,10792,2004-05,2004,2005,Man United,Bolton,Win,Home,2004-12-26,3,4,7,10,13,0,0,0,1,4,7,10,12,1,3.0,8.0,-5.0,5
10793,10793,2004-05,2004,2005,Man United,Aston Villa,Win,Away,2004-12-28,3,6,7,10,13,0,0,1,1,6,7,9,12,0,3.0,6.0,-3.0,5
10794,10794,2004-05,2004,2005,Man United,Middlesbrough,Win,Away,2005-01-01,3,6,9,10,13,3,6,7,10,3,3,3,3,0,3.0,11.0,-8.0,6
10795,10795,2004-05,2004,2005,Man United,Tottenham,Draw,Home,2005-01-04,1,6,9,12,13,4,7,10,13,2,2,2,0,1,3.0,14.0,-11.0,6
10796,10796,2004-05,2004,2005,Man United,Liverpool,Win,Away,2005-01-15,3,4,7,10,13,3,6,9,12,1,1,1,1,0,3.0,4.0,-1.0,6
10797,10797,2004-05,2004,2005,Man United,Aston Villa,Win,Home,2005-01-22,3,4,7,10,13,3,6,6,6,1,1,4,7,1,3.0,6.0,-3.0,6
10798,10798,2004-05,2004,2005,Man United,Arsenal,Win,Away,2005-02-01,3,6,7,10,13,3,4,7,10,3,3,3,3,0,3.0,1.0,2.0,7
10799,10799,2004-05,2004,2005,Man United,Birmingham,Win,Home,2005-02-05,3,6,9,10,13,3,3,3,3,3,6,7,10,1,3.0,10.0,-7.0,7
10800,10800,2004-05,2004,2005,Man United,Man City,Win,Away,2005-02-13,3,6,9,12,13,2,2,5,6,4,7,7,7,0,3.0,16.0,-13.0,7
10801,10801,2004-05,2004,2005,Man United,Portsmouth,Win,Home,2005-02-26,3,6,9,12,15,0,3,3,3,6,6,9,12,1,3.0,13.0,-10.0,7
10802,10802,2004-05,2004,2005,Man United,Crystal Palace,Draw,Away,2005-03-05,1,6,9,12,15,3,3,4,7,3,6,8,8,0,3.0,21.0,-18.0,8
10803,10803,2004-05,2004,2005,Man United,Fulham,Win,Home,2005-03-19,3,4,7,10,13,1,1,2,5,3,6,8,8,1,3.0,9.0,-6.0,8
10804,10804,2004-05,2004,2005,Man United,Blackburn,Draw,Home,2005-04-02,1,4,7,10,13,1,4,7,7,3,3,3,6,1,3.0,15.0,-12.0,9
10805,10805,2004-05,2004,2005,Man United,Norwich,Loss,Away,2005-04-09,0,4,5,8,11,0,0,0,0,4,5,8,11,0,3.0,21.0,-18.0,9
10806,10806,2004-05,2004,2005,Man United,Everton,Loss,Away,2005-04-20,0,1,4,5,8,3,3,3,6,-2,1,2,2,0,3.0,17.0,-14.0,9
10807,10807,2004-05,2004,2005,Man United,Newcastle,Win,Home,2005-04-24,3,0,1,4,5,0,0,1,4,0,1,3,1,1,3.0,5.0,-2.0,9
10808,10808,2004-05,2004,2005,Man United,Charlton,Win,Away,2005-05-01,3,3,3,4,7,1,1,1,2,2,2,3,5,0,3.0,7.0,-4.0,10
10809,10809,2004-05,2004,2005,Man United,West Brom,Draw,Home,2005-05-07,1,6,6,6,7,1,1,2,3,5,5,4,4,1,3.0,21.0,-18.0,10
10810,10810,2004-05,2004,2005,Man United,Chelsea,Loss,Home,2005-05-10,0,4,7,7,7,6,9,10,11,-2,-2,-3,-4,1,3.0,2.0,1.0,10
10811,10811,2004-05,2004,2005,Man United,Southampton,Win,Away,2005-05-15,3,1,4,7,7,4,4,5,5,-3,0,2,2,0,3.0,12.0,-9.0,10
10812,10812,2005-06,2005,2006,Man United,Everton,Win,Away,2005-08-13,3,3,4,7,10,0,3,3,4,3,1,4,6,0,3.0,4.0,-1.0,1
10813,10813,2005-06,2005,2006,Man United,Aston Villa,Win,Home,2005-08-20,3,6,6,7,10,1,1,1,2,5,5,6,8,1,3.0,10.0,-7.0,1
10814,10814,2005-06,2005,2006,Man United,Newcastle,Win,Away,2005-08-28,3,6,9,9,10,1,1,2,2,5,8,7,8,0,3.0,14.0,-11.0,1
10815,10815,2005-06,2005,2006,Man United,Man City,Draw,Home,2005-09-10,1,6,9,12,12,6,9,10,11,0,0,2,1,1,3.0,8.0,-5.0,2
10816,10816,2005-06,2005,2006,Man United,Liverpool,Draw,Away,2005-09-18,1,4,7,10,13,4,5,8,8,0,2,2,5,0,3.0,5.0,-2.0,2
10817,10817,2005-06,2005,2006,Man United,Blackburn,Loss,Home,2005-09-24,0,2,5,8,11,1,1,2,5,1,4,6,6,1,3.0,15.0,-12.0,2
10818,10818,2005-06,2005,2006,Man United,Fulham,Win,Away,2005-10-01,3,1,2,5,8,0,1,4,4,1,1,1,4,0,3.0,13.0,-10.0,3
10819,10819,2005-06,2005,2006,Man United,Sunderland,Win,Away,2005-10-15,3,3,4,5,8,4,5,5,5,-1,-1,0,3,0,3.0,21.0,-18.0,3
10820,10820,2005-06,2005,2006,Man United,Tottenham,Draw,Home,2005-10-22,1,6,6,7,8,6,9,10,11,0,-3,-3,-3,1,3.0,9.0,-6.0,3
10821,10821,2005-06,2005,2006,Man United,Middlesbrough,Loss,Away,2005-10-29,0,4,7,7,8,1,4,4,5,3,3,3,3,0,3.0,7.0,-4.0,3
10822,10822,2005-06,2005,2006,Man United,Chelsea,Win,Home,2005-11-06,3,1,4,7,7,4,7,10,13,-3,-3,-3,-6,1,3.0,1.0,2.0,4
10823,10823,2005-06,2005,2006,Man United,Charlton,Win,Away,2005-11-19,3,3,4,7,10,0,3,4,4,3,1,3,6,0,3.0,11.0,-8.0,4
10824,10824,2005-06,2005,2006,Man United,West Ham,Win,Away,2005-11-27,3,6,6,7,10,4,4,7,7,2,2,0,3,0,3.0,21.0,-18.0,4
10825,10825,2005-06,2005,2006,Man United,Portsmouth,Win,Home,2005-12-03,3,6,9,9,10,0,0,3,3,6,9,6,7,1,3.0,16.0,-13.0,5
10826,10826,2005-06,2005,2006,Man United,Everton,Draw,Home,2005-12-11,1,6,9,12,12,6,6,9,12,0,3,3,0,1,3.0,4.0,-1.0,5
10827,10827,2005-06,2005,2006,Man United,Wigan,Win,Home,2005-12-14,3,4,7,10,13,0,0,0,3,4,7,10,10,1,3.0,21.0,-18.0,5
10828,10828,2005-06,2005,2006,Man United,Aston Villa,Win,Away,2005-12-17,3,4,7,10,13,2,5,8,8,2,2,2,5,0,3.0,10.0,-7.0,5
10829,10829,2005-06,2005,2006,Man United,West Brom,Win,Home,2005-12-26,3,6,7,10,13,3,4,5,8,3,3,5,5,1,3.0,17.0,-14.0,5
10830,10830,2005-06,2005,2006,Man United,Birmingham,Draw,Away,2005-12-28,1,6,9,10,13,0,3,3,6,6,6,7,7,0,3.0,12.0,-9.0,5
10831,10831,2005-06,2005,2006,Man United,Bolton,Win,Home,2005-12-31,3,4,7,10,11,4,5,8,8,0,2,2,3,1,3.0,6.0,-3.0,5
10832,10832,2005-06,2005,2006,Man United,Arsenal,Draw,Away,2006-01-03,1,4,7,10,13,4,7,7,7,0,0,3,6,0,3.0,2.0,1.0,6
10833,10833,2005-06,2005,2006,Man United,Man City,Loss,Away,2006-01-14,0,4,5,8,11,1,1,1,4,3,4,7,7,0,3.0,8.0,-5.0,6
10834,10834,2005-06,2005,2006,Man United,Liverpool,Win,Home,2006-01-22,3,1,4,5,8,4,7,10,13,-3,-3,-5,-5,1,3.0,5.0,-2.0,6
10835,10835,2005-06,2005,2006,Man United,Blackburn,Loss,Away,2006-02-01,0,3,4,7,8,4,7,10,13,-1,-3,-3,-5,0,3.0,15.0,-12.0,7
10836,10836,2005-06,2005,2006,Man United,Fulham,Win,Home,2006-02-04,3,3,3,4,7,3,6,9,9,0,-3,-5,-2,1,3.0,13.0,-10.0,7
10837,10837,2005-06,2005,2006,Man United,Portsmouth,Win,Away,2006-02-11,3,3,6,6,7,1,1,1,1,2,5,5,6,0,3.0,16.0,-13.0,7
10838,10838,2005-06,2005,2006,Man United,Wigan,Win,Away,2006-03-06,3,6,6,9,9,1,2,3,6,5,4,6,3,0,3.0,21.0,-18.0,8
10839,10839,2005-06,2005,2006,Man United,Newcastle,Win,Home,2006-03-12,3,6,9,9,12,6,7,10,13,0,2,-1,-1,1,3.0,14.0,-11.0,8
10840,10840,2005-06,2005,2006,Man United,West Brom,Win,Away,2006-03-18,3,6,9,12,12,1,1,1,4,5,8,11,8,0,3.0,17.0,-14.0,8
10841,10841,2005-06,2005,2006,Man United,Birmingham,Win,Home,2006-03-26,3,6,9,12,15,1,1,4,4,5,8,8,11,1,3.0,12.0,-9.0,8
10842,10842,2005-06,2005,2006,Man United,West Ham,Win,Home,2006-03-29,3,6,9,12,15,3,3,4,7,3,6,8,8,1,3.0,21.0,-18.0,8
10843,10843,2005-06,2005,2006,Man United,Bolton,Win,Away,2006-04-01,3,6,9,12,15,3,6,6,9,3,3,6,6,0,3.0,6.0,-3.0,9
10844,10844,2005-06,2005,2006,Man United,Arsenal,Win,Home,2006-04-09,3,6,9,12,15,6,9,12,12,0,0,0,3,1,3.0,2.0,1.0,9
10845,10845,2005-06,2005,2006,Man United,Sunderland,Draw,Home,2006-04-14,1,6,9,12,15,1,1,1,1,5,8,11,14,1,3.0,21.0,-18.0,9
10846,10846,2005-06,2005,2006,Man United,Tottenham,Win,Away,2006-04-17,3,4,7,10,13,6,6,9,12,-2,1,1,1,0,3.0,9.0,-6.0,9
10847,10847,2005-06,2005,2006,Man United,Chelsea,Loss,Away,2006-04-29,0,4,7,10,13,6,9,10,13,-2,-2,0,0,0,3.0,1.0,2.0,9
10848,10848,2005-06,2005,2006,Man United,Middlesbrough,Draw,Home,2006-05-01,1,3,4,7,10,3,3,3,6,0,1,4,4,1,3.0,7.0,-4.0,10
10849,10849,2005-06,2005,2006,Man United,Charlton,Win,Home,2006-05-07,3,1,4,5,8,0,3,3,4,1,1,2,4,1,3.0,11.0,-8.0,10
10850,10850,2006-07,2006,2007,Man United,Fulham,Win,Home,2006-08-20,3,4,4,7,8,3,6,9,12,1,-2,-2,-4,1,2.0,12.0,-10.0,1
10851,10851,2006-07,2006,2007,Man United,Charlton,Win,Away,2006-08-23,3,6,7,7,10,0,0,0,3,6,7,7,7,0,2.0,13.0,-11.0,1
10852,10852,2006-07,2006,2007,Man United,Watford,Win,Away,2006-08-26,3,6,9,10,10,1,4,5,5,5,5,5,5,0,2.0,21.0,-19.0,1
10853,10853,2006-07,2006,2007,Man United,Tottenham,Win,Home,2006-09-09,3,6,9,12,13,3,3,3,6,3,6,9,7,1,2.0,5.0,-3.0,2
10854,10854,2006-07,2006,2007,Man United,Arsenal,Loss,Home,2006-09-17,0,6,9,12,15,1,2,5,8,5,7,7,7,1,2.0,4.0,-2.0,2
10855,10855,2006-07,2006,2007,Man United,Reading,Draw,Away,2006-09-23,1,3,6,9,12,6,6,6,9,-3,0,3,3,0,2.0,21.0,-19.0,2
10856,10856,2006-07,2006,2007,Man United,Newcastle,Win,Home,2006-10-01,3,1,4,7,10,1,4,4,4,0,0,3,6,1,2.0,7.0,-5.0,3
10857,10857,2006-07,2006,2007,Man United,Wigan,Win,Away,2006-10-14,3,4,4,7,10,1,2,2,5,3,2,5,5,0,2.0,10.0,-8.0,3
10858,10858,2006-07,2006,2007,Man United,Liverpool,Win,Home,2006-10-22,3,6,7,7,10,1,4,7,7,5,3,0,3,1,2.0,3.0,-1.0,3
10859,10859,2006-07,2006,2007,Man United,Bolton,Win,Away,2006-10-28,3,6,9,10,10,6,9,12,13,0,0,-2,-3,0,2.0,8.0,-6.0,3
10860,10860,2006-07,2006,2007,Man United,Portsmouth,Win,Home,2006-11-04,3,6,9,12,13,3,6,6,6,3,3,6,7,1,2.0,17.0,-15.0,4
10861,10861,2006-07,2006,2007,Man United,Blackburn,Win,Away,2006-11-11,3,6,9,12,15,0,0,1,4,6,9,11,11,0,2.0,6.0,-4.0,4
10862,10862,2006-07,2006,2007,Man United,Sheffield United,Win,Away,2006-11-18,3,6,9,12,15,4,4,4,5,2,5,8,10,0,2.0,21.0,-19.0,4
10863,10863,2006-07,2006,2007,Man United,Chelsea,Draw,Home,2006-11-26,1,6,9,12,15,6,6,9,12,0,3,3,3,1,2.0,1.0,1.0,4
10864,10864,2006-07,2006,2007,Man United,Everton,Win,Home,2006-11-29,3,4,7,10,13,4,4,4,5,0,3,6,8,1,2.0,11.0,-9.0,4
10865,10865,2006-07,2006,2007,Man United,Middlesbrough,Win,Away,2006-12-02,3,4,7,10,13,2,5,5,5,2,2,5,8,0,2.0,14.0,-12.0,5
10866,10866,2006-07,2006,2007,Man United,Man City,Win,Home,2006-12-09,3,6,7,10,13,4,4,7,8,2,3,3,5,1,2.0,15.0,-13.0,5
10867,10867,2006-07,2006,2007,Man United,West Ham,Loss,Away,2006-12-17,0,6,9,10,13,0,0,3,3,6,9,7,10,0,2.0,9.0,-7.0,5
10868,10868,2006-07,2006,2007,Man United,Aston Villa,Win,Away,2006-12-23,3,3,6,9,10,1,2,2,3,2,4,7,7,0,2.0,16.0,-14.0,5
10869,10869,2006-07,2006,2007,Man United,Wigan,Win,Home,2006-12-26,3,3,6,9,12,0,0,1,4,3,6,8,8,1,2.0,10.0,-8.0,5
10870,10870,2006-07,2006,2007,Man United,Reading,Win,Home,2006-12-30,3,6,6,9,12,1,1,2,2,5,5,7,10,1,2.0,21.0,-19.0,5
10871,10871,2006-07,2006,2007,Man United,Newcastle,Draw,Away,2007-01-01,1,6,9,9,12,0,3,6,6,6,6,3,6,0,2.0,7.0,-5.0,6
10872,10872,2006-07,2006,2007,Man United,Aston Villa,Win,Home,2007-01-13,3,4,7,10,10,1,1,1,1,3,6,9,9,1,2.0,16.0,-14.0,6
10873,10873,2006-07,2006,2007,Man United,Arsenal,Loss,Away,2007-01-21,0,4,7,10,13,6,6,9,12,-2,1,1,1,0,2.0,4.0,-2.0,6
10874,10874,2006-07,2006,2007,Man United,Watford,Win,Home,2007-01-31,3,3,4,7,10,3,3,4,4,0,1,3,6,1,2.0,21.0,-19.0,6
10875,10875,2006-07,2006,2007,Man United,Tottenham,Win,Away,2007-02-04,3,3,6,7,10,1,2,2,5,2,4,5,5,0,2.0,5.0,-3.0,7
10876,10876,2006-07,2006,2007,Man United,Charlton,Win,Home,2007-02-10,3,6,6,9,10,1,4,4,4,5,2,5,6,1,2.0,13.0,-11.0,7
10877,10877,2006-07,2006,2007,Man United,Fulham,Win,Away,2007-02-24,3,6,9,9,12,3,3,4,5,3,6,5,7,0,2.0,12.0,-10.0,7
10878,10878,2006-07,2006,2007,Man United,Liverpool,Win,Away,2007-03-03,3,6,9,12,12,3,4,7,10,3,5,5,2,0,2.0,3.0,-1.0,8
10879,10879,2006-07,2006,2007,Man United,Bolton,Win,Home,2007-03-17,3,6,9,12,15,0,3,6,7,6,6,6,8,1,2.0,8.0,-6.0,8
10880,10880,2006-07,2006,2007,Man United,Blackburn,Win,Home,2007-03-31,3,6,9,12,15,3,6,6,9,3,3,6,6,1,2.0,6.0,-4.0,8
10881,10881,2006-07,2006,2007,Man United,Portsmouth,Loss,Away,2007-04-07,0,6,9,12,15,2,2,2,5,4,7,10,10,0,2.0,17.0,-15.0,9
10882,10882,2006-07,2006,2007,Man United,Sheffield United,Win,Home,2007-04-17,3,3,6,9,12,3,3,3,4,0,3,6,8,1,2.0,21.0,-19.0,9
10883,10883,2006-07,2006,2007,Man United,Middlesbrough,Draw,Home,2007-04-21,1,3,6,9,12,0,3,3,3,3,3,6,9,1,2.0,14.0,-12.0,9
10884,10884,2006-07,2006,2007,Man United,Everton,Win,Away,2007-04-28,3,4,4,7,10,3,4,7,8,1,0,0,2,0,2.0,11.0,-9.0,9
10885,10885,2006-07,2006,2007,Man United,Man City,Win,Away,2007-05-05,3,4,7,7,10,1,1,2,5,3,6,5,5,0,2.0,15.0,-13.0,10
10886,10886,2006-07,2006,2007,Man United,Chelsea,Draw,Away,2007-05-09,1,6,7,10,10,2,3,6,9,4,4,4,1,0,2.0,1.0,1.0,10
10887,10887,2006-07,2006,2007,Man United,West Ham,Loss,Home,2007-05-13,0,4,7,8,11,6,9,9,9,-2,-2,-1,2,1,2.0,9.0,-7.0,10
10888,10888,2007-08,2007,2008,Man United,Reading,Draw,Home,2007-08-12,1,1,4,7,8,1,4,7,10,0,0,0,-2,1,1.0,8.0,-7.0,1
10889,10889,2007-08,2007,2008,Man United,Portsmouth,Draw,Away,2007-08-15,1,1,2,5,8,2,2,5,6,-1,0,0,2,0,1.0,9.0,-8.0,1
10890,10890,2007-08,2007,2008,Man United,Man City,Loss,Away,2007-08-19,0,2,2,3,6,6,6,6,6,-4,-4,-3,0,0,1.0,14.0,-13.0,1
10891,10891,2007-08,2007,2008,Man United,Tottenham,Win,Home,2007-08-26,3,1,2,2,3,3,3,6,7,-2,-1,-4,-4,1,1.0,5.0,-4.0,1
10892,10892,2007-08,2007,2008,Man United,Sunderland,Win,Home,2007-09-01,3,3,4,5,5,0,1,4,4,3,3,1,1,1,1.0,21.0,-20.0,2
10893,10893,2007-08,2007,2008,Man United,Everton,Win,Away,2007-09-15,3,6,6,7,8,4,4,7,10,2,2,0,-2,0,1.0,6.0,-5.0,2
10894,10894,2007-08,2007,2008,Man United,Chelsea,Win,Home,2007-09-23,3,6,9,9,10,1,4,5,8,5,5,4,2,1,1.0,2.0,-1.0,2
10895,10895,2007-08,2007,2008,Man United,Birmingham,Win,Away,2007-09-29,3,6,9,12,12,4,4,7,7,2,5,5,5,0,1.0,21.0,-20.0,2
10896,10896,2007-08,2007,2008,Man United,Wigan,Win,Home,2007-10-06,3,6,9,12,15,0,1,1,2,6,8,11,13,1,1.0,17.0,-16.0,3
10897,10897,2007-08,2007,2008,Man United,Aston Villa,Win,Away,2007-10-20,3,6,9,12,15,4,7,7,10,2,2,5,5,0,1.0,11.0,-10.0,3
10898,10898,2007-08,2007,2008,Man United,Middlesbrough,Win,Home,2007-10-27,3,6,9,12,15,0,0,1,1,6,9,11,14,1,1.0,12.0,-11.0,3
10899,10899,2007-08,2007,2008,Man United,Arsenal,Draw,Away,2007-11-03,1,6,9,12,15,4,7,10,13,2,2,2,2,0,1.0,4.0,-3.0,4
10900,10900,2007-08,2007,2008,Man United,Blackburn,Win,Home,2007-11-11,3,4,7,10,13,4,7,10,13,0,0,0,0,1,1.0,10.0,-9.0,4
10901,10901,2007-08,2007,2008,Man United,Bolton,Loss,Away,2007-11-24,0,4,7,10,13,2,3,3,3,2,4,7,10,0,1.0,7.0,-6.0,4
10902,10902,2007-08,2007,2008,Man United,Fulham,Win,Home,2007-12-03,3,3,4,7,10,1,4,5,6,2,0,2,4,1,1.0,16.0,-15.0,5
10903,10903,2007-08,2007,2008,Man United,Derby,Win,Home,2007-12-08,3,3,6,7,10,0,0,0,0,3,6,7,10,1,1.0,21.0,-20.0,5
10904,10904,2007-08,2007,2008,Man United,Liverpool,Win,Away,2007-12-16,3,6,6,9,10,3,6,9,10,3,0,0,0,0,1.0,3.0,-2.0,5
10905,10905,2007-08,2007,2008,Man United,Everton,Win,Home,2007-12-23,3,6,9,9,12,6,7,10,11,0,2,-1,1,1,1.0,6.0,-5.0,5
10906,10906,2007-08,2007,2008,Man United,Sunderland,Win,Away,2007-12-26,3,6,9,12,12,1,1,4,4,5,8,8,8,0,1.0,21.0,-20.0,5
10907,10907,2007-08,2007,2008,Man United,West Ham,Loss,Away,2007-12-29,0,6,9,12,15,4,4,7,7,2,5,5,8,0,1.0,15.0,-14.0,5
10908,10908,2007-08,2007,2008,Man United,Birmingham,Win,Home,2008-01-01,3,3,6,9,12,4,4,5,5,-1,2,4,7,1,1.0,21.0,-20.0,6
10909,10909,2007-08,2007,2008,Man United,Newcastle,Win,Home,2008-01-12,3,3,6,9,12,0,0,1,4,3,6,8,8,1,1.0,13.0,-12.0,6
10910,10910,2007-08,2007,2008,Man United,Reading,Win,Away,2008-01-19,3,6,6,9,12,0,0,1,4,6,6,8,8,0,1.0,8.0,-7.0,6
10911,10911,2007-08,2007,2008,Man United,Portsmouth,Win,Home,2008-01-30,3,6,9,9,12,3,6,6,7,3,3,3,5,1,1.0,9.0,-8.0,6
10912,10912,2007-08,2007,2008,Man United,Tottenham,Draw,Away,2008-02-02,1,6,9,12,12,4,4,4,7,2,5,8,5,0,1.0,5.0,-4.0,7
10913,10913,2007-08,2007,2008,Man United,Man City,Loss,Home,2008-02-10,0,4,7,10,13,1,2,2,5,3,5,8,8,1,1.0,14.0,-13.0,7
10914,10914,2007-08,2007,2008,Man United,Newcastle,Win,Away,2008-02-23,3,1,4,7,10,1,1,2,2,0,3,5,8,0,1.0,13.0,-12.0,7
10915,10915,2007-08,2007,2008,Man United,Fulham,Win,Away,2008-03-01,3,3,4,7,10,0,3,4,4,3,1,3,6,0,1.0,16.0,-15.0,8
10916,10916,2007-08,2007,2008,Man United,Derby,Win,Away,2008-03-15,3,6,6,7,10,1,1,1,2,5,5,6,8,0,1.0,21.0,-20.0,8
10917,10917,2007-08,2007,2008,Man United,Bolton,Win,Home,2008-03-19,3,6,9,9,10,0,0,0,3,6,9,9,7,1,1.0,7.0,-6.0,8
10918,10918,2007-08,2007,2008,Man United,Liverpool,Win,Home,2008-03-23,3,6,9,12,12,6,9,12,15,0,0,0,-3,1,1.0,3.0,-2.0,8
10919,10919,2007-08,2007,2008,Man United,Aston Villa,Win,Home,2008-03-29,3,6,9,12,15,0,1,2,5,6,8,10,10,1,1.0,11.0,-10.0,8
10920,10920,2007-08,2007,2008,Man United,Middlesbrough,Draw,Away,2008-04-06,1,6,9,12,15,3,4,5,5,3,5,7,10,0,1.0,12.0,-11.0,9
10921,10921,2007-08,2007,2008,Man United,Arsenal,Win,Home,2008-04-13,3,4,7,10,13,4,4,5,6,0,3,5,7,1,1.0,4.0,-3.0,9
10922,10922,2007-08,2007,2008,Man United,Blackburn,Draw,Away,2008-04-19,1,4,7,10,13,1,2,5,5,3,5,5,8,0,1.0,10.0,-9.0,9
10923,10923,2007-08,2007,2008,Man United,Chelsea,Loss,Away,2008-04-26,0,4,5,8,11,4,7,10,13,0,-2,-2,-2,0,1.0,2.0,-1.0,9
10924,10924,2007-08,2007,2008,Man United,West Ham,Win,Home,2008-05-03,3,1,4,5,8,4,4,4,4,-3,0,1,4,1,1.0,15.0,-14.0,10
10925,10925,2007-08,2007,2008,Man United,Wigan,Win,Away,2008-05-11,3,3,4,7,8,4,5,6,9,-1,-1,1,-1,0,1.0,17.0,-16.0,10
10926,10926,2008-09,2008,2009,Man United,Newcastle,Draw,Home,2008-08-17,1,6,6,7,10,0,1,4,5,6,5,3,5,1,1.0,12.0,-11.0,1
10927,10927,2008-09,2008,2009,Man United,Portsmouth,Win,Away,2008-08-25,3,4,7,7,8,0,0,0,0,4,7,7,8,0,1.0,8.0,-7.0,1
10928,10928,2008-09,2008,2009,Man United,Liverpool,Loss,Away,2008-09-13,0,4,7,10,10,4,7,10,13,0,0,0,-3,0,1.0,4.0,-3.0,2
10929,10929,2008-09,2008,2009,Man United,Chelsea,Draw,Away,2008-09-21,1,3,4,7,10,4,7,10,11,-1,-3,-3,-1,0,1.0,2.0,-1.0,2
10930,10930,2008-09,2008,2009,Man United,Bolton,Win,Home,2008-09-27,3,1,4,5,8,0,1,1,4,1,3,4,4,1,1.0,16.0,-15.0,2
10931,10931,2008-09,2008,2009,Man United,Blackburn,Win,Away,2008-10-04,3,4,4,7,8,6,6,6,7,-2,-2,1,1,0,1.0,7.0,-6.0,3
10932,10932,2008-09,2008,2009,Man United,West Brom,Win,Home,2008-10-18,3,6,7,7,10,6,6,9,10,0,1,-2,0,1,1.0,21.0,-20.0,3
10933,10933,2008-09,2008,2009,Man United,Everton,Draw,Away,2008-10-25,1,6,9,10,10,1,1,2,5,5,8,8,5,0,1.0,5.0,-4.0,3
10934,10934,2008-09,2008,2009,Man United,West Ham,Win,Home,2008-10-29,3,4,7,10,11,0,0,3,6,4,7,7,5,1,1.0,10.0,-9.0,3
10935,10935,2008-09,2008,2009,Man United,Hull,Win,Home,2008-11-01,3,4,7,10,13,3,6,9,12,1,1,1,1,1,1.0,21.0,-20.0,4
10936,10936,2008-09,2008,2009,Man United,Arsenal,Loss,Away,2008-11-08,0,6,7,10,13,1,4,7,8,5,3,3,5,0,1.0,3.0,-2.0,4
10937,10937,2008-09,2008,2009,Man United,Stoke,Win,Home,2008-11-15,3,3,6,7,10,4,7,7,10,-1,-1,0,0,1,1.0,21.0,-20.0,4
10938,10938,2008-09,2008,2009,Man United,Aston Villa,Draw,Away,2008-11-22,1,3,6,9,10,3,3,6,9,0,3,3,1,0,1.0,6.0,-5.0,4
10939,10939,2008-09,2008,2009,Man United,Man City,Win,Away,2008-11-30,3,4,4,7,10,4,4,4,4,0,0,3,6,0,1.0,9.0,-8.0,4
10940,10940,2008-09,2008,2009,Man United,Sunderland,Win,Home,2008-12-06,3,4,7,7,10,0,3,3,3,4,4,4,7,1,1.0,15.0,-14.0,5
10941,10941,2008-09,2008,2009,Man United,Tottenham,Draw,Away,2008-12-13,1,6,7,10,10,3,6,6,9,3,1,4,1,0,1.0,11.0,-10.0,5
10942,10942,2008-09,2008,2009,Man United,Stoke,Win,Away,2008-12-26,3,4,7,8,11,1,2,3,6,3,5,5,5,0,1.0,21.0,-20.0,5
10943,10943,2008-09,2008,2009,Man United,Middlesbrough,Win,Home,2008-12-29,3,4,7,10,11,0,1,1,2,4,6,9,9,1,1.0,13.0,-12.0,5
10944,10944,2008-09,2008,2009,Man United,Chelsea,Win,Home,2009-01-11,3,6,7,10,13,4,5,6,9,2,2,4,4,1,1.0,2.0,-1.0,6
10945,10945,2008-09,2008,2009,Man United,Wigan,Win,Home,2009-01-14,3,6,9,10,13,6,9,12,12,0,0,-2,1,1,1.0,14.0,-13.0,6
10946,10946,2008-09,2008,2009,Man United,Bolton,Win,Away,2009-01-17,3,6,9,12,13,0,0,3,3,6,9,9,10,0,1.0,16.0,-15.0,6
10947,10947,2008-09,2008,2009,Man United,West Brom,Win,Away,2009-01-27,3,6,9,12,15,3,6,6,9,3,3,6,6,0,1.0,21.0,-20.0,6
10948,10948,2008-09,2008,2009,Man United,Everton,Win,Home,2009-01-31,3,6,9,12,15,2,5,8,11,4,4,4,4,1,1.0,5.0,-4.0,6
10949,10949,2008-09,2008,2009,Man United,West Ham,Win,Away,2009-02-08,3,6,9,12,15,4,7,8,11,2,2,4,4,0,1.0,10.0,-9.0,7
10950,10950,2008-09,2008,2009,Man United,Fulham,Win,Home,2009-02-18,3,6,9,12,15,4,4,4,5,2,5,8,10,1,1.0,17.0,-16.0,7
10951,10951,2008-09,2008,2009,Man United,Blackburn,Win,Home,2009-02-21,3,6,9,12,15,1,2,5,6,5,7,7,9,1,1.0,7.0,-6.0,7
10952,10952,2008-09,2008,2009,Man United,Newcastle,Win,Away,2009-03-04,3,6,9,12,15,1,4,5,5,5,5,7,10,0,1.0,12.0,-11.0,8
10953,10953,2008-09,2008,2009,Man United,Liverpool,Loss,Home,2009-03-14,0,6,9,12,15,3,4,7,10,3,5,5,5,1,1.0,4.0,-3.0,8
10954,10954,2008-09,2008,2009,Man United,Fulham,Loss,Away,2009-03-21,0,3,6,9,12,3,3,4,7,0,3,5,5,0,1.0,17.0,-16.0,8
10955,10955,2008-09,2008,2009,Man United,Aston Villa,Win,Home,2009-04-05,3,0,3,6,9,0,0,1,1,0,3,5,8,1,1.0,6.0,-5.0,9
10956,10956,2008-09,2008,2009,Man United,Sunderland,Win,Away,2009-04-11,3,3,3,6,9,0,0,1,1,3,3,5,8,0,1.0,15.0,-14.0,9
10957,10957,2008-09,2008,2009,Man United,Portsmouth,Win,Home,2009-04-22,3,6,6,6,9,4,5,8,9,2,1,-2,0,1,1.0,8.0,-7.0,9
10958,10958,2008-09,2008,2009,Man United,Tottenham,Win,Home,2009-04-25,3,6,9,9,9,6,6,9,12,0,3,0,-3,1,1.0,11.0,-10.0,9
10959,10959,2008-09,2008,2009,Man United,Middlesbrough,Win,Away,2009-05-02,3,6,9,12,12,1,4,4,4,5,5,8,8,0,1.0,13.0,-12.0,10
10960,10960,2008-09,2008,2009,Man United,Man City,Win,Home,2009-05-10,3,6,9,12,15,6,9,9,9,0,0,3,6,1,1.0,9.0,-8.0,10
10961,10961,2008-09,2008,2009,Man United,Wigan,Win,Away,2009-05-13,3,6,9,12,15,1,1,1,1,5,8,11,14,0,1.0,14.0,-13.0,10
10962,10962,2008-09,2008,2009,Man United,Arsenal,Draw,Home,2009-05-16,1,6,9,12,15,3,6,7,10,3,3,5,5,1,1.0,3.0,-2.0,10
10963,10963,2008-09,2008,2009,Man United,Hull,Win,Away,2009-05-24,3,4,7,10,13,1,1,1,1,3,6,9,12,0,1.0,21.0,-20.0,10
10964,10964,2009-10,2009,2010,Man United,Birmingham,Win,Home,2009-08-16,3,4,7,10,13,3,4,4,5,1,3,6,8,1,1.0,21.0,-20.0,1
10965,10965,2009-10,2009,2010,Man United,Burnley,Loss,Away,2009-08-19,0,6,7,10,13,0,0,0,0,6,7,10,13,0,1.0,21.0,-20.0,1
10966,10966,2009-10,2009,2010,Man United,Wigan,Win,Away,2009-08-22,3,3,6,7,10,3,6,6,6,0,0,1,4,0,1.0,11.0,-10.0,1
10967,10967,2009-10,2009,2010,Man United,Arsenal,Win,Home,2009-08-29,3,3,6,9,10,6,9,10,10,-3,-3,-1,0,1,1.0,4.0,-3.0,1
10968,10968,2009-10,2009,2010,Man United,Tottenham,Win,Away,2009-09-12,3,6,6,9,12,6,9,12,12,0,-3,-3,0,0,1.0,8.0,-7.0,2
10969,10969,2009-10,2009,2010,Man United,Man City,Win,Home,2009-09-20,3,6,9,9,12,6,9,12,15,0,0,-3,-3,1,1.0,10.0,-9.0,2
10970,10970,2009-10,2009,2010,Man United,Stoke,Win,Away,2009-09-26,3,6,9,12,12,1,4,5,5,5,5,7,7,0,1.0,12.0,-11.0,2
10971,10971,2009-10,2009,2010,Man United,Sunderland,Draw,Home,2009-10-03,1,6,9,12,15,3,6,6,9,3,3,6,6,1,1.0,16.0,-15.0,3
10972,10972,2009-10,2009,2010,Man United,Bolton,Win,Home,2009-10-17,3,4,7,10,13,4,5,8,8,0,2,2,5,1,1.0,13.0,-12.0,3
10973,10973,2009-10,2009,2010,Man United,Liverpool,Loss,Away,2009-10-25,0,4,7,10,13,0,3,6,9,4,4,4,4,0,1.0,2.0,-1.0,3
10974,10974,2009-10,2009,2010,Man United,Blackburn,Win,Home,2009-10-31,3,3,4,7,10,3,3,6,6,0,1,1,4,1,1.0,15.0,-14.0,3
10975,10975,2009-10,2009,2010,Man United,Chelsea,Loss,Away,2009-11-08,0,3,6,7,10,6,6,9,9,-3,0,-2,1,0,1.0,3.0,-2.0,4
10976,10976,2009-10,2009,2010,Man United,Everton,Win,Home,2009-11-21,3,3,3,6,7,4,4,5,6,-1,-1,1,1,1,1.0,5.0,-4.0,4
10977,10977,2009-10,2009,2010,Man United,Portsmouth,Win,Away,2009-11-28,3,3,6,6,9,0,3,4,4,3,3,2,5,0,1.0,14.0,-13.0,4
10978,10978,2009-10,2009,2010,Man United,West Ham,Win,Away,2009-12-05,3,6,6,9,9,4,4,7,8,2,2,2,1,0,1.0,9.0,-8.0,5
10979,10979,2009-10,2009,2010,Man United,Aston Villa,Loss,Home,2009-12-12,0,6,9,9,12,4,5,8,8,2,4,1,4,1,1.0,6.0,-5.0,5
10980,10980,2009-10,2009,2010,Man United,Wolves,Win,Home,2009-12-15,3,3,6,9,9,6,6,6,6,-3,0,3,3,1,1.0,21.0,-20.0,5
10981,10981,2009-10,2009,2010,Man United,Fulham,Loss,Away,2009-12-19,0,3,6,9,12,4,5,8,8,-1,1,1,4,0,1.0,7.0,-6.0,5
10982,10982,2009-10,2009,2010,Man United,Hull,Win,Away,2009-12-27,3,3,3,6,9,1,1,2,5,2,2,4,4,0,1.0,17.0,-16.0,5
10983,10983,2009-10,2009,2010,Man United,Wigan,Win,Home,2009-12-30,3,3,6,6,9,1,2,2,5,2,4,4,4,1,1.0,11.0,-10.0,5
10984,10984,2009-10,2009,2010,Man United,Birmingham,Draw,Away,2010-01-09,1,6,6,9,9,4,5,8,11,2,1,1,-2,0,1.0,21.0,-20.0,6
10985,10985,2009-10,2009,2010,Man United,Burnley,Win,Home,2010-01-16,3,4,7,7,10,1,1,2,3,3,6,5,7,1,1.0,21.0,-20.0,6
10986,10986,2009-10,2009,2010,Man United,Hull,Win,Home,2010-01-23,3,4,7,10,10,2,2,2,3,2,5,8,7,1,1.0,17.0,-16.0,6
10987,10987,2009-10,2009,2010,Man United,Arsenal,Win,Away,2010-01-31,3,6,7,10,13,4,7,8,11,2,0,2,2,0,1.0,4.0,-3.0,6
10988,10988,2009-10,2009,2010,Man United,Portsmouth,Win,Home,2010-02-06,3,6,9,10,13,0,1,1,1,6,8,9,12,1,1.0,14.0,-13.0,7
10989,10989,2009-10,2009,2010,Man United,Aston Villa,Draw,Away,2010-02-10,1,6,9,12,13,4,5,6,6,2,4,6,7,0,1.0,6.0,-5.0,7
10990,10990,2009-10,2009,2010,Man United,Everton,Loss,Away,2010-02-20,0,4,7,10,13,3,6,9,12,1,1,1,1,0,1.0,5.0,-4.0,7
10991,10991,2009-10,2009,2010,Man United,West Ham,Win,Home,2010-02-23,3,1,4,7,10,6,6,7,8,-5,-2,0,2,1,1.0,9.0,-8.0,7
10992,10992,2009-10,2009,2010,Man United,Wolves,Win,Away,2010-03-06,3,3,4,7,10,0,3,3,4,3,1,4,6,0,1.0,21.0,-20.0,8
10993,10993,2009-10,2009,2010,Man United,Fulham,Win,Home,2010-03-14,3,6,6,7,10,4,7,8,11,2,-1,-1,-1,1,1.0,7.0,-6.0,8
10994,10994,2009-10,2009,2010,Man United,Liverpool,Win,Home,2010-03-21,3,6,9,9,10,3,6,7,7,3,3,2,3,1,1.0,2.0,-1.0,8
10995,10995,2009-10,2009,2010,Man United,Bolton,Win,Away,2010-03-27,3,6,9,12,12,3,3,6,9,3,6,6,3,0,1.0,13.0,-12.0,8
10996,10996,2009-10,2009,2010,Man United,Chelsea,Loss,Home,2010-04-03,0,6,9,12,15,6,7,10,10,0,2,2,5,1,1.0,3.0,-2.0,9
10997,10997,2009-10,2009,2010,Man United,Blackburn,Draw,Away,2010-04-11,1,3,6,9,12,4,7,8,8,-1,-1,1,4,0,1.0,15.0,-14.0,9
10998,10998,2009-10,2009,2010,Man United,Man City,Win,Away,2010-04-17,3,1,4,7,10,6,9,9,12,-5,-5,-2,-2,0,1.0,10.0,-9.0,9
10999,10999,2009-10,2009,2010,Man United,Tottenham,Win,Home,2010-04-24,3,4,4,7,10,6,6,9,12,-2,-2,-2,-2,1,1.0,8.0,-7.0,9
11000,11000,2009-10,2009,2010,Man United,Sunderland,Win,Away,2010-05-02,3,6,7,7,10,6,6,9,9,0,1,-2,1,0,1.0,16.0,-15.0,10
11001,11001,2009-10,2009,2010,Man United,Stoke,Win,Home,2010-05-09,3,6,9,10,10,4,4,4,5,2,5,6,5,1,1.0,12.0,-11.0,10
11002,11002,2010-11,2010,2011,Man United,Newcastle,Win,Home,2010-08-16,3,6,9,12,13,0,3,3,4,6,6,9,9,1,2.0,21.0,-19.0,1
11003,11003,2010-11,2010,2011,Man United,Fulham,Draw,Away,2010-08-22,1,6,9,12,15,1,1,4,4,5,8,8,11,0,2.0,12.0,-10.0,1
11004,11004,2010-11,2010,2011,Man United,West Ham,Win,Home,2010-08-28,3,4,7,10,13,0,1,1,4,4,6,9,9,1,2.0,17.0,-15.0,1
11005,11005,2010-11,2010,2011,Man United,Everton,Draw,Away,2010-09-11,1,4,7,10,13,1,1,4,5,3,6,6,8,0,2.0,8.0,-6.0,2
11006,11006,2010-11,2010,2011,Man United,Liverpool,Win,Home,2010-09-19,3,4,5,8,11,4,4,5,6,0,1,3,5,1,2.0,7.0,-5.0,2
11007,11007,2010-11,2010,2011,Man United,Bolton,Draw,Away,2010-09-26,1,4,7,8,11,1,2,5,6,3,5,3,5,0,2.0,14.0,-12.0,2
11008,11008,2010-11,2010,2011,Man United,Sunderland,Draw,Away,2010-10-02,1,4,5,8,9,2,3,6,6,2,2,2,3,0,2.0,13.0,-11.0,3
11009,11009,2010-11,2010,2011,Man United,West Brom,Draw,Home,2010-10-16,1,2,5,6,9,4,7,8,8,-2,-2,-2,1,1,2.0,21.0,-19.0,3
11010,11010,2010-11,2010,2011,Man United,Stoke,Win,Away,2010-10-24,3,2,3,6,7,3,6,7,10,-1,-3,-1,-3,0,2.0,11.0,-9.0,3
11011,11011,2010-11,2010,2011,Man United,Tottenham,Win,Home,2010-10-30,3,4,5,6,9,4,7,7,10,0,-2,-1,-1,1,2.0,4.0,-2.0,3
11012,11012,2010-11,2010,2011,Man United,Wolves,Win,Home,2010-11-06,3,6,7,8,9,3,4,4,4,3,3,4,5,1,2.0,15.0,-13.0,4
11013,11013,2010-11,2010,2011,Man United,Man City,Draw,Away,2010-11-10,1,6,9,10,11,3,3,6,9,3,6,4,2,0,2.0,5.0,-3.0,4
11014,11014,2010-11,2010,2011,Man United,Aston Villa,Draw,Away,2010-11-13,1,4,7,10,11,4,5,5,6,0,2,5,5,0,2.0,6.0,-4.0,4
11015,11015,2010-11,2010,2011,Man United,Wigan,Win,Home,2010-11-20,3,2,5,8,11,4,4,4,5,-2,1,4,6,1,2.0,16.0,-14.0,4
11016,11016,2010-11,2010,2011,Man United,Blackburn,Win,Home,2010-11-27,3,4,5,8,11,3,6,9,9,1,-1,-1,2,1,2.0,10.0,-8.0,4
11017,11017,2010-11,2010,2011,Man United,Arsenal,Win,Home,2010-12-13,3,6,7,8,11,6,6,9,12,0,1,-1,-1,1,2.0,3.0,-1.0,5
11018,11018,2010-11,2010,2011,Man United,Sunderland,Win,Home,2010-12-26,3,6,9,10,11,4,7,7,8,2,2,3,3,1,2.0,13.0,-11.0,5
11019,11019,2010-11,2010,2011,Man United,Birmingham,Draw,Away,2010-12-28,1,6,9,12,13,1,2,5,6,5,7,7,7,0,2.0,9.0,-7.0,5
11020,11020,2010-11,2010,2011,Man United,West Brom,Win,Away,2011-01-01,3,4,7,10,13,0,0,3,6,4,7,7,7,0,2.0,21.0,-19.0,6
11021,11021,2010-11,2010,2011,Man United,Stoke,Win,Home,2011-01-04,3,4,7,10,13,3,6,6,7,1,1,4,6,1,2.0,11.0,-9.0,6
11022,11022,2010-11,2010,2011,Man United,Tottenham,Draw,Away,2011-01-16,1,6,7,10,13,3,6,9,10,3,1,1,3,0,2.0,4.0,-2.0,6
11023,11023,2010-11,2010,2011,Man United,Birmingham,Win,Home,2011-01-22,3,4,7,8,11,4,4,5,5,0,3,3,6,1,2.0,9.0,-7.0,6
11024,11024,2010-11,2010,2011,Man United,Blackpool,Win,Away,2011-01-25,3,4,7,10,11,0,3,3,3,4,4,7,8,0,2.0,21.0,-19.0,6
11025,11025,2010-11,2010,2011,Man United,Aston Villa,Win,Home,2011-02-01,3,6,7,10,13,6,7,7,8,0,0,3,5,1,2.0,6.0,-4.0,7
11026,11026,2010-11,2010,2011,Man United,Wolves,Loss,Away,2011-02-05,0,6,9,10,13,0,0,3,3,6,9,7,10,0,2.0,15.0,-13.0,7
11027,11027,2010-11,2010,2011,Man United,Man City,Win,Home,2011-02-12,3,3,6,9,10,4,4,7,8,-1,2,2,2,1,2.0,5.0,-3.0,7
11028,11028,2010-11,2010,2011,Man United,Wigan,Win,Away,2011-02-26,3,3,6,9,12,4,5,5,5,-1,1,4,7,0,2.0,16.0,-14.0,7
11029,11029,2010-11,2010,2011,Man United,Chelsea,Loss,Away,2011-03-01,0,6,6,9,12,1,4,7,10,5,2,2,2,0,2.0,1.0,1.0,8
11030,11030,2010-11,2010,2011,Man United,Liverpool,Loss,Away,2011-03-06,0,3,6,6,9,1,4,7,10,2,2,-1,-1,0,2.0,7.0,-5.0,8
11031,11031,2010-11,2010,2011,Man United,Bolton,Win,Home,2011-03-19,3,0,3,6,6,4,7,7,10,-4,-4,-1,-4,1,2.0,14.0,-12.0,8
11032,11032,2010-11,2010,2011,Man United,West Ham,Win,Away,2011-04-02,3,3,3,6,9,4,7,8,8,-1,-4,-2,1,0,2.0,17.0,-15.0,9
11033,11033,2010-11,2010,2011,Man United,Fulham,Win,Home,2011-04-09,3,6,6,6,9,3,6,7,8,3,0,-1,1,1,2.0,12.0,-10.0,9
11034,11034,2010-11,2010,2011,Man United,Newcastle,Draw,Away,2011-04-19,1,6,9,9,9,3,3,3,4,3,6,6,5,0,2.0,21.0,-19.0,9
11035,11035,2010-11,2010,2011,Man United,Everton,Win,Home,2011-04-23,3,4,7,10,10,6,7,10,11,-2,0,0,-1,1,2.0,8.0,-6.0,9
11036,11036,2010-11,2010,2011,Man United,Arsenal,Loss,Away,2011-05-01,0,4,7,10,13,1,2,5,6,3,5,5,7,0,2.0,3.0,-1.0,10
11037,11037,2010-11,2010,2011,Man United,Chelsea,Win,Home,2011-05-08,3,3,4,7,10,6,9,12,15,-3,-5,-5,-5,1,2.0,1.0,1.0,10
11038,11038,2010-11,2010,2011,Man United,Blackburn,Draw,Away,2011-05-14,1,3,6,7,10,4,4,4,5,-1,2,3,5,0,2.0,10.0,-8.0,10
11039,11039,2010-11,2010,2011,Man United,Blackpool,Win,Home,2011-05-22,3,4,4,7,8,4,5,6,6,0,-1,1,2,1,2.0,21.0,-19.0,10
11040,11040,2011-12,2011,2012,Man United,West Brom,Win,Away,2011-08-14,3,4,7,7,10,4,4,7,8,0,3,0,2,0,1.0,11.0,-10.0,1
11041,11041,2011-12,2011,2012,Man United,Tottenham,Win,Home,2011-08-22,3,6,7,10,10,6,6,7,7,0,1,3,3,1,1.0,5.0,-4.0,1
11042,11042,2011-12,2011,2012,Man United,Arsenal,Win,Home,2011-08-28,3,6,9,10,13,1,2,2,2,5,7,8,11,1,1.0,4.0,-3.0,1
11043,11043,2011-12,2011,2012,Man United,Bolton,Win,Away,2011-09-10,3,6,9,12,13,0,3,3,3,6,6,9,10,0,1.0,14.0,-13.0,2
11044,11044,2011-12,2011,2012,Man United,Chelsea,Win,Home,2011-09-18,3,6,9,12,15,6,9,10,10,0,0,2,5,1,1.0,2.0,-1.0,2
11045,11045,2011-12,2011,2012,Man United,Stoke,Draw,Away,2011-09-24,1,6,9,12,15,3,6,7,8,3,3,5,7,0,1.0,13.0,-12.0,2
11046,11046,2011-12,2011,2012,Man United,Norwich,Win,Home,2011-10-01,3,4,7,10,13,6,6,6,7,-2,1,4,6,1,1.0,21.0,-20.0,3
11047,11047,2011-12,2011,2012,Man United,Liverpool,Draw,Away,2011-10-15,1,4,7,10,13,6,6,6,9,-2,1,4,4,0,1.0,6.0,-5.0,3
11048,11048,2011-12,2011,2012,Man United,Man City,Loss,Home,2011-10-23,0,4,5,8,11,6,9,10,13,-2,-4,-2,-2,1,1.0,3.0,-2.0,3
11049,11049,2011-12,2011,2012,Man United,Everton,Win,Away,2011-10-29,3,1,4,5,8,3,3,3,6,-2,1,2,2,0,1.0,7.0,-6.0,3
11050,11050,2011-12,2011,2012,Man United,Sunderland,Win,Home,2011-11-05,3,3,4,7,8,4,4,5,5,-1,0,2,3,1,1.0,10.0,-9.0,4
11051,11051,2011-12,2011,2012,Man United,Swansea,Win,Away,2011-11-19,3,6,6,7,10,4,5,5,8,2,1,2,2,0,1.0,21.0,-20.0,4
11052,11052,2011-12,2011,2012,Man United,Newcastle,Draw,Home,2011-11-26,1,6,9,9,10,3,6,9,10,3,3,0,0,1,1.0,12.0,-11.0,4
11053,11053,2011-12,2011,2012,Man United,Aston Villa,Win,Away,2011-12-03,3,4,7,10,10,1,4,5,5,3,3,5,5,0,1.0,9.0,-8.0,5
11054,11054,2011-12,2011,2012,Man United,Wolves,Win,Home,2011-12-10,3,4,7,10,13,3,3,6,6,1,4,4,7,1,1.0,17.0,-16.0,5
11055,11055,2011-12,2011,2012,Man United,QPR,Win,Away,2011-12-18,3,6,7,10,13,1,1,4,4,5,6,6,9,0,1.0,21.0,-20.0,5
11056,11056,2011-12,2011,2012,Man United,Fulham,Win,Away,2011-12-21,3,6,9,10,13,3,6,7,8,3,3,3,5,0,1.0,8.0,-7.0,5
11057,11057,2011-12,2011,2012,Man United,Wigan,Win,Home,2011-12-26,3,6,9,12,13,2,5,5,8,4,4,7,5,1,1.0,16.0,-15.0,5
11058,11058,2011-12,2011,2012,Man United,Blackburn,Loss,Home,2011-12-31,0,6,9,12,15,1,1,1,4,5,8,11,11,1,1.0,15.0,-14.0,5
11059,11059,2011-12,2011,2012,Man United,Newcastle,Loss,Away,2012-01-04,0,3,6,9,12,3,3,4,4,0,3,5,8,0,1.0,12.0,-11.0,6
11060,11060,2011-12,2011,2012,Man United,Bolton,Win,Home,2012-01-14,3,0,3,6,9,4,4,7,7,-4,-1,-1,2,1,1.0,14.0,-13.0,6
11061,11061,2011-12,2011,2012,Man United,Arsenal,Win,Away,2012-01-22,3,3,3,6,9,0,3,4,7,3,0,2,2,0,1.0,4.0,-3.0,6
11062,11062,2011-12,2011,2012,Man United,Stoke,Win,Home,2012-01-31,3,6,6,6,9,1,4,5,6,5,2,1,3,1,1.0,13.0,-12.0,6
11063,11063,2011-12,2011,2012,Man United,Chelsea,Draw,Away,2012-02-05,1,6,9,9,9,2,5,8,8,4,4,1,1,0,1.0,2.0,-1.0,7
11064,11064,2011-12,2011,2012,Man United,Liverpool,Win,Home,2012-02-11,3,4,7,10,10,4,4,5,5,0,3,5,5,1,1.0,6.0,-5.0,7
11065,11065,2011-12,2011,2012,Man United,Norwich,Win,Away,2012-02-26,3,4,7,10,13,6,6,7,10,-2,1,3,3,0,1.0,21.0,-20.0,7
11066,11066,2011-12,2011,2012,Man United,Tottenham,Win,Away,2012-03-04,3,6,7,10,13,3,4,7,7,3,3,3,6,0,1.0,5.0,-4.0,8
11067,11067,2011-12,2011,2012,Man United,West Brom,Win,Home,2012-03-11,3,6,9,10,13,6,9,9,10,0,0,1,3,1,1.0,11.0,-10.0,8
11068,11068,2011-12,2011,2012,Man United,Wolves,Win,Away,2012-03-18,3,6,9,12,13,0,1,1,4,6,8,11,9,0,1.0,17.0,-16.0,8
11069,11069,2011-12,2011,2012,Man United,Fulham,Win,Home,2012-03-26,3,6,9,12,15,0,3,6,9,6,6,6,6,1,1.0,8.0,-7.0,8
11070,11070,2011-12,2011,2012,Man United,Blackburn,Win,Away,2012-04-02,3,6,9,12,15,3,6,7,7,3,3,5,8,0,1.0,15.0,-14.0,9
11071,11071,2011-12,2011,2012,Man United,QPR,Win,Home,2012-04-08,3,6,9,12,15,3,6,6,7,3,3,6,8,1,1.0,21.0,-20.0,9
11072,11072,2011-12,2011,2012,Man United,Wigan,Loss,Away,2012-04-11,0,6,9,12,15,3,6,7,8,3,3,5,7,0,1.0,16.0,-15.0,9
11073,11073,2011-12,2011,2012,Man United,Aston Villa,Win,Home,2012-04-15,3,3,6,9,12,2,2,2,5,1,4,7,7,1,1.0,9.0,-8.0,9
11074,11074,2011-12,2011,2012,Man United,Everton,Draw,Home,2012-04-22,1,3,6,9,12,4,7,10,10,-1,-1,-1,2,1,1.0,7.0,-6.0,9
11075,11075,2011-12,2011,2012,Man United,Man City,Loss,Away,2012-04-30,0,4,4,7,10,6,9,9,10,-2,-5,-2,0,0,1.0,3.0,-2.0,9
11076,11076,2011-12,2011,2012,Man United,Swansea,Win,Home,2012-05-06,3,1,4,4,7,2,5,5,5,-1,-1,-1,2,1,1.0,21.0,-20.0,10
11077,11077,2011-12,2011,2012,Man United,Sunderland,Win,Away,2012-05-13,3,3,4,7,7,1,2,3,3,2,2,4,4,0,1.0,10.0,-9.0,10
11078,11078,2012-13,2012,2013,Man United,Everton,Loss,Away,2012-08-20,0,6,6,7,10,4,5,8,9,2,1,-1,1,0,2.0,7.0,-5.0,1
11079,11079,2012-13,2012,2013,Man United,Fulham,Win,Home,2012-08-25,3,3,6,6,7,3,6,9,9,0,0,-3,-2,1,2.0,9.0,-7.0,1
11080,11080,2012-13,2012,2013,Man United,Southampton,Win,Away,2012-09-02,3,3,6,9,9,0,0,1,4,3,6,8,5,0,2.0,21.0,-19.0,2
11081,11081,2012-13,2012,2013,Man United,Wigan,Win,Home,2012-09-15,3,6,6,9,12,4,4,7,10,2,2,2,2,1,2.0,15.0,-13.0,2
11082,11082,2012-13,2012,2013,Man United,Liverpool,Win,Away,2012-09-23,3,6,9,9,12,1,2,2,2,5,7,7,10,0,2.0,8.0,-6.0,2
11083,11083,2012-13,2012,2013,Man United,Tottenham,Loss,Home,2012-09-29,0,6,9,12,12,6,7,8,8,0,2,4,4,1,2.0,4.0,-2.0,2
11084,11084,2012-13,2012,2013,Man United,Newcastle,Win,Away,2012-10-07,3,3,6,9,12,4,5,6,6,-1,1,3,6,0,2.0,5.0,-3.0,3
11085,11085,2012-13,2012,2013,Man United,Stoke,Win,Home,2012-10-20,3,3,6,9,12,4,4,5,6,-1,2,4,6,1,2.0,14.0,-12.0,3
11086,11086,2012-13,2012,2013,Man United,Chelsea,Win,Away,2012-10-28,3,6,6,9,12,6,9,12,13,0,-3,-3,-1,0,2.0,6.0,-4.0,3
11087,11087,2012-13,2012,2013,Man United,Arsenal,Win,Home,2012-11-03,3,6,9,9,12,3,6,6,7,3,3,3,5,1,2.0,3.0,-1.0,4
11088,11088,2012-13,2012,2013,Man United,Aston Villa,Win,Away,2012-11-10,3,6,9,12,12,4,4,4,5,2,5,8,7,0,2.0,16.0,-14.0,4
11089,11089,2012-13,2012,2013,Man United,Norwich,Loss,Away,2012-11-17,0,6,9,12,15,4,5,8,8,2,4,4,7,0,2.0,12.0,-10.0,4
11090,11090,2012-13,2012,2013,Man United,QPR,Win,Home,2012-11-24,3,3,6,9,12,0,1,1,2,3,5,8,10,1,2.0,17.0,-15.0,4
11091,11091,2012-13,2012,2013,Man United,West Ham,Win,Home,2012-11-28,3,3,6,9,12,1,4,5,5,2,2,4,7,1,2.0,21.0,-19.0,4
11092,11092,2012-13,2012,2013,Man United,Reading,Win,Away,2012-12-01,3,6,6,9,12,0,3,4,5,6,3,5,7,0,2.0,21.0,-19.0,5
11093,11093,2012-13,2012,2013,Man United,Man City,Win,Away,2012-12-09,3,6,9,9,12,4,5,8,11,2,4,1,1,0,2.0,1.0,1.0,5
11094,11094,2012-13,2012,2013,Man United,Sunderland,Win,Home,2012-12-15,3,6,9,12,12,3,3,4,4,3,6,8,8,1,2.0,13.0,-11.0,5
11095,11095,2012-13,2012,2013,Man United,Swansea,Draw,Away,2012-12-23,1,6,9,12,15,0,3,6,7,6,6,6,8,0,2.0,11.0,-9.0,5
11096,11096,2012-13,2012,2013,Man United,Newcastle,Win,Home,2012-12-26,3,4,7,10,13,3,3,6,6,1,4,4,7,1,2.0,5.0,-3.0,5
11097,11097,2012-13,2012,2013,Man United,West Brom,Win,Home,2012-12-29,3,4,7,10,13,6,7,7,7,-2,0,3,6,1,2.0,10.0,-8.0,5
11098,11098,2012-13,2012,2013,Man United,Wigan,Win,Away,2013-01-01,3,6,7,10,13,3,3,3,4,3,4,7,9,0,2.0,15.0,-13.0,6
11099,11099,2012-13,2012,2013,Man United,Liverpool,Win,Home,2013-01-13,3,6,9,10,13,6,6,9,9,0,3,1,4,1,2.0,8.0,-6.0,6
11100,11100,2012-13,2012,2013,Man United,Tottenham,Draw,Away,2013-01-20,1,6,9,12,13,4,7,10,11,2,2,2,2,0,2.0,4.0,-2.0,6
11101,11101,2012-13,2012,2013,Man United,Southampton,Win,Home,2013-01-30,3,4,7,10,13,2,5,6,7,2,2,4,6,1,2.0,21.0,-19.0,6
11102,11102,2012-13,2012,2013,Man United,Fulham,Win,Away,2013-02-02,3,4,7,10,13,3,4,7,7,1,3,3,6,0,2.0,9.0,-7.0,7
11103,11103,2012-13,2012,2013,Man United,Everton,Win,Home,2013-02-10,3,6,7,10,13,4,5,6,9,2,2,4,4,1,2.0,7.0,-5.0,7
11104,11104,2012-13,2012,2013,Man United,QPR,Win,Away,2013-02-23,3,6,9,10,13,1,2,3,4,5,7,7,9,0,2.0,17.0,-15.0,7
11105,11105,2012-13,2012,2013,Man United,Norwich,Win,Home,2013-03-02,3,6,9,12,13,4,5,6,6,2,4,6,7,1,2.0,12.0,-10.0,8
11106,11106,2012-13,2012,2013,Man United,Reading,Win,Home,2013-03-16,3,6,9,12,15,0,0,0,3,6,9,12,12,1,2.0,21.0,-19.0,8
11107,11107,2012-13,2012,2013,Man United,Sunderland,Win,Away,2013-03-30,3,6,9,12,15,1,2,2,2,5,7,10,13,0,2.0,13.0,-11.0,8
11108,11108,2012-13,2012,2013,Man United,Man City,Loss,Home,2013-04-08,0,6,9,12,15,3,6,9,9,3,3,3,6,1,2.0,1.0,1.0,9
11109,11109,2012-13,2012,2013,Man United,Stoke,Win,Away,2013-04-14,3,3,6,9,12,0,1,1,1,3,5,8,11,0,2.0,14.0,-12.0,9
11110,11110,2012-13,2012,2013,Man United,West Ham,Draw,Away,2013-04-17,1,3,6,9,12,2,5,5,8,1,1,4,4,0,2.0,21.0,-19.0,9
11111,11111,2012-13,2012,2013,Man United,Aston Villa,Win,Home,2013-04-22,3,4,4,7,10,4,4,7,10,0,0,0,0,1,2.0,16.0,-14.0,9
11112,11112,2012-13,2012,2013,Man United,Arsenal,Draw,Away,2013-04-28,1,4,7,7,10,4,7,10,13,0,0,-3,-3,0,2.0,3.0,-1.0,9
11113,11113,2012-13,2012,2013,Man United,Chelsea,Loss,Home,2013-05-05,0,4,5,8,8,4,7,10,10,0,-2,-2,-2,1,2.0,6.0,-4.0,10
11114,11114,2012-13,2012,2013,Man United,Swansea,Win,Home,2013-05-12,3,1,4,5,8,4,4,5,6,-3,0,0,2,1,2.0,11.0,-9.0,10
11115,11115,2012-13,2012,2013,Man United,West Brom,Draw,Away,2013-05-19,1,3,4,7,8,0,0,3,4,3,4,4,4,0,2.0,10.0,-8.0,10
11116,11116,2013-14,2013,2014,Man United,Swansea,Win,Away,2013-08-17,3,4,4,5,8,0,3,4,4,4,1,1,4,0,1.0,9.0,-8.0,1
11117,11117,2013-14,2013,2014,Man United,Chelsea,Draw,Home,2013-08-26,1,4,7,7,8,6,9,12,13,-2,-2,-5,-5,1,1.0,3.0,-2.0,1
11118,11118,2013-14,2013,2014,Man United,Liverpool,Loss,Away,2013-09-01,0,4,5,8,8,6,9,12,13,-2,-4,-4,-5,0,1.0,7.0,-6.0,2
11119,11119,2013-14,2013,2014,Man United,Crystal Palace,Win,Home,2013-09-14,3,1,4,5,8,3,3,4,5,-2,1,1,3,1,1.0,21.0,-20.0,2
11120,11120,2013-14,2013,2014,Man United,Man City,Loss,Away,2013-09-22,0,3,4,7,8,4,4,7,7,-1,0,0,1,0,1.0,2.0,-1.0,2
11121,11121,2013-14,2013,2014,Man United,West Brom,Loss,Home,2013-09-28,0,3,3,4,7,4,4,5,5,-1,-1,-1,2,1,1.0,8.0,-7.0,2
11122,11122,2013-14,2013,2014,Man United,Sunderland,Win,Away,2013-10-05,3,0,3,3,4,0,0,0,1,0,3,3,3,0,1.0,17.0,-16.0,3
11123,11123,2013-14,2013,2014,Man United,Southampton,Draw,Home,2013-10-19,1,3,3,6,6,6,9,10,10,-3,-6,-4,-4,1,1.0,14.0,-13.0,3
11124,11124,2013-14,2013,2014,Man United,Stoke,Win,Home,2013-10-26,3,4,4,4,7,1,1,1,2,3,3,3,5,1,1.0,13.0,-12.0,3
11125,11125,2013-14,2013,2014,Man United,Fulham,Win,Away,2013-11-02,3,4,7,7,7,3,6,6,6,1,1,1,1,0,1.0,12.0,-11.0,4
11126,11126,2013-14,2013,2014,Man United,Arsenal,Win,Home,2013-11-10,3,6,7,10,10,6,9,10,13,0,-2,0,-3,1,1.0,4.0,-3.0,4
11127,11127,2013-14,2013,2014,Man United,Cardiff,Draw,Away,2013-11-24,1,6,9,10,13,3,4,4,4,3,5,6,9,0,1.0,21.0,-20.0,4
11128,11128,2013-14,2013,2014,Man United,Tottenham,Draw,Away,2013-12-01,1,4,7,10,11,0,1,4,7,4,6,6,4,0,1.0,5.0,-4.0,5
11129,11129,2013-14,2013,2014,Man United,Everton,Loss,Home,2013-12-04,0,2,5,8,11,4,5,6,9,-2,0,2,2,1,1.0,6.0,-5.0,5
11130,11130,2013-14,2013,2014,Man United,Newcastle,Loss,Home,2013-12-07,0,1,2,5,8,3,6,9,12,-2,-4,-4,-4,1,1.0,16.0,-15.0,5
11131,11131,2013-14,2013,2014,Man United,Aston Villa,Win,Away,2013-12-15,3,0,1,2,5,3,4,5,8,-3,-3,-3,-3,0,1.0,15.0,-14.0,5
11132,11132,2013-14,2013,2014,Man United,West Ham,Win,Home,2013-12-21,3,3,3,4,5,1,1,4,4,2,2,0,1,1,1.0,10.0,-9.0,5
11133,11133,2013-14,2013,2014,Man United,Hull,Win,Away,2013-12-26,3,6,6,6,7,2,3,3,6,4,3,3,1,0,1.0,21.0,-20.0,5
11134,11134,2013-14,2013,2014,Man United,Norwich,Win,Away,2013-12-28,3,6,9,9,9,1,2,5,5,5,7,4,4,0,1.0,11.0,-10.0,5
11135,11135,2013-14,2013,2014,Man United,Tottenham,Loss,Home,2014-01-01,0,6,9,12,12,4,7,7,10,2,2,5,2,1,1.0,5.0,-4.0,6
11136,11136,2013-14,2013,2014,Man United,Swansea,Win,Home,2014-01-11,3,3,6,9,12,1,1,1,2,2,5,8,10,1,1.0,9.0,-8.0,6
11137,11137,2013-14,2013,2014,Man United,Chelsea,Loss,Away,2014-01-19,0,3,6,9,12,6,9,12,13,-3,-3,-3,-1,0,1.0,3.0,-2.0,6
11138,11138,2013-14,2013,2014,Man United,Cardiff,Win,Home,2014-01-28,3,3,3,6,9,0,0,1,1,3,3,5,8,1,1.0,21.0,-20.0,6
11139,11139,2013-14,2013,2014,Man United,Stoke,Loss,Away,2014-02-01,0,3,6,6,9,0,0,1,1,3,6,5,8,0,1.0,13.0,-12.0,7
11140,11140,2013-14,2013,2014,Man United,Fulham,Draw,Home,2014-02-09,1,3,3,6,6,0,0,0,3,3,3,6,3,1,1.0,12.0,-11.0,7
11141,11141,2013-14,2013,2014,Man United,Arsenal,Draw,Away,2014-02-12,1,1,4,4,7,3,4,7,10,-2,0,-3,-3,0,1.0,4.0,-3.0,7
11142,11142,2013-14,2013,2014,Man United,Crystal Palace,Win,Away,2014-02-22,3,2,2,5,5,3,6,9,9,-1,-4,-4,-4,0,1.0,21.0,-20.0,7
11143,11143,2013-14,2013,2014,Man United,West Brom,Win,Away,2014-03-08,3,4,5,5,8,2,2,3,3,2,3,2,5,0,1.0,8.0,-7.0,8
11144,11144,2013-14,2013,2014,Man United,Liverpool,Loss,Home,2014-03-16,0,6,7,8,8,6,9,12,13,0,-2,-4,-5,1,1.0,7.0,-6.0,8
11145,11145,2013-14,2013,2014,Man United,West Ham,Win,Away,2014-03-22,3,3,6,7,8,0,3,6,9,3,3,1,-1,0,1.0,10.0,-9.0,8
11146,11146,2013-14,2013,2014,Man United,Man City,Loss,Home,2014-03-25,0,3,6,9,10,6,9,10,10,-3,-3,-1,0,1,1.0,2.0,-1.0,8
11147,11147,2013-14,2013,2014,Man United,Aston Villa,Win,Home,2014-03-29,3,3,3,6,9,3,6,6,7,0,-3,0,2,1,1.0,15.0,-14.0,8
11148,11148,2013-14,2013,2014,Man United,Newcastle,Win,Away,2014-04-05,3,3,6,6,9,0,3,3,6,3,3,3,3,0,1.0,16.0,-15.0,9
11149,11149,2013-14,2013,2014,Man United,Everton,Loss,Away,2014-04-20,0,6,6,9,9,3,6,9,12,3,0,0,-3,0,1.0,6.0,-5.0,9
11150,11150,2013-14,2013,2014,Man United,Norwich,Win,Home,2014-04-26,3,3,6,6,9,0,0,0,3,3,6,6,6,1,1.0,11.0,-10.0,9
11151,11151,2013-14,2013,2014,Man United,Sunderland,Loss,Home,2014-05-03,0,3,6,9,9,6,7,7,7,-3,-1,2,2,1,1.0,17.0,-16.0,10
11152,11152,2013-14,2013,2014,Man United,Hull,Win,Home,2014-05-06,3,3,3,6,9,1,1,4,4,2,2,2,5,1,1.0,21.0,-20.0,10
11153,11153,2013-14,2013,2014,Man United,Southampton,Draw,Away,2014-05-11,1,3,6,6,9,6,7,7,7,-3,-1,-1,2,0,1.0,14.0,-13.0,10
11154,11154,2014-15,2014,2015,Man United,Swansea,Loss,Home,2014-08-16,0,4,4,7,7,3,6,9,9,1,-2,-2,-2,1,7.0,12.0,-5.0,1
11155,11155,2014-15,2014,2015,Man United,Sunderland,Draw,Away,2014-08-24,1,1,4,4,7,1,4,7,10,0,0,-3,-3,0,7.0,14.0,-7.0,1
11156,11156,2014-15,2014,2015,Man United,Burnley,Draw,Away,2014-08-30,1,1,2,5,5,0,3,3,3,1,-1,2,2,0,7.0,21.0,-14.0,1
11157,11157,2014-15,2014,2015,Man United,QPR,Win,Home,2014-09-14,3,2,2,3,6,3,3,3,3,-1,-1,0,3,1,7.0,21.0,-14.0,2
11158,11158,2014-15,2014,2015,Man United,Leicester,Loss,Away,2014-09-21,0,4,5,5,6,4,4,5,5,0,1,0,1,0,7.0,21.0,-14.0,2
11159,11159,2014-15,2014,2015,Man United,West Ham,Win,Home,2014-09-27,3,3,4,5,5,4,4,7,7,-1,0,-2,-2,1,7.0,13.0,-6.0,2
11160,11160,2014-15,2014,2015,Man United,Everton,Win,Home,2014-10-05,3,3,6,7,8,1,4,4,5,2,2,3,3,1,7.0,5.0,2.0,3
11161,11161,2014-15,2014,2015,Man United,West Brom,Draw,Away,2014-10-20,1,6,6,9,10,3,6,6,6,3,0,3,4,0,7.0,17.0,-10.0,3
11162,11162,2014-15,2014,2015,Man United,Chelsea,Draw,Home,2014-10-26,1,4,7,7,10,6,9,10,13,-2,-2,-3,-3,1,7.0,3.0,4.0,3
11163,11163,2014-15,2014,2015,Man United,Man City,Loss,Away,2014-11-02,0,2,5,8,8,3,6,9,10,-1,-1,-1,-2,0,7.0,1.0,6.0,4
11164,11164,2014-15,2014,2015,Man United,Crystal Palace,Win,Home,2014-11-08,3,1,2,5,8,1,1,1,4,0,1,4,4,1,7.0,11.0,-4.0,4
11165,11165,2014-15,2014,2015,Man United,Arsenal,Win,Away,2014-11-22,3,3,4,5,8,3,6,7,7,0,-2,-2,1,0,7.0,4.0,3.0,4
11166,11166,2014-15,2014,2015,Man United,Hull,Win,Home,2014-11-29,3,6,6,7,8,0,0,1,2,6,6,6,6,1,7.0,16.0,-9.0,4
11167,11167,2014-15,2014,2015,Man United,Stoke,Win,Home,2014-12-02,3,6,9,9,10,0,3,4,4,6,6,5,6,1,7.0,9.0,-2.0,5
11168,11168,2014-15,2014,2015,Man United,Southampton,Win,Away,2014-12-08,3,6,9,12,12,0,1,4,7,6,8,8,5,0,7.0,8.0,-1.0,5
11169,11169,2014-15,2014,2015,Man United,Liverpool,Win,Home,2014-12-14,3,6,9,12,15,4,7,7,7,2,2,5,8,1,7.0,2.0,5.0,5
11170,11170,2014-15,2014,2015,Man United,Aston Villa,Draw,Away,2014-12-20,1,6,9,12,15,3,6,7,8,3,3,5,7,0,7.0,15.0,-8.0,5
11171,11171,2014-15,2014,2015,Man United,Newcastle,Win,Home,2014-12-26,3,4,7,10,13,0,3,4,4,4,4,6,9,1,7.0,10.0,-3.0,5
11172,11172,2014-15,2014,2015,Man United,Tottenham,Draw,Away,2014-12-28,1,4,7,10,13,6,9,10,10,-2,-2,0,3,0,7.0,6.0,1.0,5
11173,11173,2014-15,2014,2015,Man United,Stoke,Draw,Away,2015-01-01,1,4,5,8,11,6,6,7,10,-2,-1,1,1,0,7.0,9.0,-2.0,6
11174,11174,2014-15,2014,2015,Man United,Southampton,Loss,Home,2015-01-11,0,2,5,6,9,4,7,10,10,-2,-2,-4,-1,1,7.0,8.0,-1.0,6
11175,11175,2014-15,2014,2015,Man United,QPR,Win,Away,2015-01-17,3,1,2,5,6,1,2,2,5,0,0,3,1,0,7.0,21.0,-14.0,6
11176,11176,2014-15,2014,2015,Man United,Leicester,Win,Home,2015-01-31,3,3,4,5,8,3,4,7,7,0,0,-2,1,1,7.0,21.0,-14.0,6
11177,11177,2014-15,2014,2015,Man United,West Ham,Draw,Away,2015-02-08,1,6,6,7,8,3,4,5,5,3,2,2,3,0,7.0,13.0,-6.0,7
11178,11178,2014-15,2014,2015,Man United,Burnley,Win,Home,2015-02-11,3,4,7,7,8,1,1,4,5,3,6,3,3,1,7.0,21.0,-14.0,7
11179,11179,2014-15,2014,2015,Man United,Swansea,Loss,Away,2015-02-21,0,4,7,10,10,1,4,4,5,3,3,6,5,0,7.0,12.0,-5.0,7
11180,11180,2014-15,2014,2015,Man United,Sunderland,Win,Home,2015-02-28,3,3,4,7,10,1,2,5,5,2,2,2,5,1,7.0,14.0,-7.0,7
11181,11181,2014-15,2014,2015,Man United,Newcastle,Win,Away,2015-03-04,3,3,6,7,10,3,4,5,8,0,2,2,2,0,7.0,10.0,-3.0,8
11182,11182,2014-15,2014,2015,Man United,Tottenham,Win,Home,2015-03-15,3,6,6,9,10,6,7,7,10,0,-1,2,0,1,7.0,6.0,1.0,8
11183,11183,2014-15,2014,2015,Man United,Liverpool,Win,Away,2015-03-22,3,6,9,9,12,6,9,12,15,0,0,-3,-3,0,7.0,2.0,5.0,8
11184,11184,2014-15,2014,2015,Man United,Aston Villa,Win,Home,2015-04-04,3,6,9,12,12,3,6,6,6,3,3,6,6,1,7.0,15.0,-8.0,9
11185,11185,2014-15,2014,2015,Man United,Man City,Win,Home,2015-04-12,3,6,9,12,15,3,3,6,6,3,6,6,9,1,7.0,1.0,6.0,9
11186,11186,2014-15,2014,2015,Man United,Chelsea,Loss,Away,2015-04-18,0,6,9,12,15,6,9,10,13,0,0,2,2,0,7.0,3.0,4.0,9
11187,11187,2014-15,2014,2015,Man United,Everton,Loss,Away,2015-04-26,0,3,6,9,12,4,7,10,13,-1,-1,-1,-1,0,7.0,5.0,2.0,9
11188,11188,2014-15,2014,2015,Man United,West Brom,Loss,Home,2015-05-02,0,0,3,6,9,4,4,4,4,-4,-1,2,5,1,7.0,17.0,-10.0,10
11189,11189,2014-15,2014,2015,Man United,Crystal Palace,Win,Away,2015-05-09,3,0,0,3,6,0,0,3,6,0,0,0,0,0,7.0,11.0,-4.0,10
11190,11190,2014-15,2014,2015,Man United,Arsenal,Draw,Home,2015-05-17,1,3,3,3,6,3,4,7,10,0,-1,-4,-4,1,7.0,4.0,3.0,10
11191,11191,2014-15,2014,2015,Man United,Hull,Draw,Away,2015-05-24,1,4,4,4,4,0,0,3,6,4,4,1,-2,0,7.0,16.0,-9.0,10
11192,11192,2015-16,2015,2016,Man United,Tottenham,Win,Home,2015-08-08,3,2,5,5,5,6,6,6,7,-4,-1,-1,-2,1,4.0,5.0,-1.0,1
11193,11193,2015-16,2015,2016,Man United,Aston Villa,Win,Away,2015-08-14,3,4,5,8,8,3,3,6,9,1,2,2,-1,0,4.0,17.0,-13.0,1
11194,11194,2015-16,2015,2016,Man United,Newcastle,Draw,Home,2015-08-22,1,6,7,8,11,1,4,4,5,5,3,4,6,1,4.0,15.0,-11.0,1
11195,11195,2015-16,2015,2016,Man United,Swansea,Loss,Away,2015-08-30,0,4,7,8,9,4,5,5,5,0,2,3,4,0,4.0,8.0,-4.0,1
11196,11196,2015-16,2015,2016,Man United,Liverpool,Win,Home,2015-09-12,3,1,4,7,8,1,4,7,7,0,0,0,1,1,4.0,6.0,-2.0,2
11197,11197,2015-16,2015,2016,Man United,Southampton,Win,Away,2015-09-20,3,3,4,7,10,4,5,5,6,-1,-1,2,4,0,4.0,7.0,-3.0,2
11198,11198,2015-16,2015,2016,Man United,Sunderland,Win,Home,2015-09-26,3,6,6,7,10,0,1,2,2,6,5,5,8,1,4.0,16.0,-12.0,2
11199,11199,2015-16,2015,2016,Man United,Arsenal,Loss,Away,2015-10-04,0,6,9,9,10,3,6,9,10,3,3,0,0,0,4.0,3.0,1.0,3
11200,11200,2015-16,2015,2016,Man United,Everton,Win,Away,2015-10-17,3,3,6,9,9,4,5,8,9,-1,1,1,0,0,4.0,11.0,-7.0,3
11201,11201,2015-16,2015,2016,Man United,Man City,Draw,Home,2015-10-25,1,3,6,9,12,6,6,6,9,-3,0,3,3,1,4.0,2.0,2.0,3
11202,11202,2015-16,2015,2016,Man United,Crystal Palace,Draw,Away,2015-10-31,1,4,4,7,10,0,3,6,6,4,1,1,4,0,4.0,10.0,-6.0,3
11203,11203,2015-16,2015,2016,Man United,West Brom,Win,Home,2015-11-07,3,2,5,5,8,3,6,6,6,-1,-1,-1,2,1,4.0,13.0,-9.0,4
11204,11204,2015-16,2015,2016,Man United,Watford,Win,Away,2015-11-21,3,4,5,8,8,3,6,6,7,1,-1,2,1,0,4.0,21.0,-17.0,4
11205,11205,2015-16,2015,2016,Man United,Leicester,Draw,Away,2015-11-28,1,6,7,8,11,6,9,12,13,0,-2,-4,-2,0,4.0,14.0,-10.0,4
11206,11206,2015-16,2015,2016,Man United,West Ham,Draw,Home,2015-12-05,1,4,7,8,9,1,2,2,5,3,5,6,4,1,4.0,12.0,-8.0,5
11207,11207,2015-16,2015,2016,Man United,Bournemouth,Loss,Away,2015-12-12,0,2,5,8,9,4,5,5,5,-2,0,3,4,0,4.0,21.0,-17.0,5
11208,11208,2015-16,2015,2016,Man United,Norwich,Loss,Home,2015-12-19,0,1,2,5,8,1,2,2,5,0,0,3,3,1,4.0,21.0,-17.0,5
11209,11209,2015-16,2015,2016,Man United,Stoke,Loss,Away,2015-12-26,0,0,1,2,5,1,4,4,7,-1,-3,-2,-2,0,4.0,9.0,-5.0,5
11210,11210,2015-16,2015,2016,Man United,Chelsea,Draw,Home,2015-12-28,1,0,0,1,2,4,4,4,5,-4,-4,-3,-3,1,4.0,1.0,3.0,5
11211,11211,2015-16,2015,2016,Man United,Swansea,Win,Home,2016-01-02,3,1,1,1,2,4,5,5,5,-3,-4,-4,-3,1,4.0,8.0,-4.0,6
11212,11212,2015-16,2015,2016,Man United,Newcastle,Draw,Away,2016-01-12,1,4,4,4,4,0,0,1,4,4,4,3,0,0,4.0,15.0,-11.0,6
11213,11213,2015-16,2015,2016,Man United,Liverpool,Win,Away,2016-01-17,3,4,5,5,5,1,4,7,7,3,1,-2,-2,0,4.0,6.0,-2.0,6
11214,11214,2015-16,2015,2016,Man United,Southampton,Loss,Home,2016-01-23,0,4,7,8,8,6,6,6,9,-2,1,2,-1,1,4.0,7.0,-3.0,6
11215,11215,2015-16,2015,2016,Man United,Stoke,Win,Home,2016-02-02,3,3,4,7,8,1,4,4,7,2,0,3,1,1,4.0,9.0,-5.0,7
11216,11216,2015-16,2015,2016,Man United,Chelsea,Draw,Away,2016-02-07,1,3,6,7,10,4,5,6,9,-1,1,1,1,0,4.0,1.0,3.0,7
11217,11217,2015-16,2015,2016,Man United,Sunderland,Loss,Away,2016-02-13,0,4,4,7,8,1,2,2,5,3,2,5,3,0,4.0,16.0,-12.0,7
11218,11218,2015-16,2015,2016,Man United,Arsenal,Win,Home,2016-02-28,3,1,4,4,7,6,7,7,8,-5,-3,-3,-1,1,4.0,3.0,1.0,7
11219,11219,2015-16,2015,2016,Man United,Watford,Win,Home,2016-03-02,3,3,4,7,7,4,4,5,8,-1,0,2,-1,1,4.0,21.0,-17.0,8
11220,11220,2015-16,2015,2016,Man United,West Brom,Loss,Away,2016-03-06,0,6,6,7,10,4,7,7,8,2,-1,0,2,0,4.0,13.0,-9.0,8
11221,11221,2015-16,2015,2016,Man United,Man City,Win,Away,2016-03-20,3,3,6,6,7,4,4,4,4,-1,2,2,3,0,4.0,2.0,2.0,8
11222,11222,2015-16,2015,2016,Man United,Everton,Win,Home,2016-04-03,3,3,6,9,9,0,3,3,6,3,3,6,3,1,4.0,11.0,-7.0,9
11223,11223,2015-16,2015,2016,Man United,Tottenham,Loss,Away,2016-04-10,0,6,6,9,12,4,7,8,8,2,-1,1,4,0,4.0,5.0,-1.0,9
11224,11224,2015-16,2015,2016,Man United,Aston Villa,Win,Home,2016-04-16,3,3,6,6,9,0,0,0,0,3,6,6,9,1,4.0,17.0,-13.0,9
11225,11225,2015-16,2015,2016,Man United,Crystal Palace,Win,Home,2016-04-20,3,3,6,9,9,2,5,6,6,1,1,3,3,1,4.0,10.0,-6.0,9
11226,11226,2015-16,2015,2016,Man United,Leicester,Draw,Home,2016-05-01,1,6,6,9,12,4,7,10,13,2,-1,-1,-1,1,4.0,14.0,-10.0,10
11227,11227,2015-16,2015,2016,Man United,Norwich,Win,Away,2016-05-07,3,4,7,7,10,0,0,3,6,4,7,4,4,0,4.0,21.0,-17.0,10
11228,11228,2015-16,2015,2016,Man United,West Ham,Loss,Away,2016-05-10,0,4,7,10,10,3,6,7,8,1,1,3,2,0,4.0,12.0,-8.0,10
11229,11229,2015-16,2015,2016,Man United,Bournemouth,Win,Home,2016-05-17,3,3,4,7,10,1,1,1,4,2,3,6,6,1,4.0,21.0,-17.0,10
11230,11230,2016-17,2016,2017,Man United,Bournemouth,Win,Away,2016-08-14,3,3,6,7,10,1,1,1,1,2,5,6,9,0,5.0,16.0,-11.0,1
11231,11231,2016-17,2016,2017,Man United,Southampton,Win,Home,2016-08-19,3,6,6,9,10,4,7,10,13,2,-1,-1,-3,1,5.0,6.0,-1.0,1
11232,11232,2016-17,2016,2017,Man United,Hull,Win,Away,2016-08-27,3,6,9,9,12,6,7,7,7,0,2,2,5,0,5.0,21.0,-16.0,1
11233,11233,2016-17,2016,2017,Man United,Man City,Loss,Home,2016-09-10,0,6,9,12,12,6,9,10,11,0,0,2,1,1,5.0,4.0,1.0,2
11234,11234,2016-17,2016,2017,Man United,Watford,Loss,Away,2016-09-18,0,3,6,9,12,3,3,4,5,0,3,5,7,0,5.0,13.0,-8.0,2
11235,11235,2016-17,2016,2017,Man United,Leicester,Win,Home,2016-09-24,3,0,3,6,9,3,6,7,7,-3,-3,-1,2,1,5.0,1.0,4.0,2
11236,11236,2016-17,2016,2017,Man United,Stoke,Draw,Home,2016-10-02,1,3,3,6,9,1,1,1,1,2,2,5,8,1,5.0,9.0,-4.0,3
11237,11237,2016-17,2016,2017,Man United,Liverpool,Draw,Away,2016-10-17,1,4,4,4,7,6,9,12,13,-2,-5,-8,-6,0,5.0,8.0,-3.0,3
11238,11238,2016-17,2016,2017,Man United,Chelsea,Loss,Away,2016-10-23,0,2,5,5,5,6,6,6,7,-4,-1,-1,-2,0,5.0,10.0,-5.0,3
11239,11239,2016-17,2016,2017,Man United,Burnley,Draw,Home,2016-10-29,1,1,2,5,5,3,3,6,6,-2,-1,-1,-1,1,5.0,21.0,-16.0,3
11240,11240,2016-17,2016,2017,Man United,Swansea,Win,Away,2016-11-06,3,1,2,3,6,1,1,1,1,0,1,2,5,0,5.0,12.0,-7.0,4
11241,11241,2016-17,2016,2017,Man United,Arsenal,Draw,Home,2016-11-19,1,4,4,5,6,4,5,8,11,0,-1,-3,-5,1,5.0,2.0,3.0,4
11242,11242,2016-17,2016,2017,Man United,West Ham,Draw,Home,2016-11-27,1,4,5,5,6,1,1,4,7,3,4,1,-1,1,5.0,7.0,-2.0,4
11243,11243,2016-17,2016,2017,Man United,Everton,Draw,Away,2016-12-04,1,2,5,6,6,1,1,4,4,1,4,2,2,0,5.0,11.0,-6.0,5
11244,11244,2016-17,2016,2017,Man United,Tottenham,Win,Home,2016-12-11,3,2,3,6,7,3,6,7,8,-1,-3,-1,-1,1,5.0,3.0,2.0,5
11245,11245,2016-17,2016,2017,Man United,Crystal Palace,Win,Away,2016-12-14,3,4,5,6,9,4,4,4,4,0,1,2,5,0,5.0,15.0,-10.0,5
11246,11246,2016-17,2016,2017,Man United,West Brom,Win,Away,2016-12-17,3,6,7,8,9,3,6,7,10,3,1,1,-1,0,5.0,14.0,-9.0,5
11247,11247,2016-17,2016,2017,Man United,Sunderland,Win,Home,2016-12-26,3,6,9,10,11,3,3,6,6,3,6,4,5,1,5.0,17.0,-12.0,5
11248,11248,2016-17,2016,2017,Man United,Middlesbrough,Win,Home,2016-12-31,3,6,9,12,13,3,3,3,6,3,6,9,7,1,5.0,21.0,-16.0,5
11249,11249,2016-17,2016,2017,Man United,West Ham,Win,Away,2017-01-02,3,6,9,12,15,3,6,9,10,3,3,3,5,0,5.0,7.0,-2.0,6
11250,11250,2016-17,2016,2017,Man United,Liverpool,Draw,Home,2017-01-15,1,6,9,12,15,4,7,10,13,2,2,2,2,1,5.0,8.0,-3.0,6
11251,11251,2016-17,2016,2017,Man United,Stoke,Draw,Away,2017-01-21,1,4,7,10,13,6,6,6,7,-2,1,4,6,0,5.0,9.0,-4.0,6
11252,11252,2016-17,2016,2017,Man United,Hull,Draw,Home,2017-02-01,1,2,5,8,11,3,3,4,4,-1,2,4,7,1,5.0,21.0,-16.0,7
11253,11253,2016-17,2016,2017,Man United,Leicester,Win,Away,2017-02-05,3,2,3,6,9,0,0,1,4,2,3,5,5,0,5.0,1.0,4.0,7
11254,11254,2016-17,2016,2017,Man United,Watford,Win,Home,2017-02-11,3,4,5,6,9,6,7,8,8,-2,-2,-2,1,1,5.0,13.0,-8.0,7
11255,11255,2016-17,2016,2017,Man United,Bournemouth,Draw,Home,2017-03-04,1,6,7,8,9,0,0,0,1,6,7,8,8,1,5.0,16.0,-11.0,8
11256,11256,2016-17,2016,2017,Man United,Middlesbrough,Win,Away,2017-03-19,3,4,7,8,9,0,1,1,2,4,6,7,7,0,5.0,21.0,-16.0,8
11257,11257,2016-17,2016,2017,Man United,West Brom,Draw,Home,2017-04-01,1,4,7,10,11,3,3,6,7,1,4,4,4,1,5.0,14.0,-9.0,9
11258,11258,2016-17,2016,2017,Man United,Everton,Draw,Home,2017-04-04,1,4,5,8,11,3,6,6,9,1,-1,2,2,1,5.0,11.0,-6.0,9
11259,11259,2016-17,2016,2017,Man United,Sunderland,Win,Away,2017-04-09,3,2,5,6,9,0,1,1,1,2,4,5,8,0,5.0,17.0,-12.0,9
11260,11260,2016-17,2016,2017,Man United,Chelsea,Win,Home,2017-04-16,3,4,5,8,9,6,6,9,12,-2,-1,-1,-3,1,5.0,10.0,-5.0,9
11261,11261,2016-17,2016,2017,Man United,Burnley,Win,Away,2017-04-23,3,6,7,8,11,1,4,4,5,5,3,4,6,0,5.0,21.0,-16.0,9
11262,11262,2016-17,2016,2017,Man United,Man City,Draw,Away,2017-04-27,1,6,9,10,11,6,6,7,8,0,3,3,3,0,5.0,4.0,1.0,9
11263,11263,2016-17,2016,2017,Man United,Swansea,Draw,Home,2017-04-30,1,4,7,10,11,3,3,3,4,1,4,7,7,1,5.0,12.0,-7.0,9
11264,11264,2016-17,2016,2017,Man United,Arsenal,Loss,Away,2017-05-07,0,2,5,8,11,3,6,6,9,-1,-1,2,2,0,5.0,2.0,3.0,10
11265,11265,2016-17,2016,2017,Man United,Tottenham,Loss,Away,2017-05-14,0,1,2,5,8,3,6,9,12,-2,-4,-4,-4,0,5.0,3.0,2.0,10
11266,11266,2016-17,2016,2017,Man United,Southampton,Draw,Away,2017-05-17,1,0,1,2,5,3,4,5,5,-3,-3,-3,0,0,5.0,6.0,-1.0,10
11267,11267,2016-17,2016,2017,Man United,Crystal Palace,Win,Home,2017-05-21,3,1,1,2,3,3,3,3,6,-2,-2,-1,-3,1,5.0,15.0,-10.0,10
11268,11268,2017-18,2017,2018,Man United,West Ham,Win,Home,2017-08-13,3,4,4,4,5,3,6,7,8,1,-2,-3,-3,1,6.0,11.0,-5.0,1
11269,11269,2017-18,2017,2018,Man United,Swansea,Win,Away,2017-08-19,3,6,7,7,7,4,7,10,11,2,0,-3,-4,0,6.0,15.0,-9.0,1
11270,11270,2017-18,2017,2018,Man United,Leicester,Win,Home,2017-08-26,3,6,9,10,10,3,4,4,4,3,5,6,6,1,6.0,12.0,-6.0,1
11271,11271,2017-18,2017,2018,Man United,Stoke,Draw,Away,2017-09-09,1,6,9,12,13,4,4,7,7,2,5,5,6,0,6.0,13.0,-7.0,2
11272,11272,2017-18,2017,2018,Man United,Everton,Win,Home,2017-09-17,3,4,7,10,13,0,1,4,4,4,6,6,9,1,6.0,7.0,-1.0,2
11273,11273,2017-18,2017,2018,Man United,Southampton,Win,Away,2017-09-23,3,4,7,10,13,3,4,7,8,1,3,3,5,0,6.0,8.0,-2.0,2
11274,11274,2017-18,2017,2018,Man United,Crystal Palace,Win,Home,2017-09-30,3,6,7,10,13,0,0,0,0,6,7,10,13,1,6.0,14.0,-8.0,2
11275,11275,2017-18,2017,2018,Man United,Liverpool,Draw,Away,2017-10-14,1,6,9,10,13,4,5,5,8,2,4,5,5,0,6.0,4.0,2.0,3
11276,11276,2017-18,2017,2018,Man United,Huddersfield,Loss,Away,2017-10-21,0,4,7,10,11,0,1,2,2,4,6,8,9,0,6.0,21.0,-15.0,3
11277,11277,2017-18,2017,2018,Man United,Tottenham,Win,Home,2017-10-28,3,1,4,7,10,6,9,12,13,-5,-5,-5,-3,1,6.0,2.0,4.0,3
11278,11278,2017-18,2017,2018,Man United,Chelsea,Loss,Away,2017-11-05,0,3,4,7,10,6,6,6,9,-3,-2,1,1,0,6.0,1.0,5.0,4
11279,11279,2017-18,2017,2018,Man United,Newcastle,Win,Home,2017-11-18,3,3,3,4,7,0,3,4,5,3,0,0,2,1,6.0,21.0,-15.0,4
11280,11280,2017-18,2017,2018,Man United,Brighton,Win,Home,2017-11-25,3,3,6,6,7,4,5,8,9,-1,1,-2,-2,1,6.0,21.0,-15.0,4
11281,11281,2017-18,2017,2018,Man United,Watford,Win,Away,2017-11-28,3,6,6,9,9,6,6,6,6,0,0,3,3,0,6.0,17.0,-11.0,4
11282,11282,2017-18,2017,2018,Man United,Arsenal,Win,Away,2017-12-02,3,6,9,9,12,6,9,9,12,0,0,0,0,0,6.0,5.0,1.0,5
11283,11283,2017-18,2017,2018,Man United,Man City,Loss,Home,2017-12-10,0,6,9,12,12,6,9,12,15,0,0,0,-3,1,6.0,3.0,3.0,5
11284,11284,2017-18,2017,2018,Man United,Bournemouth,Win,Home,2017-12-13,3,3,6,9,12,2,2,3,6,1,4,6,6,1,6.0,9.0,-3.0,5
11285,11285,2017-18,2017,2018,Man United,West Brom,Win,Away,2017-12-17,3,3,6,9,12,1,2,3,4,2,4,6,8,0,6.0,10.0,-4.0,5
11286,11286,2017-18,2017,2018,Man United,Leicester,Draw,Away,2017-12-23,1,6,6,9,12,3,6,9,12,3,0,0,0,0,6.0,12.0,-6.0,5
11287,11287,2017-18,2017,2018,Man United,Burnley,Draw,Home,2017-12-26,1,4,7,7,10,1,4,7,7,3,3,0,3,1,6.0,16.0,-10.0,5
11288,11288,2017-18,2017,2018,Man United,Southampton,Draw,Home,2017-12-30,1,2,5,8,8,1,1,1,2,1,4,7,6,1,6.0,8.0,-2.0,5
11289,11289,2017-18,2017,2018,Man United,Everton,Win,Away,2018-01-01,3,2,3,6,9,1,2,5,8,1,1,1,1,0,6.0,7.0,-1.0,6
11290,11290,2017-18,2017,2018,Man United,Stoke,Win,Home,2018-01-15,3,4,5,6,9,0,1,4,4,4,4,2,5,1,6.0,13.0,-7.0,6
11291,11291,2017-18,2017,2018,Man United,Burnley,Win,Away,2018-01-20,3,6,7,8,9,0,1,2,2,6,6,6,7,0,6.0,16.0,-10.0,6
11292,11292,2017-18,2017,2018,Man United,Tottenham,Loss,Away,2018-01-31,0,6,9,10,11,4,5,8,11,2,4,2,0,0,6.0,2.0,4.0,6
11293,11293,2017-18,2017,2018,Man United,Huddersfield,Win,Home,2018-02-03,3,3,6,9,10,0,0,0,1,3,6,9,9,1,6.0,21.0,-15.0,7
11294,11294,2017-18,2017,2018,Man United,Newcastle,Loss,Away,2018-02-11,0,3,6,9,12,2,2,3,6,1,4,6,6,0,6.0,21.0,-15.0,7
11295,11295,2017-18,2017,2018,Man United,Chelsea,Win,Home,2018-02-25,3,3,3,6,9,3,3,6,7,0,0,0,2,1,6.0,1.0,5.0,7
11296,11296,2017-18,2017,2018,Man United,Crystal Palace,Win,Away,2018-03-05,3,3,6,6,9,0,1,2,2,3,5,4,7,0,6.0,14.0,-8.0,8
11297,11297,2017-18,2017,2018,Man United,Liverpool,Win,Home,2018-03-10,3,6,6,9,9,6,9,10,13,0,-3,-1,-4,1,6.0,4.0,2.0,8
11298,11298,2017-18,2017,2018,Man United,Swansea,Win,Home,2018-03-31,3,6,9,9,12,4,4,7,8,2,5,2,4,1,6.0,15.0,-9.0,8
11299,11299,2017-18,2017,2018,Man United,Man City,Win,Away,2018-04-07,3,6,9,12,12,6,9,12,15,0,0,0,-3,0,6.0,3.0,3.0,9
11300,11300,2017-18,2017,2018,Man United,West Brom,Loss,Home,2018-04-15,0,6,9,12,15,1,1,1,1,5,8,11,14,1,6.0,10.0,-4.0,9
11301,11301,2017-18,2017,2018,Man United,Bournemouth,Win,Away,2018-04-18,3,3,6,9,12,1,2,5,5,2,4,4,7,0,6.0,9.0,-3.0,9
11302,11302,2017-18,2017,2018,Man United,Arsenal,Win,Home,2018-04-29,3,3,6,9,12,3,6,9,12,0,0,0,0,1,6.0,5.0,1.0,9
11303,11303,2017-18,2017,2018,Man United,Brighton,Loss,Away,2018-05-04,0,6,6,9,12,2,2,3,3,4,4,6,9,0,6.0,21.0,-15.0,10
11304,11304,2017-18,2017,2018,Man United,West Ham,Draw,Away,2018-05-10,1,3,6,6,9,3,3,4,5,0,3,2,4,0,6.0,11.0,-5.0,10
11305,11305,2017-18,2017,2018,Man United,Watford,Win,Home,2018-05-13,3,1,4,7,7,3,4,4,4,-2,0,3,3,1,6.0,17.0,-11.0,10
11306,11306,2002-03,2002,2003,Middlesbrough,Southampton,Draw,Away,2002-08-17,1,0,0,0,0,3,3,4,7,-3,-3,-4,-7,0,12.0,11.0,1.0,1
11307,11307,2002-03,2002,2003,Middlesbrough,Fulham,Draw,Home,2002-08-24,1,1,1,1,1,3,4,7,10,-2,-3,-6,-9,1,12.0,13.0,-1.0,1
11308,11308,2002-03,2002,2003,Middlesbrough,Blackburn,Win,Home,2002-08-31,3,2,2,2,2,4,5,8,8,-2,-3,-6,-6,1,12.0,10.0,2.0,1
11309,11309,2002-03,2002,2003,Middlesbrough,Man United,Loss,Away,2002-09-03,0,4,5,5,5,2,5,6,6,2,0,-1,-1,0,12.0,3.0,9.0,2
11310,11310,2002-03,2002,2003,Middlesbrough,Sunderland,Win,Home,2002-09-10,3,3,4,5,5,4,4,5,6,-1,0,0,-1,1,12.0,17.0,-5.0,2
11311,11311,2002-03,2002,2003,Middlesbrough,Everton,Loss,Away,2002-09-14,0,3,6,7,8,0,1,4,5,3,5,3,3,0,12.0,15.0,-3.0,2
11312,11312,2002-03,2002,2003,Middlesbrough,Birmingham,Win,Home,2002-09-21,3,3,3,6,7,4,7,8,8,-1,-4,-2,-1,1,12.0,21.0,-9.0,2
11313,11313,2002-03,2002,2003,Middlesbrough,Tottenham,Win,Away,2002-09-28,3,3,6,6,9,3,3,6,9,0,3,0,0,0,12.0,9.0,3.0,2
11314,11314,2002-03,2002,2003,Middlesbrough,Bolton,Win,Home,2002-10-05,3,6,6,9,9,1,1,4,7,5,5,5,2,1,12.0,16.0,-4.0,3
11315,11315,2002-03,2002,2003,Middlesbrough,Charlton,Loss,Away,2002-10-20,0,6,9,9,12,0,1,1,1,6,8,8,11,0,12.0,14.0,-2.0,3
11316,11316,2002-03,2002,2003,Middlesbrough,Leeds,Draw,Home,2002-10-26,1,3,6,9,9,1,1,1,4,2,5,8,5,1,12.0,5.0,7.0,3
11317,11317,2002-03,2002,2003,Middlesbrough,Newcastle,Loss,Away,2002-11-04,0,1,4,7,10,3,6,9,12,-2,-2,-2,-2,0,12.0,4.0,8.0,4
11318,11318,2002-03,2002,2003,Middlesbrough,Liverpool,Win,Home,2002-11-09,3,1,1,4,7,6,9,12,15,-5,-8,-8,-8,1,12.0,2.0,10.0,4
11319,11319,2002-03,2002,2003,Middlesbrough,Chelsea,Loss,Away,2002-11-16,0,3,4,4,7,4,7,10,10,-1,-3,-6,-3,0,12.0,6.0,6.0,4
11320,11320,2002-03,2002,2003,Middlesbrough,Man City,Win,Home,2002-11-23,3,3,3,4,4,3,6,9,9,0,-3,-5,-5,1,12.0,21.0,-9.0,4
11321,11321,2002-03,2002,2003,Middlesbrough,West Brom,Loss,Away,2002-11-30,0,3,6,6,7,1,2,2,2,2,4,4,5,0,12.0,21.0,-9.0,4
11322,11322,2002-03,2002,2003,Middlesbrough,West Ham,Draw,Home,2002-12-07,1,3,3,6,6,0,1,1,1,3,2,5,5,1,12.0,7.0,5.0,5
11323,11323,2002-03,2002,2003,Middlesbrough,Chelsea,Draw,Home,2002-12-14,1,1,4,4,7,6,7,10,13,-5,-3,-6,-6,1,12.0,6.0,6.0,5
11324,11324,2002-03,2002,2003,Middlesbrough,Arsenal,Loss,Away,2002-12-21,0,2,2,5,5,1,4,4,7,1,-2,1,-2,0,12.0,1.0,11.0,5
11325,11325,2002-03,2002,2003,Middlesbrough,Man United,Win,Home,2002-12-26,3,1,2,2,5,3,6,9,12,-2,-4,-7,-7,1,12.0,3.0,9.0,5
11326,11326,2002-03,2002,2003,Middlesbrough,Aston Villa,Loss,Away,2002-12-28,0,3,4,5,5,0,3,3,3,3,1,2,2,0,12.0,8.0,4.0,5
11327,11327,2002-03,2002,2003,Middlesbrough,Blackburn,Loss,Away,2003-01-01,0,3,3,4,5,2,5,5,6,1,-2,-1,-1,0,12.0,10.0,2.0,6
11328,11328,2002-03,2002,2003,Middlesbrough,Southampton,Draw,Home,2003-01-11,1,0,3,3,4,6,7,8,9,-6,-4,-5,-5,1,12.0,11.0,1.0,6
11329,11329,2002-03,2002,2003,Middlesbrough,Fulham,Loss,Away,2003-01-19,0,1,1,4,4,1,2,2,2,0,-1,2,2,0,12.0,13.0,-1.0,6
11330,11330,2002-03,2002,2003,Middlesbrough,Aston Villa,Loss,Home,2003-01-28,0,1,1,1,4,1,4,7,7,0,-3,-6,-3,1,12.0,8.0,4.0,6
11331,11331,2002-03,2002,2003,Middlesbrough,Liverpool,Draw,Away,2003-02-08,1,0,1,1,1,4,7,8,8,-4,-6,-7,-7,0,12.0,2.0,10.0,7
11332,11332,2002-03,2002,2003,Middlesbrough,Sunderland,Win,Away,2003-02-22,3,1,1,2,2,0,0,0,1,1,1,2,1,0,12.0,17.0,-5.0,7
11333,11333,2002-03,2002,2003,Middlesbrough,Everton,Draw,Home,2003-03-01,1,4,4,4,5,3,6,9,12,1,-2,-5,-7,1,12.0,15.0,-3.0,8
11334,11334,2002-03,2002,2003,Middlesbrough,Newcastle,Win,Home,2003-03-05,3,4,5,5,5,6,7,10,13,-2,-2,-5,-8,1,12.0,4.0,8.0,8
11335,11335,2002-03,2002,2003,Middlesbrough,Leeds,Win,Away,2003-03-15,3,4,7,8,8,0,3,3,3,4,4,5,5,0,12.0,5.0,7.0,8
11336,11336,2002-03,2002,2003,Middlesbrough,Charlton,Draw,Home,2003-03-22,1,6,7,10,11,0,3,6,9,6,4,4,2,1,12.0,14.0,-2.0,8
11337,11337,2002-03,2002,2003,Middlesbrough,West Brom,Win,Home,2003-04-05,3,4,7,8,11,0,0,0,0,4,7,8,11,1,12.0,21.0,-9.0,9
11338,11338,2002-03,2002,2003,Middlesbrough,Man City,Draw,Away,2003-04-12,1,4,7,10,11,0,3,3,3,4,4,7,8,0,12.0,21.0,-9.0,9
11339,11339,2002-03,2002,2003,Middlesbrough,Arsenal,Loss,Home,2003-04-19,0,4,5,8,11,2,5,5,8,2,0,3,3,1,12.0,1.0,11.0,9
11340,11340,2002-03,2002,2003,Middlesbrough,West Ham,Loss,Away,2003-04-21,0,1,4,5,8,1,2,5,6,0,2,0,2,0,12.0,7.0,5.0,9
11341,11341,2002-03,2002,2003,Middlesbrough,Birmingham,Loss,Away,2003-04-26,0,0,1,4,5,6,9,9,12,-6,-8,-5,-7,0,12.0,21.0,-9.0,9
11342,11342,2002-03,2002,2003,Middlesbrough,Tottenham,Win,Home,2003-05-03,3,0,0,1,4,3,3,4,7,-3,-3,-3,-3,1,12.0,9.0,3.0,10
11343,11343,2002-03,2002,2003,Middlesbrough,Bolton,Loss,Away,2003-05-11,0,3,3,3,4,2,3,6,6,1,0,-3,-2,0,12.0,16.0,-4.0,10
11344,11344,1995-96,1995,1996,Middlesbrough,Arsenal,Draw,Away,1995-08-20,1,0,0,0,0,1,2,5,8,-1,-2,-5,-8,0,21.0,12.0,9.0,1
11345,11345,1995-96,1995,1996,Middlesbrough,Chelsea,Win,Home,1995-08-26,3,1,1,1,1,2,5,6,7,-1,-4,-5,-6,1,21.0,11.0,10.0,1
11346,11346,1995-96,1995,1996,Middlesbrough,Newcastle,Loss,Away,1995-08-30,0,4,4,4,4,6,9,12,12,-2,-5,-8,-8,0,21.0,6.0,15.0,1
11347,11347,1995-96,1995,1996,Middlesbrough,Bolton,Draw,Away,1995-09-09,1,3,4,4,4,3,3,3,3,0,1,1,1,0,21.0,21.0,0.0,2
11348,11348,1995-96,1995,1996,Middlesbrough,Southampton,Draw,Home,1995-09-12,1,1,4,5,5,4,4,4,5,-3,0,1,0,1,21.0,10.0,11.0,2
11349,11349,1995-96,1995,1996,Middlesbrough,Coventry,Win,Home,1995-09-16,3,2,2,5,6,2,3,6,6,0,-1,-1,0,1,21.0,16.0,5.0,2
11350,11350,1995-96,1995,1996,Middlesbrough,Man City,Win,Away,1995-09-23,3,4,5,5,8,0,0,0,0,4,5,5,8,0,21.0,17.0,4.0,2
11351,11351,1995-96,1995,1996,Middlesbrough,Blackburn,Win,Home,1995-09-30,3,6,7,8,8,3,4,4,4,3,3,4,4,1,21.0,1.0,20.0,2
11352,11352,1995-96,1995,1996,Middlesbrough,Sheffield Weds,Win,Away,1995-10-15,3,6,9,10,11,1,1,4,5,5,8,6,6,0,21.0,13.0,8.0,3
11353,11353,1995-96,1995,1996,Middlesbrough,QPR,Win,Home,1995-10-21,3,6,9,12,13,3,3,6,6,3,6,6,7,1,21.0,8.0,13.0,3
11354,11354,1995-96,1995,1996,Middlesbrough,Man United,Loss,Away,1995-10-28,0,6,9,12,15,6,7,8,11,0,2,4,4,0,21.0,2.0,19.0,3
11355,11355,1995-96,1995,1996,Middlesbrough,Leeds,Draw,Home,1995-11-04,1,3,6,9,12,4,4,7,10,-1,2,2,2,1,21.0,5.0,16.0,4
11356,11356,1995-96,1995,1996,Middlesbrough,Wimbledon,Draw,Away,1995-11-18,1,1,4,7,10,0,0,0,0,1,4,7,10,0,21.0,9.0,12.0,4
11357,11357,1995-96,1995,1996,Middlesbrough,Tottenham,Loss,Home,1995-11-21,0,2,2,5,8,6,7,8,8,-4,-5,-3,0,1,21.0,7.0,14.0,4
11358,11358,1995-96,1995,1996,Middlesbrough,Liverpool,Win,Home,1995-11-25,3,1,2,2,5,1,1,4,7,0,1,-2,-2,1,21.0,4.0,17.0,4
11359,11359,1995-96,1995,1996,Middlesbrough,QPR,Draw,Away,1995-12-02,1,3,4,5,5,0,1,1,2,3,3,4,3,0,21.0,8.0,13.0,5
11360,11360,1995-96,1995,1996,Middlesbrough,Man City,Win,Home,1995-12-09,3,4,4,5,6,6,9,10,13,-2,-5,-5,-7,1,21.0,17.0,4.0,5
11361,11361,1995-96,1995,1996,Middlesbrough,Blackburn,Loss,Away,1995-12-16,0,4,7,7,8,3,4,7,7,1,3,0,1,0,21.0,1.0,20.0,5
11362,11362,1995-96,1995,1996,Middlesbrough,West Ham,Win,Home,1995-12-23,3,3,4,7,7,3,3,6,7,0,1,1,0,1,21.0,14.0,7.0,5
11363,11363,1995-96,1995,1996,Middlesbrough,Everton,Loss,Away,1995-12-26,0,3,6,7,10,0,3,4,5,3,3,3,5,0,21.0,15.0,6.0,5
11364,11364,1995-96,1995,1996,Middlesbrough,Nott'm Forest,Loss,Away,1995-12-30,0,3,3,6,7,3,4,5,6,0,-1,1,1,0,21.0,3.0,18.0,5
11365,11365,1995-96,1995,1996,Middlesbrough,Aston Villa,Loss,Home,1996-01-01,0,0,3,3,6,3,4,5,5,-3,-1,-2,1,1,21.0,18.0,3.0,6
11366,11366,1995-96,1995,1996,Middlesbrough,Arsenal,Loss,Home,1996-01-13,0,0,0,3,3,0,3,3,4,0,-3,0,-1,1,21.0,12.0,9.0,6
11367,11367,1995-96,1995,1996,Middlesbrough,Southampton,Loss,Away,1996-01-20,0,0,0,0,3,1,2,3,3,-1,-2,-3,0,0,21.0,10.0,11.0,6
11368,11368,1995-96,1995,1996,Middlesbrough,Chelsea,Loss,Away,1996-02-04,0,0,0,0,0,4,7,8,8,-4,-7,-8,-8,0,21.0,11.0,10.0,7
11369,11369,1995-96,1995,1996,Middlesbrough,Newcastle,Loss,Home,1996-02-10,0,0,0,0,0,6,9,12,12,-6,-9,-12,-12,1,21.0,6.0,15.0,7
11370,11370,1995-96,1995,1996,Middlesbrough,Bolton,Loss,Home,1996-02-17,0,0,0,0,0,0,0,3,3,0,0,-3,-3,1,21.0,21.0,0.0,7
11371,11371,1995-96,1995,1996,Middlesbrough,Coventry,Draw,Away,1996-02-24,1,0,0,0,0,4,4,5,5,-4,-4,-5,-5,0,21.0,16.0,5.0,7
11372,11372,1995-96,1995,1996,Middlesbrough,Everton,Loss,Home,1996-03-02,0,1,1,1,1,3,6,7,10,-2,-5,-6,-9,1,21.0,15.0,6.0,8
11373,11373,1995-96,1995,1996,Middlesbrough,West Ham,Loss,Away,1996-03-09,0,1,1,1,1,1,4,7,10,0,-3,-6,-9,0,21.0,14.0,7.0,8
11374,11374,1995-96,1995,1996,Middlesbrough,Nott'm Forest,Draw,Home,1996-03-16,1,0,1,1,1,3,3,3,6,-3,-2,-2,-5,1,21.0,3.0,18.0,8
11375,11375,1995-96,1995,1996,Middlesbrough,Aston Villa,Draw,Away,1996-03-19,1,1,1,2,2,3,6,6,9,-2,-5,-4,-7,0,21.0,18.0,3.0,8
11376,11376,1995-96,1995,1996,Middlesbrough,Leeds,Win,Away,1996-03-30,3,2,2,2,3,1,4,4,4,1,-2,-2,-1,0,21.0,5.0,16.0,8
11377,11377,1995-96,1995,1996,Middlesbrough,Sheffield Weds,Win,Home,1996-04-05,3,4,5,5,5,3,6,6,6,1,-1,-1,-1,1,21.0,13.0,8.0,9
11378,11378,1995-96,1995,1996,Middlesbrough,Tottenham,Draw,Away,1996-04-08,1,6,7,8,8,3,3,6,6,3,4,2,2,0,21.0,7.0,14.0,9
11379,11379,1995-96,1995,1996,Middlesbrough,Wimbledon,Loss,Home,1996-04-13,0,4,7,8,9,4,7,10,10,0,0,-2,-1,1,21.0,9.0,12.0,9
11380,11380,1995-96,1995,1996,Middlesbrough,Liverpool,Loss,Away,1996-04-27,0,1,4,7,8,4,4,7,7,-3,0,0,1,0,21.0,4.0,17.0,9
11381,11381,1995-96,1995,1996,Middlesbrough,Man United,Loss,Home,1996-05-04,0,0,1,4,7,6,6,9,12,-6,-5,-5,-5,1,21.0,2.0,19.0,10
11382,11382,1996-97,1996,1997,Middlesbrough,Liverpool,Draw,Home,1996-08-17,1,0,0,1,4,2,5,6,9,-2,-5,-5,-5,1,12.0,3.0,9.0,1
11383,11383,1996-97,1996,1997,Middlesbrough,Chelsea,Loss,Away,1996-08-21,0,1,1,1,2,1,2,3,6,0,-1,-2,-4,0,12.0,11.0,1.0,1
11384,11384,1996-97,1996,1997,Middlesbrough,Nott'm Forest,Draw,Away,1996-08-24,1,1,1,1,1,3,6,7,7,-2,-5,-6,-6,0,12.0,9.0,3.0,1
11385,11385,1996-97,1996,1997,Middlesbrough,West Ham,Win,Home,1996-09-04,3,1,2,2,2,4,4,5,5,-3,-2,-3,-3,1,12.0,10.0,2.0,2
11386,11386,1996-97,1996,1997,Middlesbrough,Coventry,Win,Home,1996-09-07,3,4,4,5,5,0,1,1,2,4,3,4,3,1,12.0,16.0,-4.0,2
11387,11387,1996-97,1996,1997,Middlesbrough,Everton,Win,Away,1996-09-14,3,6,7,7,8,0,1,2,5,6,6,5,3,0,12.0,6.0,6.0,2
11388,11388,1996-97,1996,1997,Middlesbrough,Arsenal,Loss,Home,1996-09-21,0,6,9,10,10,4,5,8,8,2,4,2,2,1,12.0,5.0,7.0,2
11389,11389,1996-97,1996,1997,Middlesbrough,Southampton,Loss,Away,1996-09-28,0,3,6,9,10,0,0,1,1,3,6,8,9,0,12.0,17.0,-5.0,2
11390,11390,1996-97,1996,1997,Middlesbrough,Sunderland,Draw,Away,1996-10-14,1,0,3,6,9,3,3,4,4,-3,0,2,5,0,12.0,21.0,-9.0,3
11391,11391,1996-97,1996,1997,Middlesbrough,Tottenham,Loss,Home,1996-10-19,0,1,1,4,7,3,3,6,6,-2,-2,-2,1,1,12.0,8.0,4.0,3
11392,11392,1996-97,1996,1997,Middlesbrough,Wimbledon,Draw,Home,1996-10-26,1,1,1,1,4,6,9,12,15,-5,-8,-11,-11,1,12.0,14.0,-2.0,3
11393,11393,1996-97,1996,1997,Middlesbrough,Newcastle,Loss,Away,1996-11-03,0,1,2,2,2,3,6,9,12,-2,-4,-7,-10,0,12.0,2.0,10.0,4
11394,11394,1996-97,1996,1997,Middlesbrough,Derby,Loss,Away,1996-11-17,0,1,1,2,2,3,4,4,4,-2,-3,-2,-2,0,12.0,21.0,-9.0,4
11395,11395,1996-97,1996,1997,Middlesbrough,Man United,Draw,Home,1996-11-23,1,0,1,1,2,3,3,3,6,-3,-2,-2,-4,1,12.0,1.0,11.0,4
11396,11396,1996-97,1996,1997,Middlesbrough,Aston Villa,Loss,Away,1996-11-30,0,1,1,2,2,3,6,6,9,-2,-5,-4,-7,0,12.0,4.0,8.0,4
11397,11397,1996-97,1996,1997,Middlesbrough,Leicester,Loss,Home,1996-12-03,0,1,1,1,2,0,3,3,6,1,-2,-2,-4,1,12.0,21.0,-9.0,5
11398,11398,1996-97,1996,1997,Middlesbrough,Leeds,Draw,Home,1996-12-07,1,0,1,1,1,6,6,9,9,-6,-5,-8,-8,1,12.0,13.0,-1.0,5
11399,11399,1996-97,1996,1997,Middlesbrough,Liverpool,Loss,Away,1996-12-14,0,1,1,2,2,3,4,5,8,-2,-3,-3,-6,0,12.0,3.0,9.0,5
11400,11400,1996-97,1996,1997,Middlesbrough,Everton,Win,Home,1996-12-26,3,1,1,1,2,4,5,5,8,-3,-4,-4,-6,1,12.0,6.0,6.0,5
11401,11401,1996-97,1996,1997,Middlesbrough,Coventry,Loss,Away,1996-12-28,0,3,4,4,4,6,9,9,9,-3,-5,-5,-5,0,12.0,16.0,-4.0,5
11402,11402,1996-97,1996,1997,Middlesbrough,Arsenal,Loss,Away,1997-01-01,0,3,3,4,4,2,2,3,6,1,1,1,-2,0,12.0,5.0,7.0,6
11403,11403,1996-97,1996,1997,Middlesbrough,Southampton,Loss,Home,1997-01-11,0,0,3,3,4,0,3,3,3,0,0,0,1,1,12.0,17.0,-5.0,6
11404,11404,1996-97,1996,1997,Middlesbrough,Sheffield Weds,Win,Home,1997-01-18,3,0,0,3,3,4,5,6,7,-4,-5,-3,-4,1,12.0,15.0,-3.0,6
11405,11405,1996-97,1996,1997,Middlesbrough,Wimbledon,Draw,Away,1997-02-01,1,3,3,3,6,0,1,4,4,3,2,-1,2,0,12.0,14.0,-2.0,7
11406,11406,1996-97,1996,1997,Middlesbrough,Newcastle,Loss,Home,1997-02-22,0,4,4,4,4,6,7,8,11,-2,-3,-4,-7,1,12.0,2.0,10.0,7
11407,11407,1996-97,1996,1997,Middlesbrough,Sheffield Weds,Loss,Away,1997-03-01,0,1,4,4,4,4,5,8,8,-3,-1,-4,-4,0,12.0,15.0,-3.0,8
11408,11408,1996-97,1996,1997,Middlesbrough,Derby,Win,Home,1997-03-05,3,0,1,4,4,3,4,7,7,-3,-3,-3,-3,1,12.0,21.0,-9.0,8
11409,11409,1996-97,1996,1997,Middlesbrough,Leicester,Win,Away,1997-03-15,3,3,3,4,7,4,7,10,10,-1,-4,-6,-3,0,12.0,21.0,-9.0,8
11410,11410,1996-97,1996,1997,Middlesbrough,Blackburn,Win,Home,1997-03-19,3,6,6,6,7,4,5,8,9,2,1,-2,-2,1,12.0,7.0,5.0,8
11411,11411,1996-97,1996,1997,Middlesbrough,Chelsea,Win,Home,1997-03-22,3,6,9,9,9,6,6,7,7,0,3,2,2,1,12.0,11.0,1.0,8
11412,11412,1996-97,1996,1997,Middlesbrough,Nott'm Forest,Draw,Home,1997-03-24,1,6,9,12,12,2,3,3,3,4,6,9,9,1,12.0,9.0,3.0,8
11413,11413,1996-97,1996,1997,Middlesbrough,West Ham,Draw,Away,1997-04-09,1,4,7,10,13,4,5,8,8,0,2,2,5,0,12.0,10.0,2.0,9
11414,11414,1996-97,1996,1997,Middlesbrough,Sunderland,Loss,Home,1997-04-19,0,2,5,8,11,1,2,2,2,1,3,6,9,1,12.0,21.0,-9.0,9
11415,11415,1996-97,1996,1997,Middlesbrough,Tottenham,Loss,Away,1997-04-24,0,1,2,5,8,1,1,4,4,0,1,1,4,0,12.0,8.0,4.0,9
11416,11416,1996-97,1996,1997,Middlesbrough,Aston Villa,Win,Home,1997-05-03,3,0,1,2,5,2,2,5,8,-2,-1,-3,-3,1,12.0,4.0,8.0,10
11417,11417,1996-97,1996,1997,Middlesbrough,Man United,Draw,Away,1997-05-05,1,3,3,4,5,4,7,7,10,-1,-4,-3,-5,0,12.0,1.0,11.0,10
11418,11418,1996-97,1996,1997,Middlesbrough,Blackburn,Draw,Away,1997-05-08,1,4,4,4,5,3,4,4,5,1,0,0,0,0,12.0,7.0,5.0,10
11419,11419,1996-97,1996,1997,Middlesbrough,Leeds,Draw,Away,1997-05-11,1,2,5,5,5,2,3,3,4,0,2,2,1,0,12.0,13.0,-1.0,10
11420,11420,1998-99,1998,1999,Middlesbrough,Leeds,Draw,Home,1998-08-15,1,2,3,6,6,1,2,5,5,1,1,1,1,1,21.0,5.0,16.0,1
11421,11421,1998-99,1998,1999,Middlesbrough,Aston Villa,Loss,Away,1998-08-23,0,2,3,4,7,4,7,7,10,-2,-4,-3,-3,0,21.0,7.0,14.0,1
11422,11422,1998-99,1998,1999,Middlesbrough,Derby,Draw,Home,1998-08-29,1,1,2,3,4,2,5,8,8,-1,-3,-5,-4,1,21.0,9.0,12.0,1
11423,11423,1998-99,1998,1999,Middlesbrough,Leicester,Win,Away,1998-09-09,3,1,2,3,4,3,4,4,7,-2,-2,-1,-3,0,21.0,10.0,11.0,2
11424,11424,1998-99,1998,1999,Middlesbrough,Tottenham,Win,Away,1998-09-13,3,4,4,5,6,6,6,6,7,-2,-2,-1,-1,0,21.0,14.0,7.0,2
11425,11425,1998-99,1998,1999,Middlesbrough,Everton,Draw,Home,1998-09-19,1,6,7,7,8,4,4,4,5,2,3,3,3,1,21.0,17.0,4.0,2
11426,11426,1998-99,1998,1999,Middlesbrough,Chelsea,Loss,Away,1998-09-26,0,4,7,8,8,6,7,8,8,-2,0,0,0,0,21.0,4.0,17.0,2
11427,11427,1998-99,1998,1999,Middlesbrough,Sheffield Weds,Win,Home,1998-10-03,3,1,4,7,8,3,6,6,6,-2,-2,1,2,1,21.0,16.0,5.0,3
11428,11428,1998-99,1998,1999,Middlesbrough,Blackburn,Win,Home,1998-10-17,3,3,4,7,10,4,4,4,4,-1,0,3,6,1,21.0,6.0,15.0,3
11429,11429,1998-99,1998,1999,Middlesbrough,Wimbledon,Draw,Away,1998-10-24,1,6,6,7,10,0,1,4,4,6,5,3,6,0,21.0,15.0,6.0,3
11430,11430,1998-99,1998,1999,Middlesbrough,Nott'm Forest,Draw,Home,1998-11-01,1,4,7,7,8,1,1,1,2,3,6,6,6,1,21.0,21.0,0.0,4
11431,11431,1998-99,1998,1999,Middlesbrough,Southampton,Draw,Away,1998-11-07,1,2,5,8,8,4,5,5,5,-2,0,3,3,0,21.0,12.0,9.0,4
11432,11432,1998-99,1998,1999,Middlesbrough,Charlton,Draw,Away,1998-11-14,1,2,3,6,9,2,5,5,8,0,-2,1,1,0,21.0,21.0,0.0,4
11433,11433,1998-99,1998,1999,Middlesbrough,Coventry,Win,Home,1998-11-21,3,2,3,4,7,6,6,6,9,-4,-3,-2,-2,1,21.0,11.0,10.0,4
11434,11434,1998-99,1998,1999,Middlesbrough,Arsenal,Draw,Away,1998-11-29,1,4,5,6,7,1,4,7,10,3,1,-1,-3,0,21.0,1.0,20.0,4
11435,11435,1998-99,1998,1999,Middlesbrough,Newcastle,Draw,Home,1998-12-06,1,4,5,6,7,3,4,5,5,1,1,1,2,1,21.0,13.0,8.0,5
11436,11436,1998-99,1998,1999,Middlesbrough,West Ham,Win,Home,1998-12-12,3,2,5,6,7,3,6,9,10,-1,-1,-3,-3,1,21.0,8.0,13.0,5
11437,11437,1998-99,1998,1999,Middlesbrough,Man United,Win,Away,1998-12-19,3,4,5,8,9,2,3,6,6,2,2,2,3,0,21.0,2.0,19.0,5
11438,11438,1998-99,1998,1999,Middlesbrough,Liverpool,Loss,Home,1998-12-26,0,6,7,8,11,3,3,6,9,3,4,2,2,1,21.0,3.0,18.0,5
11439,11439,1998-99,1998,1999,Middlesbrough,Derby,Loss,Away,1998-12-28,0,3,6,7,8,2,3,4,7,1,3,3,1,0,21.0,9.0,12.0,5
11440,11440,1998-99,1998,1999,Middlesbrough,Aston Villa,Draw,Home,1999-01-09,1,0,3,6,7,3,6,9,9,-3,-3,-3,-2,1,21.0,7.0,14.0,6
11441,11441,1998-99,1998,1999,Middlesbrough,Leeds,Loss,Away,1999-01-16,0,1,1,4,7,1,4,4,7,0,-3,0,0,0,21.0,5.0,16.0,6
11442,11442,1998-99,1998,1999,Middlesbrough,Leicester,Draw,Home,1999-01-30,1,1,1,1,4,1,2,5,5,0,-1,-4,-1,1,21.0,10.0,11.0,6
11443,11443,1998-99,1998,1999,Middlesbrough,Liverpool,Loss,Away,1999-02-06,0,1,2,2,2,3,4,7,10,-2,-2,-5,-8,0,21.0,3.0,18.0,7
11444,11444,1998-99,1998,1999,Middlesbrough,Everton,Loss,Away,1999-02-17,0,1,1,2,2,0,0,1,1,1,1,1,1,0,21.0,17.0,4.0,7
11445,11445,1998-99,1998,1999,Middlesbrough,Tottenham,Draw,Home,1999-02-20,1,0,1,1,2,2,3,4,7,-2,-2,-3,-5,1,21.0,14.0,7.0,7
11446,11446,1998-99,1998,1999,Middlesbrough,Sheffield Weds,Loss,Away,1999-02-27,0,1,1,2,2,6,6,9,10,-5,-5,-7,-8,0,21.0,16.0,5.0,7
11447,11447,1998-99,1998,1999,Middlesbrough,Southampton,Win,Home,1999-03-14,3,1,1,1,2,3,3,6,6,-2,-2,-5,-4,1,21.0,12.0,9.0,8
11448,11448,1998-99,1998,1999,Middlesbrough,Nott'm Forest,Win,Away,1999-03-20,3,3,4,4,4,3,4,4,4,0,0,0,0,0,21.0,21.0,0.0,8
11449,11449,1998-99,1998,1999,Middlesbrough,Blackburn,Draw,Away,1999-04-03,1,6,6,7,7,4,4,4,4,2,2,3,3,0,21.0,6.0,15.0,9
11450,11450,1998-99,1998,1999,Middlesbrough,Wimbledon,Win,Home,1999-04-05,3,4,7,7,8,1,1,1,4,3,6,6,4,1,21.0,15.0,6.0,9
11451,11451,1998-99,1998,1999,Middlesbrough,Charlton,Win,Home,1999-04-10,3,4,7,10,10,3,4,4,5,1,3,6,5,1,21.0,21.0,0.0,9
11452,11452,1998-99,1998,1999,Middlesbrough,Chelsea,Draw,Home,1999-04-14,1,6,7,10,13,6,9,9,12,0,-2,1,1,1,21.0,4.0,17.0,9
11453,11453,1998-99,1998,1999,Middlesbrough,Coventry,Win,Away,1999-04-17,3,4,7,8,11,3,6,6,7,1,1,2,4,0,21.0,11.0,10.0,9
11454,11454,1998-99,1998,1999,Middlesbrough,Arsenal,Loss,Home,1999-04-24,0,4,7,10,11,6,7,10,13,-2,0,0,-2,1,21.0,1.0,20.0,9
11455,11455,1998-99,1998,1999,Middlesbrough,Newcastle,Draw,Away,1999-05-01,1,3,4,7,10,2,2,3,6,1,2,4,4,0,21.0,13.0,8.0,10
11456,11456,1998-99,1998,1999,Middlesbrough,Man United,Loss,Home,1999-05-09,0,1,4,5,8,4,5,8,9,-3,-1,-3,-1,1,21.0,2.0,19.0,10
11457,11457,1998-99,1998,1999,Middlesbrough,West Ham,Loss,Away,1999-05-16,0,1,1,4,5,0,3,6,7,1,-2,-2,-2,0,21.0,8.0,13.0,10
11458,11458,1999-00,1999,2000,Middlesbrough,Bradford,Loss,Home,1999-08-07,0,0,1,1,4,0,0,0,0,0,1,1,4,1,9.0,21.0,-12.0,1
11459,11459,1999-00,1999,2000,Middlesbrough,Wimbledon,Win,Away,1999-08-10,3,0,0,1,1,3,3,3,4,-3,-3,-2,-3,0,9.0,16.0,-7.0,1
11460,11460,1999-00,1999,2000,Middlesbrough,Derby,Win,Away,1999-08-14,3,3,3,3,4,1,1,2,5,2,2,1,-1,0,9.0,8.0,1.0,1
11461,11461,1999-00,1999,2000,Middlesbrough,Liverpool,Win,Home,1999-08-21,3,6,6,6,6,3,6,6,7,3,0,0,-1,1,9.0,7.0,2.0,1
11462,11462,1999-00,1999,2000,Middlesbrough,Leicester,Loss,Home,1999-08-24,0,6,9,9,9,1,4,4,4,5,5,5,5,1,9.0,10.0,-1.0,1
11463,11463,1999-00,1999,2000,Middlesbrough,Aston Villa,Loss,Away,1999-08-28,0,3,6,9,9,3,4,7,10,0,2,2,-1,0,9.0,6.0,3.0,1
11464,11464,1999-00,1999,2000,Middlesbrough,Southampton,Win,Home,1999-09-11,3,0,3,6,9,3,6,6,9,-3,-3,0,0,1,9.0,17.0,-8.0,2
11465,11465,1999-00,1999,2000,Middlesbrough,Leeds,Loss,Away,1999-09-19,0,3,3,6,9,6,6,9,9,-3,-3,-3,0,0,9.0,4.0,5.0,2
11466,11466,1999-00,1999,2000,Middlesbrough,Chelsea,Loss,Home,1999-09-25,0,3,3,3,6,3,6,9,10,0,-3,-6,-4,1,9.0,3.0,6.0,2
11467,11467,1999-00,1999,2000,Middlesbrough,Newcastle,Loss,Away,1999-10-03,0,0,3,3,3,3,3,3,3,-3,0,0,0,0,9.0,13.0,-4.0,3
11468,11468,1999-00,1999,2000,Middlesbrough,West Ham,Win,Home,1999-10-17,3,0,0,3,3,3,3,6,9,-3,-3,-3,-6,1,9.0,5.0,4.0,3
11469,11469,1999-00,1999,2000,Middlesbrough,Watford,Win,Away,1999-10-24,3,3,3,3,6,0,0,3,3,3,3,0,3,0,9.0,21.0,-12.0,3
11470,11470,1999-00,1999,2000,Middlesbrough,Everton,Win,Home,1999-10-30,3,6,6,6,6,1,2,5,8,5,4,1,-2,1,9.0,14.0,-5.0,3
11471,11471,1999-00,1999,2000,Middlesbrough,Sunderland,Draw,Home,1999-11-06,1,6,9,9,9,4,7,10,13,2,2,-1,-4,1,9.0,21.0,-12.0,4
11472,11472,1999-00,1999,2000,Middlesbrough,Arsenal,Loss,Away,1999-11-20,0,4,7,10,10,1,4,7,7,3,3,3,3,0,9.0,2.0,7.0,4
11473,11473,1999-00,1999,2000,Middlesbrough,Wimbledon,Draw,Home,1999-11-27,1,1,4,7,10,3,4,5,8,-2,0,2,2,1,9.0,16.0,-7.0,4
11474,11474,1999-00,1999,2000,Middlesbrough,Bradford,Draw,Away,1999-12-04,1,1,2,5,8,0,1,1,4,1,1,4,4,0,9.0,21.0,-12.0,5
11475,11475,1999-00,1999,2000,Middlesbrough,Tottenham,Win,Home,1999-12-18,3,2,2,3,6,1,4,7,7,1,-2,-4,-1,1,9.0,11.0,-2.0,5
11476,11476,1999-00,1999,2000,Middlesbrough,Sheffield Weds,Loss,Away,1999-12-26,0,4,5,5,6,0,0,1,1,4,5,4,5,0,9.0,12.0,-3.0,5
11477,11477,1999-00,1999,2000,Middlesbrough,Derby,Loss,Home,2000-01-15,0,3,4,5,5,4,4,7,7,-1,0,-2,-2,1,9.0,8.0,1.0,6
11478,11478,1999-00,1999,2000,Middlesbrough,Liverpool,Draw,Away,2000-01-22,1,0,3,4,5,3,6,7,10,-3,-3,-3,-5,0,9.0,7.0,2.0,6
11479,11479,1999-00,1999,2000,Middlesbrough,Man United,Loss,Away,2000-01-29,0,1,1,4,5,2,5,8,11,-1,-4,-4,-6,0,9.0,1.0,8.0,6
11480,11480,1999-00,1999,2000,Middlesbrough,Leicester,Loss,Away,2000-02-05,0,1,1,1,4,1,2,2,2,0,-1,-1,2,0,9.0,10.0,-1.0,7
11481,11481,1999-00,1999,2000,Middlesbrough,Aston Villa,Loss,Home,2000-02-14,0,0,1,1,1,4,5,8,9,-4,-4,-7,-8,1,9.0,6.0,3.0,7
11482,11482,1999-00,1999,2000,Middlesbrough,Coventry,Win,Home,2000-02-19,3,0,0,1,1,3,4,7,8,-3,-4,-6,-7,1,9.0,15.0,-6.0,7
11483,11483,1999-00,1999,2000,Middlesbrough,Leeds,Draw,Home,2000-02-26,1,3,3,3,4,3,3,6,6,0,0,-3,-2,1,9.0,4.0,5.0,7
11484,11484,1999-00,1999,2000,Middlesbrough,Southampton,Draw,Away,2000-03-04,1,4,4,4,4,3,6,9,9,1,-2,-5,-5,0,9.0,17.0,-8.0,8
11485,11485,1999-00,1999,2000,Middlesbrough,Arsenal,Win,Home,2000-03-12,3,2,5,5,5,4,4,4,5,-2,1,1,0,1,9.0,2.0,7.0,8
11486,11486,1999-00,1999,2000,Middlesbrough,Sunderland,Draw,Away,2000-03-18,1,4,5,8,8,1,2,2,3,3,3,6,5,0,9.0,21.0,-12.0,8
11487,11487,1999-00,1999,2000,Middlesbrough,Sheffield Weds,Win,Home,2000-03-25,3,4,5,6,9,3,4,4,4,1,1,2,5,1,9.0,12.0,-3.0,8
11488,11488,1999-00,1999,2000,Middlesbrough,Tottenham,Win,Away,2000-04-03,3,4,7,8,9,1,4,5,8,3,3,3,1,0,9.0,11.0,-2.0,9
11489,11489,1999-00,1999,2000,Middlesbrough,Man United,Loss,Home,2000-04-10,0,6,7,10,11,6,9,12,13,0,-2,-2,-2,1,9.0,1.0,8.0,9
11490,11490,1999-00,1999,2000,Middlesbrough,Coventry,Loss,Away,2000-04-15,0,3,6,7,10,0,0,3,6,3,6,4,4,0,9.0,15.0,-6.0,9
11491,11491,1999-00,1999,2000,Middlesbrough,Chelsea,Draw,Away,2000-04-22,1,0,3,6,7,3,6,7,8,-3,-3,-1,-1,0,9.0,3.0,6.0,9
11492,11492,1999-00,1999,2000,Middlesbrough,West Ham,Win,Away,2000-04-29,3,1,1,4,7,6,9,9,12,-5,-8,-5,-5,0,9.0,5.0,4.0,9
11493,11493,1999-00,1999,2000,Middlesbrough,Newcastle,Draw,Home,2000-05-02,1,4,4,4,7,4,4,4,7,0,0,0,0,1,9.0,13.0,-4.0,10
11494,11494,1999-00,1999,2000,Middlesbrough,Watford,Draw,Home,2000-05-06,1,4,5,5,5,0,0,0,1,4,5,5,4,1,9.0,21.0,-12.0,10
11495,11495,1999-00,1999,2000,Middlesbrough,Everton,Win,Away,2000-05-14,3,2,5,6,6,1,2,5,6,1,3,1,0,0,9.0,14.0,-5.0,10
11496,11496,2000-01,2000,2001,Middlesbrough,Coventry,Win,Away,2000-08-19,3,4,5,8,9,3,3,3,6,1,2,5,3,0,12.0,14.0,-2.0,1
11497,11497,2000-01,2000,2001,Middlesbrough,Tottenham,Draw,Home,2000-08-22,1,6,7,8,11,6,6,7,10,0,1,1,1,1,12.0,10.0,2.0,1
11498,11498,2000-01,2000,2001,Middlesbrough,Leeds,Loss,Home,2000-08-26,0,4,7,8,9,4,5,8,11,0,2,0,-2,1,12.0,3.0,9.0,1
11499,11499,2000-01,2000,2001,Middlesbrough,Derby,Draw,Away,2000-09-06,1,1,4,7,8,1,2,2,3,0,2,5,5,0,12.0,16.0,-4.0,2
11500,11500,2000-01,2000,2001,Middlesbrough,Everton,Loss,Home,2000-09-09,0,1,2,5,8,1,4,4,4,0,-2,1,4,1,12.0,13.0,-1.0,2
11501,11501,2000-01,2000,2001,Middlesbrough,Man City,Draw,Away,2000-09-17,1,1,1,2,5,3,3,6,6,-2,-2,-4,-1,0,12.0,21.0,-9.0,2
11502,11502,2000-01,2000,2001,Middlesbrough,Aston Villa,Draw,Home,2000-09-23,1,1,2,2,3,6,6,7,8,-5,-4,-5,-5,1,12.0,6.0,6.0,2
11503,11503,2000-01,2000,2001,Middlesbrough,Southampton,Win,Away,2000-09-30,3,2,2,3,3,6,6,7,8,-4,-4,-4,-5,0,12.0,15.0,-3.0,2
11504,11504,2000-01,2000,2001,Middlesbrough,Newcastle,Loss,Home,2000-10-16,0,4,5,5,6,3,3,4,7,1,2,1,-1,1,12.0,11.0,1.0,3
11505,11505,2000-01,2000,2001,Middlesbrough,Charlton,Loss,Away,2000-10-21,0,3,4,5,5,1,4,7,8,2,0,-2,-3,0,12.0,21.0,-9.0,3
11506,11506,2000-01,2000,2001,Middlesbrough,Ipswich,Loss,Away,2000-10-28,0,0,3,4,5,4,7,8,11,-4,-4,-4,-6,0,12.0,21.0,-9.0,3
11507,11507,2000-01,2000,2001,Middlesbrough,Arsenal,Loss,Home,2000-11-04,0,0,0,3,4,6,9,12,13,-6,-9,-9,-9,1,12.0,2.0,10.0,4
11508,11508,2000-01,2000,2001,Middlesbrough,Man United,Loss,Away,2000-11-11,0,0,0,0,3,6,9,12,12,-6,-9,-12,-9,0,12.0,1.0,11.0,4
11509,11509,2000-01,2000,2001,Middlesbrough,Leicester,Loss,Home,2000-11-18,0,0,0,0,0,4,7,7,7,-4,-7,-7,-7,1,12.0,8.0,4.0,4
11510,11510,2000-01,2000,2001,Middlesbrough,Bradford,Draw,Home,2000-11-25,1,0,0,0,0,0,0,1,1,0,0,-1,-1,1,12.0,17.0,-5.0,4
11511,11511,2000-01,2000,2001,Middlesbrough,West Ham,Loss,Away,2000-12-02,0,1,1,1,1,6,9,10,13,-5,-8,-9,-12,0,12.0,9.0,3.0,5
11512,11512,2000-01,2000,2001,Middlesbrough,Sunderland,Loss,Away,2000-12-09,0,1,1,1,1,6,9,10,10,-5,-8,-9,-9,0,12.0,7.0,5.0,5
11513,11513,2000-01,2000,2001,Middlesbrough,Chelsea,Win,Home,2000-12-16,3,0,1,1,1,6,6,6,7,-6,-5,-5,-6,1,12.0,5.0,7.0,5
11514,11514,2000-01,2000,2001,Middlesbrough,Tottenham,Draw,Away,2000-12-23,1,3,3,4,4,2,2,5,8,1,1,-1,-4,0,12.0,10.0,2.0,5
11515,11515,2000-01,2000,2001,Middlesbrough,Liverpool,Win,Home,2000-12-26,3,4,4,4,5,6,6,9,9,-2,-2,-5,-4,1,12.0,4.0,8.0,5
11516,11516,2000-01,2000,2001,Middlesbrough,Coventry,Draw,Home,2000-12-30,1,4,7,7,7,4,4,7,7,0,3,0,0,1,12.0,14.0,-2.0,5
11517,11517,2000-01,2000,2001,Middlesbrough,Leeds,Draw,Away,2001-01-01,1,4,5,8,8,0,3,3,3,4,2,5,5,0,12.0,3.0,9.0,6
11518,11518,2000-01,2000,2001,Middlesbrough,Derby,Win,Home,2001-01-13,3,2,5,6,9,3,4,7,10,-1,1,-1,-1,1,12.0,16.0,-4.0,6
11519,11519,2000-01,2000,2001,Middlesbrough,Liverpool,Draw,Away,2001-01-20,1,4,5,8,9,6,6,9,12,-2,-1,-1,-3,0,12.0,4.0,8.0,6
11520,11520,2000-01,2000,2001,Middlesbrough,Everton,Draw,Away,2001-01-31,1,4,5,6,9,4,4,4,4,0,1,2,5,0,12.0,13.0,-1.0,6
11521,11521,2000-01,2000,2001,Middlesbrough,Man City,Draw,Home,2001-02-03,1,2,5,6,7,2,2,3,3,0,3,3,4,1,12.0,21.0,-9.0,7
11522,11522,2000-01,2000,2001,Middlesbrough,Aston Villa,Draw,Away,2001-02-10,1,2,3,6,7,3,3,3,3,-1,0,3,4,0,12.0,6.0,6.0,7
11523,11523,2000-01,2000,2001,Middlesbrough,Southampton,Loss,Home,2001-02-24,0,2,3,4,7,6,7,8,8,-4,-4,-4,-1,1,12.0,15.0,-3.0,7
11524,11524,2000-01,2000,2001,Middlesbrough,Charlton,Draw,Home,2001-03-03,1,1,2,3,4,4,5,8,9,-3,-3,-5,-5,1,12.0,21.0,-9.0,8
11525,11525,2000-01,2000,2001,Middlesbrough,Newcastle,Win,Away,2001-03-17,3,1,2,3,4,1,1,1,4,0,1,2,0,0,12.0,11.0,1.0,8
11526,11526,2000-01,2000,2001,Middlesbrough,Chelsea,Loss,Away,2001-03-31,0,4,4,5,6,3,4,5,5,1,0,0,1,0,12.0,5.0,7.0,8
11527,11527,2000-01,2000,2001,Middlesbrough,Sunderland,Draw,Home,2001-04-09,1,3,4,4,5,3,4,4,5,0,0,0,0,1,12.0,7.0,5.0,9
11528,11528,2000-01,2000,2001,Middlesbrough,Arsenal,Win,Away,2001-04-14,3,1,4,5,5,6,7,10,10,-5,-3,-5,-5,0,12.0,2.0,10.0,9
11529,11529,2000-01,2000,2001,Middlesbrough,Ipswich,Loss,Home,2001-04-16,0,4,4,7,8,4,7,10,10,0,-3,-3,-2,1,12.0,21.0,-9.0,9
11530,11530,2000-01,2000,2001,Middlesbrough,Leicester,Win,Away,2001-04-21,3,3,4,4,7,0,0,0,0,3,4,4,7,0,12.0,8.0,4.0,9
11531,11531,2000-01,2000,2001,Middlesbrough,Man United,Loss,Home,2001-04-28,0,3,6,7,7,4,7,7,10,-1,-1,0,-3,1,12.0,1.0,11.0,9
11532,11532,2000-01,2000,2001,Middlesbrough,Bradford,Draw,Away,2001-05-05,1,3,3,6,7,0,3,6,6,3,0,0,1,0,12.0,17.0,-5.0,10
11533,11533,2000-01,2000,2001,Middlesbrough,West Ham,Win,Home,2001-05-19,3,1,4,4,7,3,3,3,6,-2,1,1,1,1,12.0,9.0,3.0,10
11534,11534,2001-02,2001,2002,Middlesbrough,Arsenal,Loss,Home,2001-08-18,0,4,4,7,7,1,4,7,10,3,0,0,-3,1,14.0,2.0,12.0,1
11535,11535,2001-02,2001,2002,Middlesbrough,Bolton,Loss,Away,2001-08-21,0,3,4,4,7,3,6,9,9,0,-2,-5,-2,0,14.0,21.0,-7.0,1
11536,11536,2001-02,2001,2002,Middlesbrough,Everton,Loss,Away,2001-08-25,0,0,3,4,4,4,5,5,8,-4,-2,-1,-4,0,14.0,16.0,-2.0,1
11537,11537,2001-02,2001,2002,Middlesbrough,Newcastle,Loss,Home,2001-09-08,0,0,0,3,4,2,5,6,6,-2,-5,-3,-2,1,14.0,11.0,3.0,2
11538,11538,2001-02,2001,2002,Middlesbrough,West Ham,Win,Home,2001-09-15,3,0,0,0,3,2,2,2,5,-2,-2,-2,-2,1,14.0,15.0,-1.0,2
11539,11539,2001-02,2001,2002,Middlesbrough,Leicester,Win,Away,2001-09-17,3,3,3,3,3,4,4,4,4,-1,-1,-1,-1,0,14.0,13.0,1.0,2
11540,11540,2001-02,2001,2002,Middlesbrough,Chelsea,Draw,Away,2001-09-23,1,6,6,6,6,4,7,8,11,2,-1,-2,-5,0,14.0,6.0,8.0,2
11541,11541,2001-02,2001,2002,Middlesbrough,Southampton,Loss,Home,2001-09-29,0,4,7,7,7,3,3,3,3,1,4,4,4,1,14.0,10.0,4.0,2
11542,11542,2001-02,2001,2002,Middlesbrough,Charlton,Draw,Away,2001-10-13,1,1,4,7,7,4,4,5,8,-3,0,2,-1,0,14.0,9.0,5.0,3
11543,11543,2001-02,2001,2002,Middlesbrough,Sunderland,Win,Home,2001-10-22,3,1,2,5,8,3,4,4,5,-2,-2,1,3,1,14.0,7.0,7.0,3
11544,11544,2001-02,2001,2002,Middlesbrough,Tottenham,Loss,Away,2001-10-27,0,4,4,5,8,6,6,6,9,-2,-2,-1,-1,0,14.0,12.0,2.0,3
11545,11545,2001-02,2001,2002,Middlesbrough,Derby,Win,Home,2001-11-03,3,3,4,4,5,2,2,2,2,1,2,2,3,1,14.0,17.0,-3.0,4
11546,11546,2001-02,2001,2002,Middlesbrough,Aston Villa,Draw,Away,2001-11-17,1,3,6,7,7,3,6,6,9,0,0,1,-2,0,14.0,8.0,6.0,4
11547,11547,2001-02,2001,2002,Middlesbrough,Ipswich,Draw,Home,2001-11-25,1,4,4,7,8,0,0,1,2,4,4,6,6,1,14.0,5.0,9.0,4
11548,11548,2001-02,2001,2002,Middlesbrough,Blackburn,Win,Away,2001-12-01,3,2,5,5,8,2,5,6,7,0,0,-1,1,0,14.0,21.0,-7.0,5
11549,11549,2001-02,2001,2002,Middlesbrough,Liverpool,Loss,Away,2001-12-08,0,4,5,8,8,6,7,10,13,-2,-2,-2,-5,0,14.0,3.0,11.0,5
11550,11550,2001-02,2001,2002,Middlesbrough,Man United,Loss,Home,2001-12-15,0,3,4,5,8,3,3,3,6,0,1,2,2,1,14.0,1.0,13.0,5
11551,11551,2001-02,2001,2002,Middlesbrough,Newcastle,Loss,Away,2001-12-26,0,0,3,4,5,6,9,12,13,-6,-6,-8,-8,0,14.0,11.0,3.0,5
11552,11552,2001-02,2001,2002,Middlesbrough,Arsenal,Loss,Away,2001-12-29,0,0,0,3,4,6,6,7,10,-6,-6,-4,-6,0,14.0,2.0,12.0,5
11553,11553,2001-02,2001,2002,Middlesbrough,Everton,Win,Home,2002-01-01,3,0,0,0,3,0,0,0,3,0,0,0,0,1,14.0,16.0,-2.0,6
11554,11554,2001-02,2001,2002,Middlesbrough,Fulham,Loss,Away,2002-01-12,0,3,3,3,3,3,4,4,5,0,-1,-1,-2,0,14.0,21.0,-7.0,6
11555,11555,2001-02,2001,2002,Middlesbrough,Bolton,Draw,Home,2002-01-19,1,3,3,3,3,2,3,3,3,1,0,0,0,1,14.0,21.0,-7.0,6
11556,11556,2001-02,2001,2002,Middlesbrough,Sunderland,Win,Away,2002-01-29,3,1,4,4,4,1,2,2,5,0,2,2,-1,0,14.0,7.0,7.0,6
11557,11557,2001-02,2001,2002,Middlesbrough,Charlton,Draw,Home,2002-02-03,1,4,4,7,7,3,3,6,9,1,1,1,-2,1,14.0,9.0,5.0,7
11558,11558,2001-02,2001,2002,Middlesbrough,Leeds,Draw,Home,2002-02-09,1,4,5,5,8,0,1,1,4,4,4,4,4,1,14.0,4.0,10.0,7
11559,11559,2001-02,2001,2002,Middlesbrough,Fulham,Win,Home,2002-02-19,3,2,5,6,6,4,4,5,8,-2,1,1,-2,1,14.0,21.0,-7.0,7
11560,11560,2001-02,2001,2002,Middlesbrough,West Ham,Loss,Away,2002-02-23,0,4,5,8,9,3,3,3,6,1,2,5,3,0,14.0,15.0,-1.0,7
11561,11561,2001-02,2001,2002,Middlesbrough,Leicester,Win,Home,2002-03-02,3,3,4,5,8,0,0,0,0,3,4,5,8,1,14.0,13.0,1.0,8
11562,11562,2001-02,2001,2002,Middlesbrough,Southampton,Draw,Away,2002-03-06,1,3,6,7,8,4,4,5,8,-1,2,2,0,0,14.0,10.0,4.0,8
11563,11563,2001-02,2001,2002,Middlesbrough,Liverpool,Loss,Home,2002-03-16,0,4,4,7,8,6,7,10,13,-2,-3,-3,-5,1,14.0,3.0,11.0,8
11564,11564,2001-02,2001,2002,Middlesbrough,Man United,Win,Away,2002-03-23,3,1,4,4,7,6,7,10,13,-5,-3,-6,-6,0,14.0,1.0,13.0,8
11565,11565,2001-02,2001,2002,Middlesbrough,Tottenham,Draw,Home,2002-03-30,1,3,4,7,7,3,3,3,6,0,1,4,1,1,14.0,12.0,2.0,8
11566,11566,2001-02,2001,2002,Middlesbrough,Derby,Win,Away,2002-04-01,3,4,4,5,8,0,3,3,4,4,1,2,4,0,14.0,17.0,-3.0,9
11567,11567,2001-02,2001,2002,Middlesbrough,Aston Villa,Win,Home,2002-04-06,3,4,7,7,8,1,2,2,2,3,5,5,6,1,14.0,8.0,6.0,9
11568,11568,2001-02,2001,2002,Middlesbrough,Blackburn,Loss,Home,2002-04-20,0,6,7,10,10,4,4,4,7,2,3,6,3,1,14.0,21.0,-7.0,9
11569,11569,2001-02,2001,2002,Middlesbrough,Ipswich,Loss,Away,2002-04-24,0,3,6,7,10,0,1,1,2,3,5,6,8,0,14.0,5.0,9.0,9
11570,11570,2001-02,2001,2002,Middlesbrough,Chelsea,Loss,Home,2002-04-27,0,0,3,6,7,1,4,5,8,-1,-1,1,-1,1,14.0,6.0,8.0,9
11571,11571,2001-02,2001,2002,Middlesbrough,Leeds,Loss,Away,2002-05-11,0,0,0,3,6,3,6,9,9,-3,-6,-6,-3,0,14.0,4.0,10.0,10
11572,11572,2003-04,2003,2004,Middlesbrough,Fulham,Loss,Away,2003-08-16,0,0,0,0,3,6,7,7,10,-6,-7,-7,-7,0,11.0,14.0,-3.0,1
11573,11573,2003-04,2003,2004,Middlesbrough,Arsenal,Loss,Home,2003-08-24,0,0,0,0,0,6,9,9,10,-6,-9,-9,-10,1,11.0,2.0,9.0,1
11574,11574,2003-04,2003,2004,Middlesbrough,Leicester,Draw,Away,2003-08-26,1,0,0,0,0,1,4,5,6,-1,-4,-5,-6,0,11.0,21.0,-10.0,1
11575,11575,2003-04,2003,2004,Middlesbrough,Leeds,Loss,Home,2003-08-30,0,1,1,1,1,1,2,5,8,0,-1,-4,-7,1,11.0,15.0,-4.0,1
11576,11576,2003-04,2003,2004,Middlesbrough,Bolton,Loss,Away,2003-09-13,0,1,1,1,1,1,2,2,5,0,-1,-1,-4,0,11.0,17.0,-6.0,2
11577,11577,2003-04,2003,2004,Middlesbrough,Everton,Win,Home,2003-09-21,3,0,1,1,1,1,2,5,5,-1,-1,-4,-4,1,11.0,7.0,4.0,2
11578,11578,2003-04,2003,2004,Middlesbrough,Southampton,Win,Away,2003-09-27,3,3,3,4,4,6,9,10,11,-3,-6,-6,-7,0,11.0,8.0,3.0,2
11579,11579,2003-04,2003,2004,Middlesbrough,Chelsea,Loss,Home,2003-10-05,0,6,6,6,7,6,9,10,13,0,-3,-4,-6,1,11.0,4.0,7.0,3
11580,11580,2003-04,2003,2004,Middlesbrough,Newcastle,Loss,Home,2003-10-18,0,3,6,6,6,3,4,5,5,0,2,1,1,1,11.0,3.0,8.0,3
11581,11581,2003-04,2003,2004,Middlesbrough,Tottenham,Draw,Away,2003-10-26,1,0,3,6,6,6,7,7,7,-6,-4,-1,-1,0,11.0,10.0,1.0,3
11582,11582,2003-04,2003,2004,Middlesbrough,Wolves,Win,Home,2003-11-01,3,1,1,4,7,4,7,8,8,-3,-6,-4,-1,1,11.0,21.0,-10.0,4
11583,11583,2003-04,2003,2004,Middlesbrough,Aston Villa,Win,Away,2003-11-08,3,4,4,4,7,2,3,4,4,2,1,0,3,0,11.0,16.0,-5.0,4
11584,11584,2003-04,2003,2004,Middlesbrough,Liverpool,Draw,Home,2003-11-22,1,6,7,7,7,3,6,6,6,3,1,1,1,1,11.0,5.0,6.0,4
11585,11585,2003-04,2003,2004,Middlesbrough,Man City,Win,Away,2003-11-30,3,4,7,8,8,0,3,3,6,4,4,5,2,0,11.0,9.0,2.0,4
11586,11586,2003-04,2003,2004,Middlesbrough,Portsmouth,Draw,Home,2003-12-06,1,4,7,10,11,0,3,3,3,4,4,7,8,1,11.0,21.0,-10.0,5
11587,11587,2003-04,2003,2004,Middlesbrough,Charlton,Draw,Home,2003-12-13,1,4,5,8,11,0,1,4,7,4,4,4,4,1,11.0,12.0,-1.0,5
11588,11588,2003-04,2003,2004,Middlesbrough,Blackburn,Draw,Away,2003-12-26,1,2,5,6,9,0,3,6,6,2,2,0,3,0,11.0,6.0,5.0,5
11589,11589,2003-04,2003,2004,Middlesbrough,Man United,Loss,Home,2003-12-28,0,2,3,6,7,6,9,12,12,-4,-6,-6,-5,1,11.0,1.0,10.0,5
11590,11590,2003-04,2003,2004,Middlesbrough,Fulham,Win,Home,2004-01-07,3,1,2,3,6,3,3,3,6,-2,-1,0,0,1,11.0,14.0,-3.0,6
11591,11591,2003-04,2003,2004,Middlesbrough,Arsenal,Loss,Away,2004-01-10,0,3,4,5,6,4,7,8,11,-1,-3,-3,-5,0,11.0,2.0,9.0,6
11592,11592,2003-04,2003,2004,Middlesbrough,Leicester,Draw,Home,2004-01-17,1,3,3,4,5,1,2,3,3,2,1,1,2,1,11.0,21.0,-10.0,6
11593,11593,2003-04,2003,2004,Middlesbrough,Leeds,Win,Away,2004-01-31,3,1,4,4,5,0,0,0,1,1,4,4,4,0,11.0,15.0,-4.0,6
11594,11594,2003-04,2003,2004,Middlesbrough,Blackburn,Loss,Home,2004-02-07,0,4,4,7,7,1,1,2,5,3,3,5,2,1,11.0,6.0,5.0,7
11595,11595,2003-04,2003,2004,Middlesbrough,Man United,Win,Away,2004-02-11,3,3,4,4,7,6,6,7,10,-3,-2,-3,-3,0,11.0,1.0,10.0,7
11596,11596,2003-04,2003,2004,Middlesbrough,Newcastle,Loss,Away,2004-02-21,0,3,6,7,7,4,5,8,9,-1,1,-1,-2,0,11.0,3.0,8.0,7
11597,11597,2003-04,2003,2004,Middlesbrough,Birmingham,Loss,Away,2004-03-03,0,3,3,6,7,4,5,6,7,-1,-2,0,0,0,11.0,13.0,-2.0,8
11598,11598,2003-04,2003,2004,Middlesbrough,Tottenham,Win,Home,2004-03-09,3,0,3,3,6,4,7,7,10,-4,-4,-4,-4,1,11.0,10.0,1.0,8
11599,11599,2003-04,2003,2004,Middlesbrough,Charlton,Loss,Away,2004-03-13,0,3,3,6,6,3,3,3,3,0,0,3,3,0,11.0,12.0,-1.0,8
11600,11600,2003-04,2003,2004,Middlesbrough,Birmingham,Win,Home,2004-03-20,3,3,3,3,6,3,6,7,10,0,-3,-4,-4,1,11.0,13.0,-2.0,8
11601,11601,2003-04,2003,2004,Middlesbrough,Everton,Draw,Away,2004-03-27,1,3,6,6,6,4,7,8,8,-1,-1,-2,-2,0,11.0,7.0,4.0,8
11602,11602,2003-04,2003,2004,Middlesbrough,Bolton,Win,Home,2004-04-03,3,4,4,7,7,3,3,3,3,1,1,4,4,1,11.0,17.0,-6.0,9
11603,11603,2003-04,2003,2004,Middlesbrough,Chelsea,Draw,Away,2004-04-10,1,4,7,7,10,6,9,12,15,-2,-2,-5,-5,0,11.0,4.0,7.0,9
11604,11604,2003-04,2003,2004,Middlesbrough,Southampton,Win,Home,2004-04-12,3,4,5,8,8,6,6,9,10,-2,-1,-1,-2,1,11.0,8.0,3.0,9
11605,11605,2003-04,2003,2004,Middlesbrough,Wolves,Loss,Away,2004-04-17,0,4,7,8,11,1,1,1,1,3,6,7,10,0,11.0,21.0,-10.0,9
11606,11606,2003-04,2003,2004,Middlesbrough,Aston Villa,Loss,Home,2004-04-24,0,3,4,7,8,4,5,6,9,-1,-1,1,-1,1,11.0,16.0,-5.0,9
11607,11607,2003-04,2003,2004,Middlesbrough,Liverpool,Loss,Away,2004-05-02,0,0,3,4,7,4,4,4,7,-4,-1,0,0,0,11.0,5.0,6.0,10
11608,11608,2003-04,2003,2004,Middlesbrough,Man City,Win,Home,2004-05-08,3,0,0,3,4,4,4,5,6,-4,-4,-2,-2,1,11.0,9.0,2.0,10
11609,11609,2003-04,2003,2004,Middlesbrough,Portsmouth,Loss,Away,2004-05-15,0,3,3,3,6,1,2,5,8,2,1,-2,-2,0,11.0,21.0,-10.0,10
11610,11610,2004-05,2004,2005,Middlesbrough,Newcastle,Draw,Home,2004-08-14,1,3,3,3,3,2,3,3,6,1,0,0,-3,1,11.0,5.0,6.0,1
11611,11611,2004-05,2004,2005,Middlesbrough,Arsenal,Loss,Away,2004-08-22,0,1,4,4,4,6,9,10,11,-5,-5,-6,-7,0,11.0,1.0,10.0,1
11612,11612,2004-05,2004,2005,Middlesbrough,Fulham,Win,Away,2004-08-25,3,1,1,4,4,4,7,7,8,-3,-6,-3,-4,0,11.0,9.0,2.0,1
11613,11613,2004-05,2004,2005,Middlesbrough,Crystal Palace,Win,Home,2004-08-28,3,3,4,4,7,0,1,4,5,3,3,0,2,1,11.0,21.0,-10.0,1
11614,11614,2004-05,2004,2005,Middlesbrough,Birmingham,Win,Home,2004-09-11,3,6,6,7,7,3,3,4,5,3,3,3,2,1,11.0,10.0,1.0,2
11615,11615,2004-05,2004,2005,Middlesbrough,Everton,Loss,Away,2004-09-19,0,6,9,9,10,4,7,10,10,2,2,-1,0,0,11.0,17.0,-6.0,2
11616,11616,2004-05,2004,2005,Middlesbrough,Chelsea,Loss,Home,2004-09-25,0,3,6,9,9,2,5,8,11,1,1,1,-2,1,11.0,2.0,9.0,2
11617,11617,2004-05,2004,2005,Middlesbrough,Man United,Draw,Away,2004-10-03,1,0,3,6,9,6,7,8,9,-6,-4,-2,0,0,11.0,3.0,8.0,3
11618,11618,2004-05,2004,2005,Middlesbrough,Blackburn,Win,Away,2004-10-16,3,1,1,4,7,1,4,4,5,0,-3,0,2,0,11.0,15.0,-4.0,3
11619,11619,2004-05,2004,2005,Middlesbrough,Portsmouth,Draw,Home,2004-10-24,1,4,4,4,7,4,4,4,7,0,0,0,0,1,11.0,13.0,-2.0,3
11620,11620,2004-05,2004,2005,Middlesbrough,Charlton,Win,Away,2004-10-30,3,4,5,5,5,1,1,4,5,3,4,1,0,0,11.0,7.0,4.0,3
11621,11621,2004-05,2004,2005,Middlesbrough,Bolton,Draw,Home,2004-11-07,1,4,7,8,8,6,9,9,10,-2,-2,-1,-2,1,11.0,8.0,3.0,4
11622,11622,2004-05,2004,2005,Middlesbrough,West Brom,Win,Away,2004-11-14,3,4,5,8,9,1,1,2,5,3,4,6,4,0,11.0,21.0,-10.0,4
11623,11623,2004-05,2004,2005,Middlesbrough,Liverpool,Win,Home,2004-11-20,3,4,7,8,11,3,4,7,10,1,3,1,1,1,11.0,4.0,7.0,4
11624,11624,2004-05,2004,2005,Middlesbrough,Tottenham,Loss,Away,2004-11-28,0,6,7,10,11,0,0,0,0,6,7,10,11,0,11.0,14.0,-3.0,4
11625,11625,2004-05,2004,2005,Middlesbrough,Man City,Win,Home,2004-12-06,3,3,6,7,10,6,7,8,9,-3,-1,-1,1,1,11.0,16.0,-5.0,5
11626,11626,2004-05,2004,2005,Middlesbrough,Southampton,Draw,Away,2004-12-11,1,3,6,9,10,1,1,4,5,2,5,5,5,0,11.0,12.0,-1.0,5
11627,11627,2004-05,2004,2005,Middlesbrough,Aston Villa,Win,Home,2004-12-18,3,4,4,7,10,1,1,4,7,3,3,3,3,1,11.0,6.0,5.0,5
11628,11628,2004-05,2004,2005,Middlesbrough,Birmingham,Loss,Away,2004-12-26,0,4,7,7,10,6,6,7,8,-2,1,0,2,0,11.0,10.0,1.0,5
11629,11629,2004-05,2004,2005,Middlesbrough,Norwich,Win,Home,2004-12-28,3,3,4,7,7,0,3,3,4,3,1,4,3,1,11.0,21.0,-10.0,5
11630,11630,2004-05,2004,2005,Middlesbrough,Man United,Loss,Home,2005-01-01,0,3,6,7,10,6,9,10,13,-3,-3,-3,-3,1,11.0,3.0,8.0,6
11631,11631,2004-05,2004,2005,Middlesbrough,Chelsea,Loss,Away,2005-01-04,0,3,3,6,7,6,9,12,13,-3,-6,-6,-6,0,11.0,2.0,9.0,6
11632,11632,2004-05,2004,2005,Middlesbrough,Everton,Draw,Home,2005-01-16,1,0,3,3,6,3,3,6,7,-3,0,-3,-1,1,11.0,17.0,-6.0,6
11633,11633,2004-05,2004,2005,Middlesbrough,Norwich,Draw,Away,2005-01-22,1,1,1,4,4,0,1,1,1,1,0,3,3,0,11.0,21.0,-10.0,6
11634,11634,2004-05,2004,2005,Middlesbrough,Portsmouth,Loss,Away,2005-02-01,0,2,2,2,5,0,0,1,1,2,2,1,4,0,11.0,13.0,-2.0,7
11635,11635,2004-05,2004,2005,Middlesbrough,Blackburn,Win,Home,2005-02-05,3,1,2,2,2,0,3,6,6,1,-1,-4,-4,1,11.0,15.0,-4.0,7
11636,11636,2004-05,2004,2005,Middlesbrough,Bolton,Draw,Away,2005-02-12,1,3,4,5,5,6,9,12,15,-3,-5,-7,-10,0,11.0,8.0,3.0,7
11637,11637,2004-05,2004,2005,Middlesbrough,Charlton,Draw,Home,2005-02-27,1,4,4,5,6,1,4,7,7,3,0,-2,-1,1,11.0,7.0,4.0,7
11638,11638,2004-05,2004,2005,Middlesbrough,Aston Villa,Loss,Away,2005-03-05,0,2,5,5,6,3,3,4,4,-1,2,1,2,0,11.0,6.0,5.0,8
11639,11639,2004-05,2004,2005,Middlesbrough,Southampton,Loss,Home,2005-03-20,0,1,2,5,5,4,5,6,6,-3,-3,-1,-1,1,11.0,12.0,-1.0,8
11640,11640,2004-05,2004,2005,Middlesbrough,Crystal Palace,Win,Away,2005-04-02,3,0,1,2,5,1,4,4,4,-1,-3,-2,1,0,11.0,21.0,-10.0,9
11641,11641,2004-05,2004,2005,Middlesbrough,Arsenal,Loss,Home,2005-04-09,0,3,3,4,5,6,9,10,13,-3,-6,-6,-8,1,11.0,1.0,10.0,9
11642,11642,2004-05,2004,2005,Middlesbrough,Fulham,Draw,Home,2005-04-19,1,3,3,3,4,1,4,4,5,2,-1,-1,-1,1,11.0,9.0,2.0,9
11643,11643,2004-05,2004,2005,Middlesbrough,West Brom,Win,Home,2005-04-23,3,1,4,4,4,2,5,8,8,-1,-1,-4,-4,1,11.0,21.0,-10.0,9
11644,11644,2004-05,2004,2005,Middlesbrough,Newcastle,Draw,Away,2005-04-27,1,4,4,7,7,0,0,0,1,4,4,7,6,0,11.0,5.0,6.0,9
11645,11645,2004-05,2004,2005,Middlesbrough,Liverpool,Draw,Away,2005-04-30,1,4,5,5,8,3,4,4,7,1,1,1,1,0,11.0,4.0,7.0,9
11646,11646,2004-05,2004,2005,Middlesbrough,Tottenham,Win,Home,2005-05-07,3,2,5,6,6,3,4,5,8,-1,1,1,-2,1,11.0,14.0,-3.0,10
11647,11647,2004-05,2004,2005,Middlesbrough,Man City,Draw,Away,2005-05-15,1,4,5,8,9,6,7,10,11,-2,-2,-2,-2,0,11.0,16.0,-5.0,10
11648,11648,2005-06,2005,2006,Middlesbrough,Liverpool,Draw,Home,2005-08-13,1,4,5,6,9,3,4,4,7,1,1,2,2,1,7.0,5.0,2.0,1
11649,11649,2005-06,2005,2006,Middlesbrough,Tottenham,Loss,Away,2005-08-20,0,2,5,6,7,4,4,7,7,-2,1,-1,0,0,7.0,9.0,-2.0,1
11650,11650,2005-06,2005,2006,Middlesbrough,Birmingham,Win,Away,2005-08-23,3,1,2,5,6,1,4,4,7,0,-2,1,-1,0,7.0,12.0,-5.0,1
11651,11651,2005-06,2005,2006,Middlesbrough,Charlton,Loss,Home,2005-08-28,0,3,4,5,8,6,7,7,7,-3,-3,-2,1,1,7.0,11.0,-4.0,1
11652,11652,2005-06,2005,2006,Middlesbrough,Arsenal,Win,Home,2005-09-10,3,3,3,4,5,3,6,6,9,0,-3,-2,-4,1,7.0,2.0,5.0,2
11653,11653,2005-06,2005,2006,Middlesbrough,Wigan,Draw,Away,2005-09-18,1,3,6,6,7,6,6,6,6,-3,0,0,1,0,7.0,21.0,-14.0,2
11654,11654,2005-06,2005,2006,Middlesbrough,Sunderland,Loss,Home,2005-09-25,0,4,4,7,7,1,1,1,1,3,3,6,6,1,7.0,21.0,-14.0,2
11655,11655,2005-06,2005,2006,Middlesbrough,Aston Villa,Win,Away,2005-10-02,3,1,4,4,7,1,1,4,5,0,3,0,2,0,7.0,10.0,-3.0,3
11656,11656,2005-06,2005,2006,Middlesbrough,Portsmouth,Draw,Home,2005-10-15,1,3,4,7,7,1,2,5,5,2,2,2,2,1,7.0,16.0,-9.0,3
11657,11657,2005-06,2005,2006,Middlesbrough,West Ham,Loss,Away,2005-10-23,0,4,4,5,8,1,2,5,8,3,2,0,0,0,7.0,21.0,-14.0,3
11658,11658,2005-06,2005,2006,Middlesbrough,Man United,Win,Home,2005-10-29,3,1,4,4,5,4,7,7,8,-3,-3,-3,-3,1,7.0,3.0,4.0,3
11659,11659,2005-06,2005,2006,Middlesbrough,Everton,Loss,Away,2005-11-06,0,3,4,7,7,4,4,4,4,-1,0,3,3,0,7.0,4.0,3.0,4
11660,11660,2005-06,2005,2006,Middlesbrough,Fulham,Win,Home,2005-11-20,3,3,3,4,7,3,6,7,7,0,-3,-3,0,1,7.0,13.0,-6.0,4
11661,11661,2005-06,2005,2006,Middlesbrough,West Brom,Draw,Home,2005-11-27,1,3,6,6,7,3,3,3,6,0,3,3,1,1,7.0,17.0,-10.0,4
11662,11662,2005-06,2005,2006,Middlesbrough,Chelsea,Loss,Away,2005-12-03,0,4,4,7,7,6,6,9,10,-2,-2,-2,-3,0,7.0,1.0,6.0,5
11663,11663,2005-06,2005,2006,Middlesbrough,Liverpool,Loss,Away,2005-12-10,0,1,4,4,7,6,9,12,15,-5,-5,-8,-8,0,7.0,5.0,2.0,5
11664,11664,2005-06,2005,2006,Middlesbrough,Tottenham,Draw,Home,2005-12-18,1,0,1,4,4,6,9,10,10,-6,-8,-6,-6,1,7.0,9.0,-2.0,5
11665,11665,2005-06,2005,2006,Middlesbrough,Blackburn,Loss,Home,2005-12-26,0,1,1,2,5,3,3,3,4,-2,-2,-1,1,1,7.0,15.0,-8.0,5
11666,11666,2005-06,2005,2006,Middlesbrough,Man City,Draw,Home,2005-12-31,1,1,1,1,2,0,3,3,6,1,-2,-2,-4,1,7.0,8.0,-1.0,5
11667,11667,2005-06,2005,2006,Middlesbrough,Newcastle,Draw,Away,2006-01-02,1,1,2,2,2,0,3,6,7,1,-1,-4,-5,0,7.0,14.0,-7.0,6
11668,11668,2005-06,2005,2006,Middlesbrough,Arsenal,Loss,Away,2006-01-14,0,2,2,3,3,2,5,8,8,0,-3,-5,-5,0,7.0,2.0,5.0,6
11669,11669,2005-06,2005,2006,Middlesbrough,Wigan,Loss,Home,2006-01-21,0,1,2,2,3,0,0,3,6,1,2,-1,-3,1,7.0,21.0,-14.0,6
11670,11670,2005-06,2005,2006,Middlesbrough,Sunderland,Win,Away,2006-01-31,3,0,1,2,2,3,3,3,4,-3,-2,-1,-2,0,7.0,21.0,-14.0,6
11671,11671,2005-06,2005,2006,Middlesbrough,Aston Villa,Loss,Home,2006-02-04,0,3,3,4,5,2,2,5,6,1,1,-1,-1,1,7.0,10.0,-3.0,7
11672,11672,2005-06,2005,2006,Middlesbrough,Chelsea,Win,Home,2006-02-11,3,3,3,3,4,4,5,8,11,-1,-2,-5,-7,1,7.0,1.0,6.0,7
11673,11673,2005-06,2005,2006,Middlesbrough,West Brom,Win,Away,2006-02-26,3,3,6,6,6,3,4,4,7,0,2,2,-1,0,7.0,17.0,-10.0,7
11674,11674,2005-06,2005,2006,Middlesbrough,Birmingham,Win,Home,2006-03-04,3,6,6,9,9,3,3,4,7,3,3,5,2,1,7.0,12.0,-5.0,8
11675,11675,2005-06,2005,2006,Middlesbrough,Charlton,Loss,Away,2006-03-12,0,6,9,9,12,2,3,3,6,4,6,6,6,0,7.0,11.0,-4.0,8
11676,11676,2005-06,2005,2006,Middlesbrough,Blackburn,Loss,Away,2006-03-18,0,3,6,9,9,3,6,9,9,0,0,0,0,0,7.0,15.0,-8.0,8
11677,11677,2005-06,2005,2006,Middlesbrough,Bolton,Win,Home,2006-03-26,3,0,3,6,9,6,6,9,10,-6,-3,-3,-1,1,7.0,6.0,1.0,8
11678,11678,2005-06,2005,2006,Middlesbrough,Man City,Win,Away,2006-04-02,3,3,3,6,9,0,0,3,3,3,3,3,6,0,7.0,8.0,-1.0,9
11679,11679,2005-06,2005,2006,Middlesbrough,Newcastle,Loss,Home,2006-04-09,0,6,6,6,9,3,3,3,6,3,3,3,3,1,7.0,14.0,-7.0,9
11680,11680,2005-06,2005,2006,Middlesbrough,Portsmouth,Loss,Away,2006-04-15,0,3,6,6,6,2,5,8,11,1,1,-2,-5,0,7.0,16.0,-9.0,9
11681,11681,2005-06,2005,2006,Middlesbrough,West Ham,Win,Home,2006-04-17,3,0,3,6,6,3,4,4,7,-3,-1,2,-1,1,7.0,21.0,-14.0,9
11682,11682,2005-06,2005,2006,Middlesbrough,Everton,Loss,Home,2006-04-29,0,3,3,6,9,1,1,2,3,2,2,4,6,1,7.0,4.0,3.0,9
11683,11683,2005-06,2005,2006,Middlesbrough,Man United,Draw,Away,2006-05-01,1,3,3,3,6,3,4,7,10,0,-1,-4,-4,0,7.0,3.0,4.0,10
11684,11684,2005-06,2005,2006,Middlesbrough,Bolton,Draw,Away,2006-05-03,1,1,4,4,4,3,4,4,4,-2,0,0,0,0,7.0,6.0,1.0,10
11685,11685,2005-06,2005,2006,Middlesbrough,Fulham,Loss,Away,2006-05-07,0,2,2,5,5,3,6,9,9,-1,-4,-4,-4,0,7.0,13.0,-6.0,10
11686,11686,2006-07,2006,2007,Middlesbrough,Reading,Loss,Away,2006-08-19,0,1,2,2,5,0,0,0,0,1,2,2,5,0,14.0,21.0,-7.0,1
11687,11687,2006-07,2006,2007,Middlesbrough,Chelsea,Win,Home,2006-08-23,3,0,1,2,2,3,3,6,9,-3,-2,-4,-7,1,14.0,1.0,13.0,1
11688,11688,2006-07,2006,2007,Middlesbrough,Portsmouth,Loss,Home,2006-08-28,0,3,3,4,5,4,4,7,10,-1,-1,-3,-5,1,14.0,17.0,-3.0,1
11689,11689,2006-07,2006,2007,Middlesbrough,Arsenal,Draw,Away,2006-09-09,1,3,3,3,4,1,4,7,10,2,-1,-4,-6,0,14.0,4.0,10.0,2
11690,11690,2006-07,2006,2007,Middlesbrough,Bolton,Draw,Away,2006-09-16,1,1,4,4,4,3,4,7,10,-2,0,-3,-6,0,14.0,8.0,6.0,2
11691,11691,2006-07,2006,2007,Middlesbrough,Blackburn,Loss,Home,2006-09-23,0,2,2,5,5,4,4,5,5,-2,-2,0,0,1,14.0,6.0,8.0,2
11692,11692,2006-07,2006,2007,Middlesbrough,Sheffield United,Loss,Away,2006-09-30,0,1,2,2,5,0,1,1,1,1,1,1,4,0,14.0,21.0,-7.0,2
11693,11693,2006-07,2006,2007,Middlesbrough,Everton,Win,Home,2006-10-14,3,0,1,2,2,2,3,6,9,-2,-2,-4,-7,1,14.0,11.0,3.0,3
11694,11694,2006-07,2006,2007,Middlesbrough,Newcastle,Win,Home,2006-10-22,3,3,3,4,5,0,1,1,4,3,2,3,1,1,14.0,7.0,7.0,3
11695,11695,2006-07,2006,2007,Middlesbrough,Man City,Loss,Away,2006-10-30,0,6,6,6,7,1,2,5,5,5,4,1,2,0,14.0,15.0,-1.0,3
11696,11696,2006-07,2006,2007,Middlesbrough,Watford,Loss,Away,2006-11-04,0,3,6,6,6,2,2,3,4,1,4,3,2,0,14.0,21.0,-7.0,4
11697,11697,2006-07,2006,2007,Middlesbrough,West Ham,Win,Home,2006-11-11,3,0,3,6,6,6,6,6,6,-6,-3,0,0,1,14.0,9.0,5.0,4
11698,11698,2006-07,2006,2007,Middlesbrough,Liverpool,Draw,Home,2006-11-18,1,3,3,6,9,3,6,6,7,0,-3,0,2,1,14.0,3.0,11.0,4
11699,11699,2006-07,2006,2007,Middlesbrough,Aston Villa,Draw,Away,2006-11-25,1,4,4,4,7,4,7,7,8,0,-3,-3,-1,0,14.0,16.0,-2.0,4
11700,11700,2006-07,2006,2007,Middlesbrough,Man United,Loss,Home,2006-12-02,0,2,5,5,5,4,7,10,13,-2,-2,-5,-8,1,14.0,2.0,12.0,5
11701,11701,2006-07,2006,2007,Middlesbrough,Tottenham,Loss,Away,2006-12-05,0,1,2,5,5,3,4,4,7,-2,-2,1,-2,0,14.0,5.0,9.0,5
11702,11702,2006-07,2006,2007,Middlesbrough,Wigan,Draw,Home,2006-12-09,1,0,1,2,5,3,3,4,7,-3,-2,-2,-2,1,14.0,10.0,4.0,5
11703,11703,2006-07,2006,2007,Middlesbrough,Fulham,Loss,Away,2006-12-18,0,1,1,2,3,0,3,3,3,1,-2,-1,0,0,14.0,12.0,2.0,5
11704,11704,2006-07,2006,2007,Middlesbrough,Charlton,Win,Home,2006-12-23,3,1,1,1,2,0,3,3,4,1,-2,-2,-2,1,14.0,13.0,1.0,5
11705,11705,2006-07,2006,2007,Middlesbrough,Everton,Draw,Away,2006-12-26,1,3,4,4,4,3,3,6,6,0,1,-2,-2,0,14.0,11.0,3.0,5
11706,11706,2006-07,2006,2007,Middlesbrough,Blackburn,Loss,Away,2006-12-30,0,4,4,5,5,3,6,6,6,1,-2,-1,-1,0,14.0,6.0,8.0,5
11707,11707,2006-07,2006,2007,Middlesbrough,Sheffield United,Win,Home,2007-01-01,3,1,4,4,5,3,3,6,7,-2,1,-2,-2,1,14.0,21.0,-7.0,6
11708,11708,2006-07,2006,2007,Middlesbrough,Charlton,Win,Away,2007-01-13,3,3,4,7,7,3,4,4,4,0,0,3,3,0,14.0,13.0,1.0,6
11709,11709,2006-07,2006,2007,Middlesbrough,Bolton,Win,Home,2007-01-20,3,6,6,7,10,1,4,7,10,5,2,0,0,1,14.0,8.0,6.0,6
11710,11710,2006-07,2006,2007,Middlesbrough,Portsmouth,Draw,Away,2007-01-30,1,6,9,9,10,1,2,2,5,5,7,7,5,0,14.0,17.0,-3.0,6
11711,11711,2006-07,2006,2007,Middlesbrough,Arsenal,Draw,Home,2007-02-03,1,4,7,10,10,6,9,9,12,-2,-2,1,-2,1,14.0,4.0,10.0,7
11712,11712,2006-07,2006,2007,Middlesbrough,Chelsea,Loss,Away,2007-02-10,0,2,5,8,11,6,6,9,10,-4,-1,-1,1,0,14.0,1.0,13.0,7
11713,11713,2006-07,2006,2007,Middlesbrough,Reading,Win,Home,2007-02-24,3,1,2,5,8,6,9,12,13,-5,-7,-7,-5,1,14.0,21.0,-7.0,7
11714,11714,2006-07,2006,2007,Middlesbrough,Newcastle,Draw,Away,2007-03-03,1,3,4,5,8,3,3,6,7,0,1,-1,1,0,14.0,7.0,7.0,8
11715,11715,2006-07,2006,2007,Middlesbrough,Man City,Loss,Home,2007-03-17,0,4,4,5,6,0,0,0,0,4,4,5,6,1,14.0,15.0,-1.0,8
11716,11716,2006-07,2006,2007,Middlesbrough,West Ham,Loss,Away,2007-03-31,0,1,4,4,5,3,3,3,3,-2,1,1,2,0,14.0,9.0,5.0,8
11717,11717,2006-07,2006,2007,Middlesbrough,Watford,Win,Home,2007-04-07,3,0,1,4,4,0,1,1,2,0,0,3,2,1,14.0,21.0,-7.0,9
11718,11718,2006-07,2006,2007,Middlesbrough,Aston Villa,Loss,Home,2007-04-14,0,3,3,4,7,4,5,6,6,-1,-2,-2,1,1,14.0,16.0,-2.0,9
11719,11719,2006-07,2006,2007,Middlesbrough,Liverpool,Loss,Away,2007-04-18,0,3,3,3,4,4,7,8,8,-1,-4,-5,-4,0,14.0,3.0,11.0,9
11720,11720,2006-07,2006,2007,Middlesbrough,Man United,Draw,Away,2007-04-21,1,0,3,3,3,3,6,9,12,-3,-3,-6,-9,0,14.0,2.0,12.0,9
11721,11721,2006-07,2006,2007,Middlesbrough,Tottenham,Loss,Home,2007-04-28,0,1,1,4,4,2,2,5,8,-1,-1,-1,-4,1,14.0,5.0,9.0,9
11722,11722,2006-07,2006,2007,Middlesbrough,Wigan,Win,Away,2007-05-05,3,1,1,1,4,0,1,2,2,1,0,-1,2,0,14.0,10.0,4.0,10
11723,11723,2006-07,2006,2007,Middlesbrough,Fulham,Win,Home,2007-05-13,3,3,4,4,4,3,4,4,4,0,0,0,0,1,14.0,12.0,2.0,10
11724,11724,2007-08,2007,2008,Middlesbrough,Blackburn,Loss,Home,2007-08-11,0,6,6,7,7,2,5,8,9,4,1,-1,-2,1,12.0,10.0,2.0,1
11725,11725,2007-08,2007,2008,Middlesbrough,Wigan,Loss,Away,2007-08-15,0,3,6,6,7,3,3,3,3,0,3,3,4,0,12.0,17.0,-5.0,1
11726,11726,2007-08,2007,2008,Middlesbrough,Fulham,Win,Away,2007-08-18,3,0,3,6,6,3,3,6,6,-3,0,0,0,0,12.0,16.0,-4.0,1
11727,11727,2007-08,2007,2008,Middlesbrough,Newcastle,Draw,Home,2007-08-26,1,3,3,6,9,4,5,5,5,-1,-2,1,4,1,12.0,13.0,-1.0,1
11728,11728,2007-08,2007,2008,Middlesbrough,Birmingham,Win,Home,2007-09-01,3,4,4,4,7,3,4,4,4,1,0,0,3,1,12.0,21.0,-9.0,2
11729,11729,2007-08,2007,2008,Middlesbrough,West Ham,Loss,Away,2007-09-15,0,4,7,7,7,4,7,7,10,0,0,0,-3,0,12.0,15.0,-3.0,2
11730,11730,2007-08,2007,2008,Middlesbrough,Sunderland,Draw,Home,2007-09-22,1,3,4,7,7,3,3,3,4,0,1,4,3,1,12.0,21.0,-9.0,2
11731,11731,2007-08,2007,2008,Middlesbrough,Everton,Loss,Away,2007-09-30,0,1,4,5,8,0,3,4,4,1,1,1,4,0,12.0,6.0,6.0,2
11732,11732,2007-08,2007,2008,Middlesbrough,Man City,Loss,Away,2007-10-07,0,1,1,4,5,4,7,7,7,-3,-6,-3,-2,0,12.0,14.0,-2.0,3
11733,11733,2007-08,2007,2008,Middlesbrough,Chelsea,Loss,Home,2007-10-20,0,0,1,1,4,4,4,5,5,-4,-3,-4,-1,1,12.0,2.0,10.0,3
11734,11734,2007-08,2007,2008,Middlesbrough,Man United,Loss,Away,2007-10-27,0,0,0,1,1,6,9,12,15,-6,-9,-11,-14,0,12.0,1.0,11.0,3
11735,11735,2007-08,2007,2008,Middlesbrough,Tottenham,Draw,Home,2007-11-03,1,0,0,0,1,0,1,2,3,0,-1,-2,-2,1,12.0,5.0,7.0,4
11736,11736,2007-08,2007,2008,Middlesbrough,Bolton,Draw,Away,2007-11-11,1,1,1,1,1,2,2,2,3,-1,-1,-1,-2,0,12.0,7.0,5.0,4
11737,11737,2007-08,2007,2008,Middlesbrough,Aston Villa,Loss,Home,2007-11-24,0,2,2,2,2,6,7,7,10,-4,-5,-5,-8,1,12.0,11.0,1.0,4
11738,11738,2007-08,2007,2008,Middlesbrough,Reading,Draw,Away,2007-12-01,1,1,2,2,2,0,0,3,3,1,2,-1,-1,0,12.0,8.0,4.0,5
11739,11739,2007-08,2007,2008,Middlesbrough,Arsenal,Win,Home,2007-12-09,3,1,2,3,3,4,7,10,11,-3,-5,-7,-8,1,12.0,4.0,8.0,5
11740,11740,2007-08,2007,2008,Middlesbrough,Derby,Win,Away,2007-12-15,3,4,4,5,6,0,0,0,0,4,4,5,6,0,12.0,21.0,-9.0,5
11741,11741,2007-08,2007,2008,Middlesbrough,West Ham,Loss,Home,2007-12-22,0,6,7,7,8,3,3,4,7,3,4,3,1,1,12.0,15.0,-3.0,5
11742,11742,2007-08,2007,2008,Middlesbrough,Birmingham,Loss,Away,2007-12-26,0,3,6,7,7,1,1,4,4,2,5,3,3,0,12.0,21.0,-9.0,5
11743,11743,2007-08,2007,2008,Middlesbrough,Portsmouth,Win,Away,2007-12-29,3,0,3,6,7,1,1,4,5,-1,2,2,2,0,12.0,9.0,3.0,5
11744,11744,2007-08,2007,2008,Middlesbrough,Everton,Loss,Home,2008-01-01,0,3,3,6,9,3,3,6,9,0,0,0,0,1,12.0,6.0,6.0,6
11745,11745,2007-08,2007,2008,Middlesbrough,Liverpool,Draw,Home,2008-01-12,1,3,3,3,6,2,5,8,8,1,-2,-5,-2,1,12.0,3.0,9.0,6
11746,11746,2007-08,2007,2008,Middlesbrough,Blackburn,Draw,Away,2008-01-19,1,1,4,4,4,6,9,10,10,-5,-5,-6,-6,0,12.0,10.0,2.0,6
11747,11747,2007-08,2007,2008,Middlesbrough,Wigan,Win,Home,2008-01-29,3,2,2,5,5,3,4,4,7,-1,-2,1,-2,1,12.0,17.0,-5.0,6
11748,11748,2007-08,2007,2008,Middlesbrough,Newcastle,Draw,Away,2008-02-03,1,4,5,5,8,1,1,1,1,3,4,4,7,0,12.0,13.0,-1.0,7
11749,11749,2007-08,2007,2008,Middlesbrough,Fulham,Win,Home,2008-02-09,3,4,5,6,6,4,4,4,4,0,1,2,2,1,12.0,16.0,-4.0,7
11750,11750,2007-08,2007,2008,Middlesbrough,Liverpool,Loss,Away,2008-02-23,0,4,7,8,9,4,4,5,6,0,3,3,3,0,12.0,3.0,9.0,7
11751,11751,2007-08,2007,2008,Middlesbrough,Reading,Loss,Home,2008-03-01,0,3,4,7,8,0,0,0,0,3,4,7,8,1,12.0,8.0,4.0,8
11752,11752,2007-08,2007,2008,Middlesbrough,Aston Villa,Draw,Away,2008-03-12,1,0,3,4,7,4,7,7,8,-4,-4,-3,-1,0,12.0,11.0,1.0,8
11753,11753,2007-08,2007,2008,Middlesbrough,Arsenal,Draw,Away,2008-03-15,1,1,1,4,5,2,3,6,9,-1,-2,-2,-4,0,12.0,4.0,8.0,8
11754,11754,2007-08,2007,2008,Middlesbrough,Derby,Win,Home,2008-03-22,3,2,2,2,5,0,1,1,1,2,1,1,4,1,12.0,21.0,-9.0,8
11755,11755,2007-08,2007,2008,Middlesbrough,Chelsea,Loss,Away,2008-03-30,0,4,5,5,5,4,7,10,13,0,-2,-5,-8,0,12.0,2.0,10.0,8
11756,11756,2007-08,2007,2008,Middlesbrough,Man United,Draw,Home,2008-04-06,1,3,4,5,5,6,9,12,15,-3,-5,-7,-10,1,12.0,1.0,11.0,9
11757,11757,2007-08,2007,2008,Middlesbrough,Tottenham,Draw,Away,2008-04-12,1,1,4,5,6,1,4,5,5,0,0,0,1,0,12.0,5.0,7.0,9
11758,11758,2007-08,2007,2008,Middlesbrough,Bolton,Loss,Home,2008-04-19,0,2,2,5,6,3,3,4,4,-1,-1,1,2,1,12.0,7.0,5.0,9
11759,11759,2007-08,2007,2008,Middlesbrough,Sunderland,Loss,Away,2008-04-26,0,1,2,2,5,0,3,6,9,1,-1,-4,-4,0,12.0,21.0,-9.0,9
11760,11760,2007-08,2007,2008,Middlesbrough,Portsmouth,Win,Home,2008-05-03,3,0,1,2,2,0,1,4,7,0,0,-2,-5,1,12.0,9.0,3.0,10
11761,11761,2007-08,2007,2008,Middlesbrough,Man City,Win,Home,2008-05-11,3,3,3,4,5,0,3,6,6,3,0,-2,-1,1,12.0,14.0,-2.0,10
11762,11762,2008-09,2008,2009,Middlesbrough,Tottenham,Win,Home,2008-08-16,3,6,6,6,7,3,4,5,6,3,2,1,1,1,13.0,11.0,2.0,1
11763,11763,2008-09,2008,2009,Middlesbrough,Liverpool,Loss,Away,2008-08-23,0,6,9,9,9,6,9,10,13,0,0,-1,-4,0,13.0,4.0,9.0,1
11764,11764,2008-09,2008,2009,Middlesbrough,Stoke,Win,Home,2008-08-30,3,3,6,9,9,3,3,3,3,0,3,6,6,1,13.0,21.0,-8.0,1
11765,11765,2008-09,2008,2009,Middlesbrough,Portsmouth,Loss,Away,2008-09-13,0,3,6,9,12,3,3,3,3,0,3,6,9,0,13.0,8.0,5.0,2
11766,11766,2008-09,2008,2009,Middlesbrough,Sunderland,Loss,Away,2008-09-20,0,3,3,6,9,1,4,4,4,2,-1,2,5,0,13.0,15.0,-2.0,2
11767,11767,2008-09,2008,2009,Middlesbrough,West Brom,Loss,Home,2008-09-27,0,0,3,3,6,3,4,4,4,-3,-1,-1,2,1,13.0,21.0,-8.0,2
11768,11768,2008-09,2008,2009,Middlesbrough,Wigan,Win,Away,2008-10-04,3,0,0,3,3,4,5,8,8,-4,-5,-5,-5,0,13.0,14.0,-1.0,3
11769,11769,2008-09,2008,2009,Middlesbrough,Chelsea,Loss,Home,2008-10-18,0,3,3,3,6,6,7,10,11,-3,-4,-7,-5,1,13.0,2.0,11.0,3
11770,11770,2008-09,2008,2009,Middlesbrough,Blackburn,Draw,Away,2008-10-25,1,3,3,3,3,1,4,7,7,2,-1,-4,-4,0,13.0,7.0,6.0,3
11771,11771,2008-09,2008,2009,Middlesbrough,Man City,Win,Home,2008-10-29,3,1,4,4,4,4,4,4,7,-3,0,0,-3,1,13.0,9.0,4.0,3
11772,11772,2008-09,2008,2009,Middlesbrough,West Ham,Draw,Home,2008-11-01,1,4,4,7,7,0,0,0,3,4,4,7,4,1,13.0,10.0,3.0,4
11773,11773,2008-09,2008,2009,Middlesbrough,Aston Villa,Win,Away,2008-11-09,3,4,5,5,8,3,6,7,7,1,-1,-2,1,0,13.0,6.0,7.0,4
11774,11774,2008-09,2008,2009,Middlesbrough,Everton,Draw,Away,2008-11-16,1,4,7,8,8,6,9,10,10,-2,-2,-2,-2,0,13.0,5.0,8.0,4
11775,11775,2008-09,2008,2009,Middlesbrough,Bolton,Loss,Home,2008-11-22,0,4,5,8,9,3,6,6,6,1,-1,2,3,1,13.0,16.0,-3.0,4
11776,11776,2008-09,2008,2009,Middlesbrough,Newcastle,Draw,Home,2008-11-29,1,1,4,5,8,2,2,5,8,-1,2,0,0,1,13.0,12.0,1.0,4
11777,11777,2008-09,2008,2009,Middlesbrough,Hull,Loss,Away,2008-12-06,0,1,2,5,6,2,3,3,3,-1,-1,2,3,0,13.0,21.0,-8.0,5
11778,11778,2008-09,2008,2009,Middlesbrough,Arsenal,Draw,Home,2008-12-13,1,1,1,2,5,6,6,6,9,-5,-5,-4,-4,1,13.0,3.0,10.0,5
11779,11779,2008-09,2008,2009,Middlesbrough,Fulham,Loss,Away,2008-12-20,0,1,2,2,3,2,3,4,7,-1,-1,-2,-4,0,13.0,17.0,-4.0,5
11780,11780,2008-09,2008,2009,Middlesbrough,Everton,Loss,Home,2008-12-26,0,1,1,2,2,4,4,7,7,-3,-3,-5,-5,1,13.0,5.0,8.0,5
11781,11781,2008-09,2008,2009,Middlesbrough,Man United,Loss,Away,2008-12-29,0,0,1,1,2,4,7,10,11,-4,-6,-9,-9,0,13.0,1.0,12.0,5
11782,11782,2008-09,2008,2009,Middlesbrough,Sunderland,Draw,Home,2009-01-10,1,0,0,1,1,1,4,7,7,-1,-4,-6,-6,1,13.0,15.0,-2.0,6
11783,11783,2008-09,2008,2009,Middlesbrough,West Brom,Loss,Away,2009-01-17,0,1,1,1,2,3,3,6,6,-2,-2,-5,-4,0,13.0,21.0,-8.0,6
11784,11784,2008-09,2008,2009,Middlesbrough,Chelsea,Loss,Away,2009-01-28,0,1,1,1,1,3,4,7,8,-2,-3,-6,-7,0,13.0,2.0,11.0,6
11785,11785,2008-09,2008,2009,Middlesbrough,Blackburn,Draw,Home,2009-01-31,1,0,1,1,1,4,5,6,9,-4,-4,-5,-8,1,13.0,7.0,6.0,6
11786,11786,2008-09,2008,2009,Middlesbrough,Man City,Loss,Away,2009-02-07,0,1,1,2,2,3,6,7,10,-2,-5,-5,-8,0,13.0,9.0,4.0,7
11787,11787,2008-09,2008,2009,Middlesbrough,Wigan,Draw,Home,2009-02-21,1,1,1,1,2,2,3,3,3,-1,-2,-2,-1,1,13.0,14.0,-1.0,7
11788,11788,2008-09,2008,2009,Middlesbrough,Liverpool,Win,Home,2009-02-28,3,1,2,2,2,4,7,8,9,-3,-5,-6,-7,1,13.0,4.0,9.0,7
11789,11789,2008-09,2008,2009,Middlesbrough,Tottenham,Loss,Away,2009-03-04,0,4,4,5,5,4,4,7,8,0,0,-2,-3,0,13.0,11.0,2.0,8
11790,11790,2008-09,2008,2009,Middlesbrough,Portsmouth,Draw,Home,2009-03-14,1,3,4,4,5,1,4,4,4,2,0,0,1,1,13.0,8.0,5.0,8
11791,11791,2008-09,2008,2009,Middlesbrough,Stoke,Loss,Away,2009-03-21,0,1,4,5,5,3,4,5,5,-2,0,0,0,0,13.0,21.0,-8.0,8
11792,11792,2008-09,2008,2009,Middlesbrough,Bolton,Loss,Away,2009-04-04,0,1,1,4,5,1,1,4,7,0,0,0,-2,0,13.0,16.0,-3.0,9
11793,11793,2008-09,2008,2009,Middlesbrough,Hull,Win,Home,2009-04-11,3,0,1,1,4,1,2,5,5,-1,-1,-4,-1,1,13.0,21.0,-8.0,9
11794,11794,2008-09,2008,2009,Middlesbrough,Fulham,Draw,Home,2009-04-18,1,3,3,4,4,3,6,9,9,0,-3,-5,-5,1,13.0,17.0,-4.0,9
11795,11795,2008-09,2008,2009,Middlesbrough,Arsenal,Loss,Away,2009-04-26,0,4,4,4,5,4,7,10,13,0,-3,-6,-8,0,13.0,3.0,10.0,9
11796,11796,2008-09,2008,2009,Middlesbrough,Man United,Loss,Home,2009-05-02,0,1,4,4,4,6,9,12,12,-5,-5,-8,-8,1,13.0,1.0,12.0,10
11797,11797,2008-09,2008,2009,Middlesbrough,Newcastle,Loss,Away,2009-05-11,0,0,1,4,4,1,1,2,2,-1,0,2,2,0,13.0,12.0,1.0,10
11798,11798,2008-09,2008,2009,Middlesbrough,Aston Villa,Draw,Home,2009-05-16,1,0,0,1,4,3,4,5,6,-3,-4,-4,-2,1,13.0,6.0,7.0,10
11799,11799,2008-09,2008,2009,Middlesbrough,West Ham,Loss,Away,2009-05-24,0,1,1,1,2,0,3,3,4,1,-2,-2,-2,0,13.0,10.0,3.0,10
11800,11800,2016-17,2016,2017,Middlesbrough,Stoke,Draw,Home,2016-08-13,1,1,1,1,1,3,4,4,4,-2,-3,-3,-3,1,21.0,9.0,12.0,1
11801,11801,2016-17,2016,2017,Middlesbrough,Sunderland,Win,Away,2016-08-21,3,1,2,2,2,1,4,7,8,0,-2,-5,-6,0,21.0,17.0,4.0,1
11802,11802,2016-17,2016,2017,Middlesbrough,West Brom,Draw,Away,2016-08-28,1,4,4,5,5,3,4,5,5,1,0,0,0,0,21.0,14.0,7.0,1
11803,11803,2016-17,2016,2017,Middlesbrough,Crystal Palace,Loss,Home,2016-09-10,0,4,5,5,6,1,1,1,4,3,4,4,2,1,21.0,15.0,6.0,2
11804,11804,2016-17,2016,2017,Middlesbrough,Everton,Loss,Away,2016-09-17,0,1,4,5,5,6,9,10,13,-5,-5,-5,-8,0,21.0,11.0,10.0,2
11805,11805,2016-17,2016,2017,Middlesbrough,Tottenham,Loss,Home,2016-09-24,0,0,1,4,5,6,7,10,11,-6,-6,-6,-6,1,21.0,3.0,18.0,2
11806,11806,2016-17,2016,2017,Middlesbrough,West Ham,Draw,Away,2016-10-01,1,0,0,1,4,0,0,0,3,0,0,1,1,0,21.0,7.0,14.0,3
11807,11807,2016-17,2016,2017,Middlesbrough,Watford,Loss,Home,2016-10-16,0,1,1,1,2,1,4,7,7,0,-3,-6,-5,1,21.0,13.0,8.0,3
11808,11808,2016-17,2016,2017,Middlesbrough,Arsenal,Draw,Away,2016-10-22,1,1,1,1,1,6,9,12,15,-5,-8,-11,-14,0,21.0,2.0,19.0,3
11809,11809,2016-17,2016,2017,Middlesbrough,Bournemouth,Win,Home,2016-10-29,3,1,2,2,2,4,5,8,8,-3,-3,-6,-6,1,21.0,16.0,5.0,3
11810,11810,2016-17,2016,2017,Middlesbrough,Man City,Draw,Away,2016-11-05,1,4,4,5,5,4,5,5,8,0,-1,0,-3,0,21.0,4.0,17.0,4
11811,11811,2016-17,2016,2017,Middlesbrough,Chelsea,Loss,Home,2016-11-20,0,4,5,5,6,6,9,12,15,-2,-4,-7,-9,1,21.0,10.0,11.0,4
11812,11812,2016-17,2016,2017,Middlesbrough,Leicester,Draw,Away,2016-11-26,1,1,4,5,5,0,1,4,4,1,3,1,1,0,21.0,1.0,20.0,4
11813,11813,2016-17,2016,2017,Middlesbrough,Hull,Win,Home,2016-12-05,3,1,2,5,6,1,4,4,4,0,-2,1,2,1,21.0,21.0,0.0,5
11814,11814,2016-17,2016,2017,Middlesbrough,Southampton,Loss,Away,2016-12-11,0,4,4,5,8,3,4,4,4,1,0,1,4,0,21.0,6.0,15.0,5
11815,11815,2016-17,2016,2017,Middlesbrough,Liverpool,Loss,Home,2016-12-14,0,3,4,4,5,1,4,5,8,2,0,-1,-3,1,21.0,8.0,13.0,5
11816,11816,2016-17,2016,2017,Middlesbrough,Swansea,Win,Home,2016-12-17,3,0,3,4,4,3,3,6,7,-3,0,-2,-3,1,21.0,12.0,9.0,5
11817,11817,2016-17,2016,2017,Middlesbrough,Burnley,Loss,Away,2016-12-26,0,3,3,6,7,0,3,3,3,3,0,3,4,0,21.0,21.0,0.0,5
11818,11818,2016-17,2016,2017,Middlesbrough,Man United,Loss,Away,2016-12-31,0,3,3,3,6,6,9,12,13,-3,-6,-9,-7,0,21.0,5.0,16.0,5
11819,11819,2016-17,2016,2017,Middlesbrough,Leicester,Draw,Home,2017-01-02,1,0,3,3,3,3,4,4,7,-3,-1,-1,-4,1,21.0,1.0,20.0,6
11820,11820,2016-17,2016,2017,Middlesbrough,Watford,Draw,Away,2017-01-14,1,1,1,4,4,0,1,1,1,1,0,3,3,0,21.0,13.0,8.0,6
11821,11821,2016-17,2016,2017,Middlesbrough,West Ham,Loss,Home,2017-01-21,0,2,2,2,5,3,3,6,9,-1,-1,-4,-4,1,21.0,7.0,14.0,6
11822,11822,2016-17,2016,2017,Middlesbrough,West Brom,Draw,Home,2017-01-31,1,1,2,2,2,3,6,9,9,-2,-4,-7,-7,1,21.0,14.0,7.0,6
11823,11823,2016-17,2016,2017,Middlesbrough,Tottenham,Loss,Away,2017-02-04,0,1,2,3,3,2,5,8,11,-1,-3,-5,-8,0,21.0,3.0,18.0,7
11824,11824,2016-17,2016,2017,Middlesbrough,Everton,Draw,Home,2017-02-11,1,1,1,2,3,4,7,10,13,-3,-6,-8,-10,1,21.0,11.0,10.0,7
11825,11825,2016-17,2016,2017,Middlesbrough,Crystal Palace,Loss,Away,2017-02-25,0,1,2,2,3,0,3,3,3,1,-1,-1,0,0,21.0,15.0,6.0,7
11826,11826,2016-17,2016,2017,Middlesbrough,Stoke,Loss,Away,2017-03-04,0,1,1,2,2,3,3,4,5,-2,-2,-2,-3,0,21.0,9.0,12.0,8
11827,11827,2016-17,2016,2017,Middlesbrough,Man United,Loss,Home,2017-03-19,0,0,1,1,2,4,7,8,9,-4,-6,-7,-7,1,21.0,5.0,16.0,8
11828,11828,2016-17,2016,2017,Middlesbrough,Swansea,Draw,Away,2017-04-02,1,0,0,1,1,0,3,3,6,0,-3,-2,-5,0,21.0,12.0,9.0,9
11829,11829,2016-17,2016,2017,Middlesbrough,Hull,Loss,Away,2017-04-05,0,1,1,1,2,3,6,6,7,-2,-5,-5,-5,0,21.0,21.0,0.0,9
11830,11830,2016-17,2016,2017,Middlesbrough,Burnley,Draw,Home,2017-04-08,1,1,1,1,1,3,4,4,4,-2,-3,-3,-3,1,21.0,21.0,0.0,9
11831,11831,2016-17,2016,2017,Middlesbrough,Arsenal,Loss,Home,2017-04-17,0,1,2,2,2,3,4,4,4,-2,-2,-2,-2,1,21.0,2.0,19.0,9
11832,11832,2016-17,2016,2017,Middlesbrough,Bournemouth,Loss,Away,2017-04-22,0,1,1,2,2,0,1,2,5,1,0,0,-3,0,21.0,16.0,5.0,9
11833,11833,2016-17,2016,2017,Middlesbrough,Sunderland,Win,Home,2017-04-26,3,0,1,1,2,1,1,1,2,-1,0,0,0,1,21.0,17.0,4.0,9
11834,11834,2016-17,2016,2017,Middlesbrough,Man City,Draw,Home,2017-04-30,1,3,3,4,4,4,7,7,8,-1,-4,-3,-4,1,21.0,4.0,17.0,9
11835,11835,2016-17,2016,2017,Middlesbrough,Chelsea,Loss,Away,2017-05-08,0,4,4,4,5,6,6,9,12,-2,-2,-5,-7,0,21.0,10.0,11.0,10
11836,11836,2016-17,2016,2017,Middlesbrough,Southampton,Loss,Home,2017-05-13,0,1,4,4,4,1,2,2,2,0,2,2,2,1,21.0,6.0,15.0,10
11837,11837,2016-17,2016,2017,Middlesbrough,Liverpool,Loss,Away,2017-05-21,0,0,1,4,4,4,7,7,10,-4,-6,-3,-6,0,21.0,8.0,13.0,10
11838,11838,1993-94,1993,1994,Newcastle,Tottenham,Loss,Home,1993-08-14,0,0,0,0,0,0,0,0,0,0,0,0,0,1,21.0,8.0,13.0,1
11839,11839,1993-94,1993,1994,Newcastle,Coventry,Loss,Away,1993-08-18,0,0,0,0,0,3,3,3,3,-3,-3,-3,-3,0,21.0,15.0,6.0,1
11840,11840,1993-94,1993,1994,Newcastle,Man United,Draw,Away,1993-08-21,1,0,0,0,0,6,6,6,6,-6,-6,-6,-6,0,21.0,1.0,20.0,1
11841,11841,1993-94,1993,1994,Newcastle,Everton,Win,Home,1993-08-25,3,1,1,1,1,6,9,9,9,-5,-8,-8,-8,1,21.0,13.0,8.0,1
11842,11842,1993-94,1993,1994,Newcastle,Blackburn,Draw,Home,1993-08-29,1,4,4,4,4,6,6,9,9,-2,-2,-5,-5,1,21.0,4.0,17.0,1
11843,11843,1993-94,1993,1994,Newcastle,Ipswich,Draw,Away,1993-08-31,1,4,5,5,5,1,4,7,10,3,1,-2,-5,0,21.0,16.0,5.0,1
11844,11844,1993-94,1993,1994,Newcastle,Sheffield Weds,Win,Home,1993-09-13,3,2,5,6,6,2,2,2,3,0,3,4,3,1,21.0,7.0,14.0,2
11845,11845,1993-94,1993,1994,Newcastle,Swindon,Draw,Away,1993-09-18,1,4,5,8,9,1,2,2,2,3,3,6,7,0,21.0,21.0,0.0,2
11846,11846,1993-94,1993,1994,Newcastle,West Ham,Win,Home,1993-09-25,3,4,5,6,9,4,4,4,7,0,1,2,2,1,21.0,21.0,0.0,2
11847,11847,1993-94,1993,1994,Newcastle,Aston Villa,Win,Away,1993-10-02,3,4,7,8,9,4,5,8,11,0,2,0,-2,0,21.0,2.0,19.0,3
11848,11848,1993-94,1993,1994,Newcastle,QPR,Loss,Home,1993-10-16,0,6,7,10,11,4,5,5,8,2,2,5,3,1,21.0,5.0,16.0,3
11849,11849,1993-94,1993,1994,Newcastle,Southampton,Loss,Away,1993-10-24,0,3,6,7,10,2,2,2,2,1,4,5,8,0,21.0,18.0,3.0,3
11850,11850,1993-94,1993,1994,Newcastle,Wimbledon,Win,Home,1993-10-30,3,0,3,6,7,1,1,2,5,-1,2,4,2,1,21.0,12.0,9.0,3
11851,11851,1993-94,1993,1994,Newcastle,Oldham,Win,Away,1993-11-08,3,3,3,6,9,4,4,5,6,-1,-1,1,3,0,21.0,19.0,2.0,4
11852,11852,1993-94,1993,1994,Newcastle,Liverpool,Win,Home,1993-11-21,3,6,6,6,9,6,7,10,11,0,-1,-4,-2,1,21.0,6.0,15.0,4
11853,11853,1993-94,1993,1994,Newcastle,Sheffield United,Win,Home,1993-11-24,3,6,9,9,9,0,1,2,3,6,8,7,6,1,21.0,14.0,7.0,4
11854,11854,1993-94,1993,1994,Newcastle,Arsenal,Loss,Away,1993-11-27,0,6,9,12,12,4,4,5,6,2,5,7,6,0,21.0,10.0,11.0,4
11855,11855,1993-94,1993,1994,Newcastle,Tottenham,Win,Away,1993-12-04,3,3,6,9,12,2,3,3,3,1,3,6,9,0,21.0,8.0,13.0,5
11856,11856,1993-94,1993,1994,Newcastle,Man United,Draw,Home,1993-12-11,1,3,6,9,12,4,7,8,11,-1,-1,1,1,1,21.0,1.0,20.0,5
11857,11857,1993-94,1993,1994,Newcastle,Everton,Win,Away,1993-12-18,3,4,4,7,10,1,4,5,6,3,0,2,4,0,21.0,13.0,8.0,5
11858,11858,1993-94,1993,1994,Newcastle,Leeds,Draw,Home,1993-12-22,1,4,7,7,10,3,6,9,12,1,1,-2,-2,1,21.0,17.0,4.0,5
11859,11859,1993-94,1993,1994,Newcastle,Chelsea,Loss,Away,1993-12-28,0,4,5,8,8,1,1,1,2,3,4,7,6,0,21.0,11.0,10.0,5
11860,11860,1993-94,1993,1994,Newcastle,Man City,Win,Home,1994-01-01,3,1,4,5,8,1,1,4,4,0,3,1,4,1,21.0,9.0,12.0,6
11861,11861,1993-94,1993,1994,Newcastle,Norwich,Win,Away,1994-01-04,3,3,4,7,8,3,6,6,9,0,-2,1,-1,0,21.0,3.0,18.0,6
11862,11862,1993-94,1993,1994,Newcastle,QPR,Win,Away,1994-01-16,3,6,6,7,10,1,2,5,8,5,4,2,2,0,21.0,5.0,16.0,6
11863,11863,1993-94,1993,1994,Newcastle,Southampton,Loss,Home,1994-01-22,0,6,9,9,10,3,4,7,7,3,5,2,3,1,21.0,18.0,3.0,6
11864,11864,1993-94,1993,1994,Newcastle,Wimbledon,Loss,Away,1994-02-12,0,3,6,9,9,1,4,4,5,2,2,5,4,0,21.0,12.0,9.0,7
11865,11865,1993-94,1993,1994,Newcastle,Blackburn,Loss,Away,1994-02-19,0,0,3,6,9,6,9,12,15,-6,-6,-6,-6,0,21.0,4.0,17.0,7
11866,11866,1993-94,1993,1994,Newcastle,Coventry,Win,Home,1994-02-23,3,0,0,3,6,4,4,7,7,-4,-4,-4,-1,1,21.0,15.0,6.0,7
11867,11867,1993-94,1993,1994,Newcastle,Sheffield Weds,Win,Away,1994-03-05,3,3,3,3,6,4,7,7,10,-1,-4,-4,-4,0,21.0,7.0,14.0,8
11868,11868,1993-94,1993,1994,Newcastle,Swindon,Win,Home,1994-03-12,3,6,6,6,6,1,2,2,5,5,4,4,1,1,21.0,21.0,0.0,8
11869,11869,1993-94,1993,1994,Newcastle,West Ham,Win,Away,1994-03-19,3,6,9,9,9,2,3,4,4,4,6,5,5,0,21.0,21.0,0.0,8
11870,11870,1993-94,1993,1994,Newcastle,Ipswich,Win,Home,1994-03-22,3,6,9,12,12,4,4,7,8,2,5,5,4,1,21.0,16.0,5.0,8
11871,11871,1993-94,1993,1994,Newcastle,Norwich,Win,Home,1994-03-29,3,6,9,12,15,3,3,3,4,3,6,9,11,1,21.0,3.0,18.0,8
11872,11872,1993-94,1993,1994,Newcastle,Leeds,Draw,Away,1994-04-01,1,6,9,12,15,3,6,7,8,3,3,5,7,0,21.0,17.0,4.0,9
11873,11873,1993-94,1993,1994,Newcastle,Chelsea,Draw,Home,1994-04-04,1,4,7,10,13,3,6,6,9,1,1,4,4,1,21.0,11.0,10.0,9
11874,11874,1993-94,1993,1994,Newcastle,Man City,Loss,Away,1994-04-09,0,2,5,8,11,6,7,8,9,-4,-2,0,2,0,21.0,9.0,12.0,9
11875,11875,1993-94,1993,1994,Newcastle,Liverpool,Win,Away,1994-04-16,3,1,2,5,8,4,4,4,4,-3,-2,1,4,0,21.0,6.0,15.0,9
11876,11876,1993-94,1993,1994,Newcastle,Oldham,Win,Home,1994-04-23,3,3,4,5,8,0,3,6,7,3,1,-1,1,1,21.0,19.0,2.0,9
11877,11877,1993-94,1993,1994,Newcastle,Aston Villa,Win,Home,1994-04-27,3,6,6,7,8,3,3,4,4,3,3,3,4,1,21.0,2.0,19.0,9
11878,11878,1993-94,1993,1994,Newcastle,Sheffield United,Loss,Away,1994-04-30,0,6,9,9,10,3,4,7,10,3,5,2,0,0,21.0,14.0,7.0,9
11879,11879,1993-94,1993,1994,Newcastle,Arsenal,Win,Home,1994-05-07,3,3,6,9,9,1,4,5,8,2,2,4,1,1,21.0,10.0,11.0,10
11880,11880,1994-95,1994,1995,Newcastle,Leicester,Win,Away,1994-08-21,3,3,6,9,12,0,0,0,0,3,6,9,12,0,3.0,21.0,-18.0,1
11881,11881,1994-95,1994,1995,Newcastle,Coventry,Win,Home,1994-08-24,3,6,6,9,12,2,5,8,9,4,1,1,3,1,3.0,11.0,-8.0,1
11882,11882,1994-95,1994,1995,Newcastle,Southampton,Win,Home,1994-08-27,3,6,9,9,12,2,3,3,6,4,6,6,6,1,3.0,18.0,-15.0,1
11883,11883,1994-95,1994,1995,Newcastle,West Ham,Win,Away,1994-08-31,3,6,9,12,12,0,1,2,3,6,8,10,9,0,3.0,13.0,-10.0,1
11884,11884,1994-95,1994,1995,Newcastle,Chelsea,Win,Home,1994-09-10,3,6,9,12,15,6,9,12,12,0,0,0,3,1,3.0,14.0,-11.0,2
11885,11885,1994-95,1994,1995,Newcastle,Arsenal,Win,Away,1994-09-18,3,6,9,12,15,2,2,2,5,4,7,10,10,0,3.0,4.0,-1.0,2
11886,11886,1994-95,1994,1995,Newcastle,Liverpool,Draw,Home,1994-09-24,1,6,9,12,15,1,4,7,10,5,5,5,5,1,3.0,8.0,-5.0,2
11887,11887,1994-95,1994,1995,Newcastle,Aston Villa,Win,Away,1994-10-01,3,4,7,10,13,0,3,6,7,4,4,4,6,0,3.0,10.0,-7.0,3
11888,11888,1994-95,1994,1995,Newcastle,Blackburn,Draw,Home,1994-10-09,1,4,7,10,13,3,6,9,10,1,1,1,3,1,3.0,2.0,1.0,3
11889,11889,1994-95,1994,1995,Newcastle,Crystal Palace,Win,Away,1994-10-15,3,4,5,8,11,3,3,4,5,1,2,4,6,0,3.0,21.0,-18.0,3
11890,11890,1994-95,1994,1995,Newcastle,Sheffield Weds,Win,Home,1994-10-22,3,4,7,8,11,6,6,7,8,-2,1,1,3,1,3.0,7.0,-4.0,3
11891,11891,1994-95,1994,1995,Newcastle,Man United,Loss,Away,1994-10-29,0,6,7,10,11,6,6,9,9,0,1,1,2,0,3.0,1.0,2.0,3
11892,11892,1994-95,1994,1995,Newcastle,QPR,Win,Home,1994-11-05,3,3,6,7,10,6,6,6,7,-3,0,1,3,1,3.0,9.0,-6.0,4
11893,11893,1994-95,1994,1995,Newcastle,Nott'm Forest,Draw,Away,1994-11-07,1,3,6,9,10,0,3,6,7,3,3,3,3,0,3.0,21.0,-18.0,4
11894,11894,1994-95,1994,1995,Newcastle,Wimbledon,Loss,Away,1994-11-19,0,4,4,7,10,3,6,6,6,1,-2,1,4,0,3.0,6.0,-3.0,4
11895,11895,1994-95,1994,1995,Newcastle,Ipswich,Draw,Home,1994-11-26,1,1,4,4,7,0,3,3,3,1,1,1,4,1,3.0,19.0,-16.0,4
11896,11896,1994-95,1994,1995,Newcastle,Tottenham,Loss,Away,1994-12-03,0,1,2,5,5,2,2,2,5,-1,0,3,0,0,3.0,15.0,-12.0,5
11897,11897,1994-95,1994,1995,Newcastle,Leicester,Win,Home,1994-12-10,3,1,1,2,5,1,4,4,4,0,-3,-2,1,1,3.0,21.0,-18.0,5
11898,11898,1994-95,1994,1995,Newcastle,Coventry,Draw,Away,1994-12-17,1,3,4,4,5,1,4,7,8,2,0,-3,-3,0,3.0,11.0,-8.0,5
11899,11899,1994-95,1994,1995,Newcastle,Leeds,Draw,Away,1994-12-26,1,4,4,5,5,4,4,7,7,0,0,-2,-2,0,3.0,5.0,-2.0,5
11900,11900,1994-95,1994,1995,Newcastle,Norwich,Loss,Away,1994-12-31,0,2,5,5,6,0,3,6,6,2,2,-1,0,0,3.0,12.0,-9.0,5
11901,11901,1994-95,1994,1995,Newcastle,Man City,Draw,Home,1995-01-02,1,1,2,5,5,1,1,1,1,0,1,4,4,1,3.0,16.0,-13.0,6
11902,11902,1994-95,1994,1995,Newcastle,Man United,Draw,Home,1995-01-15,1,1,2,3,6,4,5,8,8,-3,-3,-5,-2,1,3.0,1.0,2.0,6
11903,11903,1994-95,1994,1995,Newcastle,Sheffield Weds,Draw,Away,1995-01-21,1,2,2,3,4,2,5,8,11,0,-3,-5,-7,0,3.0,7.0,-4.0,6
11904,11904,1994-95,1994,1995,Newcastle,Wimbledon,Win,Home,1995-01-25,3,2,3,3,4,6,7,10,13,-4,-4,-7,-9,1,3.0,6.0,-3.0,6
11905,11905,1994-95,1994,1995,Newcastle,Everton,Win,Home,1995-02-01,3,4,5,6,6,4,5,5,8,0,0,1,-2,1,3.0,17.0,-14.0,7
11906,11906,1994-95,1994,1995,Newcastle,QPR,Loss,Away,1995-02-04,0,6,7,8,9,0,3,4,5,6,4,4,4,0,3.0,9.0,-6.0,7
11907,11907,1994-95,1994,1995,Newcastle,Nott'm Forest,Win,Home,1995-02-11,3,3,6,7,8,4,4,4,7,-1,2,3,1,1,3.0,21.0,-18.0,7
11908,11908,1994-95,1994,1995,Newcastle,Aston Villa,Win,Home,1995-02-25,3,3,6,9,10,4,7,7,10,-1,-1,2,0,1,3.0,10.0,-7.0,7
11909,11909,1994-95,1994,1995,Newcastle,Ipswich,Win,Away,1995-02-28,3,6,6,9,12,3,3,3,4,3,3,6,8,0,3.0,19.0,-16.0,7
11910,11910,1994-95,1994,1995,Newcastle,Liverpool,Loss,Away,1995-03-04,0,6,9,9,12,4,5,6,6,2,4,3,6,0,3.0,8.0,-5.0,8
11911,11911,1994-95,1994,1995,Newcastle,West Ham,Win,Home,1995-03-08,3,3,6,9,9,3,3,4,7,0,3,5,2,1,3.0,13.0,-10.0,8
11912,11912,1994-95,1994,1995,Newcastle,Arsenal,Win,Home,1995-03-19,3,3,6,9,12,0,3,6,7,3,3,3,5,1,3.0,4.0,-1.0,8
11913,11913,1994-95,1994,1995,Newcastle,Southampton,Loss,Away,1995-03-22,0,6,6,9,12,1,2,2,3,5,4,7,9,0,3.0,18.0,-15.0,8
11914,11914,1994-95,1994,1995,Newcastle,Chelsea,Draw,Away,1995-04-01,1,3,6,6,9,0,0,3,4,3,6,3,5,0,3.0,14.0,-11.0,9
11915,11915,1994-95,1994,1995,Newcastle,Norwich,Win,Home,1995-04-08,3,1,4,7,7,0,3,3,4,1,1,4,3,1,3.0,12.0,-9.0,9
11916,11916,1994-95,1994,1995,Newcastle,Everton,Loss,Away,1995-04-14,0,4,4,7,10,3,4,4,5,1,0,3,5,0,3.0,17.0,-14.0,9
11917,11917,1994-95,1994,1995,Newcastle,Leeds,Loss,Home,1995-04-17,0,3,4,4,7,4,7,8,8,-1,-3,-4,-1,1,3.0,5.0,-2.0,9
11918,11918,1994-95,1994,1995,Newcastle,Man City,Draw,Away,1995-04-29,1,0,3,4,4,6,6,6,6,-6,-3,-2,-2,0,3.0,16.0,-13.0,9
11919,11919,1994-95,1994,1995,Newcastle,Tottenham,Draw,Home,1995-05-03,1,1,1,4,5,4,5,8,8,-3,-4,-4,-3,1,3.0,15.0,-12.0,10
11920,11920,1994-95,1994,1995,Newcastle,Blackburn,Loss,Away,1995-05-08,0,2,2,2,5,3,3,4,7,-1,-1,-2,-2,0,3.0,2.0,1.0,10
11921,11921,1994-95,1994,1995,Newcastle,Crystal Palace,Win,Home,1995-05-14,3,1,2,2,2,3,3,3,3,-2,-1,-1,-1,1,3.0,21.0,-18.0,10
11922,11922,1995-96,1995,1996,Newcastle,Coventry,Win,Home,1995-08-19,3,3,4,5,5,4,4,4,4,-1,0,1,1,1,6.0,16.0,-10.0,1
11923,11923,1995-96,1995,1996,Newcastle,Bolton,Win,Away,1995-08-22,3,6,6,7,8,0,0,0,0,6,6,7,8,0,6.0,21.0,-15.0,1
11924,11924,1995-96,1995,1996,Newcastle,Sheffield Weds,Win,Away,1995-08-27,3,6,9,9,10,3,6,6,7,3,3,3,3,0,6.0,13.0,-7.0,1
11925,11925,1995-96,1995,1996,Newcastle,Middlesbrough,Win,Home,1995-08-30,3,6,9,12,12,4,4,4,4,2,5,8,8,1,6.0,21.0,-15.0,1
11926,11926,1995-96,1995,1996,Newcastle,Southampton,Loss,Away,1995-09-09,0,6,9,12,15,1,1,2,2,5,8,10,13,0,6.0,10.0,-4.0,2
11927,11927,1995-96,1995,1996,Newcastle,Man City,Win,Home,1995-09-16,3,3,6,9,12,0,0,0,1,3,6,9,11,1,6.0,17.0,-11.0,2
11928,11928,1995-96,1995,1996,Newcastle,Chelsea,Win,Home,1995-09-24,3,3,6,9,12,6,7,7,8,-3,-1,2,4,1,6.0,11.0,-5.0,2
11929,11929,1995-96,1995,1996,Newcastle,Everton,Win,Away,1995-10-01,3,6,6,9,12,0,0,3,6,6,6,6,6,0,6.0,15.0,-9.0,3
11930,11930,1995-96,1995,1996,Newcastle,QPR,Win,Away,1995-10-14,3,6,9,9,12,3,6,6,6,3,3,3,6,0,6.0,8.0,-2.0,3
11931,11931,1995-96,1995,1996,Newcastle,Wimbledon,Win,Home,1995-10-21,3,6,9,12,12,0,0,0,3,6,9,12,9,1,6.0,9.0,-3.0,3
11932,11932,1995-96,1995,1996,Newcastle,Tottenham,Draw,Away,1995-10-29,1,6,9,12,15,1,4,7,10,5,5,5,5,0,6.0,7.0,-1.0,3
11933,11933,1995-96,1995,1996,Newcastle,Liverpool,Win,Home,1995-11-04,3,4,7,10,13,6,7,8,11,-2,0,2,2,1,6.0,4.0,2.0,4
11934,11934,1995-96,1995,1996,Newcastle,Blackburn,Win,Home,1995-11-08,3,4,7,10,13,3,4,7,7,1,3,3,6,1,6.0,1.0,5.0,4
11935,11935,1995-96,1995,1996,Newcastle,Aston Villa,Draw,Away,1995-11-18,1,6,7,10,13,6,6,6,9,0,1,4,4,0,6.0,18.0,-12.0,4
11936,11936,1995-96,1995,1996,Newcastle,Leeds,Win,Home,1995-11-25,3,4,7,8,11,4,7,8,8,0,0,0,3,1,6.0,5.0,1.0,4
11937,11937,1995-96,1995,1996,Newcastle,Wimbledon,Draw,Away,1995-12-03,1,4,7,10,11,1,2,2,2,3,5,8,9,0,6.0,9.0,-3.0,5
11938,11938,1995-96,1995,1996,Newcastle,Chelsea,Loss,Away,1995-12-09,0,4,5,8,11,2,5,5,6,2,0,3,5,0,6.0,11.0,-5.0,5
11939,11939,1995-96,1995,1996,Newcastle,Everton,Win,Home,1995-12-16,3,1,4,5,8,4,5,8,11,-3,-1,-3,-3,1,6.0,15.0,-9.0,5
11940,11940,1995-96,1995,1996,Newcastle,Nott'm Forest,Win,Home,1995-12-23,3,3,4,7,8,2,3,4,4,1,1,3,4,1,6.0,3.0,3.0,5
11941,11941,1995-96,1995,1996,Newcastle,Man United,Loss,Away,1995-12-27,0,6,6,7,10,0,1,2,3,6,5,5,7,0,6.0,2.0,4.0,5
11942,11942,1995-96,1995,1996,Newcastle,Arsenal,Win,Home,1996-01-02,3,3,6,6,7,3,3,4,5,0,3,2,2,1,6.0,12.0,-6.0,6
11943,11943,1995-96,1995,1996,Newcastle,Coventry,Win,Away,1996-01-14,3,3,6,9,9,4,7,7,10,-1,-1,2,-1,0,6.0,16.0,-10.0,6
11944,11944,1995-96,1995,1996,Newcastle,Bolton,Win,Home,1996-01-20,3,6,6,9,12,3,3,3,4,3,3,6,8,1,6.0,21.0,-15.0,6
11945,11945,1995-96,1995,1996,Newcastle,Sheffield Weds,Win,Home,1996-02-03,3,6,9,9,12,1,4,4,5,5,5,5,7,1,6.0,13.0,-7.0,7
11946,11946,1995-96,1995,1996,Newcastle,Middlesbrough,Win,Away,1996-02-10,3,6,9,12,12,0,0,0,0,6,9,12,12,0,6.0,21.0,-15.0,7
11947,11947,1995-96,1995,1996,Newcastle,West Ham,Loss,Away,1996-02-21,0,6,9,12,15,6,9,12,12,0,0,0,3,0,6.0,14.0,-8.0,7
11948,11948,1995-96,1995,1996,Newcastle,Man City,Draw,Away,1996-02-24,1,3,6,9,12,3,4,5,5,0,2,4,7,0,6.0,17.0,-11.0,7
11949,11949,1995-96,1995,1996,Newcastle,Man United,Loss,Home,1996-03-04,0,1,4,7,10,6,9,12,15,-5,-5,-5,-5,1,6.0,2.0,4.0,8
11950,11950,1995-96,1995,1996,Newcastle,West Ham,Win,Home,1996-03-18,3,1,1,4,7,4,4,7,10,-3,-3,-3,-3,1,6.0,14.0,-8.0,8
11951,11951,1995-96,1995,1996,Newcastle,Arsenal,Loss,Away,1996-03-23,0,3,4,4,7,3,6,7,10,0,-2,-3,-3,0,6.0,12.0,-6.0,8
11952,11952,1995-96,1995,1996,Newcastle,Liverpool,Loss,Away,1996-04-03,0,3,3,4,4,3,4,7,10,0,-1,-3,-6,0,6.0,4.0,2.0,9
11953,11953,1995-96,1995,1996,Newcastle,QPR,Win,Home,1996-04-06,3,0,3,3,4,4,5,5,5,-4,-2,-2,-1,1,6.0,8.0,-2.0,9
11954,11954,1995-96,1995,1996,Newcastle,Blackburn,Loss,Away,1996-04-08,0,3,3,6,6,0,3,6,7,3,0,0,-1,0,6.0,1.0,5.0,9
11955,11955,1995-96,1995,1996,Newcastle,Aston Villa,Win,Home,1996-04-14,3,3,3,3,6,6,7,7,10,-3,-4,-4,-4,1,6.0,18.0,-12.0,9
11956,11956,1995-96,1995,1996,Newcastle,Southampton,Win,Home,1996-04-17,3,3,6,6,6,3,6,6,6,0,0,0,0,1,6.0,10.0,-4.0,9
11957,11957,1995-96,1995,1996,Newcastle,Leeds,Win,Away,1996-04-29,3,6,6,9,9,0,0,0,3,6,6,9,6,0,6.0,5.0,1.0,9
11958,11958,1995-96,1995,1996,Newcastle,Nott'm Forest,Draw,Away,1996-05-02,1,6,9,9,12,1,1,4,7,5,8,5,5,0,6.0,3.0,3.0,10
11959,11959,1995-96,1995,1996,Newcastle,Tottenham,Draw,Home,1996-05-04,1,4,7,10,10,4,5,6,6,0,2,4,4,1,6.0,7.0,-1.0,10
11960,11960,1996-97,1996,1997,Newcastle,Everton,Loss,Away,1996-08-17,0,2,5,8,11,6,7,7,10,-4,-2,1,1,0,2.0,6.0,-4.0,1
11961,11961,1996-97,1996,1997,Newcastle,Wimbledon,Win,Home,1996-08-21,3,1,2,5,8,1,1,1,4,0,1,4,4,1,2.0,14.0,-12.0,1
11962,11962,1996-97,1996,1997,Newcastle,Sheffield Weds,Loss,Home,1996-08-24,0,3,4,5,8,6,7,7,8,-3,-3,-2,0,1,2.0,15.0,-13.0,1
11963,11963,1996-97,1996,1997,Newcastle,Sunderland,Win,Away,1996-09-04,3,3,3,4,5,4,5,5,5,-1,-2,-1,0,0,2.0,21.0,-19.0,2
11964,11964,1996-97,1996,1997,Newcastle,Tottenham,Win,Away,1996-09-07,3,3,6,6,7,1,2,5,6,2,4,1,1,0,2.0,8.0,-6.0,2
11965,11965,1996-97,1996,1997,Newcastle,Blackburn,Win,Home,1996-09-14,3,6,6,9,9,0,1,1,1,6,5,8,8,1,2.0,7.0,-5.0,2
11966,11966,1996-97,1996,1997,Newcastle,Leeds,Win,Away,1996-09-21,3,6,9,9,12,0,3,6,6,6,6,3,6,0,2.0,13.0,-11.0,2
11967,11967,1996-97,1996,1997,Newcastle,Aston Villa,Win,Home,1996-09-30,3,6,9,12,12,2,3,6,9,4,6,6,3,1,2.0,4.0,-2.0,2
11968,11968,1996-97,1996,1997,Newcastle,Derby,Win,Away,1996-10-12,3,6,9,12,15,1,4,7,8,5,5,5,7,0,2.0,21.0,-19.0,3
11969,11969,1996-97,1996,1997,Newcastle,Man United,Win,Home,1996-10-20,3,6,9,12,15,6,7,10,13,0,2,2,2,1,2.0,1.0,1.0,3
11970,11970,1996-97,1996,1997,Newcastle,Leicester,Loss,Away,1996-10-26,0,6,9,12,15,0,3,6,6,6,6,6,9,0,2.0,21.0,-19.0,3
11971,11971,1996-97,1996,1997,Newcastle,Middlesbrough,Win,Home,1996-11-03,3,3,6,9,12,1,2,2,2,2,4,7,10,1,2.0,12.0,-10.0,4
11972,11972,1996-97,1996,1997,Newcastle,West Ham,Draw,Home,1996-11-16,1,3,6,9,12,3,6,6,6,0,0,3,6,1,2.0,10.0,-8.0,4
11973,11973,1996-97,1996,1997,Newcastle,Chelsea,Draw,Away,1996-11-23,1,4,4,7,10,4,7,7,10,0,-3,0,0,0,2.0,11.0,-9.0,4
11974,11974,1996-97,1996,1997,Newcastle,Arsenal,Loss,Home,1996-11-30,0,2,5,5,8,3,4,7,8,-1,1,-2,0,1,2.0,5.0,-3.0,4
11975,11975,1996-97,1996,1997,Newcastle,Nott'm Forest,Draw,Away,1996-12-09,1,1,2,5,5,1,1,1,1,0,1,4,4,0,2.0,9.0,-7.0,5
11976,11976,1996-97,1996,1997,Newcastle,Coventry,Loss,Away,1996-12-17,0,1,2,3,6,0,0,1,2,1,2,2,4,0,2.0,16.0,-14.0,5
11977,11977,1996-97,1996,1997,Newcastle,Liverpool,Draw,Home,1996-12-23,1,1,1,2,3,6,6,9,10,-5,-5,-7,-7,1,2.0,3.0,-1.0,5
11978,11978,1996-97,1996,1997,Newcastle,Blackburn,Loss,Away,1996-12-26,0,1,2,2,3,1,4,5,6,0,-2,-3,-3,0,2.0,7.0,-5.0,5
11979,11979,1996-97,1996,1997,Newcastle,Tottenham,Win,Home,1996-12-28,3,1,1,2,2,4,5,8,8,-3,-4,-6,-6,1,2.0,8.0,-6.0,5
11980,11980,1996-97,1996,1997,Newcastle,Leeds,Win,Home,1997-01-01,3,3,4,4,5,0,1,2,3,3,3,2,2,1,2.0,13.0,-11.0,6
11981,11981,1996-97,1996,1997,Newcastle,Aston Villa,Draw,Away,1997-01-11,1,6,6,7,7,2,2,5,8,4,4,2,-1,0,2.0,4.0,-2.0,6
11982,11982,1996-97,1996,1997,Newcastle,Southampton,Draw,Away,1997-01-18,1,4,7,7,8,3,3,6,6,1,4,1,2,0,2.0,17.0,-15.0,6
11983,11983,1996-97,1996,1997,Newcastle,Everton,Win,Home,1997-01-29,3,2,5,8,8,0,0,0,0,2,5,8,8,1,2.0,6.0,-4.0,6
11984,11984,1996-97,1996,1997,Newcastle,Leicester,Win,Home,1997-02-02,3,4,5,8,11,4,4,5,6,0,1,3,5,1,2.0,21.0,-19.0,7
11985,11985,1996-97,1996,1997,Newcastle,Middlesbrough,Win,Away,1997-02-22,3,6,7,8,11,4,4,4,4,2,3,4,7,0,2.0,12.0,-10.0,7
11986,11986,1996-97,1996,1997,Newcastle,Southampton,Loss,Home,1997-03-01,0,6,9,10,11,1,1,2,5,5,8,8,6,1,2.0,17.0,-15.0,8
11987,11987,1996-97,1996,1997,Newcastle,Liverpool,Loss,Away,1997-03-10,0,3,6,9,10,1,4,7,10,2,2,2,0,0,2.0,3.0,-1.0,8
11988,11988,1996-97,1996,1997,Newcastle,Coventry,Win,Home,1997-03-15,3,0,3,6,9,2,2,3,3,-2,1,3,6,1,2.0,16.0,-14.0,8
11989,11989,1996-97,1996,1997,Newcastle,Wimbledon,Draw,Away,1997-03-23,1,3,3,6,9,1,2,2,3,2,1,4,6,0,2.0,14.0,-12.0,8
11990,11990,1996-97,1996,1997,Newcastle,Sunderland,Draw,Home,1997-04-05,1,4,4,4,7,1,1,4,4,3,3,0,3,1,2.0,21.0,-19.0,9
11991,11991,1996-97,1996,1997,Newcastle,Sheffield Weds,Draw,Away,1997-04-13,1,2,5,5,5,4,4,7,10,-2,1,-2,-5,0,2.0,15.0,-13.0,9
11992,11992,1996-97,1996,1997,Newcastle,Chelsea,Win,Home,1997-04-16,3,2,3,6,6,0,0,3,6,2,3,3,0,1,2.0,11.0,-9.0,9
11993,11993,1996-97,1996,1997,Newcastle,Derby,Win,Home,1997-04-19,3,4,5,6,9,4,7,10,10,0,-2,-4,-1,1,2.0,21.0,-19.0,9
11994,11994,1996-97,1996,1997,Newcastle,Arsenal,Win,Away,1997-05-03,3,6,7,8,9,2,5,8,8,4,2,0,1,0,2.0,5.0,-3.0,10
11995,11995,1996-97,1996,1997,Newcastle,West Ham,Draw,Away,1997-05-06,1,6,9,10,11,6,7,7,8,0,2,3,3,0,2.0,10.0,-8.0,10
11996,11996,1996-97,1996,1997,Newcastle,Man United,Draw,Away,1997-05-08,1,4,7,10,11,2,5,8,8,2,2,2,3,0,2.0,1.0,1.0,10
11997,11997,1996-97,1996,1997,Newcastle,Nott'm Forest,Win,Home,1997-05-11,3,2,5,8,11,2,3,3,4,0,2,5,7,1,2.0,9.0,-7.0,10
11998,11998,1997-98,1997,1998,Newcastle,Sheffield Weds,Win,Home,1997-08-09,3,4,5,8,11,1,1,1,4,3,4,7,7,1,2.0,7.0,-5.0,1
11999,11999,1997-98,1997,1998,Newcastle,Aston Villa,Win,Home,1997-08-23,3,6,7,8,11,0,3,3,4,6,4,5,7,1,2.0,5.0,-3.0,1
12000,12000,1997-98,1997,1998,Newcastle,Wimbledon,Loss,Home,1997-09-13,0,6,9,10,11,0,1,2,5,6,8,8,6,1,2.0,8.0,-6.0,2
12001,12001,1997-98,1997,1998,Newcastle,West Ham,Win,Away,1997-09-20,3,3,6,9,10,3,4,4,7,0,2,5,3,0,2.0,14.0,-12.0,2
12002,12002,1997-98,1997,1998,Newcastle,Everton,Win,Home,1997-09-24,3,3,6,9,12,3,4,4,7,0,2,5,5,1,2.0,15.0,-13.0,2
12003,12003,1997-98,1997,1998,Newcastle,Chelsea,Loss,Away,1997-09-27,0,6,6,9,12,1,4,7,10,5,2,2,2,0,2.0,6.0,-4.0,2
12004,12004,1997-98,1997,1998,Newcastle,Tottenham,Win,Home,1997-10-04,3,3,6,6,9,2,3,3,4,1,3,3,5,1,2.0,10.0,-8.0,3
12005,12005,1997-98,1997,1998,Newcastle,Leeds,Loss,Away,1997-10-18,0,3,6,9,9,4,7,7,10,-1,-1,2,-1,0,2.0,11.0,-9.0,3
12006,12006,1997-98,1997,1998,Newcastle,Blackburn,Draw,Home,1997-10-25,1,3,3,6,9,6,7,8,9,-3,-4,-2,0,1,2.0,13.0,-11.0,3
12007,12007,1997-98,1997,1998,Newcastle,Leicester,Draw,Home,1997-11-01,1,1,4,4,7,3,3,6,7,-2,1,-2,0,1,2.0,9.0,-7.0,4
12008,12008,1997-98,1997,1998,Newcastle,Coventry,Draw,Away,1997-11-08,1,2,2,5,5,4,4,5,6,-2,-2,0,-1,0,2.0,17.0,-15.0,4
12009,12009,1997-98,1997,1998,Newcastle,Southampton,Win,Home,1997-11-22,3,2,3,3,6,6,9,9,12,-4,-6,-6,-6,1,2.0,16.0,-14.0,4
12010,12010,1997-98,1997,1998,Newcastle,Crystal Palace,Win,Away,1997-11-29,3,4,5,6,6,4,7,8,8,0,-2,-2,-2,0,2.0,21.0,-19.0,4
12011,12011,1997-98,1997,1998,Newcastle,Bolton,Loss,Away,1997-12-01,0,6,7,8,9,4,4,5,8,2,3,3,1,0,2.0,21.0,-19.0,5
12012,12012,1997-98,1997,1998,Newcastle,Arsenal,Loss,Home,1997-12-06,0,3,6,7,8,0,3,3,4,3,3,4,4,1,2.0,3.0,-1.0,5
12013,12013,1997-98,1997,1998,Newcastle,Barnsley,Draw,Away,1997-12-13,1,0,3,6,7,0,3,3,4,0,0,3,3,0,2.0,21.0,-19.0,5
12014,12014,1997-98,1997,1998,Newcastle,Derby,Draw,Home,1997-12-17,1,1,1,4,7,4,4,7,7,-3,-3,-3,0,1,2.0,12.0,-10.0,5
12015,12015,1997-98,1997,1998,Newcastle,Man United,Loss,Home,1997-12-21,0,2,2,2,5,6,9,12,12,-4,-7,-10,-7,1,2.0,1.0,1.0,5
12016,12016,1997-98,1997,1998,Newcastle,Derby,Loss,Away,1997-12-26,0,1,2,2,2,2,3,6,6,-1,-1,-4,-4,0,2.0,12.0,-10.0,5
12017,12017,1997-98,1997,1998,Newcastle,Liverpool,Loss,Home,1997-12-28,0,0,1,2,2,6,9,9,12,-6,-8,-7,-10,1,2.0,4.0,-2.0,5
12018,12018,1997-98,1997,1998,Newcastle,Sheffield Weds,Loss,Away,1998-01-10,0,0,0,1,2,2,2,2,5,-2,-2,-1,-3,0,2.0,7.0,-5.0,6
12019,12019,1997-98,1997,1998,Newcastle,Bolton,Win,Home,1998-01-17,3,0,0,0,1,1,2,2,3,-1,-2,-2,-2,1,2.0,21.0,-19.0,6
12020,12020,1997-98,1997,1998,Newcastle,Liverpool,Loss,Away,1998-01-20,0,3,3,3,3,4,7,10,13,-1,-4,-7,-10,0,2.0,4.0,-2.0,6
12021,12021,1997-98,1997,1998,Newcastle,Aston Villa,Win,Away,1998-02-01,3,3,3,3,3,1,2,5,6,2,1,-2,-3,0,2.0,5.0,-3.0,7
12022,12022,1997-98,1997,1998,Newcastle,West Ham,Loss,Home,1998-02-07,0,3,6,6,6,1,4,7,10,2,2,-1,-4,1,2.0,14.0,-12.0,7
12023,12023,1997-98,1997,1998,Newcastle,Leeds,Draw,Home,1998-02-22,1,3,3,6,6,3,3,3,4,0,0,3,2,1,2.0,11.0,-9.0,7
12024,12024,1997-98,1997,1998,Newcastle,Everton,Draw,Away,1998-02-28,1,1,4,4,7,1,2,3,6,0,2,1,1,0,2.0,15.0,-13.0,7
12025,12025,1997-98,1997,1998,Newcastle,Coventry,Draw,Home,1998-03-14,1,2,2,5,5,6,9,12,15,-4,-7,-7,-10,1,2.0,17.0,-15.0,8
12026,12026,1997-98,1997,1998,Newcastle,Crystal Palace,Loss,Home,1998-03-18,0,2,3,3,6,0,0,0,0,2,3,3,6,1,2.0,21.0,-19.0,8
12027,12027,1997-98,1997,1998,Newcastle,Southampton,Loss,Away,1998-03-28,0,1,2,3,3,3,6,9,9,-2,-4,-6,-6,0,2.0,16.0,-14.0,8
12028,12028,1997-98,1997,1998,Newcastle,Wimbledon,Draw,Away,1998-03-31,1,0,1,2,3,3,3,3,6,-3,-2,-1,-3,0,2.0,8.0,-6.0,8
12029,12029,1997-98,1997,1998,Newcastle,Arsenal,Loss,Away,1998-04-11,0,1,1,2,3,6,9,12,13,-5,-8,-10,-10,0,2.0,3.0,-1.0,9
12030,12030,1997-98,1997,1998,Newcastle,Barnsley,Win,Home,1998-04-13,3,1,1,1,2,3,3,3,6,-2,-2,-2,-4,1,2.0,21.0,-19.0,9
12031,12031,1997-98,1997,1998,Newcastle,Man United,Draw,Away,1998-04-18,1,3,4,4,4,4,7,7,8,-1,-3,-3,-4,0,2.0,1.0,1.0,9
12032,12032,1997-98,1997,1998,Newcastle,Tottenham,Loss,Away,1998-04-25,0,4,4,5,5,2,2,3,6,2,2,2,-1,0,2.0,10.0,-8.0,9
12033,12033,1997-98,1997,1998,Newcastle,Leicester,Draw,Away,1998-04-29,1,1,4,4,5,4,5,8,9,-3,-1,-4,-4,0,2.0,9.0,-7.0,9
12034,12034,1997-98,1997,1998,Newcastle,Chelsea,Win,Home,1998-05-02,3,1,2,5,5,3,6,9,9,-2,-4,-4,-4,1,2.0,6.0,-4.0,10
12035,12035,1997-98,1997,1998,Newcastle,Blackburn,Loss,Away,1998-05-10,0,4,4,5,8,3,4,4,4,1,0,1,4,0,2.0,13.0,-11.0,10
12036,12036,1998-99,1998,1999,Newcastle,Charlton,Draw,Home,1998-08-15,1,3,4,4,5,0,0,0,0,3,4,4,5,1,13.0,21.0,-8.0,1
12037,12037,1998-99,1998,1999,Newcastle,Chelsea,Draw,Away,1998-08-22,1,1,4,5,5,3,3,3,6,-2,1,2,-1,0,13.0,4.0,9.0,1
12038,12038,1998-99,1998,1999,Newcastle,Liverpool,Loss,Home,1998-08-30,0,2,2,5,6,4,4,7,10,-2,-2,-2,-4,1,13.0,3.0,10.0,1
12039,12039,1998-99,1998,1999,Newcastle,Aston Villa,Loss,Away,1998-09-09,0,1,2,2,5,6,7,10,13,-5,-5,-8,-8,0,13.0,7.0,6.0,2
12040,12040,1998-99,1998,1999,Newcastle,Southampton,Win,Home,1998-09-12,3,0,1,2,2,0,0,0,1,0,1,2,1,1,13.0,12.0,1.0,2
12041,12041,1998-99,1998,1999,Newcastle,Coventry,Win,Away,1998-09-19,3,3,3,4,5,0,1,1,4,3,2,3,1,0,13.0,11.0,2.0,2
12042,12042,1998-99,1998,1999,Newcastle,Nott'm Forest,Win,Home,1998-09-26,3,6,6,6,7,1,1,4,7,5,5,2,0,1,13.0,21.0,-8.0,2
12043,12043,1998-99,1998,1999,Newcastle,Arsenal,Loss,Away,1998-10-04,0,6,9,9,9,3,4,5,6,3,5,4,3,0,13.0,1.0,12.0,3
12044,12044,1998-99,1998,1999,Newcastle,Derby,Win,Home,1998-10-17,3,3,6,9,9,0,3,6,9,3,3,3,0,1,13.0,9.0,4.0,3
12045,12045,1998-99,1998,1999,Newcastle,Tottenham,Loss,Away,1998-10-24,0,3,6,9,12,3,4,5,5,0,2,4,7,0,13.0,14.0,-1.0,3
12046,12046,1998-99,1998,1999,Newcastle,West Ham,Loss,Home,1998-10-31,0,3,3,6,9,1,1,4,5,2,2,2,4,1,13.0,8.0,5.0,3
12047,12047,1998-99,1998,1999,Newcastle,Man United,Draw,Away,1998-11-08,1,0,3,3,6,4,7,10,13,-4,-4,-7,-7,0,13.0,2.0,11.0,4
12048,12048,1998-99,1998,1999,Newcastle,Sheffield Weds,Draw,Home,1998-11-14,1,1,1,4,4,1,2,2,2,0,-1,2,2,1,13.0,16.0,-3.0,4
12049,12049,1998-99,1998,1999,Newcastle,Everton,Loss,Away,1998-11-23,0,2,2,2,5,0,0,1,2,2,2,1,3,0,13.0,17.0,-4.0,4
12050,12050,1998-99,1998,1999,Newcastle,Wimbledon,Win,Home,1998-11-28,3,1,2,2,2,3,6,7,8,-2,-4,-5,-6,1,13.0,15.0,-2.0,4
12051,12051,1998-99,1998,1999,Newcastle,Middlesbrough,Draw,Away,1998-12-06,1,3,4,5,5,4,5,6,7,-1,-1,-1,-2,0,13.0,21.0,-8.0,5
12052,12052,1998-99,1998,1999,Newcastle,Blackburn,Draw,Away,1998-12-12,1,4,4,5,6,3,3,3,3,1,1,2,3,0,13.0,6.0,7.0,5
12053,12053,1998-99,1998,1999,Newcastle,Leicester,Win,Home,1998-12-19,3,2,5,5,6,6,7,7,7,-4,-2,-2,-1,1,13.0,10.0,3.0,5
12054,12054,1998-99,1998,1999,Newcastle,Leeds,Loss,Home,1998-12-26,0,4,5,8,8,3,6,6,9,1,-1,2,-1,1,13.0,5.0,8.0,5
12055,12055,1998-99,1998,1999,Newcastle,Liverpool,Loss,Away,1998-12-28,0,3,4,5,8,6,6,6,9,-3,-2,-1,-1,0,13.0,3.0,10.0,5
12056,12056,1998-99,1998,1999,Newcastle,Chelsea,Loss,Home,1999-01-09,0,0,3,4,5,4,7,8,9,-4,-4,-4,-4,1,13.0,4.0,9.0,6
12057,12057,1998-99,1998,1999,Newcastle,Charlton,Draw,Away,1999-01-17,1,0,0,3,4,0,0,0,0,0,0,3,4,0,13.0,21.0,-8.0,6
12058,12058,1998-99,1998,1999,Newcastle,Aston Villa,Win,Home,1999-01-30,3,1,1,1,4,4,7,7,10,-3,-6,-6,-6,1,13.0,7.0,6.0,6
12059,12059,1998-99,1998,1999,Newcastle,Leeds,Win,Away,1999-02-06,3,4,4,4,4,3,3,4,7,1,1,0,-3,0,13.0,5.0,8.0,7
12060,12060,1998-99,1998,1999,Newcastle,Coventry,Win,Home,1999-02-17,3,6,7,7,7,4,4,7,7,2,3,0,0,1,13.0,11.0,2.0,7
12061,12061,1998-99,1998,1999,Newcastle,Southampton,Loss,Away,1999-02-20,0,6,9,10,10,3,3,6,7,3,6,4,3,0,13.0,12.0,1.0,7
12062,12062,1998-99,1998,1999,Newcastle,Arsenal,Draw,Home,1999-02-28,1,3,6,9,10,4,7,10,13,-1,-1,-1,-3,1,13.0,1.0,12.0,7
12063,12063,1998-99,1998,1999,Newcastle,Nott'm Forest,Win,Away,1999-03-10,3,1,4,7,10,1,1,1,4,0,3,6,6,0,13.0,21.0,-8.0,8
12064,12064,1998-99,1998,1999,Newcastle,Man United,Loss,Home,1999-03-13,0,4,4,7,10,6,7,10,13,-2,-3,-3,-3,1,13.0,2.0,11.0,8
12065,12065,1998-99,1998,1999,Newcastle,West Ham,Loss,Away,1999-03-20,0,3,4,4,7,3,6,7,10,0,-2,-3,-3,0,13.0,8.0,5.0,8
12066,12066,1998-99,1998,1999,Newcastle,Derby,Win,Away,1999-04-03,3,0,3,4,4,3,6,7,7,-3,-3,-3,-3,0,13.0,9.0,4.0,9
12067,12067,1998-99,1998,1999,Newcastle,Tottenham,Draw,Home,1999-04-05,1,3,3,6,7,3,3,6,7,0,0,0,0,1,13.0,14.0,-1.0,9
12068,12068,1998-99,1998,1999,Newcastle,Everton,Loss,Home,1999-04-17,0,4,4,4,7,3,3,3,3,1,1,1,4,1,13.0,17.0,-4.0,9
12069,12069,1998-99,1998,1999,Newcastle,Sheffield Weds,Draw,Away,1999-04-21,1,1,4,4,4,3,3,3,3,-2,1,1,1,0,13.0,16.0,-3.0,9
12070,12070,1998-99,1998,1999,Newcastle,Wimbledon,Draw,Away,1999-04-24,1,1,2,5,5,0,0,1,1,1,2,4,4,0,13.0,15.0,-2.0,9
12071,12071,1998-99,1998,1999,Newcastle,Middlesbrough,Draw,Home,1999-05-01,1,2,2,3,6,3,4,7,10,-1,-2,-4,-4,1,13.0,21.0,-8.0,10
12072,12072,1998-99,1998,1999,Newcastle,Leicester,Loss,Away,1999-05-08,0,2,3,3,4,0,3,6,7,2,0,-3,-3,0,13.0,10.0,3.0,10
12073,12073,1998-99,1998,1999,Newcastle,Blackburn,Draw,Home,1999-05-16,1,1,2,3,3,1,2,2,3,0,0,1,0,1,13.0,6.0,7.0,10
12074,12074,1999-00,1999,2000,Newcastle,Aston Villa,Loss,Home,1999-08-07,0,1,2,3,4,0,0,3,6,1,2,0,-2,1,13.0,6.0,7.0,1
12075,12075,1999-00,1999,2000,Newcastle,Tottenham,Loss,Away,1999-08-09,0,1,1,2,3,0,1,1,1,1,0,1,2,0,13.0,11.0,2.0,1
12076,12076,1999-00,1999,2000,Newcastle,Southampton,Loss,Away,1999-08-15,0,0,1,1,2,3,6,9,12,-3,-5,-8,-10,0,13.0,17.0,-4.0,1
12077,12077,1999-00,1999,2000,Newcastle,Wimbledon,Draw,Home,1999-08-21,1,0,0,1,1,1,4,4,4,-1,-4,-3,-3,1,13.0,16.0,-3.0,1
12078,12078,1999-00,1999,2000,Newcastle,Sunderland,Loss,Home,1999-08-25,0,1,1,1,2,1,4,4,4,0,-3,-3,-2,1,13.0,21.0,-8.0,1
12079,12079,1999-00,1999,2000,Newcastle,Man United,Loss,Away,1999-08-30,0,1,1,1,1,6,9,12,13,-5,-8,-11,-12,0,13.0,1.0,12.0,1
12080,12080,1999-00,1999,2000,Newcastle,Chelsea,Loss,Away,1999-09-11,0,0,1,1,1,6,7,10,13,-6,-6,-9,-12,0,13.0,3.0,10.0,2
12081,12081,1999-00,1999,2000,Newcastle,Sheffield Weds,Win,Home,1999-09-19,3,0,0,1,1,0,0,0,1,0,0,1,0,1,13.0,12.0,1.0,2
12082,12082,1999-00,1999,2000,Newcastle,Leeds,Loss,Away,1999-09-25,0,3,3,3,4,6,9,9,12,-3,-6,-6,-8,0,13.0,4.0,9.0,2
12083,12083,1999-00,1999,2000,Newcastle,Middlesbrough,Win,Home,1999-10-03,3,3,3,3,3,0,3,3,3,3,0,0,0,1,13.0,9.0,4.0,3
12084,12084,1999-00,1999,2000,Newcastle,Coventry,Loss,Away,1999-10-16,0,3,6,6,6,4,4,4,5,-1,2,2,1,0,13.0,15.0,-2.0,3
12085,12085,1999-00,1999,2000,Newcastle,Derby,Win,Home,1999-10-25,3,3,3,6,6,1,1,1,2,2,2,5,4,1,13.0,8.0,5.0,3
12086,12086,1999-00,1999,2000,Newcastle,Arsenal,Draw,Away,1999-10-30,1,3,6,6,9,6,6,9,12,-3,0,-3,-3,0,13.0,2.0,11.0,3
12087,12087,1999-00,1999,2000,Newcastle,Everton,Draw,Home,1999-11-07,1,4,4,7,7,1,1,2,5,3,3,5,2,1,13.0,14.0,-1.0,4
12088,12088,1999-00,1999,2000,Newcastle,Watford,Draw,Away,1999-11-20,1,2,5,5,8,1,1,1,1,1,4,4,7,0,13.0,21.0,-8.0,4
12089,12089,1999-00,1999,2000,Newcastle,Tottenham,Win,Home,1999-11-28,3,2,3,6,6,6,6,9,12,-4,-3,-3,-6,1,13.0,11.0,2.0,4
12090,12090,1999-00,1999,2000,Newcastle,Aston Villa,Win,Away,1999-12-04,3,4,5,6,9,1,1,1,2,3,4,5,7,0,13.0,6.0,7.0,5
12091,12091,1999-00,1999,2000,Newcastle,Bradford,Loss,Away,1999-12-18,0,6,7,8,9,1,1,2,2,5,6,6,7,0,13.0,21.0,-8.0,5
12092,12092,1999-00,1999,2000,Newcastle,Liverpool,Draw,Home,1999-12-26,1,3,6,7,8,6,6,9,12,-3,0,-2,-4,1,13.0,7.0,6.0,5
12093,12093,1999-00,1999,2000,Newcastle,Leicester,Win,Away,1999-12-28,3,1,4,7,8,0,0,3,6,1,4,4,2,0,13.0,10.0,3.0,5
12094,12094,1999-00,1999,2000,Newcastle,West Ham,Draw,Home,2000-01-03,1,4,4,7,10,2,2,3,6,2,2,4,4,1,13.0,5.0,8.0,6
12095,12095,1999-00,1999,2000,Newcastle,Southampton,Win,Home,2000-01-16,3,4,5,5,8,3,3,3,4,1,2,2,4,1,13.0,17.0,-4.0,6
12096,12096,1999-00,1999,2000,Newcastle,Wimbledon,Loss,Away,2000-01-22,0,4,7,8,8,3,3,4,5,1,4,4,3,0,13.0,16.0,-3.0,6
12097,12097,1999-00,1999,2000,Newcastle,Sunderland,Draw,Away,2000-02-05,1,3,4,7,8,0,0,1,1,3,4,6,7,0,13.0,21.0,-8.0,7
12098,12098,1999-00,1999,2000,Newcastle,Man United,Win,Home,2000-02-12,3,1,4,5,8,6,9,10,11,-5,-5,-5,-3,1,13.0,1.0,12.0,7
12099,12099,1999-00,1999,2000,Newcastle,Sheffield Weds,Win,Away,2000-02-26,3,4,4,7,8,1,1,4,7,3,3,3,1,0,13.0,12.0,1.0,7
12100,12100,1999-00,1999,2000,Newcastle,Chelsea,Loss,Home,2000-03-04,0,6,7,7,10,6,9,10,11,0,-2,-3,-1,1,13.0,3.0,10.0,8
12101,12101,1999-00,1999,2000,Newcastle,Watford,Win,Home,2000-03-11,3,3,6,7,7,0,1,1,1,3,5,6,6,1,13.0,21.0,-8.0,8
12102,12102,1999-00,1999,2000,Newcastle,Everton,Win,Away,2000-03-19,3,3,6,9,10,1,2,5,8,2,4,4,2,0,13.0,14.0,-1.0,8
12103,12103,1999-00,1999,2000,Newcastle,Liverpool,Loss,Away,2000-03-25,0,6,6,9,12,4,5,6,9,2,1,3,3,0,13.0,7.0,6.0,8
12104,12104,1999-00,1999,2000,Newcastle,Bradford,Win,Home,2000-04-01,3,3,6,6,9,0,0,1,2,3,6,5,7,1,13.0,21.0,-8.0,9
12105,12105,1999-00,1999,2000,Newcastle,West Ham,Loss,Away,2000-04-12,0,3,6,9,9,3,4,4,7,0,2,5,2,0,13.0,5.0,8.0,9
12106,12106,1999-00,1999,2000,Newcastle,Leicester,Loss,Home,2000-04-15,0,3,3,6,9,1,4,4,4,2,-1,2,5,1,13.0,10.0,3.0,9
12107,12107,1999-00,1999,2000,Newcastle,Leeds,Draw,Home,2000-04-23,1,0,3,3,6,0,0,0,3,0,3,3,3,1,13.0,4.0,9.0,9
12108,12108,1999-00,1999,2000,Newcastle,Coventry,Win,Home,2000-04-29,3,1,1,4,4,3,3,3,3,-2,-2,1,1,1,13.0,15.0,-2.0,9
12109,12109,1999-00,1999,2000,Newcastle,Middlesbrough,Draw,Away,2000-05-02,1,4,4,4,7,4,4,4,7,0,0,0,0,0,13.0,9.0,4.0,10
12110,12110,1999-00,1999,2000,Newcastle,Derby,Draw,Away,2000-05-06,1,4,5,5,5,4,5,5,6,0,0,0,-1,0,13.0,8.0,5.0,10
12111,12111,1999-00,1999,2000,Newcastle,Arsenal,Win,Home,2000-05-14,3,2,5,6,6,4,7,10,13,-2,-2,-4,-7,1,13.0,2.0,11.0,10
12112,12112,2000-01,2000,2001,Newcastle,Man United,Loss,Away,2000-08-20,0,4,5,8,9,6,9,12,15,-2,-4,-4,-6,0,11.0,1.0,10.0,1
12113,12113,2000-01,2000,2001,Newcastle,Derby,Win,Home,2000-08-23,3,3,4,5,8,1,2,3,6,2,2,2,2,1,11.0,16.0,-5.0,1
12114,12114,2000-01,2000,2001,Newcastle,Tottenham,Win,Home,2000-08-26,3,3,6,7,8,4,7,7,8,-1,-1,0,0,1,11.0,10.0,1.0,1
12115,12115,2000-01,2000,2001,Newcastle,Coventry,Win,Away,2000-09-06,3,6,6,9,10,6,6,6,9,0,0,3,1,0,11.0,14.0,-3.0,2
12116,12116,2000-01,2000,2001,Newcastle,Chelsea,Draw,Home,2000-09-09,1,6,9,9,12,2,2,5,8,4,7,4,4,1,11.0,5.0,6.0,2
12117,12117,2000-01,2000,2001,Newcastle,Southampton,Loss,Away,2000-09-16,0,4,7,10,10,1,2,2,3,3,5,8,7,0,11.0,15.0,-4.0,2
12118,12118,2000-01,2000,2001,Newcastle,Charlton,Loss,Home,2000-09-23,0,1,4,7,10,4,5,5,5,-3,-1,2,5,1,11.0,21.0,-10.0,2
12119,12119,2000-01,2000,2001,Newcastle,Man City,Win,Away,2000-09-30,3,0,1,4,7,2,2,5,5,-2,-1,-1,2,0,11.0,21.0,-10.0,2
12120,12120,2000-01,2000,2001,Newcastle,Middlesbrough,Win,Away,2000-10-16,3,3,3,4,7,4,5,5,6,-1,-2,-1,1,0,11.0,12.0,-1.0,3
12121,12121,2000-01,2000,2001,Newcastle,Everton,Loss,Home,2000-10-21,0,6,6,6,7,1,2,2,5,5,4,4,2,1,11.0,13.0,-2.0,3
12122,12122,2000-01,2000,2001,Newcastle,West Ham,Loss,Away,2000-10-28,0,3,6,6,6,1,2,5,6,2,4,1,0,0,11.0,9.0,2.0,3
12123,12123,2000-01,2000,2001,Newcastle,Ipswich,Win,Home,2000-11-04,3,0,3,6,6,6,7,10,11,-6,-4,-4,-5,1,11.0,21.0,-10.0,4
12124,12124,2000-01,2000,2001,Newcastle,Leicester,Draw,Away,2000-11-11,1,3,3,6,9,6,6,6,7,-3,-3,0,2,0,11.0,8.0,3.0,4
12125,12125,2000-01,2000,2001,Newcastle,Sunderland,Loss,Home,2000-11-18,0,4,4,4,7,1,4,5,8,3,0,-1,-1,1,11.0,7.0,4.0,4
12126,12126,2000-01,2000,2001,Newcastle,Liverpool,Win,Home,2000-11-26,3,1,4,4,4,3,3,6,9,-2,1,-2,-5,1,11.0,4.0,7.0,4
12127,12127,2000-01,2000,2001,Newcastle,Aston Villa,Draw,Away,2000-12-02,1,3,4,7,7,1,4,7,10,2,0,0,-3,0,11.0,6.0,5.0,5
12128,12128,2000-01,2000,2001,Newcastle,Arsenal,Loss,Away,2000-12-09,0,4,4,5,8,3,3,4,7,1,1,1,1,0,11.0,2.0,9.0,5
12129,12129,2000-01,2000,2001,Newcastle,Bradford,Win,Home,2000-12-16,3,1,4,4,5,4,5,5,5,-3,-1,-1,0,1,11.0,17.0,-6.0,5
12130,12130,2000-01,2000,2001,Newcastle,Derby,Loss,Away,2000-12-23,0,3,4,7,7,3,6,6,9,0,-2,1,-2,0,11.0,16.0,-5.0,5
12131,12131,2000-01,2000,2001,Newcastle,Leeds,Win,Home,2000-12-26,3,3,3,4,7,3,3,3,6,0,0,1,1,1,11.0,3.0,8.0,5
12132,12132,2000-01,2000,2001,Newcastle,Man United,Draw,Home,2000-12-30,1,3,6,6,7,6,6,7,10,-3,0,-1,-3,1,11.0,1.0,10.0,5
12133,12133,2000-01,2000,2001,Newcastle,Tottenham,Loss,Away,2001-01-02,0,4,4,7,7,0,1,2,3,4,3,5,4,0,11.0,10.0,1.0,6
12134,12134,2000-01,2000,2001,Newcastle,Coventry,Win,Home,2001-01-13,3,1,4,4,7,2,5,6,6,-1,-1,-2,1,1,11.0,14.0,-3.0,6
12135,12135,2000-01,2000,2001,Newcastle,Leeds,Win,Away,2001-01-20,3,3,4,7,7,4,4,4,7,-1,0,3,0,0,11.0,3.0,8.0,6
12136,12136,2000-01,2000,2001,Newcastle,Chelsea,Loss,Away,2001-01-31,0,6,6,7,10,4,7,8,11,2,-1,-1,-1,0,11.0,5.0,6.0,6
12137,12137,2000-01,2000,2001,Newcastle,Charlton,Loss,Away,2001-02-11,0,3,6,6,7,4,5,6,9,-1,1,0,-2,0,11.0,21.0,-10.0,7
12138,12138,2000-01,2000,2001,Newcastle,Man City,Loss,Home,2001-02-24,0,0,3,6,6,1,2,3,3,-1,1,3,3,1,11.0,21.0,-10.0,7
12139,12139,2000-01,2000,2001,Newcastle,Everton,Draw,Away,2001-03-03,1,0,0,3,6,3,4,4,5,-3,-4,-1,1,0,11.0,13.0,-2.0,8
12140,12140,2000-01,2000,2001,Newcastle,Middlesbrough,Loss,Home,2001-03-17,0,1,1,1,4,1,2,3,4,0,-1,-2,0,1,11.0,12.0,-1.0,8
12141,12141,2000-01,2000,2001,Newcastle,Bradford,Draw,Away,2001-03-31,1,1,1,1,1,1,1,1,1,0,0,0,0,0,11.0,17.0,-6.0,8
12142,12142,2000-01,2000,2001,Newcastle,Ipswich,Loss,Away,2001-04-14,0,1,2,2,2,4,7,7,10,-3,-5,-5,-8,0,11.0,21.0,-10.0,9
12143,12143,2000-01,2000,2001,Newcastle,West Ham,Win,Home,2001-04-16,3,1,1,2,2,4,4,4,4,-3,-3,-2,-2,1,11.0,9.0,2.0,9
12144,12144,2000-01,2000,2001,Newcastle,Sunderland,Draw,Away,2001-04-21,1,3,4,4,5,0,1,1,4,3,3,3,1,0,11.0,7.0,4.0,9
12145,12145,2000-01,2000,2001,Newcastle,Leicester,Win,Home,2001-04-28,3,4,4,5,5,0,0,0,0,4,4,5,5,1,11.0,8.0,3.0,9
12146,12146,2000-01,2000,2001,Newcastle,Southampton,Draw,Home,2001-05-01,1,4,7,7,8,1,1,1,1,3,6,6,7,1,11.0,15.0,-4.0,10
12147,12147,2000-01,2000,2001,Newcastle,Liverpool,Loss,Away,2001-05-05,0,4,5,8,8,6,9,12,12,-2,-4,-4,-4,0,11.0,4.0,7.0,10
12148,12148,2000-01,2000,2001,Newcastle,Arsenal,Draw,Home,2001-05-15,1,1,4,5,8,6,9,9,12,-5,-5,-4,-4,1,11.0,2.0,9.0,10
12149,12149,2000-01,2000,2001,Newcastle,Aston Villa,Win,Home,2001-05-19,3,1,2,5,6,4,5,6,9,-3,-3,-1,-3,1,11.0,6.0,5.0,10
12150,12150,2001-02,2001,2002,Newcastle,Chelsea,Draw,Away,2001-08-19,1,4,4,5,8,4,7,7,7,0,-3,-2,1,0,11.0,6.0,5.0,1
12151,12151,2001-02,2001,2002,Newcastle,Sunderland,Draw,Home,2001-08-26,1,4,5,5,6,3,4,7,10,1,1,-2,-4,1,11.0,7.0,4.0,1
12152,12152,2001-02,2001,2002,Newcastle,Middlesbrough,Win,Away,2001-09-08,3,2,5,6,6,0,0,3,4,2,5,3,2,0,11.0,14.0,-3.0,2
12153,12153,2001-02,2001,2002,Newcastle,Man United,Win,Home,2001-09-15,3,4,5,8,9,4,5,8,8,0,0,0,1,1,11.0,1.0,10.0,2
12154,12154,2001-02,2001,2002,Newcastle,West Ham,Loss,Away,2001-09-23,0,6,7,8,11,1,2,2,2,5,5,6,9,0,11.0,15.0,-4.0,2
12155,12155,2001-02,2001,2002,Newcastle,Leicester,Win,Home,2001-09-26,3,3,6,7,8,1,4,5,5,2,2,2,3,1,11.0,13.0,-2.0,2
12156,12156,2001-02,2001,2002,Newcastle,Liverpool,Loss,Home,2001-09-30,0,3,6,9,10,6,6,6,9,-3,0,3,1,1,11.0,3.0,8.0,2
12157,12157,2001-02,2001,2002,Newcastle,Bolton,Win,Away,2001-10-13,3,3,3,6,9,1,2,2,3,2,1,4,6,0,11.0,21.0,-10.0,3
12158,12158,2001-02,2001,2002,Newcastle,Tottenham,Loss,Home,2001-10-21,0,3,6,6,9,3,3,6,6,0,3,0,3,1,11.0,12.0,-1.0,3
12159,12159,2001-02,2001,2002,Newcastle,Everton,Win,Away,2001-10-27,3,3,3,6,6,4,7,7,7,-1,-4,-1,-1,0,11.0,16.0,-5.0,3
12160,12160,2001-02,2001,2002,Newcastle,Aston Villa,Win,Home,2001-11-03,3,3,6,6,9,6,6,9,12,-3,0,-3,-3,1,11.0,8.0,3.0,4
12161,12161,2001-02,2001,2002,Newcastle,Fulham,Loss,Away,2001-11-17,0,6,6,9,9,6,7,7,8,0,-1,2,1,0,11.0,21.0,-10.0,4
12162,12162,2001-02,2001,2002,Newcastle,Derby,Win,Home,2001-11-24,3,3,6,6,9,3,4,5,5,0,2,1,4,1,11.0,17.0,-6.0,4
12163,12163,2001-02,2001,2002,Newcastle,Charlton,Draw,Away,2001-12-01,1,3,6,9,9,1,4,4,4,2,2,5,5,0,11.0,9.0,2.0,5
12164,12164,2001-02,2001,2002,Newcastle,Ipswich,Win,Away,2001-12-09,3,4,4,7,10,1,1,1,1,3,3,6,9,0,11.0,5.0,6.0,5
12165,12165,2001-02,2001,2002,Newcastle,Blackburn,Win,Home,2001-12-15,3,4,7,7,10,0,1,2,5,4,6,5,5,1,11.0,21.0,-10.0,5
12166,12166,2001-02,2001,2002,Newcastle,Arsenal,Win,Away,2001-12-18,3,6,7,10,10,4,7,10,11,2,0,0,-1,0,11.0,2.0,9.0,5
12167,12167,2001-02,2001,2002,Newcastle,Leeds,Win,Away,2001-12-22,3,6,9,10,13,4,7,8,9,2,2,2,4,0,11.0,4.0,7.0,5
12168,12168,2001-02,2001,2002,Newcastle,Middlesbrough,Win,Home,2001-12-26,3,6,9,12,13,0,3,4,5,6,6,8,8,1,11.0,14.0,-3.0,5
12169,12169,2001-02,2001,2002,Newcastle,Chelsea,Loss,Home,2001-12-29,0,6,9,12,15,3,6,7,7,3,3,5,8,1,11.0,6.0,5.0,5
12170,12170,2001-02,2001,2002,Newcastle,Man United,Loss,Away,2002-01-02,0,3,6,9,12,6,9,12,15,-3,-3,-3,-3,0,11.0,1.0,10.0,6
12171,12171,2001-02,2001,2002,Newcastle,Leeds,Win,Home,2002-01-12,3,0,3,6,9,6,9,9,12,-6,-6,-3,-3,1,11.0,4.0,7.0,6
12172,12172,2001-02,2001,2002,Newcastle,Leicester,Draw,Away,2002-01-19,1,3,3,6,9,1,1,2,3,2,2,4,6,0,11.0,13.0,-2.0,6
12173,12173,2001-02,2001,2002,Newcastle,Tottenham,Win,Away,2002-01-30,3,4,4,4,7,1,4,5,5,3,0,-1,2,0,11.0,12.0,-1.0,6
12174,12174,2001-02,2001,2002,Newcastle,Bolton,Win,Home,2002-02-02,3,4,7,7,7,1,2,3,4,3,5,4,3,1,11.0,21.0,-10.0,7
12175,12175,2001-02,2001,2002,Newcastle,Southampton,Win,Home,2002-02-09,3,6,7,10,10,4,5,5,8,2,2,5,2,1,11.0,10.0,1.0,7
12176,12176,2001-02,2001,2002,Newcastle,Sunderland,Win,Away,2002-02-24,3,6,9,10,13,3,3,4,4,3,6,6,9,0,11.0,7.0,4.0,7
12177,12177,2001-02,2001,2002,Newcastle,Arsenal,Loss,Home,2002-03-02,0,6,9,12,13,6,7,10,13,0,2,2,0,1,11.0,2.0,9.0,8
12178,12178,2001-02,2001,2002,Newcastle,Liverpool,Loss,Away,2002-03-06,0,3,6,9,12,4,7,10,13,-1,-1,-1,-1,0,11.0,3.0,8.0,8
12179,12179,2001-02,2001,2002,Newcastle,Ipswich,Draw,Home,2002-03-16,1,0,3,6,9,0,0,0,3,0,3,6,6,1,11.0,5.0,6.0,8
12180,12180,2001-02,2001,2002,Newcastle,Everton,Win,Home,2002-03-29,3,1,1,4,7,6,6,7,8,-5,-5,-3,-1,1,11.0,16.0,-5.0,8
12181,12181,2001-02,2001,2002,Newcastle,Aston Villa,Draw,Away,2002-04-02,1,4,4,4,7,1,1,1,4,3,3,3,3,0,11.0,8.0,3.0,9
12182,12182,2001-02,2001,2002,Newcastle,Fulham,Draw,Home,2002-04-08,1,4,5,5,5,1,1,1,1,3,4,4,4,1,11.0,21.0,-10.0,9
12183,12183,2001-02,2001,2002,Newcastle,Derby,Win,Away,2002-04-13,3,2,5,6,6,0,0,0,3,2,5,6,3,0,11.0,17.0,-6.0,9
12184,12184,2001-02,2001,2002,Newcastle,Charlton,Win,Home,2002-04-20,3,4,5,8,9,1,1,1,1,3,4,7,8,1,11.0,9.0,2.0,9
12185,12185,2001-02,2001,2002,Newcastle,Blackburn,Draw,Away,2002-04-23,1,6,7,8,11,4,7,7,7,2,0,1,4,0,11.0,21.0,-10.0,9
12186,12186,2001-02,2001,2002,Newcastle,West Ham,Win,Home,2002-04-27,3,4,7,8,9,3,4,7,10,1,3,1,-1,1,11.0,15.0,-4.0,9
12187,12187,2001-02,2001,2002,Newcastle,Southampton,Loss,Away,2002-05-11,0,4,7,10,11,0,1,4,4,4,6,6,7,0,11.0,10.0,1.0,10
12188,12188,2002-03,2002,2003,Newcastle,West Ham,Win,Home,2002-08-19,3,3,4,7,10,3,3,6,7,0,1,1,3,1,4.0,7.0,-3.0,1
12189,12189,2002-03,2002,2003,Newcastle,Man City,Loss,Away,2002-08-24,0,3,6,7,10,0,0,3,4,3,6,4,6,0,4.0,21.0,-17.0,1
12190,12190,2002-03,2002,2003,Newcastle,Liverpool,Draw,Away,2002-09-02,1,3,3,6,7,4,7,10,13,-1,-4,-4,-6,0,4.0,2.0,2.0,2
12191,12191,2002-03,2002,2003,Newcastle,Leeds,Loss,Home,2002-09-11,0,1,4,4,7,0,3,6,9,1,1,-2,-2,1,4.0,5.0,-1.0,2
12192,12192,2002-03,2002,2003,Newcastle,Chelsea,Loss,Away,2002-09-14,0,1,1,4,4,4,5,6,9,-3,-4,-2,-5,0,4.0,6.0,-2.0,2
12193,12193,2002-03,2002,2003,Newcastle,Sunderland,Win,Home,2002-09-21,3,0,1,1,4,0,1,4,4,0,0,-3,0,1,4.0,17.0,-13.0,2
12194,12194,2002-03,2002,2003,Newcastle,Birmingham,Win,Away,2002-09-28,3,3,3,4,4,3,4,7,8,0,-1,-3,-4,0,4.0,21.0,-17.0,2
12195,12195,2002-03,2002,2003,Newcastle,West Brom,Win,Home,2002-10-05,3,6,6,6,7,0,3,6,9,6,3,0,-2,1,4.0,21.0,-17.0,3
12196,12196,2002-03,2002,2003,Newcastle,Blackburn,Loss,Away,2002-10-19,0,6,9,9,9,3,6,7,7,3,3,2,2,0,4.0,10.0,-6.0,3
12197,12197,2002-03,2002,2003,Newcastle,Charlton,Win,Home,2002-10-26,3,3,6,9,9,3,3,4,4,0,3,5,5,1,4.0,14.0,-10.0,3
12198,12198,2002-03,2002,2003,Newcastle,Middlesbrough,Win,Home,2002-11-04,3,3,6,9,12,1,4,7,10,2,2,2,2,1,4.0,12.0,-8.0,4
12199,12199,2002-03,2002,2003,Newcastle,Arsenal,Loss,Away,2002-11-09,0,6,6,9,12,3,3,6,9,3,3,3,3,0,4.0,1.0,3.0,4
12200,12200,2002-03,2002,2003,Newcastle,Southampton,Win,Home,2002-11-16,3,3,6,6,9,1,4,7,10,2,2,-1,-1,1,4.0,11.0,-7.0,4
12201,12201,2002-03,2002,2003,Newcastle,Man United,Loss,Away,2002-11-23,0,3,6,9,9,1,4,5,6,2,2,4,3,0,4.0,3.0,1.0,4
12202,12202,2002-03,2002,2003,Newcastle,Everton,Win,Home,2002-12-01,3,3,3,6,9,6,9,12,15,-3,-6,-6,-6,1,4.0,15.0,-11.0,5
12203,12203,2002-03,2002,2003,Newcastle,Aston Villa,Win,Away,2002-12-07,3,3,6,6,9,3,4,7,8,0,2,-1,1,0,4.0,8.0,-4.0,5
12204,12204,2002-03,2002,2003,Newcastle,Southampton,Draw,Away,2002-12-14,1,6,6,9,9,6,9,9,10,0,-3,0,-1,0,4.0,11.0,-7.0,5
12205,12205,2002-03,2002,2003,Newcastle,Fulham,Win,Home,2002-12-21,3,4,7,7,10,3,3,6,7,1,4,1,3,1,4.0,13.0,-9.0,5
12206,12206,2002-03,2002,2003,Newcastle,Bolton,Loss,Away,2002-12-26,0,4,7,10,10,1,2,2,3,3,5,8,7,0,4.0,16.0,-12.0,5
12207,12207,2002-03,2002,2003,Newcastle,Tottenham,Win,Home,2002-12-29,3,3,4,7,10,4,5,8,9,-1,-1,-1,1,1,4.0,9.0,-5.0,5
12208,12208,2002-03,2002,2003,Newcastle,Liverpool,Win,Home,2003-01-01,3,3,6,7,10,2,3,3,3,1,3,4,7,1,4.0,2.0,2.0,6
12209,12209,2002-03,2002,2003,Newcastle,West Ham,Draw,Away,2003-01-11,1,6,6,9,10,2,3,3,4,4,3,6,6,0,4.0,7.0,-3.0,6
12210,12210,2002-03,2002,2003,Newcastle,Man City,Win,Home,2003-01-18,3,4,7,7,10,4,7,10,10,0,0,-3,0,1,4.0,21.0,-17.0,6
12211,12211,2002-03,2002,2003,Newcastle,Bolton,Win,Home,2003-01-22,3,4,7,10,10,2,2,3,6,2,5,7,4,1,4.0,16.0,-12.0,6
12212,12212,2002-03,2002,2003,Newcastle,Tottenham,Win,Away,2003-01-29,3,6,7,10,13,6,6,6,7,0,1,4,6,0,4.0,9.0,-5.0,6
12213,12213,2002-03,2002,2003,Newcastle,Arsenal,Draw,Home,2003-02-09,1,6,9,10,13,4,7,10,13,2,2,0,0,1,4.0,1.0,3.0,7
12214,12214,2002-03,2002,2003,Newcastle,Leeds,Win,Away,2003-02-22,3,4,7,10,11,3,3,4,4,1,4,6,7,0,4.0,5.0,-1.0,7
12215,12215,2002-03,2002,2003,Newcastle,Chelsea,Win,Home,2003-03-01,3,4,7,10,13,3,4,7,7,1,3,3,6,1,4.0,6.0,-2.0,8
12216,12216,2002-03,2002,2003,Newcastle,Middlesbrough,Loss,Away,2003-03-05,0,6,7,10,13,4,5,5,5,2,2,5,8,0,4.0,12.0,-8.0,8
12217,12217,2002-03,2002,2003,Newcastle,Charlton,Win,Away,2003-03-15,3,3,6,7,10,3,6,9,12,0,0,-2,-2,0,4.0,14.0,-10.0,8
12218,12218,2002-03,2002,2003,Newcastle,Blackburn,Win,Home,2003-03-22,3,3,6,9,10,6,9,12,12,-3,-3,-3,-2,1,4.0,10.0,-6.0,8
12219,12219,2002-03,2002,2003,Newcastle,Everton,Loss,Away,2003-04-06,0,6,6,9,12,1,2,5,5,5,4,4,7,0,4.0,15.0,-11.0,9
12220,12220,2002-03,2002,2003,Newcastle,Man United,Loss,Home,2003-04-12,0,3,6,6,9,6,9,12,13,-3,-3,-6,-4,1,4.0,3.0,1.0,9
12221,12221,2002-03,2002,2003,Newcastle,Fulham,Loss,Away,2003-04-19,0,0,3,6,6,0,0,1,4,0,3,5,2,0,4.0,13.0,-9.0,9
12222,12222,2002-03,2002,2003,Newcastle,Aston Villa,Draw,Home,2003-04-21,1,0,0,3,6,4,5,6,6,-4,-5,-3,0,1,4.0,8.0,-4.0,9
12223,12223,2002-03,2002,2003,Newcastle,Sunderland,Win,Away,2003-04-26,3,1,1,1,4,0,0,0,0,1,1,1,4,0,4.0,17.0,-13.0,9
12224,12224,2002-03,2002,2003,Newcastle,Birmingham,Win,Home,2003-05-03,3,4,4,4,4,6,9,12,12,-2,-5,-8,-8,1,4.0,21.0,-17.0,10
12225,12225,2002-03,2002,2003,Newcastle,West Brom,Draw,Away,2003-05-11,1,6,7,7,7,1,1,4,4,5,6,3,3,0,4.0,21.0,-17.0,10
12226,12226,2003-04,2003,2004,Newcastle,Leeds,Draw,Away,2003-08-17,1,4,7,8,8,6,6,9,9,-2,1,-1,-1,0,3.0,15.0,-12.0,1
12227,12227,2003-04,2003,2004,Newcastle,Man United,Loss,Home,2003-08-23,0,2,5,8,9,6,9,12,15,-4,-4,-4,-6,1,3.0,1.0,2.0,1
12228,12228,2003-04,2003,2004,Newcastle,Birmingham,Loss,Home,2003-08-30,0,1,2,5,8,4,5,5,8,-3,-3,0,0,1,3.0,13.0,-10.0,1
12229,12229,2003-04,2003,2004,Newcastle,Everton,Draw,Away,2003-09-13,1,0,1,2,5,1,4,4,4,-1,-3,-2,1,0,3.0,7.0,-4.0,2
12230,12230,2003-04,2003,2004,Newcastle,Bolton,Draw,Home,2003-09-20,1,1,1,2,3,4,4,5,5,-3,-3,-3,-2,1,3.0,17.0,-14.0,2
12231,12231,2003-04,2003,2004,Newcastle,Arsenal,Loss,Away,2003-09-26,0,2,2,2,3,2,5,8,11,0,-3,-6,-8,0,3.0,2.0,1.0,2
12232,12232,2003-04,2003,2004,Newcastle,Southampton,Win,Home,2003-10-04,3,1,2,2,2,3,6,9,10,-2,-4,-7,-8,1,3.0,8.0,-5.0,3
12233,12233,2003-04,2003,2004,Newcastle,Middlesbrough,Win,Away,2003-10-18,3,3,4,5,5,3,6,6,6,0,-2,-1,-1,0,3.0,11.0,-8.0,3
12234,12234,2003-04,2003,2004,Newcastle,Fulham,Win,Away,2003-10-21,3,6,6,7,8,4,7,8,9,2,-1,-1,-1,0,3.0,14.0,-11.0,3
12235,12235,2003-04,2003,2004,Newcastle,Portsmouth,Win,Home,2003-10-25,3,6,9,9,10,3,3,3,4,3,6,6,6,1,3.0,21.0,-18.0,3
12236,12236,2003-04,2003,2004,Newcastle,Aston Villa,Draw,Home,2003-11-01,1,6,9,12,12,2,3,3,6,4,6,9,6,1,3.0,16.0,-13.0,4
12237,12237,2003-04,2003,2004,Newcastle,Chelsea,Loss,Away,2003-11-09,0,4,7,10,13,6,6,7,10,-2,1,3,3,0,3.0,4.0,-1.0,4
12238,12238,2003-04,2003,2004,Newcastle,Man City,Win,Home,2003-11-22,3,1,4,7,10,3,3,6,6,-2,1,1,4,1,3.0,9.0,-6.0,4
12239,12239,2003-04,2003,2004,Newcastle,Wolves,Draw,Away,2003-11-29,1,3,4,7,10,1,1,4,5,2,3,3,5,0,3.0,21.0,-18.0,4
12240,12240,2003-04,2003,2004,Newcastle,Liverpool,Draw,Home,2003-12-06,1,4,4,5,8,4,4,7,10,0,0,-2,-2,1,3.0,5.0,-2.0,5
12241,12241,2003-04,2003,2004,Newcastle,Tottenham,Win,Home,2003-12-13,3,2,5,5,6,3,6,6,6,-1,-1,-1,0,1,3.0,10.0,-7.0,5
12242,12242,2003-04,2003,2004,Newcastle,Charlton,Draw,Away,2003-12-20,1,4,5,8,8,1,1,2,5,3,4,6,3,0,3.0,12.0,-9.0,5
12243,12243,2003-04,2003,2004,Newcastle,Leicester,Draw,Away,2003-12-26,1,4,5,6,9,0,1,4,5,4,4,2,4,0,3.0,21.0,-18.0,5
12244,12244,2003-04,2003,2004,Newcastle,Blackburn,Loss,Home,2003-12-28,0,2,5,6,7,1,1,4,7,1,4,2,0,1,3.0,6.0,-3.0,5
12245,12245,2003-04,2003,2004,Newcastle,Leeds,Win,Home,2004-01-07,3,1,2,5,6,1,2,5,6,0,0,0,0,1,3.0,15.0,-12.0,6
12246,12246,2003-04,2003,2004,Newcastle,Man United,Draw,Away,2004-01-11,1,3,4,5,8,6,9,12,15,-3,-5,-7,-7,0,3.0,1.0,2.0,6
12247,12247,2003-04,2003,2004,Newcastle,Fulham,Win,Home,2004-01-19,3,4,4,5,6,3,3,6,6,1,1,-1,0,1,3.0,14.0,-11.0,6
12248,12248,2003-04,2003,2004,Newcastle,Birmingham,Draw,Away,2004-01-31,1,4,7,7,8,4,4,4,7,0,3,3,1,0,3.0,13.0,-10.0,6
12249,12249,2003-04,2003,2004,Newcastle,Leicester,Win,Home,2004-02-07,3,4,5,8,8,1,1,2,3,3,4,6,5,1,3.0,21.0,-18.0,7
12250,12250,2003-04,2003,2004,Newcastle,Blackburn,Draw,Away,2004-02-11,1,4,7,8,11,3,4,4,5,1,3,4,6,0,3.0,6.0,-3.0,7
12251,12251,2003-04,2003,2004,Newcastle,Middlesbrough,Win,Home,2004-02-21,3,4,5,8,9,3,6,7,7,1,-1,1,2,1,3.0,11.0,-8.0,7
12252,12252,2003-04,2003,2004,Newcastle,Portsmouth,Draw,Away,2004-02-29,1,4,7,8,11,0,1,1,4,4,6,7,7,0,3.0,21.0,-18.0,7
12253,12253,2003-04,2003,2004,Newcastle,Tottenham,Loss,Away,2004-03-14,0,4,5,8,9,1,4,7,7,3,1,1,2,0,3.0,10.0,-7.0,8
12254,12254,2003-04,2003,2004,Newcastle,Charlton,Win,Home,2004-03-20,3,1,4,5,8,3,6,6,6,-2,-2,-1,2,1,3.0,12.0,-9.0,8
12255,12255,2003-04,2003,2004,Newcastle,Bolton,Loss,Away,2004-03-28,0,3,4,7,8,0,0,0,1,3,4,7,7,0,3.0,17.0,-14.0,8
12256,12256,2003-04,2003,2004,Newcastle,Everton,Win,Home,2004-04-03,3,3,3,4,7,2,5,8,9,1,-2,-4,-2,1,3.0,7.0,-4.0,9
12257,12257,2003-04,2003,2004,Newcastle,Arsenal,Draw,Home,2004-04-11,1,3,6,6,7,4,7,10,13,-1,-1,-4,-6,1,3.0,2.0,1.0,9
12258,12258,2003-04,2003,2004,Newcastle,Aston Villa,Draw,Away,2004-04-18,1,4,4,7,7,4,5,8,8,0,-1,-1,-1,0,3.0,16.0,-13.0,9
12259,12259,2003-04,2003,2004,Newcastle,Chelsea,Win,Home,2004-04-25,3,2,5,5,8,1,2,5,8,1,3,0,0,1,3.0,4.0,-1.0,9
12260,12260,2003-04,2003,2004,Newcastle,Man City,Loss,Away,2004-05-01,0,4,5,8,8,1,2,3,4,3,3,5,4,0,3.0,9.0,-6.0,10
12261,12261,2003-04,2003,2004,Newcastle,Wolves,Draw,Home,2004-05-09,1,3,4,5,8,4,7,7,8,-1,-3,-2,0,1,3.0,21.0,-18.0,10
12262,12262,2003-04,2003,2004,Newcastle,Southampton,Draw,Away,2004-05-12,1,1,4,5,6,1,1,4,4,0,3,1,2,0,3.0,8.0,-5.0,10
12263,12263,2003-04,2003,2004,Newcastle,Liverpool,Draw,Away,2004-05-15,1,2,2,5,6,6,9,10,10,-4,-7,-5,-4,0,3.0,5.0,-2.0,10
12264,12264,2004-05,2004,2005,Newcastle,Middlesbrough,Draw,Away,2004-08-14,1,2,3,3,6,3,3,3,3,-1,0,0,3,0,5.0,11.0,-6.0,1
12265,12265,2004-05,2004,2005,Newcastle,Tottenham,Loss,Home,2004-08-21,0,2,3,4,4,4,7,7,8,-2,-4,-3,-4,1,5.0,14.0,-9.0,1
12266,12266,2004-05,2004,2005,Newcastle,Norwich,Draw,Home,2004-08-25,1,1,2,3,4,1,2,2,2,0,0,1,2,1,5.0,21.0,-16.0,1
12267,12267,2004-05,2004,2005,Newcastle,Aston Villa,Loss,Away,2004-08-28,0,1,2,3,4,1,4,4,5,0,-2,-1,-1,0,5.0,6.0,-1.0,1
12268,12268,2004-05,2004,2005,Newcastle,Blackburn,Win,Home,2004-09-11,3,1,1,2,3,1,1,2,3,0,0,0,0,1,5.0,15.0,-10.0,2
12269,12269,2004-05,2004,2005,Newcastle,Southampton,Win,Away,2004-09-19,3,3,4,4,5,1,1,4,4,2,3,0,1,0,5.0,12.0,-7.0,2
12270,12270,2004-05,2004,2005,Newcastle,West Brom,Win,Home,2004-09-25,3,6,6,7,7,1,1,2,3,5,5,5,4,1,5.0,21.0,-16.0,2
12271,12271,2004-05,2004,2005,Newcastle,Birmingham,Draw,Away,2004-10-03,1,6,9,9,10,2,2,2,5,4,7,7,5,0,5.0,10.0,-5.0,3
12272,12272,2004-05,2004,2005,Newcastle,Charlton,Draw,Away,2004-10-17,1,4,7,10,10,3,4,5,5,1,3,5,5,0,5.0,7.0,-2.0,3
12273,12273,2004-05,2004,2005,Newcastle,Man City,Win,Home,2004-10-24,3,2,5,8,11,4,4,7,7,-2,1,1,4,1,5.0,16.0,-11.0,3
12274,12274,2004-05,2004,2005,Newcastle,Bolton,Loss,Away,2004-10-31,0,4,5,8,11,6,6,7,8,-2,-1,1,3,0,5.0,8.0,-3.0,3
12275,12275,2004-05,2004,2005,Newcastle,Fulham,Loss,Home,2004-11-07,0,3,4,5,8,3,3,3,6,0,1,2,2,1,5.0,9.0,-4.0,4
12276,12276,2004-05,2004,2005,Newcastle,Man United,Loss,Home,2004-11-14,0,0,3,4,5,1,4,5,6,-1,-1,-1,-1,1,5.0,3.0,2.0,4
12277,12277,2004-05,2004,2005,Newcastle,Crystal Palace,Win,Away,2004-11-20,3,0,0,3,4,1,4,7,7,-1,-4,-4,-3,0,5.0,21.0,-16.0,4
12278,12278,2004-05,2004,2005,Newcastle,Everton,Draw,Home,2004-11-28,1,3,3,3,6,6,6,7,10,-3,-3,-4,-4,1,5.0,17.0,-12.0,4
12279,12279,2004-05,2004,2005,Newcastle,Chelsea,Loss,Away,2004-12-04,0,4,4,4,4,4,7,10,13,0,-3,-6,-9,0,5.0,2.0,3.0,5
12280,12280,2004-05,2004,2005,Newcastle,Portsmouth,Draw,Home,2004-12-11,1,1,4,4,4,6,6,6,6,-5,-2,-2,-2,1,5.0,13.0,-8.0,5
12281,12281,2004-05,2004,2005,Newcastle,Liverpool,Loss,Away,2004-12-19,0,1,2,5,5,1,2,5,5,0,0,0,0,0,5.0,4.0,1.0,5
12282,12282,2004-05,2004,2005,Newcastle,Blackburn,Draw,Away,2004-12-26,1,1,1,2,5,2,2,5,6,-1,-1,-3,-1,0,5.0,15.0,-10.0,5
12283,12283,2004-05,2004,2005,Newcastle,Arsenal,Loss,Home,2004-12-29,0,1,2,2,3,6,7,10,10,-5,-5,-8,-7,1,5.0,1.0,4.0,5
12284,12284,2004-05,2004,2005,Newcastle,Birmingham,Win,Home,2005-01-01,3,1,1,2,2,6,9,12,12,-5,-8,-10,-10,1,5.0,10.0,-5.0,6
12285,12285,2004-05,2004,2005,Newcastle,West Brom,Draw,Away,2005-01-03,1,3,4,4,5,2,2,2,2,1,2,2,3,0,5.0,21.0,-16.0,6
12286,12286,2004-05,2004,2005,Newcastle,Southampton,Win,Home,2005-01-15,3,4,4,5,5,1,1,2,2,3,3,3,3,1,5.0,12.0,-7.0,6
12287,12287,2004-05,2004,2005,Newcastle,Arsenal,Loss,Away,2005-01-23,0,4,7,7,8,1,4,7,10,3,3,0,-2,0,5.0,1.0,4.0,6
12288,12288,2004-05,2004,2005,Newcastle,Man City,Draw,Away,2005-02-02,1,3,4,7,7,3,4,7,8,0,0,0,-1,0,5.0,16.0,-11.0,7
12289,12289,2004-05,2004,2005,Newcastle,Charlton,Draw,Home,2005-02-05,1,1,4,5,8,3,6,6,6,-2,-2,-1,2,1,5.0,7.0,-2.0,7
12290,12290,2004-05,2004,2005,Newcastle,Bolton,Win,Home,2005-02-27,3,2,2,5,6,4,7,10,13,-2,-5,-5,-7,1,5.0,8.0,-3.0,7
12291,12291,2004-05,2004,2005,Newcastle,Liverpool,Win,Home,2005-03-05,3,4,5,5,8,3,6,6,6,1,-1,-1,2,1,5.0,4.0,1.0,8
12292,12292,2004-05,2004,2005,Newcastle,Portsmouth,Draw,Away,2005-03-19,1,6,7,8,8,0,0,0,3,6,7,8,5,0,5.0,13.0,-8.0,8
12293,12293,2004-05,2004,2005,Newcastle,Aston Villa,Loss,Home,2005-04-02,0,4,7,8,9,3,3,6,6,1,4,2,3,1,5.0,6.0,-1.0,9
12294,12294,2004-05,2004,2005,Newcastle,Tottenham,Loss,Away,2005-04-10,0,1,4,7,8,4,4,4,7,-3,0,3,1,0,5.0,14.0,-9.0,9
12295,12295,2004-05,2004,2005,Newcastle,Norwich,Loss,Away,2005-04-20,0,0,1,4,7,4,4,4,4,-4,-3,0,3,0,5.0,21.0,-16.0,9
12296,12296,2004-05,2004,2005,Newcastle,Man United,Loss,Away,2005-04-24,0,0,0,1,4,0,1,4,5,0,-1,-3,-1,0,5.0,3.0,2.0,9
12297,12297,2004-05,2004,2005,Newcastle,Middlesbrough,Draw,Home,2005-04-27,1,0,0,0,1,4,4,7,7,-4,-4,-7,-6,1,5.0,11.0,-6.0,9
12298,12298,2004-05,2004,2005,Newcastle,Crystal Palace,Draw,Home,2005-04-30,1,1,1,1,1,3,4,4,4,-2,-3,-3,-3,1,5.0,21.0,-16.0,9
12299,12299,2004-05,2004,2005,Newcastle,Fulham,Win,Away,2005-05-04,3,2,2,2,2,3,4,5,5,-1,-2,-3,-3,0,5.0,9.0,-4.0,10
12300,12300,2004-05,2004,2005,Newcastle,Everton,Loss,Away,2005-05-07,0,4,5,5,5,1,4,7,7,3,1,-2,-2,0,5.0,17.0,-12.0,10
12301,12301,2004-05,2004,2005,Newcastle,Chelsea,Draw,Home,2005-05-15,1,3,4,5,5,6,9,12,13,-3,-5,-7,-8,1,5.0,2.0,3.0,10
12302,12302,2005-06,2005,2006,Newcastle,Arsenal,Loss,Away,2005-08-14,0,1,4,5,6,3,6,9,12,-2,-2,-4,-6,0,14.0,2.0,12.0,1
12303,12303,2005-06,2005,2006,Newcastle,West Ham,Draw,Home,2005-08-20,1,1,1,4,5,4,7,10,13,-3,-6,-6,-8,1,14.0,21.0,-7.0,1
12304,12304,2005-06,2005,2006,Newcastle,Bolton,Loss,Away,2005-08-24,0,1,2,2,5,1,4,5,5,0,-2,-3,0,0,14.0,6.0,8.0,1
12305,12305,2005-06,2005,2006,Newcastle,Man United,Loss,Home,2005-08-28,0,1,1,2,2,6,9,9,10,-5,-8,-7,-8,1,14.0,3.0,11.0,1
12306,12306,2005-06,2005,2006,Newcastle,Fulham,Draw,Home,2005-09-10,1,0,1,1,2,3,3,4,7,-3,-2,-3,-5,1,14.0,13.0,1.0,2
12307,12307,2005-06,2005,2006,Newcastle,Blackburn,Win,Away,2005-09-18,3,1,1,2,2,1,2,5,5,0,-1,-3,-3,0,14.0,15.0,-1.0,2
12308,12308,2005-06,2005,2006,Newcastle,Man City,Win,Home,2005-09-24,3,4,4,4,5,1,4,7,10,3,0,-3,-5,1,14.0,8.0,6.0,2
12309,12309,2005-06,2005,2006,Newcastle,Portsmouth,Draw,Away,2005-10-01,1,6,7,7,7,1,4,4,5,5,3,3,2,0,14.0,16.0,-2.0,3
12310,12310,2005-06,2005,2006,Newcastle,Wigan,Loss,Away,2005-10-15,0,4,7,8,8,6,7,10,13,-2,0,-2,-5,0,14.0,21.0,-7.0,3
12311,12311,2005-06,2005,2006,Newcastle,Sunderland,Win,Home,2005-10-23,3,1,4,7,8,1,4,5,5,0,0,2,3,1,14.0,21.0,-7.0,3
12312,12312,2005-06,2005,2006,Newcastle,West Brom,Win,Away,2005-10-30,3,3,4,7,10,3,3,3,4,0,1,4,6,0,14.0,17.0,-3.0,3
12313,12313,2005-06,2005,2006,Newcastle,Birmingham,Win,Home,2005-11-05,3,6,6,7,10,0,0,0,1,6,6,7,9,1,14.0,12.0,2.0,4
12314,12314,2005-06,2005,2006,Newcastle,Chelsea,Loss,Away,2005-11-19,0,6,9,9,10,3,4,7,10,3,5,2,0,0,14.0,1.0,13.0,4
12315,12315,2005-06,2005,2006,Newcastle,Everton,Loss,Away,2005-11-27,0,3,6,9,9,3,6,7,7,0,0,2,2,0,14.0,4.0,10.0,4
12316,12316,2005-06,2005,2006,Newcastle,Aston Villa,Draw,Home,2005-12-03,1,0,3,6,9,6,6,6,6,-6,-3,0,3,1,14.0,10.0,4.0,5
12317,12317,2005-06,2005,2006,Newcastle,Arsenal,Win,Home,2005-12-10,3,1,1,4,7,3,6,9,10,-2,-5,-5,-3,1,14.0,2.0,12.0,5
12318,12318,2005-06,2005,2006,Newcastle,West Ham,Win,Away,2005-12-17,3,4,4,4,7,3,6,6,7,1,-2,-2,0,0,14.0,21.0,-7.0,5
12319,12319,2005-06,2005,2006,Newcastle,Liverpool,Loss,Away,2005-12-26,0,6,7,7,7,6,9,12,15,0,-2,-5,-8,0,14.0,5.0,9.0,5
12320,12320,2005-06,2005,2006,Newcastle,Tottenham,Loss,Away,2005-12-31,0,3,6,7,7,3,4,7,10,0,2,0,-3,0,14.0,9.0,5.0,5
12321,12321,2005-06,2005,2006,Newcastle,Middlesbrough,Draw,Home,2006-01-02,1,0,3,6,7,1,2,2,2,-1,1,4,5,1,14.0,7.0,7.0,6
12322,12322,2005-06,2005,2006,Newcastle,Fulham,Loss,Away,2006-01-14,0,1,1,4,7,3,4,4,7,-2,-3,0,0,0,14.0,13.0,1.0,6
12323,12323,2005-06,2005,2006,Newcastle,Blackburn,Loss,Home,2006-01-21,0,1,1,1,4,4,7,10,10,-3,-6,-9,-6,1,14.0,15.0,-1.0,6
12324,12324,2005-06,2005,2006,Newcastle,Man City,Loss,Away,2006-02-01,0,0,1,1,1,3,3,4,4,-3,-2,-3,-3,0,14.0,8.0,6.0,7
12325,12325,2005-06,2005,2006,Newcastle,Portsmouth,Win,Home,2006-02-04,3,0,0,1,1,1,1,1,4,-1,-1,0,-3,1,14.0,16.0,-2.0,7
12326,12326,2005-06,2005,2006,Newcastle,Aston Villa,Win,Away,2006-02-11,3,3,3,3,4,4,5,5,8,-1,-2,-2,-4,0,14.0,10.0,4.0,7
12327,12327,2005-06,2005,2006,Newcastle,Charlton,Draw,Home,2006-02-22,1,6,6,6,6,3,3,4,5,3,3,2,1,1,14.0,11.0,3.0,7
12328,12328,2005-06,2005,2006,Newcastle,Everton,Win,Home,2006-02-25,3,4,7,7,7,6,7,10,13,-2,0,-3,-6,1,14.0,4.0,10.0,7
12329,12329,2005-06,2005,2006,Newcastle,Bolton,Win,Home,2006-03-04,3,4,7,10,10,4,5,6,9,0,2,4,1,1,14.0,6.0,8.0,8
12330,12330,2005-06,2005,2006,Newcastle,Man United,Loss,Away,2006-03-12,0,6,7,10,13,6,9,9,12,0,-2,1,1,0,14.0,3.0,11.0,8
12331,12331,2005-06,2005,2006,Newcastle,Liverpool,Loss,Home,2006-03-19,0,3,6,7,10,3,4,7,10,0,2,0,0,1,14.0,5.0,9.0,8
12332,12332,2005-06,2005,2006,Newcastle,Charlton,Loss,Away,2006-03-26,0,0,3,6,7,3,4,5,6,-3,-1,1,1,0,14.0,11.0,3.0,8
12333,12333,2005-06,2005,2006,Newcastle,Tottenham,Win,Home,2006-04-01,3,0,0,3,6,6,6,9,10,-6,-6,-6,-4,1,14.0,9.0,5.0,9
12334,12334,2005-06,2005,2006,Newcastle,Middlesbrough,Win,Away,2006-04-09,3,3,3,3,6,6,6,6,9,-3,-3,-3,-3,0,14.0,7.0,7.0,9
12335,12335,2005-06,2005,2006,Newcastle,Wigan,Win,Home,2006-04-15,3,6,6,6,6,2,2,5,8,4,4,1,-2,1,14.0,21.0,-7.0,9
12336,12336,2005-06,2005,2006,Newcastle,Sunderland,Win,Away,2006-04-17,3,6,9,9,9,2,2,2,2,4,7,7,7,0,14.0,21.0,-7.0,9
12337,12337,2005-06,2005,2006,Newcastle,West Brom,Win,Home,2006-04-22,3,6,9,12,12,1,2,2,2,5,7,10,10,1,14.0,17.0,-3.0,9
12338,12338,2005-06,2005,2006,Newcastle,Birmingham,Draw,Away,2006-04-29,1,6,9,12,15,4,4,5,8,2,5,7,7,0,14.0,12.0,2.0,9
12339,12339,2005-06,2005,2006,Newcastle,Chelsea,Win,Home,2006-05-07,3,4,7,10,13,3,6,9,12,1,1,1,1,1,14.0,1.0,13.0,10
12340,12340,2006-07,2006,2007,Newcastle,Wigan,Win,Home,2006-08-19,3,4,7,10,13,0,0,3,3,4,7,7,10,1,7.0,10.0,-3.0,1
12341,12341,2006-07,2006,2007,Newcastle,Aston Villa,Loss,Away,2006-08-27,0,6,7,10,13,4,7,7,7,2,0,3,6,0,7.0,16.0,-9.0,1
12342,12342,2006-07,2006,2007,Newcastle,Fulham,Loss,Home,2006-09-09,0,3,6,7,10,4,4,7,7,-1,2,0,3,1,7.0,12.0,-5.0,2
12343,12343,2006-07,2006,2007,Newcastle,West Ham,Win,Away,2006-09-17,3,0,3,6,7,1,2,5,8,-1,1,1,-1,0,7.0,9.0,-2.0,2
12344,12344,2006-07,2006,2007,Newcastle,Liverpool,Loss,Away,2006-09-20,0,3,3,6,9,0,3,4,7,3,0,2,2,0,7.0,3.0,4.0,2
12345,12345,2006-07,2006,2007,Newcastle,Everton,Draw,Home,2006-09-24,1,3,3,3,6,4,7,8,11,-1,-4,-5,-5,1,7.0,11.0,-4.0,2
12346,12346,2006-07,2006,2007,Newcastle,Man United,Loss,Away,2006-10-01,0,1,4,4,4,1,4,7,10,0,0,-3,-6,0,7.0,2.0,5.0,3
12347,12347,2006-07,2006,2007,Newcastle,Bolton,Loss,Home,2006-10-15,0,1,1,4,4,6,7,10,10,-5,-6,-6,-6,1,7.0,8.0,-1.0,3
12348,12348,2006-07,2006,2007,Newcastle,Middlesbrough,Loss,Away,2006-10-22,0,0,1,1,4,3,3,4,5,-3,-2,-3,-1,0,7.0,14.0,-7.0,3
12349,12349,2006-07,2006,2007,Newcastle,Charlton,Draw,Home,2006-10-28,1,0,0,1,1,1,1,1,1,-1,-1,0,0,1,7.0,13.0,-6.0,3
12350,12350,2006-07,2006,2007,Newcastle,Sheffield United,Loss,Home,2006-11-04,0,1,1,1,2,0,1,4,4,1,0,-3,-2,1,7.0,21.0,-14.0,4
12351,12351,2006-07,2006,2007,Newcastle,Man City,Draw,Away,2006-11-11,1,1,1,1,1,3,3,4,5,-2,-2,-3,-4,0,7.0,15.0,-8.0,4
12352,12352,2006-07,2006,2007,Newcastle,Arsenal,Draw,Away,2006-11-18,1,1,2,2,2,3,4,7,10,-2,-2,-5,-8,0,7.0,4.0,3.0,4
12353,12353,2006-07,2006,2007,Newcastle,Portsmouth,Win,Home,2006-11-26,3,2,2,3,3,4,4,7,7,-2,-2,-4,-4,1,7.0,17.0,-10.0,4
12354,12354,2006-07,2006,2007,Newcastle,Reading,Win,Home,2006-12-06,3,4,5,5,6,6,9,12,12,-2,-4,-7,-6,1,7.0,21.0,-14.0,5
12355,12355,2006-07,2006,2007,Newcastle,Blackburn,Win,Away,2006-12-09,3,6,7,8,8,3,4,4,4,3,3,4,4,0,7.0,6.0,1.0,5
12356,12356,2006-07,2006,2007,Newcastle,Chelsea,Loss,Away,2006-12-13,0,6,9,10,11,4,5,8,11,2,4,2,0,0,7.0,1.0,6.0,5
12357,12357,2006-07,2006,2007,Newcastle,Watford,Win,Home,2006-12-16,3,3,6,9,10,2,2,2,2,1,4,7,8,1,7.0,21.0,-14.0,5
12358,12358,2006-07,2006,2007,Newcastle,Tottenham,Win,Home,2006-12-23,3,3,6,9,12,6,9,9,12,-3,-3,0,0,1,7.0,5.0,2.0,5
12359,12359,2006-07,2006,2007,Newcastle,Bolton,Loss,Away,2006-12-26,0,6,6,9,12,6,9,9,9,0,-3,0,3,0,7.0,8.0,-1.0,5
12360,12360,2006-07,2006,2007,Newcastle,Everton,Loss,Away,2006-12-30,0,3,6,6,9,4,4,4,7,-1,2,2,2,0,7.0,11.0,-4.0,5
12361,12361,2006-07,2006,2007,Newcastle,Man United,Draw,Home,2007-01-01,1,0,3,6,6,6,9,9,12,-6,-6,-3,-6,1,7.0,2.0,5.0,6
12362,12362,2006-07,2006,2007,Newcastle,Tottenham,Win,Away,2007-01-14,3,1,1,4,7,1,4,4,7,0,-3,0,0,0,7.0,5.0,2.0,6
12363,12363,2006-07,2006,2007,Newcastle,West Ham,Draw,Home,2007-01-20,1,4,4,4,7,1,1,1,2,3,3,3,5,1,7.0,9.0,-2.0,6
12364,12364,2006-07,2006,2007,Newcastle,Aston Villa,Win,Home,2007-01-31,3,4,5,5,5,3,4,4,4,1,1,1,1,1,7.0,16.0,-9.0,6
12365,12365,2006-07,2006,2007,Newcastle,Fulham,Loss,Away,2007-02-03,0,4,7,8,8,1,2,3,4,3,5,5,4,0,7.0,12.0,-5.0,7
12366,12366,2006-07,2006,2007,Newcastle,Liverpool,Win,Home,2007-02-10,3,3,4,7,8,4,7,10,13,-1,-3,-3,-5,1,7.0,3.0,4.0,7
12367,12367,2006-07,2006,2007,Newcastle,Wigan,Loss,Away,2007-02-25,0,3,6,7,10,1,4,4,4,2,2,3,6,0,7.0,10.0,-3.0,7
12368,12368,2006-07,2006,2007,Newcastle,Middlesbrough,Draw,Home,2007-03-03,1,3,3,6,7,3,4,5,8,0,-1,1,-1,1,7.0,14.0,-7.0,8
12369,12369,2006-07,2006,2007,Newcastle,Charlton,Loss,Away,2007-03-18,0,1,4,4,7,4,4,4,5,-3,0,0,2,0,7.0,13.0,-6.0,8
12370,12370,2006-07,2006,2007,Newcastle,Man City,Loss,Home,2007-03-31,0,1,1,4,4,3,3,3,3,-2,-2,1,1,1,7.0,15.0,-8.0,8
12371,12371,2006-07,2006,2007,Newcastle,Sheffield United,Win,Away,2007-04-07,3,0,1,1,4,0,1,1,4,0,0,0,0,0,7.0,21.0,-14.0,9
12372,12372,2006-07,2006,2007,Newcastle,Arsenal,Draw,Home,2007-04-09,1,3,3,4,4,0,0,3,6,3,3,1,-2,1,7.0,4.0,3.0,9
12373,12373,2006-07,2006,2007,Newcastle,Portsmouth,Loss,Away,2007-04-14,0,4,4,4,5,3,4,5,5,1,0,-1,0,0,7.0,17.0,-10.0,9
12374,12374,2006-07,2006,2007,Newcastle,Chelsea,Draw,Home,2007-04-22,1,1,4,4,4,6,9,12,15,-5,-5,-8,-11,1,7.0,1.0,6.0,9
12375,12375,2006-07,2006,2007,Newcastle,Reading,Loss,Away,2007-04-30,0,1,2,5,5,6,7,7,7,-5,-5,-2,-2,0,7.0,21.0,-14.0,9
12376,12376,2006-07,2006,2007,Newcastle,Blackburn,Loss,Home,2007-05-05,0,1,1,2,5,4,7,7,7,-3,-6,-5,-2,1,7.0,6.0,1.0,10
12377,12377,2006-07,2006,2007,Newcastle,Watford,Draw,Away,2007-05-13,1,0,1,1,2,3,4,4,7,-3,-3,-3,-5,0,7.0,21.0,-14.0,10
12378,12378,2007-08,2007,2008,Newcastle,Bolton,Win,Away,2007-08-11,3,1,1,2,2,1,2,2,2,0,-1,0,0,0,13.0,7.0,6.0,1
12379,12379,2007-08,2007,2008,Newcastle,Aston Villa,Draw,Home,2007-08-18,1,4,4,4,5,1,4,7,8,3,0,-3,-3,1,13.0,11.0,2.0,1
12380,12380,2007-08,2007,2008,Newcastle,Middlesbrough,Draw,Away,2007-08-26,1,4,5,5,5,3,3,6,9,1,2,-1,-4,0,13.0,12.0,1.0,1
12381,12381,2007-08,2007,2008,Newcastle,Wigan,Win,Home,2007-09-01,3,2,5,6,6,4,7,7,10,-2,-2,-1,-4,1,13.0,17.0,-4.0,2
12382,12382,2007-08,2007,2008,Newcastle,Derby,Loss,Away,2007-09-17,0,4,5,8,9,0,0,0,1,4,5,8,8,0,13.0,21.0,-8.0,2
12383,12383,2007-08,2007,2008,Newcastle,West Ham,Win,Home,2007-09-23,3,3,4,5,8,6,7,10,10,-3,-3,-5,-2,1,13.0,15.0,-2.0,2
12384,12384,2007-08,2007,2008,Newcastle,Man City,Loss,Away,2007-09-29,0,3,6,7,8,4,4,4,7,-1,2,3,1,0,13.0,14.0,-1.0,2
12385,12385,2007-08,2007,2008,Newcastle,Everton,Win,Home,2007-10-07,3,3,3,6,7,3,3,6,7,0,0,0,0,1,13.0,6.0,7.0,3
12386,12386,2007-08,2007,2008,Newcastle,Tottenham,Win,Home,2007-10-22,3,3,6,6,9,2,3,3,4,1,3,3,5,1,13.0,5.0,8.0,3
12387,12387,2007-08,2007,2008,Newcastle,Reading,Loss,Away,2007-10-27,0,6,6,9,9,3,3,6,6,3,3,3,3,0,13.0,8.0,5.0,3
12388,12388,2007-08,2007,2008,Newcastle,Portsmouth,Loss,Home,2007-11-03,0,3,6,6,9,4,7,10,13,-1,-1,-4,-4,1,13.0,9.0,4.0,4
12389,12389,2007-08,2007,2008,Newcastle,Sunderland,Draw,Away,2007-11-10,1,0,3,6,6,1,1,1,1,-1,2,5,5,0,13.0,21.0,-8.0,4
12390,12390,2007-08,2007,2008,Newcastle,Liverpool,Loss,Home,2007-11-24,0,1,1,4,7,4,5,8,9,-3,-4,-4,-2,1,13.0,3.0,10.0,4
12391,12391,2007-08,2007,2008,Newcastle,Blackburn,Loss,Away,2007-12-01,0,1,1,1,4,1,1,2,5,0,0,-1,-1,0,13.0,10.0,3.0,5
12392,12392,2007-08,2007,2008,Newcastle,Arsenal,Draw,Home,2007-12-05,1,0,1,1,1,6,9,10,11,-6,-8,-9,-10,1,13.0,4.0,9.0,5
12393,12393,2007-08,2007,2008,Newcastle,Birmingham,Win,Home,2007-12-08,3,1,1,2,2,3,3,3,6,-2,-2,-1,-4,1,13.0,21.0,-8.0,5
12394,12394,2007-08,2007,2008,Newcastle,Fulham,Win,Away,2007-12-15,3,4,4,4,5,0,1,1,4,4,3,3,1,0,13.0,16.0,-3.0,5
12395,12395,2007-08,2007,2008,Newcastle,Derby,Draw,Home,2007-12-23,1,6,7,7,7,0,0,0,0,6,7,7,7,1,13.0,21.0,-8.0,5
12396,12396,2007-08,2007,2008,Newcastle,Wigan,Loss,Away,2007-12-26,0,4,7,8,8,4,4,5,5,0,3,3,3,0,13.0,17.0,-4.0,5
12397,12397,2007-08,2007,2008,Newcastle,Chelsea,Loss,Away,2007-12-29,0,1,4,7,8,4,4,7,10,-3,0,0,-2,0,13.0,2.0,11.0,5
12398,12398,2007-08,2007,2008,Newcastle,Man City,Loss,Home,2008-01-02,0,0,1,4,7,2,3,6,6,-2,-2,-2,1,1,13.0,14.0,-1.0,6
12399,12399,2007-08,2007,2008,Newcastle,Man United,Loss,Away,2008-01-12,0,0,0,1,4,3,6,9,12,-3,-6,-8,-8,0,13.0,1.0,12.0,6
12400,12400,2007-08,2007,2008,Newcastle,Bolton,Draw,Home,2008-01-19,1,0,0,0,1,3,3,3,6,-3,-3,-3,-5,1,13.0,7.0,6.0,6
12401,12401,2007-08,2007,2008,Newcastle,Arsenal,Loss,Away,2008-01-29,0,1,1,1,1,4,7,10,11,-3,-6,-9,-10,0,13.0,4.0,9.0,6
12402,12402,2007-08,2007,2008,Newcastle,Middlesbrough,Draw,Home,2008-02-03,1,1,1,1,1,4,5,5,8,-3,-4,-4,-7,1,13.0,12.0,1.0,7
12403,12403,2007-08,2007,2008,Newcastle,Aston Villa,Loss,Away,2008-02-09,0,1,2,2,2,1,2,5,8,0,0,-3,-6,0,13.0,11.0,2.0,7
12404,12404,2007-08,2007,2008,Newcastle,Man United,Loss,Home,2008-02-23,0,1,1,2,2,1,4,7,10,0,-3,-5,-8,1,13.0,1.0,12.0,7
12405,12405,2007-08,2007,2008,Newcastle,Blackburn,Loss,Home,2008-03-01,0,0,1,1,2,3,4,5,6,-3,-3,-4,-4,1,13.0,10.0,3.0,8
12406,12406,2007-08,2007,2008,Newcastle,Liverpool,Loss,Away,2008-03-08,0,0,0,1,1,6,9,10,13,-6,-9,-9,-12,0,13.0,3.0,10.0,8
12407,12407,2007-08,2007,2008,Newcastle,Birmingham,Draw,Away,2008-03-17,1,0,0,0,1,3,4,5,6,-3,-4,-5,-5,0,13.0,21.0,-8.0,8
12408,12408,2007-08,2007,2008,Newcastle,Fulham,Win,Home,2008-03-22,3,1,1,1,1,4,4,4,4,-3,-3,-3,-3,1,13.0,16.0,-3.0,8
12409,12409,2007-08,2007,2008,Newcastle,Tottenham,Win,Away,2008-03-30,3,4,4,4,4,4,4,7,7,0,0,-3,-3,0,13.0,5.0,8.0,8
12410,12410,2007-08,2007,2008,Newcastle,Reading,Win,Home,2008-04-05,3,6,7,7,7,4,4,7,10,2,3,0,-3,1,13.0,8.0,5.0,9
12411,12411,2007-08,2007,2008,Newcastle,Portsmouth,Draw,Away,2008-04-12,1,6,9,10,10,6,6,9,12,0,3,1,-2,0,13.0,9.0,4.0,9
12412,12412,2007-08,2007,2008,Newcastle,Sunderland,Win,Home,2008-04-20,3,4,7,10,11,3,6,9,9,1,1,1,2,1,13.0,21.0,-8.0,9
12413,12413,2007-08,2007,2008,Newcastle,West Ham,Draw,Away,2008-04-26,1,4,7,10,13,3,3,3,4,1,4,7,9,0,13.0,15.0,-2.0,9
12414,12414,2007-08,2007,2008,Newcastle,Chelsea,Loss,Home,2008-05-05,0,4,5,8,11,6,7,10,13,-2,-2,-2,-2,1,13.0,2.0,11.0,10
12415,12415,2007-08,2007,2008,Newcastle,Everton,Loss,Away,2008-05-11,0,1,4,5,8,1,1,2,5,0,3,3,3,0,13.0,6.0,7.0,10
12416,12416,2008-09,2008,2009,Newcastle,Man United,Draw,Away,2008-08-17,1,0,1,4,5,6,6,7,10,-6,-5,-3,-5,0,12.0,1.0,11.0,1
12417,12417,2008-09,2008,2009,Newcastle,Bolton,Win,Home,2008-08-23,3,1,1,2,5,4,7,8,11,-3,-6,-6,-6,1,12.0,16.0,-4.0,1
12418,12418,2008-09,2008,2009,Newcastle,Arsenal,Loss,Away,2008-08-30,0,4,4,4,5,3,6,9,12,1,-2,-5,-7,0,12.0,3.0,9.0,1
12419,12419,2008-09,2008,2009,Newcastle,Hull,Loss,Home,2008-09-13,0,3,4,4,4,1,4,4,4,2,0,0,0,1,12.0,21.0,-9.0,2
12420,12420,2008-09,2008,2009,Newcastle,West Ham,Loss,Away,2008-09-20,0,0,3,4,4,3,3,6,7,-3,0,-2,-3,0,12.0,10.0,2.0,2
12421,12421,2008-09,2008,2009,Newcastle,Blackburn,Loss,Home,2008-09-27,0,0,0,3,4,3,3,4,7,-3,-3,-1,-3,1,12.0,7.0,5.0,2
12422,12422,2008-09,2008,2009,Newcastle,Everton,Draw,Away,2008-10-05,1,0,0,0,3,1,4,4,7,-1,-4,-4,-4,0,12.0,5.0,7.0,3
12423,12423,2008-09,2008,2009,Newcastle,Man City,Draw,Home,2008-10-20,1,1,1,1,1,0,3,3,6,1,-2,-2,-5,1,12.0,9.0,3.0,3
12424,12424,2008-09,2008,2009,Newcastle,Sunderland,Loss,Away,2008-10-25,0,2,2,2,2,2,2,5,6,0,0,-3,-4,0,12.0,15.0,-3.0,3
12425,12425,2008-09,2008,2009,Newcastle,West Brom,Win,Home,2008-10-28,3,1,2,2,2,0,3,6,6,1,-1,-4,-4,1,12.0,21.0,-9.0,3
12426,12426,2008-09,2008,2009,Newcastle,Aston Villa,Win,Home,2008-11-03,3,3,4,5,5,6,7,7,10,-3,-3,-2,-5,1,12.0,6.0,6.0,4
12427,12427,2008-09,2008,2009,Newcastle,Fulham,Loss,Away,2008-11-09,0,6,6,7,8,3,4,5,5,3,2,2,3,0,12.0,17.0,-5.0,4
12428,12428,2008-09,2008,2009,Newcastle,Wigan,Draw,Home,2008-11-15,1,3,6,6,7,4,4,4,4,-1,2,2,3,1,12.0,14.0,-2.0,4
12429,12429,2008-09,2008,2009,Newcastle,Chelsea,Draw,Away,2008-11-22,1,1,4,7,7,6,9,12,12,-5,-5,-5,-5,0,12.0,2.0,10.0,4
12430,12430,2008-09,2008,2009,Newcastle,Middlesbrough,Draw,Away,2008-11-29,1,2,2,5,8,1,4,5,8,1,-2,0,0,0,12.0,13.0,-1.0,4
12431,12431,2008-09,2008,2009,Newcastle,Stoke,Draw,Home,2008-12-06,1,2,3,3,6,4,4,5,8,-2,-1,-2,-2,1,12.0,21.0,-9.0,5
12432,12432,2008-09,2008,2009,Newcastle,Portsmouth,Win,Away,2008-12-14,3,2,3,4,4,4,5,6,9,-2,-2,-2,-5,0,12.0,8.0,4.0,5
12433,12433,2008-09,2008,2009,Newcastle,Tottenham,Win,Home,2008-12-21,3,4,5,6,7,4,4,7,7,0,1,-1,0,1,12.0,11.0,1.0,5
12434,12434,2008-09,2008,2009,Newcastle,Wigan,Loss,Away,2008-12-26,0,6,7,8,9,3,6,9,10,3,1,-1,-1,0,12.0,14.0,-2.0,5
12435,12435,2008-09,2008,2009,Newcastle,Liverpool,Loss,Home,2008-12-28,0,3,6,7,8,4,5,8,9,-1,1,-1,-1,1,12.0,4.0,8.0,5
12436,12436,2008-09,2008,2009,Newcastle,West Ham,Draw,Home,2009-01-10,1,0,3,6,7,6,6,7,7,-6,-3,-1,0,1,12.0,10.0,2.0,6
12437,12437,2008-09,2008,2009,Newcastle,Blackburn,Loss,Away,2009-01-17,0,1,1,4,7,2,5,5,5,-1,-4,-1,2,0,12.0,7.0,5.0,6
12438,12438,2008-09,2008,2009,Newcastle,Man City,Loss,Away,2009-01-28,0,1,1,1,4,4,7,7,7,-3,-6,-6,-3,0,12.0,9.0,3.0,6
12439,12439,2008-09,2008,2009,Newcastle,Sunderland,Draw,Home,2009-02-01,1,0,1,1,1,3,4,4,5,-3,-3,-3,-4,1,12.0,15.0,-3.0,7
12440,12440,2008-09,2008,2009,Newcastle,West Brom,Win,Away,2009-02-07,3,1,1,2,2,1,4,4,7,0,-3,-2,-5,0,12.0,21.0,-9.0,7
12441,12441,2008-09,2008,2009,Newcastle,Everton,Draw,Home,2009-02-22,1,4,4,4,5,3,4,5,8,1,0,-1,-3,1,12.0,5.0,7.0,7
12442,12442,2008-09,2008,2009,Newcastle,Bolton,Loss,Away,2009-03-01,0,4,5,5,5,3,6,7,7,1,-1,-2,-2,0,12.0,16.0,-4.0,8
12443,12443,2008-09,2008,2009,Newcastle,Man United,Loss,Home,2009-03-04,0,1,4,5,5,6,9,12,15,-5,-5,-7,-10,1,12.0,1.0,11.0,8
12444,12444,2008-09,2008,2009,Newcastle,Hull,Draw,Away,2009-03-14,1,0,1,4,5,3,3,4,5,-3,-2,0,0,0,12.0,21.0,-9.0,8
12445,12445,2008-09,2008,2009,Newcastle,Arsenal,Loss,Home,2009-03-21,0,1,1,2,5,6,7,8,9,-5,-6,-6,-4,1,12.0,3.0,9.0,8
12446,12446,2008-09,2008,2009,Newcastle,Chelsea,Loss,Home,2009-04-04,0,1,1,1,2,3,6,9,12,-2,-5,-8,-10,1,12.0,2.0,10.0,9
12447,12447,2008-09,2008,2009,Newcastle,Stoke,Draw,Away,2009-04-11,1,0,1,1,1,6,6,9,10,-6,-5,-8,-9,0,12.0,21.0,-9.0,9
12448,12448,2008-09,2008,2009,Newcastle,Tottenham,Loss,Away,2009-04-19,0,1,1,2,2,3,6,9,10,-2,-5,-7,-8,0,12.0,11.0,1.0,9
12449,12449,2008-09,2008,2009,Newcastle,Portsmouth,Draw,Home,2009-04-27,1,1,1,1,2,3,4,5,8,-2,-3,-4,-6,1,12.0,8.0,4.0,9
12450,12450,2008-09,2008,2009,Newcastle,Liverpool,Loss,Away,2009-05-03,0,1,2,2,2,4,7,10,13,-3,-5,-8,-11,0,12.0,4.0,8.0,10
12451,12451,2008-09,2008,2009,Newcastle,Middlesbrough,Win,Home,2009-05-11,3,1,1,2,2,0,1,4,4,1,0,-2,-2,1,12.0,13.0,-1.0,10
12452,12452,2008-09,2008,2009,Newcastle,Fulham,Loss,Home,2009-05-16,0,3,4,4,5,3,6,7,10,0,-2,-3,-5,1,12.0,17.0,-5.0,10
12453,12453,2008-09,2008,2009,Newcastle,Aston Villa,Loss,Away,2009-05-24,0,3,3,4,4,1,4,5,6,2,-1,-1,-2,0,12.0,6.0,6.0,10
12454,12454,2010-11,2010,2011,Newcastle,Man United,Loss,Away,2010-08-16,0,0,3,3,4,6,9,12,13,-6,-6,-9,-9,0,21.0,2.0,19.0,1
12455,12455,2010-11,2010,2011,Newcastle,Aston Villa,Win,Home,2010-08-22,3,0,0,3,3,3,3,6,9,-3,-3,-3,-6,1,21.0,6.0,15.0,1
12456,12456,2010-11,2010,2011,Newcastle,Wolves,Draw,Away,2010-08-28,1,3,3,3,6,4,7,7,8,-1,-4,-4,-2,0,21.0,15.0,6.0,1
12457,12457,2010-11,2010,2011,Newcastle,Blackpool,Loss,Home,2010-09-11,0,4,4,4,4,1,4,4,4,3,0,0,0,1,21.0,21.0,0.0,2
12458,12458,2010-11,2010,2011,Newcastle,Everton,Win,Away,2010-09-18,3,1,4,4,4,1,2,2,5,0,2,2,-1,0,21.0,8.0,13.0,2
12459,12459,2010-11,2010,2011,Newcastle,Stoke,Loss,Home,2010-09-26,0,3,4,7,7,4,4,4,4,-1,0,3,3,1,21.0,11.0,10.0,2
12460,12460,2010-11,2010,2011,Newcastle,Man City,Loss,Away,2010-10-03,0,3,3,4,7,6,7,7,10,-3,-4,-3,-3,0,21.0,5.0,16.0,3
12461,12461,2010-11,2010,2011,Newcastle,Wigan,Draw,Home,2010-10-16,1,0,3,3,4,4,4,5,8,-4,-1,-2,-4,1,21.0,16.0,5.0,3
12462,12462,2010-11,2010,2011,Newcastle,West Ham,Win,Away,2010-10-23,3,1,1,4,4,2,5,6,6,-1,-4,-2,-2,0,21.0,17.0,4.0,3
12463,12463,2010-11,2010,2011,Newcastle,Sunderland,Win,Home,2010-10-31,3,4,4,4,7,4,5,6,7,0,-1,-2,0,1,21.0,13.0,8.0,3
12464,12464,2010-11,2010,2011,Newcastle,Arsenal,Win,Away,2010-11-07,3,6,7,7,7,6,9,9,9,0,-2,-2,-2,0,21.0,3.0,18.0,4
12465,12465,2010-11,2010,2011,Newcastle,Blackburn,Loss,Home,2010-11-10,0,6,9,10,10,3,3,4,4,3,6,6,6,1,21.0,10.0,11.0,4
12466,12466,2010-11,2010,2011,Newcastle,Fulham,Draw,Home,2010-11-13,1,3,6,9,10,1,4,4,4,2,2,5,6,1,21.0,12.0,9.0,4
12467,12467,2010-11,2010,2011,Newcastle,Bolton,Loss,Away,2010-11-20,0,1,4,7,10,4,7,7,8,-3,-3,0,2,0,21.0,14.0,7.0,4
12468,12468,2010-11,2010,2011,Newcastle,Chelsea,Draw,Home,2010-11-28,1,1,1,4,7,0,3,3,6,1,-2,1,1,1,21.0,1.0,20.0,4
12469,12469,2010-11,2010,2011,Newcastle,West Brom,Loss,Away,2010-12-05,0,1,2,2,5,3,3,4,4,-2,-1,-2,1,0,21.0,21.0,0.0,5
12470,12470,2010-11,2010,2011,Newcastle,Liverpool,Win,Home,2010-12-11,3,1,1,2,2,3,6,6,7,-2,-5,-4,-5,1,21.0,7.0,14.0,5
12471,12471,2010-11,2010,2011,Newcastle,Man City,Loss,Home,2010-12-26,0,3,4,4,5,3,6,7,10,0,-2,-3,-5,1,21.0,5.0,16.0,5
12472,12472,2010-11,2010,2011,Newcastle,Tottenham,Loss,Away,2010-12-28,0,3,3,4,4,4,5,8,11,-1,-2,-4,-7,0,21.0,4.0,17.0,5
12473,12473,2010-11,2010,2011,Newcastle,Wigan,Win,Away,2011-01-02,3,0,3,3,4,4,5,6,6,-4,-2,-3,-2,0,21.0,16.0,5.0,6
12474,12474,2010-11,2010,2011,Newcastle,West Ham,Win,Home,2011-01-05,3,3,3,6,6,4,7,8,8,-1,-4,-2,-2,1,21.0,17.0,4.0,6
12475,12475,2010-11,2010,2011,Newcastle,Sunderland,Draw,Away,2011-01-16,1,6,6,6,9,6,6,6,9,0,0,0,0,0,21.0,13.0,8.0,6
12476,12476,2010-11,2010,2011,Newcastle,Tottenham,Draw,Home,2011-01-22,1,4,7,7,7,1,4,7,10,3,3,0,-3,1,21.0,4.0,17.0,6
12477,12477,2010-11,2010,2011,Newcastle,Fulham,Loss,Away,2011-02-02,0,2,5,8,8,3,4,7,7,-1,1,1,1,0,21.0,12.0,9.0,7
12478,12478,2010-11,2010,2011,Newcastle,Arsenal,Draw,Home,2011-02-05,1,1,2,5,8,6,9,10,13,-5,-7,-5,-5,1,21.0,3.0,18.0,7
12479,12479,2010-11,2010,2011,Newcastle,Blackburn,Draw,Away,2011-02-12,1,1,2,3,6,0,3,3,6,1,-1,0,0,0,21.0,10.0,11.0,7
12480,12480,2010-11,2010,2011,Newcastle,Birmingham,Win,Away,2011-02-15,3,2,2,3,4,6,7,7,8,-4,-5,-4,-4,0,21.0,9.0,12.0,7
12481,12481,2010-11,2010,2011,Newcastle,Bolton,Draw,Home,2011-02-26,1,4,5,5,6,3,6,6,6,1,-1,-1,0,1,21.0,14.0,7.0,7
12482,12482,2010-11,2010,2011,Newcastle,Everton,Loss,Home,2011-03-05,0,4,5,6,6,3,6,6,7,1,-1,0,-1,1,21.0,8.0,13.0,8
12483,12483,2010-11,2010,2011,Newcastle,Stoke,Loss,Away,2011-03-19,0,1,4,5,6,1,1,1,4,0,3,4,2,0,21.0,11.0,10.0,8
12484,12484,2010-11,2010,2011,Newcastle,Wolves,Win,Home,2011-04-02,3,0,1,4,5,4,7,8,8,-4,-6,-4,-3,1,21.0,15.0,6.0,9
12485,12485,2010-11,2010,2011,Newcastle,Aston Villa,Loss,Away,2011-04-10,0,3,3,4,7,1,1,4,5,2,2,0,2,0,21.0,6.0,15.0,9
12486,12486,2010-11,2010,2011,Newcastle,Man United,Draw,Home,2011-04-19,1,3,3,3,4,6,9,9,9,-3,-6,-6,-5,1,21.0,2.0,19.0,9
12487,12487,2010-11,2010,2011,Newcastle,Blackpool,Draw,Away,2011-04-23,1,1,4,4,4,0,0,1,1,1,4,3,3,0,21.0,21.0,0.0,9
12488,12488,2010-11,2010,2011,Newcastle,Liverpool,Loss,Away,2011-05-01,0,2,2,5,5,4,7,7,10,-2,-5,-2,-5,0,21.0,7.0,14.0,10
12489,12489,2010-11,2010,2011,Newcastle,Birmingham,Win,Home,2011-05-07,3,1,2,2,5,1,1,4,5,0,1,-2,0,1,21.0,9.0,12.0,10
12490,12490,2010-11,2010,2011,Newcastle,Chelsea,Draw,Away,2011-05-15,1,3,4,5,5,3,6,9,12,0,-2,-4,-7,0,21.0,1.0,20.0,10
12491,12491,2010-11,2010,2011,Newcastle,West Brom,Draw,Home,2011-05-22,1,4,4,5,6,3,6,7,7,1,-2,-2,-1,1,21.0,21.0,0.0,10
12492,12492,2011-12,2011,2012,Newcastle,Arsenal,Draw,Home,2011-08-13,1,2,5,5,6,1,1,4,4,1,4,1,2,1,12.0,4.0,8.0,1
12493,12493,2011-12,2011,2012,Newcastle,Sunderland,Win,Away,2011-08-20,3,2,3,6,6,4,4,7,7,-2,-1,-1,-1,0,12.0,10.0,2.0,1
12494,12494,2011-12,2011,2012,Newcastle,Fulham,Win,Home,2011-08-28,3,4,5,6,9,1,2,5,5,3,3,1,4,1,12.0,8.0,4.0,1
12495,12495,2011-12,2011,2012,Newcastle,QPR,Draw,Away,2011-09-12,1,6,7,8,9,3,3,3,6,3,4,5,3,0,12.0,21.0,-9.0,2
12496,12496,2011-12,2011,2012,Newcastle,Aston Villa,Draw,Away,2011-09-17,1,4,7,8,9,2,5,6,9,2,2,2,0,0,12.0,9.0,3.0,2
12497,12497,2011-12,2011,2012,Newcastle,Blackburn,Win,Home,2011-09-24,3,2,5,8,9,4,4,4,4,-2,1,4,5,1,12.0,15.0,-3.0,2
12498,12498,2011-12,2011,2012,Newcastle,Wolves,Win,Away,2011-10-01,3,4,5,8,11,0,0,1,4,4,5,7,7,0,12.0,17.0,-5.0,3
12499,12499,2011-12,2011,2012,Newcastle,Tottenham,Draw,Home,2011-10-16,1,6,7,8,11,6,9,12,12,0,-2,-4,-1,1,12.0,5.0,7.0,3
12500,12500,2011-12,2011,2012,Newcastle,Wigan,Win,Home,2011-10-22,3,4,7,8,9,0,0,0,0,4,7,8,9,1,12.0,16.0,-4.0,3
12501,12501,2011-12,2011,2012,Newcastle,Stoke,Win,Away,2011-10-31,3,4,7,10,11,3,3,4,4,1,4,6,7,0,12.0,13.0,-1.0,3
12502,12502,2011-12,2011,2012,Newcastle,Everton,Win,Home,2011-11-05,3,6,7,10,13,3,3,3,3,3,4,7,10,1,12.0,7.0,5.0,4
12503,12503,2011-12,2011,2012,Newcastle,Man City,Loss,Away,2011-11-19,0,6,9,10,13,6,9,12,15,0,0,-2,-2,0,12.0,3.0,9.0,4
12504,12504,2011-12,2011,2012,Newcastle,Man United,Draw,Away,2011-11-26,1,3,6,9,10,6,9,9,10,-3,-3,0,0,0,12.0,1.0,11.0,4
12505,12505,2011-12,2011,2012,Newcastle,Chelsea,Loss,Home,2011-12-03,0,1,4,7,10,3,6,6,6,-2,-2,1,4,1,12.0,2.0,10.0,5
12506,12506,2011-12,2011,2012,Newcastle,Norwich,Loss,Away,2011-12-10,0,1,1,4,7,3,3,3,4,-2,-2,1,3,0,12.0,21.0,-9.0,5
12507,12507,2011-12,2011,2012,Newcastle,Swansea,Draw,Home,2011-12-17,1,0,1,1,4,3,4,4,5,-3,-3,-3,-1,1,12.0,21.0,-9.0,5
12508,12508,2011-12,2011,2012,Newcastle,West Brom,Loss,Home,2011-12-21,0,1,1,2,2,3,4,4,7,-2,-3,-2,-5,1,12.0,11.0,1.0,5
12509,12509,2011-12,2011,2012,Newcastle,Bolton,Win,Away,2011-12-26,3,1,1,1,2,3,3,3,3,-2,-2,-2,-1,0,12.0,14.0,-2.0,5
12510,12510,2011-12,2011,2012,Newcastle,Liverpool,Loss,Away,2011-12-30,0,3,4,4,4,2,5,8,8,1,-1,-4,-4,0,12.0,6.0,6.0,5
12511,12511,2011-12,2011,2012,Newcastle,Man United,Win,Home,2012-01-04,3,3,3,4,4,3,6,9,12,0,-3,-5,-8,1,12.0,1.0,11.0,6
12512,12512,2011-12,2011,2012,Newcastle,QPR,Win,Home,2012-01-15,3,3,6,6,7,0,1,1,1,3,5,5,6,1,12.0,21.0,-9.0,6
12513,12513,2011-12,2011,2012,Newcastle,Fulham,Loss,Away,2012-01-21,0,6,6,9,9,3,4,5,5,3,2,4,4,0,12.0,8.0,4.0,6
12514,12514,2011-12,2011,2012,Newcastle,Blackburn,Win,Away,2012-02-01,3,3,6,6,9,4,4,7,8,-1,2,-1,1,0,12.0,15.0,-3.0,7
12515,12515,2011-12,2011,2012,Newcastle,Aston Villa,Win,Home,2012-02-05,3,3,6,9,9,4,5,5,8,-1,1,4,1,1,12.0,9.0,3.0,7
12516,12516,2011-12,2011,2012,Newcastle,Tottenham,Loss,Away,2012-02-11,0,6,6,9,12,4,4,5,8,2,2,4,4,0,12.0,5.0,7.0,7
12517,12517,2011-12,2011,2012,Newcastle,Wolves,Draw,Home,2012-02-25,1,3,6,6,9,3,3,3,4,0,3,3,5,1,12.0,17.0,-5.0,7
12518,12518,2011-12,2011,2012,Newcastle,Sunderland,Draw,Home,2012-03-04,1,1,4,7,7,0,3,6,9,1,1,1,-2,1,12.0,10.0,2.0,8
12519,12519,2011-12,2011,2012,Newcastle,Arsenal,Loss,Away,2012-03-12,0,2,2,5,8,6,9,12,13,-4,-7,-7,-5,0,12.0,4.0,8.0,8
12520,12520,2011-12,2011,2012,Newcastle,Norwich,Win,Home,2012-03-18,3,1,2,2,5,1,1,4,7,0,1,-2,-2,1,12.0,21.0,-9.0,8
12521,12521,2011-12,2011,2012,Newcastle,West Brom,Win,Away,2012-03-25,3,3,4,5,5,1,4,7,10,2,0,-2,-5,0,12.0,11.0,1.0,8
12522,12522,2011-12,2011,2012,Newcastle,Liverpool,Win,Home,2012-04-01,3,6,6,7,8,0,3,3,3,6,3,4,5,1,12.0,6.0,6.0,9
12523,12523,2011-12,2011,2012,Newcastle,Swansea,Win,Away,2012-04-06,3,6,9,9,10,0,3,6,9,6,6,3,1,0,12.0,21.0,-9.0,9
12524,12524,2011-12,2011,2012,Newcastle,Bolton,Win,Home,2012-04-09,3,6,9,12,12,3,6,9,9,3,3,3,3,1,12.0,14.0,-2.0,9
12525,12525,2011-12,2011,2012,Newcastle,Stoke,Win,Home,2012-04-21,3,6,9,12,15,4,4,5,6,2,5,7,9,1,12.0,13.0,-1.0,9
12526,12526,2011-12,2011,2012,Newcastle,Wigan,Loss,Away,2012-04-28,0,6,9,12,15,3,6,6,9,3,3,6,6,0,12.0,16.0,-4.0,9
12527,12527,2011-12,2011,2012,Newcastle,Chelsea,Win,Away,2012-05-02,3,3,6,9,12,4,5,8,11,-1,1,1,1,0,12.0,2.0,10.0,10
12528,12528,2011-12,2011,2012,Newcastle,Man City,Loss,Home,2012-05-06,0,3,6,9,12,6,9,12,12,-3,-3,-3,0,1,12.0,3.0,9.0,10
12529,12529,2011-12,2011,2012,Newcastle,Everton,Loss,Away,2012-05-13,0,3,3,6,9,2,5,6,9,1,-2,0,0,0,12.0,7.0,5.0,10
12530,12530,2012-13,2012,2013,Newcastle,Tottenham,Win,Home,2012-08-18,3,0,3,3,6,4,7,10,10,-4,-4,-7,-4,1,5.0,4.0,1.0,1
12531,12531,2012-13,2012,2013,Newcastle,Chelsea,Loss,Away,2012-08-25,0,3,3,6,6,6,9,9,9,-3,-6,-3,-3,0,5.0,6.0,-1.0,1
12532,12532,2012-13,2012,2013,Newcastle,Aston Villa,Draw,Home,2012-09-02,1,3,3,3,6,0,0,1,2,3,3,2,4,1,5.0,16.0,-11.0,2
12533,12533,2012-13,2012,2013,Newcastle,Everton,Draw,Away,2012-09-17,1,1,4,4,4,3,6,9,10,-2,-2,-5,-6,0,5.0,7.0,-2.0,2
12534,12534,2012-13,2012,2013,Newcastle,Norwich,Win,Home,2012-09-23,3,2,2,5,5,2,3,3,6,0,-1,2,-1,1,5.0,12.0,-7.0,2
12535,12535,2012-13,2012,2013,Newcastle,Reading,Draw,Away,2012-09-29,1,4,5,5,8,0,0,1,4,4,5,4,4,0,5.0,21.0,-16.0,2
12536,12536,2012-13,2012,2013,Newcastle,Man United,Loss,Home,2012-10-07,0,4,5,6,6,3,6,9,12,1,-1,-3,-6,1,5.0,2.0,3.0,3
12537,12537,2012-13,2012,2013,Newcastle,Sunderland,Draw,Away,2012-10-21,1,1,4,5,6,3,4,5,6,-2,0,0,0,0,5.0,13.0,-8.0,3
12538,12538,2012-13,2012,2013,Newcastle,West Brom,Win,Home,2012-10-28,3,1,2,5,6,3,4,7,7,-2,-2,-2,-1,1,5.0,10.0,-5.0,3
12539,12539,2012-13,2012,2013,Newcastle,Liverpool,Draw,Away,2012-11-04,1,4,4,5,8,4,5,8,8,0,-1,-3,0,0,5.0,8.0,-3.0,4
12540,12540,2012-13,2012,2013,Newcastle,West Ham,Loss,Home,2012-11-11,0,4,5,5,6,1,4,4,7,3,1,1,-1,1,5.0,21.0,-16.0,4
12541,12541,2012-13,2012,2013,Newcastle,Swansea,Loss,Home,2012-11-17,0,1,4,5,5,2,2,5,6,-1,2,0,-1,1,5.0,11.0,-6.0,4
12542,12542,2012-13,2012,2013,Newcastle,Southampton,Loss,Away,2012-11-25,0,0,1,4,5,4,4,4,4,-4,-3,0,1,0,5.0,21.0,-16.0,4
12543,12543,2012-13,2012,2013,Newcastle,Stoke,Loss,Away,2012-11-28,0,0,0,1,4,4,7,7,8,-4,-7,-6,-4,0,5.0,14.0,-9.0,4
12544,12544,2012-13,2012,2013,Newcastle,Wigan,Win,Home,2012-12-03,3,0,0,0,1,3,3,3,6,-3,-3,-3,-5,1,5.0,15.0,-10.0,5
12545,12545,2012-13,2012,2013,Newcastle,Fulham,Loss,Away,2012-12-10,0,3,3,3,3,1,1,1,2,2,2,2,1,0,5.0,9.0,-4.0,5
12546,12546,2012-13,2012,2013,Newcastle,Man City,Loss,Home,2012-12-15,0,3,3,3,3,1,4,5,8,2,-1,-2,-5,1,5.0,1.0,4.0,5
12547,12547,2012-13,2012,2013,Newcastle,QPR,Win,Home,2012-12-22,3,0,3,3,3,4,5,6,6,-4,-2,-3,-3,1,5.0,17.0,-12.0,5
12548,12548,2012-13,2012,2013,Newcastle,Man United,Loss,Away,2012-12-26,0,3,3,6,6,4,7,10,13,-1,-4,-4,-7,0,5.0,2.0,3.0,5
12549,12549,2012-13,2012,2013,Newcastle,Arsenal,Loss,Away,2012-12-29,0,3,3,3,6,6,9,9,10,-3,-6,-6,-4,0,5.0,3.0,2.0,5
12550,12550,2012-13,2012,2013,Newcastle,Everton,Loss,Home,2013-01-02,0,0,3,3,3,3,6,7,10,-3,-3,-4,-7,1,5.0,7.0,-2.0,6
12551,12551,2012-13,2012,2013,Newcastle,Norwich,Draw,Away,2013-01-12,1,0,0,3,3,0,0,0,3,0,0,3,0,0,5.0,12.0,-7.0,6
12552,12552,2012-13,2012,2013,Newcastle,Reading,Loss,Home,2013-01-19,0,1,1,1,4,3,6,7,7,-2,-5,-6,-3,1,5.0,21.0,-16.0,6
12553,12553,2012-13,2012,2013,Newcastle,Aston Villa,Win,Away,2013-01-29,3,1,1,1,1,1,2,2,2,0,-1,-1,-1,0,5.0,16.0,-11.0,6
12554,12554,2012-13,2012,2013,Newcastle,Chelsea,Win,Home,2013-02-02,3,3,4,4,4,4,5,8,8,-1,-1,-4,-4,1,5.0,6.0,-1.0,7
12555,12555,2012-13,2012,2013,Newcastle,Tottenham,Loss,Away,2013-02-09,0,6,6,7,7,4,5,6,9,2,1,1,-2,0,5.0,4.0,1.0,7
12556,12556,2012-13,2012,2013,Newcastle,Southampton,Win,Home,2013-02-24,3,3,6,6,7,4,4,5,6,-1,2,1,1,1,5.0,21.0,-16.0,7
12557,12557,2012-13,2012,2013,Newcastle,Swansea,Loss,Away,2013-03-02,0,3,6,9,9,3,3,4,7,0,3,5,2,0,5.0,11.0,-6.0,8
12558,12558,2012-13,2012,2013,Newcastle,Stoke,Win,Home,2013-03-10,3,3,3,6,9,0,3,3,4,3,0,3,5,1,5.0,14.0,-9.0,8
12559,12559,2012-13,2012,2013,Newcastle,Wigan,Loss,Away,2013-03-17,0,3,6,6,9,3,3,4,5,0,3,2,4,0,5.0,15.0,-10.0,8
12560,12560,2012-13,2012,2013,Newcastle,Man City,Loss,Away,2013-03-30,0,3,3,6,6,3,6,6,7,0,-3,0,-1,0,5.0,1.0,4.0,8
12561,12561,2012-13,2012,2013,Newcastle,Fulham,Win,Home,2013-04-07,3,0,3,3,6,6,7,10,11,-6,-4,-7,-5,1,5.0,9.0,-4.0,9
12562,12562,2012-13,2012,2013,Newcastle,Sunderland,Loss,Home,2013-04-14,0,3,3,6,6,0,1,1,2,3,2,5,4,1,5.0,13.0,-8.0,9
12563,12563,2012-13,2012,2013,Newcastle,West Brom,Draw,Away,2013-04-20,1,3,3,3,6,0,1,4,4,3,2,-1,2,0,5.0,10.0,-5.0,9
12564,12564,2012-13,2012,2013,Newcastle,Liverpool,Loss,Home,2013-04-27,0,1,4,4,4,2,3,6,6,-1,1,-2,-2,1,5.0,8.0,-3.0,9
12565,12565,2012-13,2012,2013,Newcastle,West Ham,Draw,Away,2013-05-04,1,1,1,4,4,3,4,5,6,-2,-3,-1,-2,0,5.0,21.0,-16.0,10
12566,12566,2012-13,2012,2013,Newcastle,QPR,Win,Away,2013-05-12,3,1,2,2,5,1,1,1,2,0,1,1,3,0,5.0,17.0,-12.0,10
12567,12567,2012-13,2012,2013,Newcastle,Arsenal,Loss,Home,2013-05-19,0,4,4,5,5,6,7,10,11,-2,-3,-5,-6,1,5.0,3.0,2.0,10
12568,12568,2013-14,2013,2014,Newcastle,Man City,Loss,Away,2013-08-19,0,3,4,4,5,3,6,7,10,0,-2,-3,-5,0,16.0,2.0,14.0,1
12569,12569,2013-14,2013,2014,Newcastle,West Ham,Draw,Home,2013-08-24,1,0,3,4,4,6,6,7,7,-6,-3,-3,-3,1,16.0,10.0,6.0,1
12570,12570,2013-14,2013,2014,Newcastle,Fulham,Win,Home,2013-08-31,3,1,1,4,5,3,6,6,6,-2,-5,-2,-1,1,16.0,12.0,4.0,1
12571,12571,2013-14,2013,2014,Newcastle,Aston Villa,Win,Away,2013-09-14,3,4,4,4,7,0,3,4,4,4,1,0,3,0,16.0,15.0,1.0,2
12572,12572,2013-14,2013,2014,Newcastle,Hull,Loss,Home,2013-09-21,0,6,7,7,7,1,4,4,5,5,3,3,2,1,16.0,21.0,-5.0,2
12573,12573,2013-14,2013,2014,Newcastle,Everton,Loss,Away,2013-09-30,0,3,6,7,7,6,7,8,9,-3,-1,-1,-2,0,16.0,6.0,10.0,2
12574,12574,2013-14,2013,2014,Newcastle,Cardiff,Win,Away,2013-10-05,3,0,3,6,7,3,4,5,8,-3,-1,1,-1,0,16.0,21.0,-5.0,3
12575,12575,2013-14,2013,2014,Newcastle,Liverpool,Draw,Home,2013-10-19,1,3,3,6,9,6,6,7,10,-3,-3,-1,-1,1,16.0,7.0,9.0,3
12576,12576,2013-14,2013,2014,Newcastle,Sunderland,Loss,Away,2013-10-27,0,4,4,4,7,0,0,0,0,4,4,4,7,0,16.0,17.0,-1.0,3
12577,12577,2013-14,2013,2014,Newcastle,Chelsea,Win,Home,2013-11-02,3,1,4,4,4,6,9,10,13,-5,-5,-6,-9,1,16.0,3.0,13.0,4
12578,12578,2013-14,2013,2014,Newcastle,Tottenham,Win,Away,2013-11-10,3,3,4,7,7,4,7,7,8,-1,-3,0,-1,0,16.0,5.0,11.0,4
12579,12579,2013-14,2013,2014,Newcastle,Norwich,Win,Home,2013-11-23,3,6,6,7,10,3,4,4,4,3,2,3,6,1,16.0,11.0,5.0,4
12580,12580,2013-14,2013,2014,Newcastle,West Brom,Win,Home,2013-11-30,3,6,9,9,10,2,5,5,6,4,4,4,4,1,16.0,8.0,8.0,4
12581,12581,2013-14,2013,2014,Newcastle,Swansea,Loss,Away,2013-12-04,0,6,9,12,12,3,4,4,5,3,5,8,7,0,16.0,9.0,7.0,5
12582,12582,2013-14,2013,2014,Newcastle,Man United,Win,Away,2013-12-07,3,3,6,9,12,1,2,5,8,2,4,4,4,0,16.0,1.0,15.0,5
12583,12583,2013-14,2013,2014,Newcastle,Southampton,Draw,Home,2013-12-14,1,3,6,9,12,1,1,1,4,2,5,8,8,1,16.0,14.0,2.0,5
12584,12584,2013-14,2013,2014,Newcastle,Crystal Palace,Win,Away,2013-12-21,3,4,4,7,10,3,6,6,9,1,-2,1,1,0,16.0,21.0,-5.0,5
12585,12585,2013-14,2013,2014,Newcastle,Stoke,Win,Home,2013-12-26,3,4,7,7,10,4,7,8,8,0,0,-1,2,1,16.0,13.0,3.0,5
12586,12586,2013-14,2013,2014,Newcastle,Arsenal,Loss,Home,2013-12-29,0,6,7,10,10,4,4,5,8,2,3,5,2,1,16.0,4.0,12.0,5
12587,12587,2013-14,2013,2014,Newcastle,West Brom,Loss,Away,2014-01-01,0,3,6,7,10,2,3,3,3,1,3,4,7,0,16.0,8.0,8.0,6
12588,12588,2013-14,2013,2014,Newcastle,Man City,Loss,Home,2014-01-12,0,0,3,6,7,6,9,12,15,-6,-6,-6,-8,1,16.0,2.0,14.0,6
12589,12589,2013-14,2013,2014,Newcastle,West Ham,Win,Away,2014-01-18,3,0,0,3,6,3,4,4,4,-3,-4,-1,2,0,16.0,10.0,6.0,6
12590,12590,2013-14,2013,2014,Newcastle,Norwich,Draw,Away,2014-01-28,1,3,3,3,6,3,4,4,4,0,-1,-1,2,0,16.0,11.0,5.0,6
12591,12591,2013-14,2013,2014,Newcastle,Sunderland,Loss,Home,2014-02-01,0,4,4,4,4,4,7,7,8,0,-3,-3,-4,1,16.0,17.0,-1.0,7
12592,12592,2013-14,2013,2014,Newcastle,Chelsea,Loss,Away,2014-02-08,0,1,4,4,4,4,7,10,13,-3,-3,-6,-9,0,16.0,3.0,13.0,7
12593,12593,2013-14,2013,2014,Newcastle,Tottenham,Loss,Home,2014-02-12,0,0,1,4,4,4,4,7,10,-4,-3,-3,-6,1,16.0,5.0,11.0,7
12594,12594,2013-14,2013,2014,Newcastle,Aston Villa,Win,Home,2014-02-23,3,0,0,1,4,1,1,4,5,-1,-1,-3,-1,1,16.0,15.0,1.0,7
12595,12595,2013-14,2013,2014,Newcastle,Hull,Win,Away,2014-03-01,3,3,3,3,4,3,6,7,7,0,-3,-4,-3,0,16.0,21.0,-5.0,8
12596,12596,2013-14,2013,2014,Newcastle,Fulham,Loss,Away,2014-03-15,0,6,6,6,6,0,1,1,2,6,5,5,4,0,16.0,12.0,4.0,8
12597,12597,2013-14,2013,2014,Newcastle,Crystal Palace,Win,Home,2014-03-22,3,3,6,6,6,1,2,2,5,2,4,4,1,1,16.0,21.0,-5.0,8
12598,12598,2013-14,2013,2014,Newcastle,Everton,Loss,Home,2014-03-25,0,3,6,9,9,6,9,9,9,-3,-3,0,0,1,16.0,6.0,10.0,8
12599,12599,2013-14,2013,2014,Newcastle,Southampton,Loss,Away,2014-03-29,0,3,3,6,9,3,6,6,6,0,-3,0,3,0,16.0,14.0,2.0,8
12600,12600,2013-14,2013,2014,Newcastle,Man United,Loss,Home,2014-04-05,0,0,3,3,6,3,6,6,9,-3,-3,-3,-3,1,16.0,1.0,15.0,9
12601,12601,2013-14,2013,2014,Newcastle,Stoke,Loss,Away,2014-04-12,0,0,0,3,3,3,6,9,10,-3,-6,-6,-7,0,16.0,13.0,3.0,9
12602,12602,2013-14,2013,2014,Newcastle,Swansea,Loss,Home,2014-04-19,0,0,0,0,3,0,3,4,4,0,-3,-4,-1,1,16.0,9.0,7.0,9
12603,12603,2013-14,2013,2014,Newcastle,Arsenal,Loss,Away,2014-04-28,0,0,0,0,0,6,6,7,8,-6,-6,-7,-8,0,16.0,4.0,12.0,9
12604,12604,2013-14,2013,2014,Newcastle,Cardiff,Win,Home,2014-05-03,3,0,0,0,0,1,4,4,5,-1,-4,-4,-5,1,16.0,21.0,-5.0,10
12605,12605,2013-14,2013,2014,Newcastle,Liverpool,Loss,Away,2014-05-11,0,3,3,3,3,1,4,7,10,2,-1,-4,-7,0,16.0,7.0,9.0,10
12606,12606,2014-15,2014,2015,Newcastle,Man City,Loss,Home,2014-08-17,0,3,3,3,3,6,9,12,15,-3,-6,-9,-12,1,10.0,1.0,9.0,1
12607,12607,2014-15,2014,2015,Newcastle,Aston Villa,Draw,Away,2014-08-23,1,0,3,3,3,3,3,6,6,-3,0,-3,-3,0,10.0,15.0,-5.0,1
12608,12608,2014-15,2014,2015,Newcastle,Crystal Palace,Draw,Home,2014-08-30,1,1,1,4,4,0,1,2,2,1,0,2,2,1,10.0,11.0,-1.0,1
12609,12609,2014-15,2014,2015,Newcastle,Southampton,Loss,Away,2014-09-13,0,2,2,2,5,4,4,5,8,-2,-2,-3,-3,0,10.0,8.0,2.0,2
12610,12610,2014-15,2014,2015,Newcastle,Hull,Draw,Home,2014-09-20,1,1,2,2,2,1,2,5,5,0,0,-3,-3,1,10.0,16.0,-6.0,2
12611,12611,2014-15,2014,2015,Newcastle,Stoke,Loss,Away,2014-09-29,0,1,2,3,3,1,4,5,5,0,-2,-2,-2,0,10.0,9.0,1.0,2
12612,12612,2014-15,2014,2015,Newcastle,Swansea,Draw,Away,2014-10-04,1,1,1,2,3,1,1,4,7,0,0,-2,-4,0,10.0,12.0,-2.0,3
12613,12613,2014-15,2014,2015,Newcastle,Leicester,Win,Home,2014-10-18,3,1,2,2,3,1,4,7,8,0,-2,-5,-5,1,10.0,21.0,-11.0,3
12614,12614,2014-15,2014,2015,Newcastle,Tottenham,Win,Away,2014-10-26,3,4,4,5,5,3,4,4,5,1,0,1,0,0,10.0,6.0,4.0,3
12615,12615,2014-15,2014,2015,Newcastle,Liverpool,Win,Home,2014-11-01,3,6,7,7,8,4,7,8,8,2,0,-1,0,1,10.0,2.0,8.0,4
12616,12616,2014-15,2014,2015,Newcastle,West Brom,Win,Away,2014-11-09,3,6,9,10,10,4,5,5,8,2,4,5,2,0,10.0,17.0,-7.0,4
12617,12617,2014-15,2014,2015,Newcastle,QPR,Win,Home,2014-11-22,3,6,9,12,13,1,4,4,4,5,5,8,9,1,10.0,21.0,-11.0,4
12618,12618,2014-15,2014,2015,Newcastle,West Ham,Loss,Away,2014-11-29,0,6,9,12,15,1,2,5,8,5,7,7,7,0,10.0,13.0,-3.0,4
12619,12619,2014-15,2014,2015,Newcastle,Burnley,Draw,Away,2014-12-02,1,3,6,9,12,4,7,7,7,-1,-1,2,5,0,10.0,21.0,-11.0,5
12620,12620,2014-15,2014,2015,Newcastle,Chelsea,Win,Home,2014-12-06,3,1,4,7,10,4,7,10,13,-3,-3,-3,-3,1,10.0,3.0,7.0,5
12621,12621,2014-15,2014,2015,Newcastle,Arsenal,Loss,Away,2014-12-13,0,4,4,7,10,3,6,6,6,1,-2,1,4,0,10.0,4.0,6.0,5
12622,12622,2014-15,2014,2015,Newcastle,Sunderland,Loss,Home,2014-12-21,0,3,4,4,7,2,2,3,4,1,2,1,3,1,10.0,14.0,-4.0,5
12623,12623,2014-15,2014,2015,Newcastle,Man United,Loss,Away,2014-12-26,0,0,3,4,4,4,7,10,13,-4,-4,-6,-9,0,10.0,7.0,3.0,5
12624,12624,2014-15,2014,2015,Newcastle,Everton,Win,Home,2014-12-28,3,0,0,3,4,0,3,3,4,0,-3,0,0,1,10.0,5.0,5.0,5
12625,12625,2014-15,2014,2015,Newcastle,Burnley,Draw,Home,2015-01-01,1,3,3,3,6,1,1,4,4,2,2,-1,2,1,10.0,21.0,-11.0,6
12626,12626,2014-15,2014,2015,Newcastle,Chelsea,Loss,Away,2015-01-10,0,4,4,4,4,1,4,7,10,3,0,-3,-6,0,10.0,3.0,7.0,6
12627,12627,2014-15,2014,2015,Newcastle,Southampton,Loss,Home,2015-01-17,0,1,4,4,4,6,7,10,13,-5,-3,-6,-9,1,10.0,8.0,2.0,6
12628,12628,2014-15,2014,2015,Newcastle,Hull,Win,Away,2015-01-31,3,0,1,4,4,0,3,3,6,0,-2,1,-2,0,10.0,16.0,-6.0,6
12629,12629,2014-15,2014,2015,Newcastle,Stoke,Draw,Home,2015-02-08,1,3,3,4,7,6,6,7,10,-3,-3,-3,-3,1,10.0,9.0,1.0,7
12630,12630,2014-15,2014,2015,Newcastle,Crystal Palace,Draw,Away,2015-02-11,1,4,4,4,5,3,6,9,10,1,-2,-5,-5,0,10.0,11.0,-1.0,7
12631,12631,2014-15,2014,2015,Newcastle,Man City,Loss,Away,2015-02-21,0,2,5,5,5,4,5,5,6,-2,0,0,-1,0,10.0,1.0,9.0,7
12632,12632,2014-15,2014,2015,Newcastle,Aston Villa,Win,Home,2015-02-28,3,1,2,5,5,0,0,0,0,1,2,5,5,1,10.0,15.0,-5.0,7
12633,12633,2014-15,2014,2015,Newcastle,Man United,Loss,Home,2015-03-04,0,3,4,5,8,3,6,7,10,0,-2,-2,-2,1,10.0,7.0,3.0,8
12634,12634,2014-15,2014,2015,Newcastle,Everton,Loss,Away,2015-03-15,0,3,3,4,5,0,1,1,2,3,2,3,3,0,10.0,5.0,5.0,8
12635,12635,2014-15,2014,2015,Newcastle,Arsenal,Loss,Home,2015-03-21,0,0,3,3,4,6,9,12,15,-6,-6,-9,-11,1,10.0,4.0,6.0,8
12636,12636,2014-15,2014,2015,Newcastle,Sunderland,Loss,Away,2015-04-05,0,0,0,3,3,0,1,1,2,0,-1,2,1,0,10.0,14.0,-4.0,9
12637,12637,2014-15,2014,2015,Newcastle,Liverpool,Loss,Away,2015-04-13,0,0,0,0,3,0,3,6,9,0,-3,-6,-6,0,10.0,2.0,8.0,9
12638,12638,2014-15,2014,2015,Newcastle,Tottenham,Loss,Home,2015-04-19,0,0,0,0,0,1,4,4,7,-1,-4,-4,-7,1,10.0,6.0,4.0,9
12639,12639,2014-15,2014,2015,Newcastle,Swansea,Loss,Home,2015-04-25,0,0,0,0,0,1,4,7,7,-1,-4,-7,-7,1,10.0,12.0,-2.0,9
12640,12640,2014-15,2014,2015,Newcastle,Leicester,Loss,Away,2015-05-02,0,0,0,0,0,3,6,9,12,-3,-6,-9,-12,0,10.0,21.0,-11.0,10
12641,12641,2014-15,2014,2015,Newcastle,West Brom,Draw,Home,2015-05-09,1,0,0,0,0,4,7,7,7,-4,-7,-7,-7,1,10.0,17.0,-7.0,10
12642,12642,2014-15,2014,2015,Newcastle,QPR,Loss,Away,2015-05-16,0,1,1,1,1,0,1,1,2,1,0,0,-1,0,10.0,21.0,-11.0,10
12643,12643,2014-15,2014,2015,Newcastle,West Ham,Win,Home,2015-05-24,3,1,1,1,1,0,3,4,4,1,-2,-3,-3,1,10.0,13.0,-3.0,10
12644,12644,2015-16,2015,2016,Newcastle,Southampton,Draw,Home,2015-08-09,1,3,4,4,4,3,3,3,4,0,1,1,0,1,15.0,7.0,8.0,1
12645,12645,2015-16,2015,2016,Newcastle,Swansea,Loss,Away,2015-08-15,0,4,4,5,5,1,1,4,7,3,3,1,-2,0,15.0,8.0,7.0,1
12646,12646,2015-16,2015,2016,Newcastle,Man United,Draw,Away,2015-08-22,1,1,4,4,5,6,7,8,11,-5,-3,-4,-6,0,15.0,4.0,11.0,1
12647,12647,2015-16,2015,2016,Newcastle,Arsenal,Loss,Home,2015-08-29,0,1,2,5,5,4,4,7,8,-3,-2,-2,-3,1,15.0,3.0,12.0,1
12648,12648,2015-16,2015,2016,Newcastle,West Ham,Loss,Away,2015-09-14,0,1,1,2,5,3,3,6,6,-2,-2,-4,-1,0,15.0,12.0,3.0,2
12649,12649,2015-16,2015,2016,Newcastle,Watford,Loss,Home,2015-09-19,0,0,1,1,2,3,4,5,6,-3,-3,-4,-4,1,15.0,21.0,-6.0,2
12650,12650,2015-16,2015,2016,Newcastle,Chelsea,Draw,Home,2015-09-26,1,0,0,1,1,3,3,6,6,-3,-3,-5,-5,1,15.0,1.0,14.0,2
12651,12651,2015-16,2015,2016,Newcastle,Man City,Loss,Away,2015-10-03,0,1,1,1,2,0,3,6,9,1,-2,-5,-7,0,15.0,2.0,13.0,3
12652,12652,2015-16,2015,2016,Newcastle,Norwich,Win,Home,2015-10-18,3,1,1,1,1,1,2,5,5,0,-1,-4,-4,1,15.0,21.0,-6.0,3
12653,12653,2015-16,2015,2016,Newcastle,Sunderland,Loss,Away,2015-10-25,0,3,4,4,4,1,1,1,1,2,3,3,3,0,15.0,16.0,-1.0,3
12654,12654,2015-16,2015,2016,Newcastle,Stoke,Draw,Home,2015-10-31,1,3,3,4,4,3,6,9,10,0,-3,-5,-6,1,15.0,9.0,6.0,3
12655,12655,2015-16,2015,2016,Newcastle,Bournemouth,Win,Away,2015-11-07,3,1,4,4,5,0,0,1,1,1,4,3,4,0,15.0,21.0,-6.0,4
12656,12656,2015-16,2015,2016,Newcastle,Leicester,Loss,Home,2015-11-21,0,4,4,7,7,6,9,10,13,-2,-5,-3,-6,1,15.0,14.0,1.0,4
12657,12657,2015-16,2015,2016,Newcastle,Crystal Palace,Loss,Away,2015-11-28,0,3,4,4,7,3,4,4,4,0,0,0,3,0,15.0,10.0,5.0,4
12658,12658,2015-16,2015,2016,Newcastle,Liverpool,Win,Home,2015-12-06,3,0,3,4,4,6,6,9,10,-6,-3,-5,-6,1,15.0,6.0,9.0,5
12659,12659,2015-16,2015,2016,Newcastle,Tottenham,Win,Away,2015-12-13,3,3,3,6,7,2,5,6,9,1,-2,0,-2,0,15.0,5.0,10.0,5
12660,12660,2015-16,2015,2016,Newcastle,Aston Villa,Draw,Home,2015-12-19,1,6,6,6,9,1,1,1,2,5,5,5,7,1,15.0,17.0,-2.0,5
12661,12661,2015-16,2015,2016,Newcastle,Everton,Loss,Home,2015-12-26,0,4,7,7,7,1,2,3,6,3,5,4,1,1,15.0,11.0,4.0,5
12662,12662,2015-16,2015,2016,Newcastle,West Brom,Loss,Away,2015-12-28,0,1,4,7,7,0,1,2,3,1,3,5,4,0,15.0,13.0,2.0,5
12663,12663,2015-16,2015,2016,Newcastle,Arsenal,Loss,Away,2016-01-02,0,0,1,4,7,3,6,9,12,-3,-5,-5,-5,0,15.0,3.0,12.0,6
12664,12664,2015-16,2015,2016,Newcastle,Man United,Draw,Home,2016-01-12,1,0,0,1,4,4,4,4,4,-4,-4,-3,0,1,15.0,4.0,11.0,6
12665,12665,2015-16,2015,2016,Newcastle,West Ham,Win,Home,2016-01-16,3,1,1,1,2,6,9,10,11,-5,-8,-9,-9,1,15.0,12.0,3.0,6
12666,12666,2015-16,2015,2016,Newcastle,Watford,Loss,Away,2016-01-23,0,4,4,4,4,0,0,0,1,4,4,4,3,0,15.0,21.0,-6.0,6
12667,12667,2015-16,2015,2016,Newcastle,Everton,Loss,Away,2016-02-03,0,3,4,4,4,1,2,3,3,2,2,1,1,0,15.0,11.0,4.0,7
12668,12668,2015-16,2015,2016,Newcastle,West Brom,Win,Home,2016-02-06,3,0,3,4,4,2,2,3,6,-2,1,1,-2,1,15.0,13.0,2.0,7
12669,12669,2015-16,2015,2016,Newcastle,Chelsea,Loss,Away,2016-02-13,0,3,3,6,7,2,5,6,7,1,-2,0,0,0,15.0,1.0,14.0,7
12670,12670,2015-16,2015,2016,Newcastle,Stoke,Loss,Away,2016-03-02,0,3,3,3,6,6,6,6,6,-3,-3,-3,0,0,15.0,9.0,6.0,8
12671,12671,2015-16,2015,2016,Newcastle,Bournemouth,Loss,Home,2016-03-05,0,0,3,3,3,4,4,4,7,-4,-1,-1,-4,1,15.0,21.0,-6.0,8
12672,12672,2015-16,2015,2016,Newcastle,Leicester,Loss,Away,2016-03-14,0,0,0,3,3,4,7,7,10,-4,-7,-4,-7,0,15.0,14.0,1.0,8
12673,12673,2015-16,2015,2016,Newcastle,Sunderland,Draw,Home,2016-03-20,1,0,0,0,3,2,2,5,6,-2,-2,-5,-3,1,15.0,16.0,-1.0,8
12674,12674,2015-16,2015,2016,Newcastle,Norwich,Loss,Away,2016-04-02,0,1,1,1,1,4,4,4,4,-3,-3,-3,-3,0,15.0,21.0,-6.0,9
12675,12675,2015-16,2015,2016,Newcastle,Southampton,Loss,Away,2016-04-09,0,1,1,1,1,3,6,7,7,-2,-5,-6,-6,0,15.0,7.0,8.0,9
12676,12676,2015-16,2015,2016,Newcastle,Swansea,Win,Home,2016-04-16,3,0,1,1,1,4,7,7,10,-4,-6,-6,-9,1,15.0,8.0,7.0,9
12677,12677,2015-16,2015,2016,Newcastle,Man City,Draw,Home,2016-04-19,1,3,3,4,4,6,9,9,10,-3,-6,-5,-6,1,15.0,2.0,13.0,9
12678,12678,2015-16,2015,2016,Newcastle,Liverpool,Draw,Away,2016-04-23,1,4,4,4,5,6,9,10,10,-2,-5,-6,-5,0,15.0,6.0,9.0,9
12679,12679,2015-16,2015,2016,Newcastle,Crystal Palace,Win,Home,2016-04-30,3,2,5,5,5,1,2,5,6,1,3,0,-1,1,15.0,10.0,5.0,9
12680,12680,2015-16,2015,2016,Newcastle,Aston Villa,Draw,Away,2016-05-07,1,4,5,8,8,0,0,0,0,4,5,8,8,0,15.0,17.0,-2.0,10
12681,12681,2015-16,2015,2016,Newcastle,Tottenham,Win,Home,2016-05-15,3,4,5,6,9,1,2,5,8,3,3,1,1,1,15.0,5.0,10.0,10
12682,12682,2017-18,2017,2018,Newcastle,Tottenham,Loss,Home,2017-08-13,0,4,7,8,9,6,9,9,12,-2,-2,-1,-3,1,21.0,2.0,19.0,1
12683,12683,2017-18,2017,2018,Newcastle,Huddersfield,Loss,Away,2017-08-20,0,3,4,7,8,3,3,3,3,0,1,4,5,0,21.0,21.0,0.0,1
12684,12684,2017-18,2017,2018,Newcastle,West Ham,Win,Home,2017-08-26,3,0,3,4,7,0,3,3,6,0,0,1,1,1,21.0,11.0,10.0,1
12685,12685,2017-18,2017,2018,Newcastle,Swansea,Win,Away,2017-09-10,3,3,3,6,7,3,4,7,10,0,-1,-1,-3,0,21.0,15.0,6.0,2
12686,12686,2017-18,2017,2018,Newcastle,Stoke,Win,Home,2017-09-16,3,6,6,6,9,2,5,5,8,4,1,1,1,1,21.0,13.0,8.0,2
12687,12687,2017-18,2017,2018,Newcastle,Brighton,Loss,Away,2017-09-24,0,6,9,9,9,3,4,4,4,3,5,5,5,0,21.0,21.0,0.0,2
12688,12688,2017-18,2017,2018,Newcastle,Liverpool,Draw,Home,2017-10-01,1,3,6,9,9,4,4,7,10,-1,2,2,-1,1,21.0,4.0,17.0,3
12689,12689,2017-18,2017,2018,Newcastle,Southampton,Draw,Away,2017-10-15,1,1,4,7,10,0,3,3,4,1,1,4,6,0,21.0,8.0,13.0,3
12690,12690,2017-18,2017,2018,Newcastle,Crystal Palace,Win,Home,2017-10-21,3,2,2,5,8,3,3,3,3,-1,-1,2,5,1,21.0,14.0,7.0,3
12691,12691,2017-18,2017,2018,Newcastle,Burnley,Loss,Away,2017-10-30,0,4,5,5,8,1,4,5,6,3,1,0,2,0,21.0,16.0,5.0,3
12692,12692,2017-18,2017,2018,Newcastle,Bournemouth,Loss,Home,2017-11-04,0,3,4,5,5,3,3,4,4,0,1,1,1,1,21.0,9.0,12.0,4
12693,12693,2017-18,2017,2018,Newcastle,Man United,Loss,Away,2017-11-18,0,0,3,4,5,3,3,4,7,-3,0,0,-2,0,21.0,6.0,15.0,4
12694,12694,2017-18,2017,2018,Newcastle,Watford,Loss,Home,2017-11-25,0,0,0,3,4,3,3,3,6,-3,-3,0,-2,1,21.0,17.0,4.0,4
12695,12695,2017-18,2017,2018,Newcastle,West Brom,Draw,Away,2017-11-28,1,0,0,0,3,1,1,1,1,-1,-1,-1,2,0,21.0,10.0,11.0,4
12696,12696,2017-18,2017,2018,Newcastle,Chelsea,Loss,Away,2017-12-02,0,1,1,1,1,4,7,10,13,-3,-6,-9,-12,0,21.0,1.0,20.0,5
12697,12697,2017-18,2017,2018,Newcastle,Leicester,Loss,Home,2017-12-09,0,1,1,1,1,6,7,7,8,-5,-6,-6,-7,1,21.0,12.0,9.0,5
12698,12698,2017-18,2017,2018,Newcastle,Everton,Loss,Home,2017-12-13,0,0,1,1,1,4,7,7,8,-4,-6,-6,-7,1,21.0,7.0,14.0,5
12699,12699,2017-18,2017,2018,Newcastle,Arsenal,Loss,Away,2017-12-16,0,0,0,1,1,2,2,5,8,-2,-2,-4,-7,0,21.0,5.0,16.0,5
12700,12700,2017-18,2017,2018,Newcastle,West Ham,Win,Away,2017-12-23,3,0,0,0,1,4,7,7,7,-4,-7,-7,-6,0,21.0,11.0,10.0,5
12701,12701,2017-18,2017,2018,Newcastle,Man City,Loss,Home,2017-12-27,0,3,3,3,3,6,9,12,15,-3,-6,-9,-12,1,21.0,3.0,18.0,5
12702,12702,2017-18,2017,2018,Newcastle,Brighton,Draw,Home,2017-12-30,1,3,3,3,3,3,4,4,4,0,-1,-1,-1,1,21.0,21.0,0.0,5
12703,12703,2017-18,2017,2018,Newcastle,Stoke,Win,Away,2018-01-01,3,1,4,4,4,1,4,4,4,0,0,0,0,0,21.0,13.0,8.0,6
12704,12704,2017-18,2017,2018,Newcastle,Swansea,Draw,Home,2018-01-13,1,4,4,7,7,3,3,4,4,1,1,3,3,1,21.0,15.0,6.0,6
12705,12705,2017-18,2017,2018,Newcastle,Man City,Loss,Away,2018-01-20,0,4,5,5,8,3,4,7,10,1,1,-2,-2,0,21.0,3.0,18.0,6
12706,12706,2017-18,2017,2018,Newcastle,Burnley,Draw,Home,2018-01-31,1,1,4,5,5,0,0,1,2,1,4,4,3,1,21.0,16.0,5.0,6
12707,12707,2017-18,2017,2018,Newcastle,Crystal Palace,Draw,Away,2018-02-04,1,1,2,5,6,1,4,7,8,0,-2,-2,-2,0,21.0,14.0,7.0,7
12708,12708,2017-18,2017,2018,Newcastle,Man United,Win,Home,2018-02-11,3,2,2,3,6,3,6,9,12,-1,-4,-6,-6,1,21.0,6.0,15.0,7
12709,12709,2017-18,2017,2018,Newcastle,Bournemouth,Draw,Away,2018-02-24,1,4,5,5,6,3,6,7,10,1,-1,-2,-4,0,21.0,9.0,12.0,7
12710,12710,2017-18,2017,2018,Newcastle,Liverpool,Loss,Away,2018-03-03,0,4,5,6,6,6,7,10,10,-2,-2,-4,-4,0,21.0,4.0,17.0,8
12711,12711,2017-18,2017,2018,Newcastle,Southampton,Win,Home,2018-03-10,3,1,4,5,6,2,2,5,6,-1,2,0,0,1,21.0,8.0,13.0,8
12712,12712,2017-18,2017,2018,Newcastle,Huddersfield,Win,Home,2018-03-31,3,3,4,7,8,1,1,4,7,2,3,3,1,1,21.0,21.0,0.0,8
12713,12713,2017-18,2017,2018,Newcastle,Leicester,Win,Away,2018-04-07,3,6,6,7,10,6,7,8,8,0,-1,-1,2,0,21.0,12.0,9.0,9
12714,12714,2017-18,2017,2018,Newcastle,Arsenal,Win,Home,2018-04-15,3,6,9,9,10,6,9,9,9,0,0,0,1,1,21.0,5.0,16.0,9
12715,12715,2017-18,2017,2018,Newcastle,Everton,Loss,Away,2018-04-23,0,6,9,12,12,2,2,5,8,4,7,7,4,0,21.0,7.0,14.0,9
12716,12716,2017-18,2017,2018,Newcastle,West Brom,Loss,Home,2018-04-28,0,3,6,9,12,4,5,5,5,-1,1,4,7,1,21.0,10.0,11.0,9
12717,12717,2017-18,2017,2018,Newcastle,Watford,Loss,Away,2018-05-05,0,0,3,6,9,1,1,1,2,-1,2,5,7,0,21.0,17.0,4.0,10
12718,12718,2017-18,2017,2018,Newcastle,Tottenham,Loss,Away,2018-05-09,0,0,0,3,6,3,4,4,7,-3,-4,-1,-1,0,21.0,2.0,19.0,10
12719,12719,2017-18,2017,2018,Newcastle,Chelsea,Win,Home,2018-05-13,3,0,0,0,3,4,7,10,13,-4,-7,-10,-10,1,21.0,1.0,20.0,10
12720,12720,1993-94,1993,1994,Norwich,Man United,Loss,Home,1993-08-15,0,0,0,0,0,0,0,0,0,0,0,0,0,1,3.0,1.0,2.0,1
12721,12721,1993-94,1993,1994,Norwich,Blackburn,Win,Away,1993-08-18,3,0,0,0,0,3,3,3,3,-3,-3,-3,-3,0,3.0,4.0,-1.0,1
12722,12722,1993-94,1993,1994,Norwich,Leeds,Win,Away,1993-08-21,3,3,3,3,3,4,4,4,4,-1,-1,-1,-1,0,3.0,17.0,-14.0,1
12723,12723,1993-94,1993,1994,Norwich,Ipswich,Win,Home,1993-08-25,3,6,6,6,6,6,9,9,9,0,-3,-3,-3,1,3.0,16.0,-13.0,1
12724,12724,1993-94,1993,1994,Norwich,Swindon,Draw,Home,1993-08-28,1,6,9,9,9,0,0,0,0,6,9,9,9,1,3.0,21.0,-18.0,1
12725,12725,1993-94,1993,1994,Norwich,Sheffield Weds,Draw,Away,1993-09-01,1,4,7,10,10,1,1,2,2,3,6,8,8,0,3.0,7.0,-4.0,2
12726,12726,1993-94,1993,1994,Norwich,Wimbledon,Loss,Home,1993-09-11,0,2,5,8,11,4,4,5,6,-2,1,3,5,1,3.0,12.0,-9.0,2
12727,12727,1993-94,1993,1994,Norwich,QPR,Draw,Away,1993-09-18,1,1,2,5,8,3,6,6,9,-2,-4,-1,-1,0,3.0,5.0,-2.0,2
12728,12728,1993-94,1993,1994,Norwich,Everton,Win,Away,1993-09-25,3,1,2,3,6,6,6,6,6,-5,-4,-3,0,0,3.0,13.0,-10.0,2
12729,12729,1993-94,1993,1994,Norwich,Coventry,Win,Home,1993-10-02,3,4,4,5,6,1,2,5,6,3,2,0,0,1,3.0,15.0,-12.0,3
12730,12730,1993-94,1993,1994,Norwich,Chelsea,Win,Away,1993-10-16,3,6,7,7,8,3,4,7,8,3,3,0,0,0,3.0,11.0,-8.0,3
12731,12731,1993-94,1993,1994,Norwich,West Ham,Draw,Home,1993-10-23,1,6,9,10,10,4,4,7,8,2,5,3,2,1,3.0,21.0,-18.0,3
12732,12732,1993-94,1993,1994,Norwich,Arsenal,Draw,Away,1993-10-30,1,4,7,10,11,2,3,6,6,2,4,4,5,0,3.0,10.0,-7.0,3
12733,12733,1993-94,1993,1994,Norwich,Sheffield United,Win,Away,1993-11-06,3,2,5,8,11,2,3,4,4,0,2,4,7,0,3.0,14.0,-11.0,4
12734,12734,1993-94,1993,1994,Norwich,Man City,Draw,Home,1993-11-20,1,4,5,8,11,0,1,2,3,4,4,6,8,1,3.0,9.0,-6.0,4
12735,12735,1993-94,1993,1994,Norwich,Oldham,Loss,Away,1993-11-27,0,4,5,6,9,0,0,3,4,4,5,3,5,0,3.0,19.0,-16.0,4
12736,12736,1993-94,1993,1994,Norwich,Man United,Draw,Away,1993-12-04,1,1,4,5,6,4,7,10,13,-3,-3,-5,-7,0,3.0,1.0,2.0,5
12737,12737,1993-94,1993,1994,Norwich,Leeds,Win,Home,1993-12-13,3,1,2,5,6,6,9,10,11,-5,-7,-5,-5,1,3.0,17.0,-14.0,5
12738,12738,1993-94,1993,1994,Norwich,Ipswich,Loss,Away,1993-12-18,0,4,4,5,8,4,5,8,9,0,-1,-3,-1,0,3.0,16.0,-13.0,5
12739,12739,1993-94,1993,1994,Norwich,Tottenham,Win,Away,1993-12-27,3,3,4,4,5,4,5,5,6,-1,-1,-1,-1,0,3.0,8.0,-5.0,5
12740,12740,1993-94,1993,1994,Norwich,Aston Villa,Loss,Home,1993-12-29,0,3,6,7,7,0,1,2,2,3,5,5,5,1,3.0,2.0,1.0,5
12741,12741,1993-94,1993,1994,Norwich,Southampton,Win,Away,1994-01-01,3,3,3,6,7,4,4,4,4,-1,-1,2,3,0,3.0,18.0,-15.0,6
12742,12742,1993-94,1993,1994,Norwich,Newcastle,Loss,Home,1994-01-04,0,3,6,6,9,3,4,7,8,0,2,-1,1,1,3.0,21.0,-18.0,6
12743,12743,1993-94,1993,1994,Norwich,Chelsea,Draw,Home,1994-01-15,1,3,3,6,6,6,9,9,10,-3,-6,-3,-4,1,3.0,11.0,-8.0,6
12744,12744,1993-94,1993,1994,Norwich,West Ham,Draw,Away,1994-01-24,1,1,4,4,7,1,4,4,5,0,0,0,2,0,3.0,21.0,-18.0,6
12745,12745,1993-94,1993,1994,Norwich,Liverpool,Draw,Home,1994-02-05,1,2,2,5,5,6,7,10,11,-4,-5,-5,-6,1,3.0,6.0,-3.0,7
12746,12746,1993-94,1993,1994,Norwich,Arsenal,Draw,Home,1994-02-13,1,2,3,3,6,2,3,6,9,0,0,-3,-3,1,3.0,10.0,-7.0,7
12747,12747,1993-94,1993,1994,Norwich,Swindon,Draw,Away,1994-02-19,1,2,3,4,4,3,6,6,7,-1,-3,-2,-3,0,3.0,21.0,-18.0,7
12748,12748,1993-94,1993,1994,Norwich,Blackburn,Draw,Home,1994-02-22,1,2,3,4,5,6,9,12,15,-4,-6,-8,-10,1,3.0,4.0,-1.0,7
12749,12749,1993-94,1993,1994,Norwich,Sheffield Weds,Draw,Home,1994-02-26,1,2,3,4,5,6,6,9,12,-4,-3,-5,-7,1,3.0,7.0,-4.0,7
12750,12750,1993-94,1993,1994,Norwich,Wimbledon,Loss,Away,1994-03-05,0,2,3,4,5,3,3,4,7,-1,0,0,-2,0,3.0,12.0,-9.0,8
12751,12751,1993-94,1993,1994,Norwich,QPR,Loss,Home,1994-03-12,0,1,2,3,4,1,4,4,5,0,-2,-1,-1,1,3.0,5.0,-2.0,8
12752,12752,1993-94,1993,1994,Norwich,Everton,Win,Home,1994-03-21,3,0,1,2,3,3,4,5,8,-3,-3,-3,-5,1,3.0,13.0,-10.0,8
12753,12753,1993-94,1993,1994,Norwich,Coventry,Loss,Away,1994-03-26,0,3,3,4,5,0,0,0,3,3,3,4,2,0,3.0,15.0,-12.0,8
12754,12754,1993-94,1993,1994,Norwich,Newcastle,Loss,Away,1994-03-29,0,3,3,3,4,6,9,12,15,-3,-6,-9,-11,0,3.0,21.0,-18.0,8
12755,12755,1993-94,1993,1994,Norwich,Tottenham,Loss,Home,1994-04-02,0,0,3,3,3,4,5,6,6,-4,-2,-3,-3,1,3.0,8.0,-5.0,9
12756,12756,1993-94,1993,1994,Norwich,Aston Villa,Draw,Away,1994-04-04,1,0,0,3,3,1,1,1,1,-1,-1,2,2,0,3.0,2.0,1.0,9
12757,12757,1993-94,1993,1994,Norwich,Southampton,Loss,Home,1994-04-09,0,1,1,1,4,0,0,1,1,1,1,0,3,1,3.0,18.0,-15.0,9
12758,12758,1993-94,1993,1994,Norwich,Man City,Draw,Away,1994-04-16,1,1,1,1,1,6,9,10,11,-5,-8,-9,-10,0,3.0,9.0,-6.0,9
12759,12759,1993-94,1993,1994,Norwich,Sheffield United,Loss,Home,1994-04-23,0,1,2,2,2,1,4,7,8,0,-2,-5,-6,1,3.0,14.0,-11.0,9
12760,12760,1993-94,1993,1994,Norwich,Liverpool,Win,Away,1994-04-30,3,1,1,2,2,3,6,7,7,-2,-5,-5,-5,0,3.0,6.0,-3.0,9
12761,12761,1993-94,1993,1994,Norwich,Oldham,Draw,Home,1994-05-07,1,3,4,4,5,1,2,2,2,2,2,2,3,1,3.0,19.0,-16.0,10
12762,12762,1994-95,1994,1995,Norwich,Chelsea,Loss,Away,1994-08-20,0,4,4,5,5,3,4,7,8,1,0,-2,-3,0,12.0,14.0,-2.0,1
12763,12763,1994-95,1994,1995,Norwich,Crystal Palace,Draw,Home,1994-08-24,1,1,4,4,5,0,0,0,0,1,4,4,5,1,12.0,21.0,-9.0,1
12764,12764,1994-95,1994,1995,Norwich,West Ham,Win,Home,1994-08-27,3,1,2,5,5,1,2,3,6,0,0,2,-1,1,12.0,13.0,-1.0,1
12765,12765,1994-95,1994,1995,Norwich,Sheffield Weds,Draw,Away,1994-08-31,1,4,4,5,8,3,3,4,5,1,1,1,3,0,12.0,7.0,5.0,1
12766,12766,1994-95,1994,1995,Norwich,Arsenal,Draw,Home,1994-09-10,1,4,5,5,6,1,1,4,4,3,4,1,2,1,12.0,4.0,8.0,2
12767,12767,1994-95,1994,1995,Norwich,Ipswich,Win,Away,1994-09-19,3,2,5,6,6,0,3,4,4,2,2,2,2,0,12.0,19.0,-7.0,2
12768,12768,1994-95,1994,1995,Norwich,Man City,Loss,Away,1994-09-24,0,4,5,8,9,2,2,5,8,2,3,3,1,0,12.0,16.0,-4.0,2
12769,12769,1994-95,1994,1995,Norwich,Blackburn,Win,Home,1994-10-01,3,3,4,5,8,6,9,10,13,-3,-5,-5,-5,1,12.0,2.0,10.0,3
12770,12770,1994-95,1994,1995,Norwich,Leeds,Win,Home,1994-10-08,3,3,6,7,8,4,4,7,10,-1,2,0,-2,1,12.0,5.0,7.0,3
12771,12771,1994-95,1994,1995,Norwich,Aston Villa,Draw,Away,1994-10-15,1,6,6,9,10,0,0,0,3,6,6,9,7,0,12.0,10.0,2.0,3
12772,12772,1994-95,1994,1995,Norwich,QPR,Win,Home,1994-10-22,3,4,7,7,10,1,1,1,2,3,6,6,8,1,12.0,9.0,3.0,3
12773,12773,1994-95,1994,1995,Norwich,Wimbledon,Loss,Away,1994-10-30,0,4,7,10,10,0,0,0,3,4,7,10,7,0,12.0,6.0,6.0,3
12774,12774,1994-95,1994,1995,Norwich,Southampton,Draw,Away,1994-11-02,1,3,4,7,10,0,0,3,6,3,4,4,4,0,12.0,18.0,-6.0,4
12775,12775,1994-95,1994,1995,Norwich,Everton,Draw,Home,1994-11-05,1,1,4,5,8,4,4,4,4,-3,0,1,4,1,12.0,17.0,-5.0,4
12776,12776,1994-95,1994,1995,Norwich,Coventry,Loss,Away,1994-11-19,0,2,2,5,6,1,4,4,7,1,-2,1,-1,0,12.0,11.0,1.0,4
12777,12777,1994-95,1994,1995,Norwich,Leicester,Win,Home,1994-11-26,3,1,2,2,5,3,3,3,3,-2,-1,-1,2,1,12.0,21.0,-9.0,4
12778,12778,1994-95,1994,1995,Norwich,Man United,Loss,Away,1994-12-03,0,3,4,5,5,4,7,10,13,-1,-3,-5,-8,0,12.0,1.0,11.0,5
12779,12779,1994-95,1994,1995,Norwich,Chelsea,Win,Home,1994-12-10,3,3,3,4,5,3,4,7,7,0,-1,-3,-2,1,12.0,14.0,-2.0,5
12780,12780,1994-95,1994,1995,Norwich,Crystal Palace,Win,Away,1994-12-17,3,3,6,6,7,1,2,2,5,2,4,4,2,0,12.0,21.0,-9.0,5
12781,12781,1994-95,1994,1995,Norwich,Tottenham,Loss,Home,1994-12-26,0,6,6,9,9,4,7,8,9,2,-1,1,0,1,12.0,15.0,-3.0,5
12782,12782,1994-95,1994,1995,Norwich,Nott'm Forest,Loss,Away,1994-12-27,0,3,6,6,9,4,7,8,8,-1,-1,-2,1,0,12.0,21.0,-9.0,5
12783,12783,1994-95,1994,1995,Norwich,Newcastle,Win,Home,1994-12-31,3,0,3,6,6,2,5,5,6,-2,-2,1,0,1,12.0,3.0,9.0,5
12784,12784,1994-95,1994,1995,Norwich,Liverpool,Loss,Away,1995-01-02,0,3,3,6,9,6,9,10,11,-3,-6,-4,-2,0,12.0,8.0,4.0,6
12785,12785,1994-95,1994,1995,Norwich,Wimbledon,Loss,Home,1995-01-14,0,3,3,3,6,4,7,10,11,-1,-4,-7,-5,1,12.0,6.0,6.0,6
12786,12786,1994-95,1994,1995,Norwich,Coventry,Draw,Home,1995-01-25,1,0,3,3,3,1,1,1,1,-1,2,2,2,1,12.0,11.0,1.0,6
12787,12787,1994-95,1994,1995,Norwich,Everton,Loss,Away,1995-02-04,0,1,1,4,4,1,4,5,5,0,-3,-1,-1,0,12.0,17.0,-5.0,7
12788,12788,1994-95,1994,1995,Norwich,Southampton,Draw,Home,1995-02-11,1,1,1,1,4,2,3,4,5,-1,-2,-3,-1,1,12.0,18.0,-6.0,7
12789,12789,1994-95,1994,1995,Norwich,Man United,Loss,Home,1995-02-22,0,1,2,2,2,6,7,10,11,-5,-5,-8,-9,1,12.0,1.0,11.0,7
12790,12790,1994-95,1994,1995,Norwich,Blackburn,Draw,Away,1995-02-25,1,1,1,2,2,6,6,7,10,-5,-5,-5,-8,0,12.0,2.0,10.0,7
12791,12791,1994-95,1994,1995,Norwich,Man City,Draw,Home,1995-03-04,1,1,2,2,3,4,4,5,5,-3,-2,-3,-2,1,12.0,16.0,-4.0,8
12792,12792,1994-95,1994,1995,Norwich,Sheffield Weds,Draw,Home,1995-03-08,1,2,2,3,3,3,3,3,6,-1,-1,0,-3,1,12.0,7.0,5.0,8
12793,12793,1994-95,1994,1995,Norwich,West Ham,Draw,Away,1995-03-11,1,2,3,3,4,3,3,3,4,-1,0,0,0,0,12.0,13.0,-1.0,8
12794,12794,1994-95,1994,1995,Norwich,QPR,Loss,Away,1995-03-15,0,2,3,4,4,6,7,8,11,-4,-4,-4,-7,0,12.0,9.0,3.0,8
12795,12795,1994-95,1994,1995,Norwich,Ipswich,Win,Home,1995-03-20,3,1,2,3,4,0,0,3,3,1,2,0,1,1,12.0,19.0,-7.0,8
12796,12796,1994-95,1994,1995,Norwich,Arsenal,Loss,Away,1995-04-01,0,3,4,5,6,0,0,0,3,3,4,5,3,0,12.0,4.0,8.0,9
12797,12797,1994-95,1994,1995,Norwich,Leicester,Loss,Away,1995-04-05,0,3,3,4,5,0,0,0,0,3,3,4,5,0,12.0,21.0,-9.0,9
12798,12798,1994-95,1994,1995,Norwich,Newcastle,Loss,Away,1995-04-08,0,0,3,3,4,1,4,7,7,-1,-1,-4,-3,0,12.0,3.0,9.0,9
12799,12799,1994-95,1994,1995,Norwich,Nott'm Forest,Loss,Home,1995-04-12,0,0,0,3,3,4,7,10,13,-4,-7,-7,-10,1,12.0,21.0,-9.0,9
12800,12800,1994-95,1994,1995,Norwich,Tottenham,Loss,Away,1995-04-17,0,0,0,0,3,4,4,5,8,-4,-4,-5,-5,0,12.0,15.0,-3.0,9
12801,12801,1994-95,1994,1995,Norwich,Liverpool,Loss,Home,1995-04-29,0,0,0,0,0,3,6,6,9,-3,-6,-6,-9,1,12.0,8.0,4.0,9
12802,12802,1994-95,1994,1995,Norwich,Leeds,Loss,Away,1995-05-06,0,0,0,0,0,6,7,10,13,-6,-7,-10,-13,0,12.0,5.0,7.0,10
12803,12803,1994-95,1994,1995,Norwich,Aston Villa,Draw,Home,1995-05-14,1,0,0,0,0,4,4,4,4,-4,-4,-4,-4,1,12.0,10.0,2.0,10
12804,12804,2004-05,2004,2005,Norwich,Crystal Palace,Draw,Home,2004-08-14,1,1,1,1,1,4,4,4,7,-3,-3,-3,-6,1,21.0,21.0,0.0,1
12805,12805,2004-05,2004,2005,Norwich,Man United,Loss,Away,2004-08-21,0,2,2,2,2,3,4,4,4,-1,-2,-2,-2,0,21.0,3.0,18.0,1
12806,12806,2004-05,2004,2005,Norwich,Newcastle,Draw,Away,2004-08-25,1,1,2,2,2,1,2,3,4,0,0,-1,-2,0,21.0,5.0,16.0,1
12807,12807,2004-05,2004,2005,Norwich,Arsenal,Loss,Home,2004-08-28,0,1,2,3,3,6,9,12,15,-5,-7,-9,-12,1,21.0,1.0,20.0,1
12808,12808,2004-05,2004,2005,Norwich,Tottenham,Draw,Away,2004-09-12,1,1,1,2,3,4,7,8,11,-3,-6,-6,-8,0,21.0,14.0,7.0,2
12809,12809,2004-05,2004,2005,Norwich,Aston Villa,Draw,Home,2004-09-18,1,1,2,2,3,4,4,5,8,-3,-2,-3,-5,1,21.0,6.0,15.0,2
12810,12810,2004-05,2004,2005,Norwich,Liverpool,Loss,Away,2004-09-25,0,2,2,3,3,3,3,6,7,-1,-1,-3,-4,0,21.0,4.0,17.0,2
12811,12811,2004-05,2004,2005,Norwich,Portsmouth,Draw,Home,2004-10-02,1,1,2,2,3,0,3,6,6,1,-1,-4,-3,1,21.0,13.0,8.0,3
12812,12812,2004-05,2004,2005,Norwich,West Brom,Draw,Away,2004-10-16,1,1,2,3,3,3,4,4,4,-2,-2,-1,-1,0,21.0,21.0,0.0,3
12813,12813,2004-05,2004,2005,Norwich,Everton,Loss,Home,2004-10-23,0,2,2,3,4,3,6,9,12,-1,-4,-6,-8,1,21.0,17.0,4.0,3
12814,12814,2004-05,2004,2005,Norwich,Man City,Draw,Away,2004-11-01,1,1,2,2,3,3,4,4,7,-2,-2,-2,-4,0,21.0,16.0,5.0,4
12815,12815,2004-05,2004,2005,Norwich,Blackburn,Draw,Home,2004-11-06,1,1,2,3,3,1,1,2,2,0,1,1,1,1,21.0,15.0,6.0,4
12816,12816,2004-05,2004,2005,Norwich,Charlton,Loss,Away,2004-11-13,0,2,2,3,4,3,3,4,4,-1,-1,-1,0,0,21.0,7.0,14.0,4
12817,12817,2004-05,2004,2005,Norwich,Southampton,Win,Home,2004-11-20,3,1,2,2,3,4,5,6,6,-3,-3,-4,-3,1,21.0,12.0,9.0,4
12818,12818,2004-05,2004,2005,Norwich,Birmingham,Draw,Away,2004-11-27,1,3,4,5,5,1,4,4,5,2,0,1,0,0,21.0,10.0,11.0,4
12819,12819,2004-05,2004,2005,Norwich,Fulham,Loss,Home,2004-12-04,0,4,4,5,6,0,0,3,6,4,4,2,0,1,21.0,9.0,12.0,5
12820,12820,2004-05,2004,2005,Norwich,Bolton,Win,Home,2004-12-11,3,1,4,4,5,0,1,1,2,1,3,3,3,1,21.0,8.0,13.0,5
12821,12821,2004-05,2004,2005,Norwich,Chelsea,Loss,Away,2004-12-18,0,3,4,7,7,4,7,8,11,-1,-3,-1,-4,0,21.0,2.0,19.0,5
12822,12822,2004-05,2004,2005,Norwich,Tottenham,Loss,Home,2004-12-26,0,3,3,4,7,6,9,12,12,-3,-6,-8,-5,1,21.0,14.0,7.0,5
12823,12823,2004-05,2004,2005,Norwich,Middlesbrough,Loss,Away,2004-12-28,0,0,3,3,4,3,4,7,7,-3,-1,-4,-3,0,21.0,11.0,10.0,5
12824,12824,2004-05,2004,2005,Norwich,Portsmouth,Draw,Away,2005-01-01,1,0,0,3,3,3,3,4,5,-3,-3,-1,-2,0,21.0,13.0,8.0,6
12825,12825,2004-05,2004,2005,Norwich,Liverpool,Loss,Home,2005-01-03,0,1,1,1,4,3,6,9,10,-2,-5,-8,-6,1,21.0,4.0,17.0,6
12826,12826,2004-05,2004,2005,Norwich,Aston Villa,Loss,Away,2005-01-15,0,1,1,1,1,3,3,3,3,-2,-2,-2,-2,0,21.0,6.0,15.0,6
12827,12827,2004-05,2004,2005,Norwich,Middlesbrough,Draw,Home,2005-01-22,1,0,1,1,1,1,1,4,4,-1,0,-3,-3,1,21.0,11.0,10.0,6
12828,12828,2004-05,2004,2005,Norwich,Everton,Loss,Away,2005-02-02,0,1,1,2,2,1,4,4,4,0,-3,-2,-2,0,21.0,17.0,4.0,7
12829,12829,2004-05,2004,2005,Norwich,West Brom,Win,Home,2005-02-05,3,1,1,1,2,4,4,5,6,-3,-3,-4,-4,1,21.0,21.0,0.0,7
12830,12830,2004-05,2004,2005,Norwich,Blackburn,Loss,Away,2005-02-12,0,3,4,4,4,0,0,3,6,3,4,1,-2,0,21.0,15.0,6.0,7
12831,12831,2004-05,2004,2005,Norwich,Man City,Loss,Home,2005-02-28,0,3,3,4,4,1,2,2,5,2,1,2,-1,1,21.0,16.0,5.0,7
12832,12832,2004-05,2004,2005,Norwich,Chelsea,Loss,Home,2005-03-05,0,0,3,3,4,4,7,10,13,-4,-4,-7,-9,1,21.0,2.0,19.0,8
12833,12833,2004-05,2004,2005,Norwich,Bolton,Loss,Away,2005-03-19,0,0,0,3,3,3,4,7,10,-3,-4,-4,-7,0,21.0,8.0,13.0,8
12834,12834,2004-05,2004,2005,Norwich,Arsenal,Loss,Away,2005-04-02,0,0,0,0,3,6,7,10,13,-6,-7,-10,-10,0,21.0,1.0,20.0,9
12835,12835,2004-05,2004,2005,Norwich,Man United,Win,Home,2005-04-09,3,0,0,0,0,4,5,8,11,-4,-5,-8,-11,1,21.0,3.0,18.0,9
12836,12836,2004-05,2004,2005,Norwich,Crystal Palace,Draw,Away,2005-04-16,1,3,3,3,3,0,0,1,4,3,3,2,-1,0,21.0,21.0,0.0,9
12837,12837,2004-05,2004,2005,Norwich,Newcastle,Win,Home,2005-04-20,3,4,4,4,4,0,1,4,7,4,3,0,-3,1,21.0,5.0,16.0,9
12838,12838,2004-05,2004,2005,Norwich,Charlton,Win,Home,2005-04-23,3,4,7,7,7,1,1,2,2,3,6,5,5,1,21.0,7.0,14.0,9
12839,12839,2004-05,2004,2005,Norwich,Southampton,Loss,Away,2005-04-30,0,6,7,10,10,1,1,1,1,5,6,9,9,0,21.0,12.0,9.0,9
12840,12840,2004-05,2004,2005,Norwich,Birmingham,Win,Home,2005-05-07,3,3,6,7,10,4,4,5,6,-1,2,2,4,1,21.0,10.0,11.0,10
12841,12841,2004-05,2004,2005,Norwich,Fulham,Loss,Away,2005-05-15,0,3,6,9,10,3,6,6,7,0,0,3,3,0,21.0,9.0,12.0,10
12842,12842,2011-12,2011,2012,Norwich,Wigan,Draw,Away,2011-08-13,1,3,3,6,9,6,7,8,8,-3,-4,-2,1,0,21.0,16.0,5.0,1
12843,12843,2011-12,2011,2012,Norwich,Stoke,Draw,Home,2011-08-21,1,1,4,4,7,1,1,4,5,0,3,0,2,1,21.0,13.0,8.0,1
12844,12844,2011-12,2011,2012,Norwich,Chelsea,Loss,Away,2011-08-27,0,2,2,5,5,4,4,5,5,-2,-2,0,0,0,21.0,2.0,19.0,1
12845,12845,2011-12,2011,2012,Norwich,West Brom,Loss,Home,2011-09-11,0,1,2,2,5,0,0,1,4,1,2,1,1,1,21.0,11.0,10.0,2
12846,12846,2011-12,2011,2012,Norwich,Bolton,Win,Away,2011-09-17,3,0,1,2,2,0,0,3,3,0,1,-1,-1,0,21.0,14.0,7.0,2
12847,12847,2011-12,2011,2012,Norwich,Sunderland,Win,Home,2011-09-26,3,3,3,4,5,3,4,4,5,0,-1,0,0,1,21.0,10.0,11.0,2
12848,12848,2011-12,2011,2012,Norwich,Man United,Loss,Away,2011-10-01,0,6,6,6,7,4,7,10,13,2,-1,-4,-6,0,21.0,1.0,20.0,3
12849,12849,2011-12,2011,2012,Norwich,Swansea,Win,Home,2011-10-15,3,3,6,6,6,3,6,6,7,0,0,0,-1,1,21.0,21.0,0.0,3
12850,12850,2011-12,2011,2012,Norwich,Liverpool,Draw,Away,2011-10-22,1,3,6,9,9,4,7,7,7,-1,-1,2,2,0,21.0,6.0,15.0,3
12851,12851,2011-12,2011,2012,Norwich,Blackburn,Draw,Home,2011-10-29,1,4,4,7,10,1,1,1,4,3,3,6,6,1,21.0,15.0,6.0,3
12852,12852,2011-12,2011,2012,Norwich,Aston Villa,Loss,Away,2011-11-05,0,2,5,5,8,1,1,4,5,1,4,1,3,0,21.0,9.0,12.0,4
12853,12853,2011-12,2011,2012,Norwich,Arsenal,Loss,Home,2011-11-19,0,1,2,5,5,6,9,12,12,-5,-7,-7,-7,1,21.0,4.0,17.0,4
12854,12854,2011-12,2011,2012,Norwich,QPR,Win,Home,2011-11-26,3,0,1,2,5,3,3,6,7,-3,-2,-4,-2,1,21.0,21.0,0.0,4
12855,12855,2011-12,2011,2012,Norwich,Man City,Loss,Away,2011-12-03,0,3,3,4,5,4,7,10,13,-1,-4,-6,-8,0,21.0,3.0,18.0,5
12856,12856,2011-12,2011,2012,Norwich,Newcastle,Win,Home,2011-12-10,3,3,3,3,4,1,1,4,7,2,2,-1,-3,1,21.0,12.0,9.0,5
12857,12857,2011-12,2011,2012,Norwich,Everton,Draw,Away,2011-12-17,1,3,6,6,6,0,3,6,6,3,3,0,0,0,21.0,7.0,14.0,5
12858,12858,2011-12,2011,2012,Norwich,Wolves,Draw,Away,2011-12-20,1,4,4,7,7,0,3,3,3,4,1,4,4,0,21.0,17.0,4.0,5
12859,12859,2011-12,2011,2012,Norwich,Tottenham,Loss,Home,2011-12-27,0,2,5,5,8,4,4,7,10,-2,1,-2,-2,1,21.0,5.0,16.0,5
12860,12860,2011-12,2011,2012,Norwich,Fulham,Draw,Home,2011-12-31,1,1,2,5,5,1,4,4,7,0,-2,1,-2,1,21.0,8.0,13.0,5
12861,12861,2011-12,2011,2012,Norwich,QPR,Win,Away,2012-01-02,3,1,2,3,6,1,1,1,1,0,1,2,5,0,21.0,21.0,0.0,6
12862,12862,2011-12,2011,2012,Norwich,West Brom,Win,Away,2012-01-14,3,4,4,5,6,0,1,4,7,4,3,1,-1,0,21.0,11.0,10.0,6
12863,12863,2011-12,2011,2012,Norwich,Chelsea,Draw,Home,2012-01-21,1,6,7,7,8,6,6,7,8,0,1,0,0,1,21.0,2.0,19.0,6
12864,12864,2011-12,2011,2012,Norwich,Sunderland,Loss,Away,2012-02-01,0,4,7,8,8,3,6,9,10,1,1,-1,-2,0,21.0,10.0,11.0,7
12865,12865,2011-12,2011,2012,Norwich,Bolton,Win,Home,2012-02-04,3,1,4,7,8,4,4,7,8,-3,0,0,0,1,21.0,14.0,7.0,7
12866,12866,2011-12,2011,2012,Norwich,Swansea,Win,Away,2012-02-11,3,3,4,7,10,4,4,7,10,-1,0,0,0,0,21.0,21.0,0.0,7
12867,12867,2011-12,2011,2012,Norwich,Man United,Loss,Home,2012-02-26,0,6,6,7,10,4,7,10,13,2,-1,-3,-3,1,21.0,1.0,20.0,7
12868,12868,2011-12,2011,2012,Norwich,Stoke,Loss,Away,2012-03-03,0,3,6,6,7,3,3,3,3,0,3,3,4,0,21.0,13.0,8.0,8
12869,12869,2011-12,2011,2012,Norwich,Wigan,Draw,Home,2012-03-11,1,0,3,6,6,1,4,5,5,-1,-1,1,1,1,21.0,16.0,5.0,8
12870,12870,2011-12,2011,2012,Norwich,Newcastle,Loss,Away,2012-03-18,0,1,1,4,7,1,2,2,5,0,-1,2,2,0,21.0,12.0,9.0,8
12871,12871,2011-12,2011,2012,Norwich,Wolves,Win,Home,2012-03-24,3,1,1,1,4,0,0,1,1,1,1,0,3,1,21.0,17.0,4.0,8
12872,12872,2011-12,2011,2012,Norwich,Fulham,Loss,Away,2012-03-31,0,3,4,4,4,0,0,3,6,3,4,1,-2,0,21.0,8.0,13.0,8
12873,12873,2011-12,2011,2012,Norwich,Everton,Draw,Home,2012-04-07,1,3,3,4,4,6,6,6,9,-3,-3,-2,-5,1,21.0,7.0,14.0,9
12874,12874,2011-12,2011,2012,Norwich,Tottenham,Win,Away,2012-04-09,3,1,4,4,5,4,5,6,6,-3,-1,-2,-1,0,21.0,5.0,16.0,9
12875,12875,2011-12,2011,2012,Norwich,Man City,Loss,Home,2012-04-14,0,4,4,7,7,3,4,5,8,1,0,2,-1,1,21.0,3.0,18.0,9
12876,12876,2011-12,2011,2012,Norwich,Blackburn,Loss,Away,2012-04-21,0,3,4,4,7,0,0,0,0,3,4,4,7,0,21.0,15.0,6.0,9
12877,12877,2011-12,2011,2012,Norwich,Liverpool,Loss,Home,2012-04-28,0,0,3,4,4,3,4,4,4,-3,-1,0,0,1,21.0,6.0,15.0,9
12878,12878,2011-12,2011,2012,Norwich,Arsenal,Draw,Away,2012-05-05,1,0,0,3,4,2,2,5,8,-2,-2,-2,-4,0,21.0,4.0,17.0,10
12879,12879,2011-12,2011,2012,Norwich,Aston Villa,Win,Home,2012-05-13,3,1,1,1,4,2,2,3,3,-1,-1,-2,1,1,21.0,9.0,12.0,10
12880,12880,2012-13,2012,2013,Norwich,Fulham,Loss,Away,2012-08-18,0,4,4,4,4,3,6,6,9,1,-2,-2,-5,0,12.0,9.0,3.0,1
12881,12881,2012-13,2012,2013,Norwich,QPR,Draw,Home,2012-08-25,1,3,4,4,4,0,3,3,6,3,1,1,-2,1,12.0,17.0,-5.0,1
12882,12882,2012-13,2012,2013,Norwich,Tottenham,Draw,Away,2012-09-01,1,1,4,5,5,1,4,5,8,0,0,0,-3,0,12.0,4.0,8.0,2
12883,12883,2012-13,2012,2013,Norwich,West Ham,Draw,Home,2012-09-15,1,2,2,5,6,3,6,6,6,-1,-4,-1,0,1,12.0,21.0,-9.0,2
12884,12884,2012-13,2012,2013,Norwich,Newcastle,Loss,Away,2012-09-23,0,2,3,3,6,2,2,5,5,0,1,-2,1,0,12.0,5.0,7.0,2
12885,12885,2012-13,2012,2013,Norwich,Liverpool,Loss,Home,2012-09-29,0,1,2,3,3,1,1,2,2,0,1,1,1,1,12.0,8.0,4.0,2
12886,12886,2012-13,2012,2013,Norwich,Chelsea,Loss,Away,2012-10-06,0,0,1,2,3,6,7,10,13,-6,-6,-8,-10,0,12.0,6.0,6.0,3
12887,12887,2012-13,2012,2013,Norwich,Arsenal,Win,Home,2012-10-20,3,0,0,1,2,3,4,7,10,-3,-4,-6,-8,1,12.0,3.0,9.0,3
12888,12888,2012-13,2012,2013,Norwich,Aston Villa,Draw,Away,2012-10-27,1,3,3,3,4,0,1,1,4,3,2,2,0,0,12.0,16.0,-4.0,3
12889,12889,2012-13,2012,2013,Norwich,Stoke,Win,Home,2012-11-03,3,4,4,4,4,1,2,5,5,3,2,-1,-1,1,12.0,14.0,-2.0,4
12890,12890,2012-13,2012,2013,Norwich,Reading,Draw,Away,2012-11-10,1,4,7,7,7,2,2,3,4,2,5,4,3,0,12.0,21.0,-9.0,4
12891,12891,2012-13,2012,2013,Norwich,Man United,Win,Home,2012-11-17,3,4,5,8,8,6,9,12,15,-2,-4,-4,-7,1,12.0,2.0,10.0,4
12892,12892,2012-13,2012,2013,Norwich,Everton,Draw,Away,2012-11-24,1,4,7,8,11,3,4,5,6,1,3,3,5,0,12.0,7.0,5.0,4
12893,12893,2012-13,2012,2013,Norwich,Southampton,Draw,Away,2012-11-28,1,4,5,8,9,6,7,7,7,-2,-2,1,2,0,12.0,21.0,-9.0,4
12894,12894,2012-13,2012,2013,Norwich,Sunderland,Win,Home,2012-12-02,3,2,5,6,9,1,4,4,4,1,1,2,5,1,12.0,13.0,-1.0,5
12895,12895,2012-13,2012,2013,Norwich,Swansea,Win,Away,2012-12-08,3,4,5,8,9,6,7,10,11,-2,-2,-2,-2,0,12.0,11.0,1.0,5
12896,12896,2012-13,2012,2013,Norwich,Wigan,Win,Home,2012-12-15,3,6,7,8,11,1,1,4,4,5,6,4,7,1,12.0,15.0,-3.0,5
12897,12897,2012-13,2012,2013,Norwich,West Brom,Loss,Away,2012-12-22,0,6,9,10,11,1,1,1,4,5,8,9,7,0,12.0,10.0,2.0,5
12898,12898,2012-13,2012,2013,Norwich,Chelsea,Loss,Home,2012-12-26,0,3,6,9,10,6,6,7,8,-3,0,2,2,1,12.0,6.0,6.0,5
12899,12899,2012-13,2012,2013,Norwich,Man City,Loss,Home,2012-12-29,0,0,3,6,9,3,6,6,7,-3,-3,0,2,1,12.0,1.0,11.0,5
12900,12900,2012-13,2012,2013,Norwich,West Ham,Loss,Away,2013-01-01,0,0,0,3,6,0,1,1,4,0,-1,2,2,0,12.0,21.0,-9.0,6
12901,12901,2012-13,2012,2013,Norwich,Newcastle,Draw,Home,2013-01-12,1,0,0,0,3,0,0,3,3,0,0,-3,0,1,12.0,5.0,7.0,6
12902,12902,2012-13,2012,2013,Norwich,Liverpool,Loss,Away,2013-01-19,0,1,1,1,1,3,6,6,9,-2,-5,-5,-8,0,12.0,8.0,4.0,6
12903,12903,2012-13,2012,2013,Norwich,Tottenham,Draw,Home,2013-01-30,1,1,1,1,1,2,5,8,11,-1,-4,-7,-10,1,12.0,4.0,8.0,6
12904,12904,2012-13,2012,2013,Norwich,QPR,Draw,Away,2013-02-02,1,1,2,2,2,2,3,6,6,-1,-1,-4,-4,0,12.0,17.0,-5.0,7
12905,12905,2012-13,2012,2013,Norwich,Fulham,Draw,Home,2013-02-09,1,2,2,3,3,3,3,4,7,-1,-1,-1,-4,1,12.0,9.0,3.0,7
12906,12906,2012-13,2012,2013,Norwich,Everton,Win,Home,2013-02-23,3,2,3,3,4,1,4,5,6,1,-1,-2,-2,1,12.0,7.0,5.0,7
12907,12907,2012-13,2012,2013,Norwich,Man United,Loss,Away,2013-03-02,0,4,5,6,6,6,9,12,13,-2,-4,-6,-7,0,12.0,2.0,10.0,8
12908,12908,2012-13,2012,2013,Norwich,Southampton,Draw,Home,2013-03-09,1,3,4,5,6,0,3,4,4,3,1,1,2,1,12.0,21.0,-9.0,8
12909,12909,2012-13,2012,2013,Norwich,Sunderland,Draw,Away,2013-03-17,1,1,4,5,6,1,1,1,1,0,3,4,5,0,12.0,13.0,-1.0,8
12910,12910,2012-13,2012,2013,Norwich,Wigan,Loss,Away,2013-03-30,0,2,2,5,6,3,6,6,7,-1,-4,-1,-1,0,12.0,15.0,-3.0,8
12911,12911,2012-13,2012,2013,Norwich,Swansea,Draw,Home,2013-04-06,1,1,2,2,5,0,0,3,3,1,2,-1,2,1,12.0,11.0,1.0,9
12912,12912,2012-13,2012,2013,Norwich,Arsenal,Loss,Away,2013-04-13,0,1,2,3,3,6,9,9,12,-5,-7,-6,-9,0,12.0,3.0,9.0,9
12913,12913,2012-13,2012,2013,Norwich,Reading,Win,Home,2013-04-20,3,1,1,2,3,1,1,1,1,0,0,1,2,1,12.0,21.0,-9.0,9
12914,12914,2012-13,2012,2013,Norwich,Stoke,Loss,Away,2013-04-27,0,3,4,4,5,3,3,3,4,0,1,1,1,0,12.0,14.0,-2.0,9
12915,12915,2012-13,2012,2013,Norwich,Aston Villa,Loss,Home,2013-05-04,0,3,3,4,4,3,4,7,7,0,-1,-3,-3,1,12.0,16.0,-4.0,10
12916,12916,2012-13,2012,2013,Norwich,West Brom,Win,Home,2013-05-12,3,0,3,3,4,0,3,4,4,0,0,-1,0,1,12.0,10.0,2.0,10
12917,12917,2012-13,2012,2013,Norwich,Man City,Win,Away,2013-05-19,3,3,3,6,6,6,7,10,10,-3,-4,-4,-4,0,12.0,1.0,11.0,10
12918,12918,2013-14,2013,2014,Norwich,Everton,Draw,Home,2013-08-17,1,6,6,6,9,3,4,7,7,3,2,-1,2,1,11.0,6.0,5.0,1
12919,12919,2013-14,2013,2014,Norwich,Hull,Loss,Away,2013-08-24,0,4,7,7,7,1,2,2,2,3,5,5,5,0,11.0,21.0,-10.0,1
12920,12920,2013-14,2013,2014,Norwich,Southampton,Win,Home,2013-08-31,3,1,4,7,7,4,5,6,6,-3,-1,1,1,1,11.0,14.0,-3.0,1
12921,12921,2013-14,2013,2014,Norwich,Tottenham,Loss,Away,2013-09-14,0,3,4,7,10,3,6,9,12,0,-2,-2,-2,0,11.0,5.0,6.0,2
12922,12922,2013-14,2013,2014,Norwich,Aston Villa,Loss,Home,2013-09-21,0,3,3,4,7,0,0,3,4,3,3,1,3,1,11.0,15.0,-4.0,2
12923,12923,2013-14,2013,2014,Norwich,Stoke,Win,Away,2013-09-29,3,0,3,3,4,1,4,7,7,-1,-1,-4,-3,0,11.0,13.0,-2.0,2
12924,12924,2013-14,2013,2014,Norwich,Chelsea,Loss,Home,2013-10-06,0,3,3,6,6,4,4,5,8,-1,-1,1,-2,1,11.0,3.0,8.0,3
12925,12925,2013-14,2013,2014,Norwich,Arsenal,Loss,Away,2013-10-19,0,3,3,3,6,4,7,10,13,-1,-4,-7,-7,0,11.0,4.0,7.0,3
12926,12926,2013-14,2013,2014,Norwich,Cardiff,Draw,Home,2013-10-26,1,0,3,3,3,0,3,3,4,0,0,0,-1,1,11.0,21.0,-10.0,3
12927,12927,2013-14,2013,2014,Norwich,Man City,Loss,Away,2013-11-02,0,1,1,4,4,3,6,6,9,-2,-5,-2,-5,0,11.0,2.0,9.0,4
12928,12928,2013-14,2013,2014,Norwich,West Ham,Win,Home,2013-11-09,3,1,1,1,4,2,2,5,5,-1,-1,-4,-1,1,11.0,10.0,1.0,4
12929,12929,2013-14,2013,2014,Norwich,Newcastle,Loss,Away,2013-11-23,0,3,4,4,4,6,6,7,10,-3,-2,-3,-6,0,11.0,16.0,-5.0,4
12930,12930,2013-14,2013,2014,Norwich,Crystal Palace,Win,Home,2013-11-30,3,3,3,4,4,4,4,4,4,-1,-1,0,0,1,11.0,21.0,-10.0,4
12931,12931,2013-14,2013,2014,Norwich,Liverpool,Loss,Away,2013-12-04,0,3,6,6,7,1,4,4,7,2,2,2,0,0,11.0,7.0,4.0,5
12932,12932,2013-14,2013,2014,Norwich,West Brom,Win,Away,2013-12-07,3,3,3,6,6,0,1,2,5,3,2,4,1,0,11.0,8.0,3.0,5
12933,12933,2013-14,2013,2014,Norwich,Swansea,Draw,Home,2013-12-15,1,3,6,6,9,4,4,7,8,-1,2,-1,1,1,11.0,9.0,2.0,5
12934,12934,2013-14,2013,2014,Norwich,Sunderland,Draw,Away,2013-12-21,1,4,4,7,7,1,1,2,2,3,3,5,5,0,11.0,17.0,-6.0,5
12935,12935,2013-14,2013,2014,Norwich,Fulham,Loss,Home,2013-12-26,0,2,5,5,8,0,3,3,3,2,2,2,5,1,11.0,12.0,-1.0,5
12936,12936,2013-14,2013,2014,Norwich,Man United,Loss,Home,2013-12-28,0,1,2,5,5,6,9,9,9,-5,-7,-4,-4,1,11.0,1.0,10.0,5
12937,12937,2013-14,2013,2014,Norwich,Crystal Palace,Draw,Away,2014-01-01,1,0,1,2,5,3,3,3,6,-3,-2,-1,-1,0,11.0,21.0,-10.0,6
12938,12938,2013-14,2013,2014,Norwich,Everton,Loss,Away,2014-01-11,0,1,1,2,3,4,4,7,10,-3,-3,-5,-7,0,11.0,6.0,5.0,6
12939,12939,2013-14,2013,2014,Norwich,Hull,Win,Home,2014-01-18,3,1,1,1,2,0,3,3,4,1,-2,-2,-2,1,11.0,21.0,-10.0,6
12940,12940,2013-14,2013,2014,Norwich,Newcastle,Draw,Home,2014-01-28,1,3,4,4,4,3,3,3,6,0,1,1,-2,1,11.0,16.0,-5.0,6
12941,12941,2013-14,2013,2014,Norwich,Cardiff,Loss,Away,2014-02-01,0,4,4,5,5,0,0,0,1,4,4,5,4,0,11.0,21.0,-10.0,7
12942,12942,2013-14,2013,2014,Norwich,Man City,Draw,Home,2014-02-08,1,1,4,4,5,3,6,9,12,-2,-2,-5,-7,1,11.0,2.0,9.0,7
12943,12943,2013-14,2013,2014,Norwich,West Ham,Loss,Away,2014-02-11,0,1,2,5,5,6,7,7,10,-5,-5,-2,-5,0,11.0,10.0,1.0,7
12944,12944,2013-14,2013,2014,Norwich,Tottenham,Win,Home,2014-02-23,3,1,1,2,5,6,7,7,10,-5,-6,-5,-5,1,11.0,5.0,6.0,7
12945,12945,2013-14,2013,2014,Norwich,Aston Villa,Loss,Away,2014-03-02,0,3,4,4,5,1,1,1,4,2,3,3,1,0,11.0,15.0,-4.0,8
12946,12946,2013-14,2013,2014,Norwich,Stoke,Draw,Home,2014-03-08,1,3,3,4,4,3,4,5,8,0,-1,-1,-4,1,11.0,13.0,-2.0,8
12947,12947,2013-14,2013,2014,Norwich,Southampton,Loss,Away,2014-03-15,0,1,4,4,5,3,3,6,7,-2,1,-2,-2,0,11.0,14.0,-3.0,8
12948,12948,2013-14,2013,2014,Norwich,Sunderland,Win,Home,2014-03-22,3,1,1,4,4,1,1,4,7,0,0,0,-3,1,11.0,17.0,-6.0,8
12949,12949,2013-14,2013,2014,Norwich,Swansea,Loss,Away,2014-03-29,0,3,4,4,7,1,1,2,2,2,3,2,5,0,11.0,9.0,2.0,8
12950,12950,2013-14,2013,2014,Norwich,West Brom,Loss,Home,2014-04-05,0,3,3,4,4,1,4,4,5,2,-1,0,-1,1,11.0,8.0,3.0,9
12951,12951,2013-14,2013,2014,Norwich,Fulham,Loss,Away,2014-04-12,0,0,3,3,4,3,3,6,6,-3,0,-3,-2,0,11.0,12.0,-1.0,9
12952,12952,2013-14,2013,2014,Norwich,Liverpool,Loss,Home,2014-04-20,0,0,0,3,3,6,9,12,15,-6,-9,-9,-12,1,11.0,7.0,4.0,9
12953,12953,2013-14,2013,2014,Norwich,Man United,Loss,Away,2014-04-26,0,0,0,0,3,3,6,6,9,-3,-6,-6,-6,0,11.0,1.0,10.0,9
12954,12954,2013-14,2013,2014,Norwich,Chelsea,Draw,Away,2014-05-04,1,0,0,0,0,3,6,9,9,-3,-6,-9,-9,0,11.0,3.0,8.0,10
12955,12955,2013-14,2013,2014,Norwich,Arsenal,Loss,Home,2014-05-11,0,1,1,1,1,6,9,12,12,-5,-8,-11,-11,1,11.0,4.0,7.0,10
12956,12956,2015-16,2015,2016,Norwich,Crystal Palace,Loss,Home,2015-08-08,0,1,1,1,1,6,6,6,6,-5,-5,-5,-5,1,21.0,10.0,11.0,1
12957,12957,2015-16,2015,2016,Norwich,Sunderland,Win,Away,2015-08-15,3,0,1,1,1,0,1,2,5,0,0,-1,-4,0,21.0,16.0,5.0,1
12958,12958,2015-16,2015,2016,Norwich,Stoke,Draw,Home,2015-08-22,1,3,3,4,4,1,4,5,8,2,-1,-1,-4,1,21.0,9.0,12.0,1
12959,12959,2015-16,2015,2016,Norwich,Southampton,Loss,Away,2015-08-30,0,4,4,4,5,1,2,2,5,3,2,2,0,0,21.0,7.0,14.0,1
12960,12960,2015-16,2015,2016,Norwich,Bournemouth,Win,Home,2015-09-12,3,1,4,4,4,4,4,4,4,-3,0,0,0,1,21.0,21.0,0.0,2
12961,12961,2015-16,2015,2016,Norwich,Liverpool,Draw,Away,2015-09-20,1,3,4,7,7,0,1,4,7,3,3,3,0,0,21.0,6.0,15.0,2
12962,12962,2015-16,2015,2016,Norwich,West Ham,Draw,Away,2015-09-26,1,4,4,5,8,6,9,9,9,-2,-5,-4,-1,0,21.0,12.0,9.0,2
12963,12963,2015-16,2015,2016,Norwich,Leicester,Loss,Home,2015-10-03,0,2,5,5,6,1,4,5,6,1,1,0,0,1,21.0,14.0,7.0,3
12964,12964,2015-16,2015,2016,Norwich,Newcastle,Loss,Away,2015-10-18,0,1,2,5,5,1,1,1,1,0,1,4,4,0,21.0,15.0,6.0,3
12965,12965,2015-16,2015,2016,Norwich,West Brom,Loss,Home,2015-10-24,0,0,1,2,5,3,3,6,7,-3,-2,-4,-2,1,21.0,13.0,8.0,3
12966,12966,2015-16,2015,2016,Norwich,Man City,Loss,Away,2015-10-31,0,0,0,1,2,4,7,7,7,-4,-7,-6,-5,0,21.0,2.0,19.0,3
12967,12967,2015-16,2015,2016,Norwich,Swansea,Win,Home,2015-11-07,3,0,0,0,1,3,3,4,4,-3,-3,-4,-3,1,21.0,8.0,13.0,4
12968,12968,2015-16,2015,2016,Norwich,Chelsea,Loss,Away,2015-11-21,0,3,3,3,3,0,0,3,3,3,3,0,0,0,21.0,1.0,20.0,4
12969,12969,2015-16,2015,2016,Norwich,Arsenal,Draw,Home,2015-11-29,1,3,3,3,3,1,4,7,10,2,-1,-4,-7,1,21.0,3.0,18.0,4
12970,12970,2015-16,2015,2016,Norwich,Watford,Loss,Away,2015-12-05,0,1,4,4,4,3,3,6,9,-2,1,-2,-5,0,21.0,21.0,0.0,5
12971,12971,2015-16,2015,2016,Norwich,Everton,Draw,Home,2015-12-12,1,1,1,4,4,2,5,6,9,-1,-4,-2,-5,1,21.0,11.0,10.0,5
12972,12972,2015-16,2015,2016,Norwich,Man United,Win,Away,2015-12-19,3,1,2,2,5,1,2,5,8,0,0,-3,-3,0,21.0,4.0,17.0,5
12973,12973,2015-16,2015,2016,Norwich,Tottenham,Loss,Away,2015-12-26,0,4,4,5,5,3,4,5,8,1,0,0,-3,0,21.0,5.0,16.0,5
12974,12974,2015-16,2015,2016,Norwich,Aston Villa,Win,Home,2015-12-28,3,3,4,4,5,2,2,3,3,1,2,1,2,1,21.0,17.0,4.0,5
12975,12975,2015-16,2015,2016,Norwich,Southampton,Win,Home,2016-01-02,3,3,6,7,7,3,3,3,4,0,3,4,3,1,21.0,7.0,14.0,6
12976,12976,2015-16,2015,2016,Norwich,Stoke,Loss,Away,2016-01-13,0,6,6,9,10,3,6,6,7,3,0,3,3,0,21.0,9.0,12.0,6
12977,12977,2015-16,2015,2016,Norwich,Bournemouth,Loss,Away,2016-01-16,0,3,6,6,9,1,1,2,5,2,5,4,4,0,21.0,21.0,0.0,6
12978,12978,2015-16,2015,2016,Norwich,Liverpool,Loss,Home,2016-01-23,0,0,3,6,6,1,1,4,7,-1,2,2,-1,1,21.0,6.0,15.0,6
12979,12979,2015-16,2015,2016,Norwich,Tottenham,Loss,Home,2016-02-02,0,0,0,3,6,6,6,7,10,-6,-6,-4,-4,1,21.0,5.0,16.0,7
12980,12980,2015-16,2015,2016,Norwich,Aston Villa,Loss,Away,2016-02-06,0,0,0,0,3,1,2,5,5,-1,-2,-5,-2,0,21.0,17.0,4.0,7
12981,12981,2015-16,2015,2016,Norwich,West Ham,Draw,Home,2016-02-13,1,0,0,0,0,3,4,4,7,-3,-4,-4,-7,1,21.0,12.0,9.0,7
12982,12982,2015-16,2015,2016,Norwich,Leicester,Loss,Away,2016-02-27,0,1,1,1,1,3,6,9,10,-2,-5,-8,-9,0,21.0,14.0,7.0,7
12983,12983,2015-16,2015,2016,Norwich,Chelsea,Loss,Home,2016-03-01,0,1,1,1,1,6,7,8,11,-5,-6,-7,-10,1,21.0,1.0,20.0,8
12984,12984,2015-16,2015,2016,Norwich,Swansea,Loss,Away,2016-03-05,0,0,1,1,1,3,3,4,5,-3,-2,-3,-4,0,21.0,8.0,13.0,8
12985,12985,2015-16,2015,2016,Norwich,Man City,Draw,Home,2016-03-12,1,0,0,1,1,3,3,3,6,-3,-3,-2,-5,1,21.0,2.0,19.0,8
12986,12986,2015-16,2015,2016,Norwich,West Brom,Win,Away,2016-03-19,3,1,1,1,2,4,7,10,10,-3,-6,-9,-8,0,21.0,13.0,8.0,8
12987,12987,2015-16,2015,2016,Norwich,Newcastle,Win,Home,2016-04-02,3,4,4,4,4,1,1,1,1,3,3,3,3,1,21.0,15.0,6.0,9
12988,12988,2015-16,2015,2016,Norwich,Crystal Palace,Loss,Away,2016-04-09,0,6,7,7,7,1,1,2,2,5,6,5,5,0,21.0,10.0,11.0,9
12989,12989,2015-16,2015,2016,Norwich,Sunderland,Loss,Home,2016-04-16,0,3,6,7,7,1,2,3,4,2,4,4,3,1,21.0,16.0,5.0,9
12990,12990,2015-16,2015,2016,Norwich,Arsenal,Loss,Away,2016-04-30,0,0,3,6,7,4,5,6,9,-4,-2,0,-2,0,21.0,3.0,18.0,9
12991,12991,2015-16,2015,2016,Norwich,Man United,Loss,Home,2016-05-07,0,0,0,3,6,4,7,7,10,-4,-7,-4,-4,1,21.0,4.0,17.0,10
12992,12992,2015-16,2015,2016,Norwich,Watford,Win,Home,2016-05-11,3,0,0,0,3,3,3,6,7,-3,-3,-6,-4,1,21.0,21.0,0.0,10
12993,12993,2015-16,2015,2016,Norwich,Everton,Loss,Away,2016-05-15,0,3,3,3,3,0,3,3,4,3,0,0,-1,0,21.0,11.0,10.0,10
12994,12994,1994-95,1994,1995,Nott'm Forest,Ipswich,Win,Away,1994-08-20,3,0,0,0,0,1,1,2,2,-1,-1,-2,-2,0,21.0,19.0,2.0,1
12995,12995,1994-95,1994,1995,Nott'm Forest,Man United,Draw,Home,1994-08-22,1,3,3,3,3,4,7,10,13,-1,-4,-7,-10,1,21.0,1.0,20.0,1
12996,12996,1994-95,1994,1995,Nott'm Forest,Leicester,Win,Home,1994-08-27,3,4,4,4,4,0,0,0,0,4,4,4,4,1,21.0,21.0,0.0,1
12997,12997,1994-95,1994,1995,Nott'm Forest,Everton,Win,Away,1994-08-30,3,4,7,7,7,0,1,4,4,4,6,3,3,0,21.0,17.0,4.0,1
12998,12998,1994-95,1994,1995,Nott'm Forest,Sheffield Weds,Win,Home,1994-09-10,3,6,7,10,10,4,4,4,5,2,3,6,5,1,21.0,7.0,14.0,2
12999,12999,1994-95,1994,1995,Nott'm Forest,Southampton,Draw,Away,1994-09-17,1,6,9,10,13,3,3,4,5,3,6,6,8,0,21.0,18.0,3.0,2
13000,13000,1994-95,1994,1995,Nott'm Forest,Tottenham,Win,Away,1994-09-24,3,4,7,10,11,0,3,3,6,4,4,7,5,0,21.0,15.0,6.0,2
13001,13001,1994-95,1994,1995,Nott'm Forest,QPR,Win,Home,1994-10-02,3,4,7,10,13,1,2,3,3,3,5,7,10,1,21.0,9.0,12.0,3
13002,13002,1994-95,1994,1995,Nott'm Forest,Man City,Draw,Away,1994-10-08,1,6,7,10,13,3,4,5,5,3,3,5,8,0,21.0,16.0,5.0,3
13003,13003,1994-95,1994,1995,Nott'm Forest,Wimbledon,Win,Home,1994-10-17,3,4,7,8,11,0,3,4,7,4,4,4,4,1,21.0,6.0,15.0,3
13004,13004,1994-95,1994,1995,Nott'm Forest,Aston Villa,Win,Away,1994-10-22,3,4,7,10,11,1,1,1,1,3,6,9,10,0,21.0,10.0,11.0,3
13005,13005,1994-95,1994,1995,Nott'm Forest,Blackburn,Loss,Home,1994-10-29,0,6,7,10,13,3,4,4,7,3,3,6,6,1,21.0,2.0,19.0,3
13006,13006,1994-95,1994,1995,Nott'm Forest,Liverpool,Loss,Away,1994-11-05,0,3,6,7,10,3,6,6,9,0,0,1,1,0,21.0,8.0,13.0,4
13007,13007,1994-95,1994,1995,Nott'm Forest,Newcastle,Draw,Home,1994-11-07,1,0,3,6,7,3,6,9,10,-3,-3,-3,-3,1,21.0,3.0,18.0,4
13008,13008,1994-95,1994,1995,Nott'm Forest,Chelsea,Loss,Home,1994-11-19,0,1,1,4,7,1,2,5,5,0,-1,-1,2,1,21.0,14.0,7.0,4
13009,13009,1994-95,1994,1995,Nott'm Forest,Leeds,Loss,Away,1994-11-26,0,1,1,1,4,3,3,6,9,-2,-2,-5,-5,0,21.0,5.0,16.0,4
13010,13010,1994-95,1994,1995,Nott'm Forest,Arsenal,Draw,Home,1994-12-03,1,0,1,1,1,1,1,2,3,-1,0,-1,-2,1,21.0,4.0,17.0,5
13011,13011,1994-95,1994,1995,Nott'm Forest,Ipswich,Win,Home,1994-12-10,3,1,1,2,2,1,1,1,4,0,0,1,-2,1,21.0,19.0,2.0,5
13012,13012,1994-95,1994,1995,Nott'm Forest,Man United,Win,Away,1994-12-17,3,4,4,4,5,6,7,10,13,-2,-3,-6,-8,0,21.0,1.0,20.0,5
13013,13013,1994-95,1994,1995,Nott'm Forest,Coventry,Draw,Away,1994-12-26,1,6,7,7,7,1,2,5,8,5,5,2,-1,0,21.0,11.0,10.0,5
13014,13014,1994-95,1994,1995,Nott'm Forest,Norwich,Win,Home,1994-12-27,3,4,7,8,8,3,6,6,9,1,1,2,-1,1,21.0,12.0,9.0,5
13015,13015,1994-95,1994,1995,Nott'm Forest,West Ham,Loss,Away,1994-12-31,0,4,7,10,11,1,4,5,5,3,3,5,6,0,21.0,13.0,8.0,5
13016,13016,1994-95,1994,1995,Nott'm Forest,Crystal Palace,Win,Home,1995-01-02,3,3,4,7,10,1,2,2,3,2,2,5,7,1,21.0,21.0,0.0,6
13017,13017,1994-95,1994,1995,Nott'm Forest,Blackburn,Loss,Away,1995-01-14,0,3,6,7,10,6,9,10,13,-3,-3,-3,-3,0,21.0,2.0,19.0,6
13018,13018,1994-95,1994,1995,Nott'm Forest,Aston Villa,Loss,Home,1995-01-21,0,3,3,6,7,4,5,8,9,-1,-2,-2,-2,1,21.0,10.0,11.0,6
13019,13019,1994-95,1994,1995,Nott'm Forest,Chelsea,Win,Away,1995-01-25,3,0,3,3,6,2,3,3,3,-2,0,0,3,0,21.0,14.0,7.0,6
13020,13020,1994-95,1994,1995,Nott'm Forest,Liverpool,Draw,Home,1995-02-04,1,3,3,6,6,1,4,7,10,2,-1,-1,-4,1,21.0,8.0,13.0,7
13021,13021,1994-95,1994,1995,Nott'm Forest,Newcastle,Loss,Away,1995-02-11,0,4,4,4,7,3,6,7,8,1,-2,-3,-1,0,21.0,3.0,18.0,7
13022,13022,1994-95,1994,1995,Nott'm Forest,Arsenal,Loss,Away,1995-02-21,0,1,4,4,4,1,2,5,6,0,2,-1,-2,0,21.0,4.0,17.0,7
13023,13023,1994-95,1994,1995,Nott'm Forest,QPR,Draw,Away,1995-02-26,1,0,1,4,4,4,4,4,7,-4,-3,0,-3,0,21.0,9.0,12.0,7
13024,13024,1994-95,1994,1995,Nott'm Forest,Tottenham,Draw,Home,1995-03-04,1,1,1,2,5,1,4,4,7,0,-3,-2,-2,1,21.0,15.0,6.0,8
13025,13025,1994-95,1994,1995,Nott'm Forest,Everton,Win,Home,1995-03-08,3,2,2,2,3,4,4,5,8,-2,-2,-3,-5,1,21.0,17.0,4.0,8
13026,13026,1994-95,1994,1995,Nott'm Forest,Leicester,Win,Away,1995-03-11,3,4,5,5,5,1,1,2,3,3,4,3,2,0,21.0,21.0,0.0,8
13027,13027,1994-95,1994,1995,Nott'm Forest,Southampton,Win,Home,1995-03-18,3,6,7,8,8,2,2,3,4,4,5,5,4,1,21.0,18.0,3.0,8
13028,13028,1994-95,1994,1995,Nott'm Forest,Leeds,Win,Home,1995-03-22,3,6,9,10,11,6,9,9,10,0,0,1,1,1,21.0,5.0,16.0,8
13029,13029,1994-95,1994,1995,Nott'm Forest,Sheffield Weds,Win,Away,1995-04-01,3,6,9,12,13,0,0,1,4,6,9,11,9,0,21.0,7.0,14.0,9
13030,13030,1994-95,1994,1995,Nott'm Forest,West Ham,Draw,Home,1995-04-08,1,6,9,12,15,4,5,5,8,2,4,7,7,1,21.0,13.0,8.0,9
13031,13031,1994-95,1994,1995,Nott'm Forest,Norwich,Win,Away,1995-04-12,3,4,7,10,13,0,0,3,3,4,7,7,10,0,21.0,12.0,9.0,9
13032,13032,1994-95,1994,1995,Nott'm Forest,Coventry,Win,Home,1995-04-17,3,4,7,10,13,3,3,6,7,1,4,4,6,1,21.0,11.0,10.0,9
13033,13033,1994-95,1994,1995,Nott'm Forest,Crystal Palace,Win,Away,1995-04-29,3,6,7,10,13,3,4,5,8,3,3,5,5,0,21.0,21.0,0.0,9
13034,13034,1994-95,1994,1995,Nott'm Forest,Man City,Win,Home,1995-05-06,3,6,9,10,13,2,5,8,8,4,4,2,5,1,21.0,16.0,5.0,10
13035,13035,1994-95,1994,1995,Nott'm Forest,Wimbledon,Draw,Away,1995-05-13,1,6,9,12,13,2,3,3,3,4,6,9,10,0,21.0,6.0,15.0,10
13036,13036,1995-96,1995,1996,Nott'm Forest,Southampton,Win,Away,1995-08-19,3,4,7,10,13,1,2,5,6,3,5,5,7,0,3.0,10.0,-7.0,1
13037,13037,1995-96,1995,1996,Nott'm Forest,Chelsea,Draw,Home,1995-08-23,1,4,7,10,13,4,5,6,9,0,2,4,4,1,3.0,11.0,-8.0,1
13038,13038,1995-96,1995,1996,Nott'm Forest,West Ham,Draw,Home,1995-08-26,1,4,5,8,11,0,1,4,4,4,4,4,7,1,3.0,14.0,-11.0,1
13039,13039,1995-96,1995,1996,Nott'm Forest,Arsenal,Draw,Away,1995-08-29,1,2,5,6,9,4,5,5,6,-2,0,1,3,0,3.0,12.0,-9.0,1
13040,13040,1995-96,1995,1996,Nott'm Forest,Coventry,Draw,Away,1995-09-09,1,2,3,6,7,2,5,5,6,0,-2,1,1,0,3.0,16.0,-13.0,2
13041,13041,1995-96,1995,1996,Nott'm Forest,Everton,Win,Home,1995-09-17,3,2,3,4,7,3,6,6,7,-1,-3,-2,0,1,3.0,15.0,-12.0,2
13042,13042,1995-96,1995,1996,Nott'm Forest,Aston Villa,Draw,Away,1995-09-23,1,4,5,6,7,4,7,7,10,0,-2,-1,-3,0,3.0,18.0,-15.0,2
13043,13043,1995-96,1995,1996,Nott'm Forest,Man City,Win,Home,1995-09-30,3,4,5,6,7,0,0,0,0,4,5,6,7,1,3.0,17.0,-14.0,2
13044,13044,1995-96,1995,1996,Nott'm Forest,Tottenham,Win,Away,1995-10-14,3,4,7,8,9,6,9,12,13,-2,-2,-4,-4,0,3.0,7.0,-4.0,3
13045,13045,1995-96,1995,1996,Nott'm Forest,Bolton,Win,Home,1995-10-21,3,6,7,10,11,1,1,1,2,5,6,9,9,1,3.0,21.0,-18.0,3
13046,13046,1995-96,1995,1996,Nott'm Forest,QPR,Draw,Away,1995-10-28,1,6,9,10,13,0,3,3,6,6,6,7,7,0,3.0,8.0,-5.0,3
13047,13047,1995-96,1995,1996,Nott'm Forest,Wimbledon,Win,Home,1995-11-06,3,4,7,10,11,0,0,0,0,4,7,10,11,1,3.0,9.0,-6.0,4
13048,13048,1995-96,1995,1996,Nott'm Forest,Blackburn,Loss,Away,1995-11-18,0,4,7,10,13,0,3,4,7,4,4,6,6,0,3.0,1.0,2.0,4
13049,13049,1995-96,1995,1996,Nott'm Forest,Man United,Draw,Home,1995-11-27,1,3,4,7,10,6,6,9,12,-3,-2,-2,-2,1,3.0,2.0,1.0,4
13050,13050,1995-96,1995,1996,Nott'm Forest,Bolton,Draw,Away,1995-12-02,1,1,4,5,8,0,0,0,3,1,4,5,5,0,3.0,21.0,-18.0,5
13051,13051,1995-96,1995,1996,Nott'm Forest,Aston Villa,Draw,Home,1995-12-10,1,2,2,5,6,1,4,5,8,1,-2,0,-2,1,3.0,18.0,-15.0,5
13052,13052,1995-96,1995,1996,Nott'm Forest,Man City,Draw,Away,1995-12-18,1,2,3,3,6,3,6,9,10,-1,-3,-6,-4,0,3.0,17.0,-14.0,5
13053,13053,1995-96,1995,1996,Nott'm Forest,Newcastle,Loss,Away,1995-12-23,0,2,3,4,4,3,4,7,8,-1,-1,-3,-4,0,3.0,6.0,-3.0,5
13054,13054,1995-96,1995,1996,Nott'm Forest,Sheffield Weds,Win,Home,1995-12-26,3,1,2,3,4,4,5,8,9,-3,-3,-5,-5,1,3.0,13.0,-10.0,5
13055,13055,1995-96,1995,1996,Nott'm Forest,Middlesbrough,Win,Home,1995-12-30,3,3,4,5,6,3,3,6,7,0,1,-1,-1,1,3.0,21.0,-18.0,5
13056,13056,1995-96,1995,1996,Nott'm Forest,Liverpool,Loss,Away,1996-01-01,0,6,6,7,8,4,7,10,11,2,-1,-3,-3,0,3.0,4.0,-1.0,6
13057,13057,1995-96,1995,1996,Nott'm Forest,Southampton,Win,Home,1996-01-13,3,3,6,6,7,2,3,3,4,1,3,3,3,1,3.0,10.0,-7.0,6
13058,13058,1995-96,1995,1996,Nott'm Forest,Chelsea,Loss,Away,1996-01-20,0,3,6,9,9,4,5,5,8,-1,1,4,1,0,3.0,11.0,-8.0,6
13059,13059,1995-96,1995,1996,Nott'm Forest,Leeds,Win,Home,1996-01-31,3,3,3,6,9,3,4,4,7,0,-1,2,2,1,3.0,5.0,-2.0,6
13060,13060,1995-96,1995,1996,Nott'm Forest,West Ham,Loss,Away,1996-02-03,0,3,6,6,9,3,3,3,3,0,3,3,6,0,3.0,14.0,-11.0,7
13061,13061,1995-96,1995,1996,Nott'm Forest,Arsenal,Loss,Home,1996-02-10,0,3,3,6,6,1,4,4,4,2,-1,2,2,1,3.0,12.0,-9.0,7
13062,13062,1995-96,1995,1996,Nott'm Forest,Everton,Loss,Away,1996-02-24,0,0,3,3,6,3,4,7,8,-3,-1,-4,-2,0,3.0,15.0,-12.0,7
13063,13063,1995-96,1995,1996,Nott'm Forest,Sheffield Weds,Win,Away,1996-03-02,3,0,0,3,3,0,3,3,3,0,-3,0,0,0,3.0,13.0,-10.0,8
13064,13064,1995-96,1995,1996,Nott'm Forest,Middlesbrough,Draw,Away,1996-03-16,1,3,3,3,6,0,1,1,1,3,2,2,5,0,3.0,21.0,-18.0,8
13065,13065,1995-96,1995,1996,Nott'm Forest,Liverpool,Win,Home,1996-03-23,3,4,4,4,4,4,7,10,13,0,-3,-6,-9,1,3.0,4.0,-1.0,8
13066,13066,1995-96,1995,1996,Nott'm Forest,Wimbledon,Loss,Away,1996-03-30,0,4,7,7,7,3,4,5,6,1,3,2,1,0,3.0,9.0,-6.0,8
13067,13067,1995-96,1995,1996,Nott'm Forest,Tottenham,Win,Home,1996-04-06,3,3,4,7,7,3,6,6,9,0,-2,1,-2,1,3.0,7.0,-4.0,9
13068,13068,1995-96,1995,1996,Nott'm Forest,Leeds,Win,Away,1996-04-08,3,3,6,7,10,3,3,4,4,0,3,3,6,0,3.0,5.0,-2.0,9
13069,13069,1995-96,1995,1996,Nott'm Forest,Blackburn,Loss,Home,1996-04-13,0,6,6,9,10,3,3,6,9,3,3,3,1,1,3.0,1.0,2.0,9
13070,13070,1995-96,1995,1996,Nott'm Forest,Coventry,Draw,Home,1996-04-17,1,3,6,6,9,3,6,6,6,0,0,0,3,1,3.0,16.0,-13.0,9
13071,13071,1995-96,1995,1996,Nott'm Forest,Man United,Loss,Away,1996-04-28,0,1,4,7,7,3,6,9,12,-2,-2,-2,-5,0,3.0,2.0,1.0,9
13072,13072,1995-96,1995,1996,Nott'm Forest,Newcastle,Draw,Home,1996-05-02,1,1,1,4,7,6,9,9,12,-5,-8,-5,-5,1,3.0,6.0,-3.0,10
13073,13073,1995-96,1995,1996,Nott'm Forest,QPR,Win,Home,1996-05-04,3,1,2,2,5,3,6,6,9,-2,-4,-4,-4,1,3.0,8.0,-5.0,10
13074,13074,1996-97,1996,1997,Nott'm Forest,Coventry,Win,Away,1996-08-17,3,4,4,5,5,4,5,8,8,0,-1,-3,-3,0,9.0,16.0,-7.0,1
13075,13075,1996-97,1996,1997,Nott'm Forest,Sunderland,Loss,Home,1996-08-21,0,6,7,7,8,1,1,1,1,5,6,6,7,1,9.0,21.0,-12.0,1
13076,13076,1996-97,1996,1997,Nott'm Forest,Middlesbrough,Draw,Home,1996-08-24,1,3,6,7,7,1,1,1,1,2,5,6,6,1,9.0,12.0,-3.0,1
13077,13077,1996-97,1996,1997,Nott'm Forest,Southampton,Draw,Away,1996-09-04,1,1,4,7,8,0,1,2,5,1,3,5,3,0,9.0,17.0,-8.0,2
13078,13078,1996-97,1996,1997,Nott'm Forest,Leicester,Draw,Home,1996-09-07,1,2,2,5,8,0,3,4,5,2,-1,1,3,1,9.0,21.0,-12.0,2
13079,13079,1996-97,1996,1997,Nott'm Forest,Man United,Loss,Away,1996-09-14,0,2,3,3,6,4,5,6,9,-2,-2,-3,-3,0,9.0,1.0,8.0,2
13080,13080,1996-97,1996,1997,Nott'm Forest,West Ham,Loss,Home,1996-09-21,0,1,2,3,3,1,1,4,5,0,1,-1,-2,1,9.0,10.0,-1.0,2
13081,13081,1996-97,1996,1997,Nott'm Forest,Chelsea,Draw,Away,1996-09-28,1,0,1,2,3,1,4,5,8,-1,-3,-3,-5,0,9.0,11.0,-2.0,2
13082,13082,1996-97,1996,1997,Nott'm Forest,Leeds,Loss,Away,1996-10-12,0,1,1,2,3,0,0,0,3,1,1,2,0,0,9.0,13.0,-4.0,3
13083,13083,1996-97,1996,1997,Nott'm Forest,Derby,Draw,Home,1996-10-19,1,1,1,1,2,0,1,4,7,1,0,-3,-5,1,9.0,21.0,-12.0,3
13084,13084,1996-97,1996,1997,Nott'm Forest,Everton,Loss,Home,1996-10-28,0,1,2,2,2,6,7,7,7,-5,-5,-5,-5,1,9.0,6.0,3.0,3
13085,13085,1996-97,1996,1997,Nott'm Forest,Aston Villa,Loss,Away,1996-11-02,0,1,1,2,2,3,3,3,4,-2,-2,-1,-2,0,9.0,4.0,5.0,4
13086,13086,1996-97,1996,1997,Nott'm Forest,Sheffield Weds,Loss,Away,1996-11-18,0,0,1,1,2,2,3,3,3,-2,-2,-2,-1,0,9.0,15.0,-6.0,4
13087,13087,1996-97,1996,1997,Nott'm Forest,Blackburn,Draw,Home,1996-11-25,1,0,0,1,1,4,4,5,5,-4,-4,-4,-4,1,9.0,7.0,2.0,4
13088,13088,1996-97,1996,1997,Nott'm Forest,Wimbledon,Loss,Away,1996-11-30,0,1,1,1,2,2,3,4,7,-1,-2,-3,-5,0,9.0,14.0,-5.0,4
13089,13089,1996-97,1996,1997,Nott'm Forest,Newcastle,Draw,Home,1996-12-09,1,1,1,1,1,1,2,5,5,0,-1,-4,-4,1,9.0,2.0,7.0,5
13090,13090,1996-97,1996,1997,Nott'm Forest,Liverpool,Loss,Away,1996-12-17,0,1,2,2,2,3,6,7,8,-2,-4,-5,-6,0,9.0,3.0,6.0,5
13091,13091,1996-97,1996,1997,Nott'm Forest,Arsenal,Win,Home,1996-12-21,3,1,1,2,2,4,7,10,10,-3,-6,-8,-8,1,9.0,5.0,4.0,5
13092,13092,1996-97,1996,1997,Nott'm Forest,Man United,Loss,Home,1996-12-26,0,3,4,4,5,4,5,8,9,-1,-1,-4,-4,1,9.0,1.0,8.0,5
13093,13093,1996-97,1996,1997,Nott'm Forest,Leicester,Draw,Away,1996-12-28,1,3,3,4,4,1,2,5,5,2,1,-1,-1,0,9.0,21.0,-12.0,5
13094,13094,1996-97,1996,1997,Nott'm Forest,West Ham,Win,Away,1997-01-01,3,1,4,4,5,3,4,4,5,-2,0,0,0,0,9.0,10.0,-1.0,6
13095,13095,1996-97,1996,1997,Nott'm Forest,Chelsea,Win,Home,1997-01-11,3,4,4,7,7,4,7,10,10,0,-3,-3,-3,1,9.0,11.0,-2.0,6
13096,13096,1996-97,1996,1997,Nott'm Forest,Tottenham,Win,Home,1997-01-19,3,6,7,7,10,0,3,4,5,6,4,3,5,1,9.0,8.0,1.0,6
13097,13097,1996-97,1996,1997,Nott'm Forest,Coventry,Loss,Home,1997-01-29,0,6,9,10,10,0,1,4,7,6,8,6,3,1,9.0,16.0,-7.0,6
13098,13098,1996-97,1996,1997,Nott'm Forest,Everton,Loss,Away,1997-02-01,0,3,6,9,10,0,0,0,0,3,6,9,10,0,9.0,6.0,3.0,7
13099,13099,1996-97,1996,1997,Nott'm Forest,Aston Villa,Draw,Home,1997-02-22,1,0,3,6,9,6,6,6,7,-6,-3,0,2,1,9.0,4.0,5.0,7
13100,13100,1996-97,1996,1997,Nott'm Forest,Tottenham,Win,Away,1997-03-01,3,1,1,4,7,1,1,4,4,0,0,0,3,0,9.0,8.0,1.0,8
13101,13101,1996-97,1996,1997,Nott'm Forest,Sheffield Weds,Loss,Home,1997-03-05,0,4,4,4,7,6,7,8,11,-2,-3,-4,-4,1,9.0,15.0,-6.0,8
13102,13102,1996-97,1996,1997,Nott'm Forest,Arsenal,Loss,Away,1997-03-08,0,3,4,4,4,3,3,4,5,0,1,0,-1,0,9.0,5.0,4.0,8
13103,13103,1996-97,1996,1997,Nott'm Forest,Blackburn,Draw,Away,1997-03-11,1,0,3,4,4,4,5,8,8,-4,-2,-4,-4,0,9.0,7.0,2.0,8
13104,13104,1996-97,1996,1997,Nott'm Forest,Liverpool,Draw,Home,1997-03-15,1,1,1,4,5,3,4,7,10,-2,-3,-3,-5,1,9.0,3.0,6.0,8
13105,13105,1996-97,1996,1997,Nott'm Forest,Sunderland,Draw,Away,1997-03-22,1,2,2,2,5,0,3,3,3,2,-1,-1,2,0,9.0,21.0,-12.0,8
13106,13106,1996-97,1996,1997,Nott'm Forest,Middlesbrough,Draw,Away,1997-03-24,1,2,3,3,3,6,9,12,12,-4,-6,-9,-9,0,9.0,12.0,-3.0,8
13107,13107,1996-97,1996,1997,Nott'm Forest,Southampton,Loss,Home,1997-04-05,0,2,3,4,4,1,1,2,3,1,2,2,1,1,9.0,17.0,-8.0,9
13108,13108,1996-97,1996,1997,Nott'm Forest,Leeds,Draw,Home,1997-04-19,1,1,2,3,4,1,2,2,3,0,0,1,1,1,9.0,13.0,-4.0,9
13109,13109,1996-97,1996,1997,Nott'm Forest,Derby,Draw,Away,1997-04-23,1,1,2,3,4,3,4,7,10,-2,-2,-4,-6,0,9.0,21.0,-12.0,9
13110,13110,1996-97,1996,1997,Nott'm Forest,Wimbledon,Draw,Home,1997-05-03,1,2,2,3,4,0,3,3,3,2,-1,0,1,1,9.0,14.0,-5.0,10
13111,13111,1996-97,1996,1997,Nott'm Forest,Newcastle,Loss,Away,1997-05-11,0,2,3,3,4,2,5,8,11,0,-2,-5,-7,0,9.0,2.0,7.0,10
13112,13112,1998-99,1998,1999,Nott'm Forest,Arsenal,Loss,Away,1998-08-17,0,1,2,3,3,0,3,6,9,1,-1,-3,-6,0,21.0,1.0,20.0,1
13113,13113,1998-99,1998,1999,Nott'm Forest,Coventry,Win,Home,1998-08-22,3,0,1,2,3,4,7,8,9,-4,-6,-6,-6,1,21.0,11.0,10.0,1
13114,13114,1998-99,1998,1999,Nott'm Forest,Southampton,Win,Away,1998-08-29,3,3,3,4,5,0,1,1,4,3,2,3,1,0,21.0,12.0,9.0,1
13115,13115,1998-99,1998,1999,Nott'm Forest,Everton,Loss,Home,1998-09-08,0,6,6,6,7,0,1,2,2,6,5,4,5,1,21.0,17.0,4.0,2
13116,13116,1998-99,1998,1999,Nott'm Forest,Chelsea,Loss,Away,1998-09-12,0,3,6,6,6,2,2,5,5,1,4,1,1,0,21.0,4.0,17.0,2
13117,13117,1998-99,1998,1999,Nott'm Forest,West Ham,Draw,Home,1998-09-19,1,0,3,6,6,3,4,5,8,-3,-1,1,-2,1,21.0,8.0,13.0,2
13118,13118,1998-99,1998,1999,Nott'm Forest,Newcastle,Loss,Away,1998-09-26,0,1,1,4,7,6,6,6,7,-5,-5,-2,0,0,21.0,13.0,8.0,2
13119,13119,1998-99,1998,1999,Nott'm Forest,Charlton,Loss,Home,1998-10-03,0,1,1,1,4,2,2,2,3,-1,-1,-1,1,1,21.0,21.0,0.0,3
13120,13120,1998-99,1998,1999,Nott'm Forest,Leeds,Draw,Home,1998-10-17,1,0,1,1,1,1,2,3,6,-1,-1,-2,-5,1,21.0,5.0,16.0,3
13121,13121,1998-99,1998,1999,Nott'm Forest,Liverpool,Loss,Away,1998-10-24,0,1,1,2,2,2,2,3,3,-1,-1,-1,-1,0,21.0,3.0,18.0,3
13122,13122,1998-99,1998,1999,Nott'm Forest,Middlesbrough,Draw,Away,1998-11-01,1,1,1,1,2,4,7,7,8,-3,-6,-6,-6,0,21.0,21.0,0.0,4
13123,13123,1998-99,1998,1999,Nott'm Forest,Wimbledon,Loss,Home,1998-11-07,0,1,2,2,2,2,2,2,3,-1,0,0,-1,1,21.0,15.0,6.0,4
13124,13124,1998-99,1998,1999,Nott'm Forest,Derby,Draw,Home,1998-11-16,1,1,1,2,2,4,5,5,5,-3,-4,-3,-3,1,21.0,9.0,12.0,4
13125,13125,1998-99,1998,1999,Nott'm Forest,Tottenham,Loss,Away,1998-11-21,0,1,2,2,3,1,2,5,5,0,0,-3,-2,0,21.0,14.0,7.0,4
13126,13126,1998-99,1998,1999,Nott'm Forest,Aston Villa,Draw,Home,1998-11-28,1,1,1,2,2,3,6,7,8,-2,-5,-5,-6,1,21.0,7.0,14.0,4
13127,13127,1998-99,1998,1999,Nott'm Forest,Sheffield Weds,Loss,Away,1998-12-07,0,1,2,2,3,4,5,5,6,-3,-3,-3,-3,0,21.0,16.0,5.0,5
13128,13128,1998-99,1998,1999,Nott'm Forest,Leicester,Loss,Away,1998-12-12,0,1,1,2,2,4,4,4,5,-3,-3,-2,-3,0,21.0,10.0,11.0,5
13129,13129,1998-99,1998,1999,Nott'm Forest,Blackburn,Draw,Home,1998-12-19,1,0,1,1,2,4,4,4,4,-4,-3,-3,-2,1,21.0,6.0,15.0,5
13130,13130,1998-99,1998,1999,Nott'm Forest,Man United,Loss,Away,1998-12-26,0,1,1,2,2,1,2,3,6,0,-1,-1,-4,0,21.0,2.0,19.0,5
13131,13131,1998-99,1998,1999,Nott'm Forest,Southampton,Draw,Home,1998-12-28,1,1,1,1,2,3,3,3,3,-2,-2,-2,-1,1,21.0,12.0,9.0,5
13132,13132,1998-99,1998,1999,Nott'm Forest,Coventry,Loss,Away,1999-01-09,0,1,2,2,2,1,2,2,2,0,0,0,0,0,21.0,11.0,10.0,6
13133,13133,1998-99,1998,1999,Nott'm Forest,Arsenal,Loss,Home,1999-01-16,0,1,1,2,2,4,7,10,10,-3,-6,-8,-8,1,21.0,1.0,20.0,6
13134,13134,1998-99,1998,1999,Nott'm Forest,Everton,Win,Away,1999-01-30,3,0,1,1,2,1,1,2,2,-1,0,-1,0,0,21.0,17.0,4.0,6
13135,13135,1998-99,1998,1999,Nott'm Forest,Man United,Loss,Home,1999-02-06,0,3,3,4,4,6,9,12,13,-3,-6,-8,-9,1,21.0,2.0,19.0,7
13136,13136,1998-99,1998,1999,Nott'm Forest,West Ham,Loss,Away,1999-02-13,0,3,3,3,4,1,1,1,4,2,2,2,0,0,21.0,8.0,13.0,7
13137,13137,1998-99,1998,1999,Nott'm Forest,Chelsea,Loss,Home,1999-02-20,0,0,3,3,3,4,4,7,10,-4,-1,-4,-7,1,21.0,4.0,17.0,7
13138,13138,1998-99,1998,1999,Nott'm Forest,Charlton,Draw,Away,1999-02-27,1,0,0,3,3,6,9,9,10,-6,-9,-6,-7,0,21.0,21.0,0.0,7
13139,13139,1998-99,1998,1999,Nott'm Forest,Newcastle,Loss,Home,1999-03-10,0,1,1,1,4,1,4,7,10,0,-3,-6,-6,1,21.0,13.0,8.0,8
13140,13140,1998-99,1998,1999,Nott'm Forest,Wimbledon,Win,Away,1999-03-13,3,1,1,1,1,3,4,5,5,-2,-3,-4,-4,0,21.0,15.0,6.0,8
13141,13141,1998-99,1998,1999,Nott'm Forest,Middlesbrough,Loss,Home,1999-03-20,0,3,4,4,4,3,4,4,4,0,0,0,0,1,21.0,21.0,0.0,8
13142,13142,1998-99,1998,1999,Nott'm Forest,Leeds,Loss,Away,1999-04-03,0,3,3,4,4,6,9,12,15,-3,-6,-8,-11,0,21.0,5.0,16.0,9
13143,13143,1998-99,1998,1999,Nott'm Forest,Liverpool,Draw,Home,1999-04-05,1,0,3,3,4,3,3,4,4,-3,0,-1,0,1,21.0,3.0,18.0,9
13144,13144,1998-99,1998,1999,Nott'm Forest,Derby,Loss,Away,1999-04-10,0,1,1,4,4,0,3,6,7,1,-2,-2,-3,0,21.0,9.0,12.0,9
13145,13145,1998-99,1998,1999,Nott'm Forest,Tottenham,Loss,Home,1999-04-17,0,1,1,1,4,1,4,4,7,0,-3,-3,-3,1,21.0,14.0,7.0,9
13146,13146,1998-99,1998,1999,Nott'm Forest,Aston Villa,Loss,Away,1999-04-24,0,0,1,1,1,6,7,8,8,-6,-6,-7,-7,0,21.0,7.0,14.0,9
13147,13147,1998-99,1998,1999,Nott'm Forest,Sheffield Weds,Win,Home,1999-05-01,3,0,0,1,1,2,2,5,5,-2,-2,-4,-4,1,21.0,16.0,5.0,10
13148,13148,1998-99,1998,1999,Nott'm Forest,Blackburn,Win,Away,1999-05-08,3,3,3,3,4,1,2,2,3,2,1,1,1,0,21.0,6.0,15.0,10
13149,13149,1998-99,1998,1999,Nott'm Forest,Leicester,Win,Home,1999-05-16,3,6,6,6,6,3,3,6,9,3,3,0,-3,1,21.0,10.0,11.0,10
13150,13150,1993-94,1993,1994,Oldham,Ipswich,Loss,Home,1993-08-14,0,0,0,0,0,0,0,0,0,0,0,0,0,1,19.0,16.0,3.0,1
13151,13151,1993-94,1993,1994,Oldham,Swindon,Win,Away,1993-08-18,3,0,0,0,0,0,0,0,0,0,0,0,0,0,19.0,21.0,-2.0,1
13152,13152,1993-94,1993,1994,Oldham,Blackburn,Loss,Away,1993-08-21,0,3,3,3,3,3,3,3,3,0,0,0,0,0,19.0,4.0,15.0,1
13153,13153,1993-94,1993,1994,Oldham,Coventry,Draw,Home,1993-08-24,1,3,3,3,3,4,7,7,7,-1,-4,-4,-4,1,19.0,15.0,4.0,1
13154,13154,1993-94,1993,1994,Oldham,Wimbledon,Draw,Home,1993-08-28,1,1,4,4,4,1,2,5,5,0,2,-1,-1,1,19.0,12.0,7.0,1
13155,13155,1993-94,1993,1994,Oldham,Leeds,Loss,Away,1993-08-30,0,2,2,5,5,0,0,3,4,2,2,2,1,0,19.0,17.0,2.0,1
13156,13156,1993-94,1993,1994,Oldham,Everton,Loss,Home,1993-09-11,0,1,2,2,5,0,0,3,6,1,2,-1,-1,1,19.0,13.0,6.0,2
13157,13157,1993-94,1993,1994,Oldham,Tottenham,Loss,Away,1993-09-18,0,0,1,2,2,2,2,5,8,-2,-1,-3,-6,0,19.0,8.0,11.0,2
13158,13158,1993-94,1993,1994,Oldham,Aston Villa,Draw,Home,1993-09-25,1,0,0,1,2,4,7,10,10,-4,-7,-9,-8,1,19.0,2.0,17.0,2
13159,13159,1993-94,1993,1994,Oldham,Man City,Draw,Away,1993-10-04,1,1,1,1,2,3,6,9,10,-2,-5,-8,-8,0,19.0,9.0,10.0,3
13160,13160,1993-94,1993,1994,Oldham,Liverpool,Loss,Away,1993-10-16,0,2,2,2,2,1,1,1,1,1,1,1,1,0,19.0,6.0,13.0,3
13161,13161,1993-94,1993,1994,Oldham,Arsenal,Draw,Home,1993-10-23,1,1,2,2,2,2,5,5,8,-1,-3,-3,-6,1,19.0,10.0,9.0,3
13162,13162,1993-94,1993,1994,Oldham,Chelsea,Win,Away,1993-10-30,3,1,2,3,3,0,0,3,4,1,2,0,-1,0,19.0,11.0,8.0,3
13163,13163,1993-94,1993,1994,Oldham,Newcastle,Loss,Home,1993-11-08,0,4,4,5,6,3,3,6,9,1,1,-1,-3,1,19.0,21.0,-2.0,4
13164,13164,1993-94,1993,1994,Oldham,West Ham,Loss,Away,1993-11-20,0,3,4,4,5,3,4,5,8,0,0,-1,-3,0,19.0,21.0,-2.0,4
13165,13165,1993-94,1993,1994,Oldham,Sheffield Weds,Loss,Away,1993-11-24,0,0,3,4,4,4,5,6,7,-4,-2,-2,-3,0,19.0,7.0,12.0,4
13166,13166,1993-94,1993,1994,Oldham,Norwich,Win,Home,1993-11-27,3,0,0,3,4,4,5,6,9,-4,-5,-3,-5,1,19.0,3.0,16.0,4
13167,13167,1993-94,1993,1994,Oldham,Ipswich,Draw,Away,1993-12-04,1,3,3,3,6,4,5,5,5,-1,-2,-2,1,0,19.0,16.0,3.0,5
13168,13168,1993-94,1993,1994,Oldham,Swindon,Win,Home,1993-12-07,3,4,4,4,4,1,4,5,5,3,0,-1,-1,1,19.0,21.0,-2.0,5
13169,13169,1993-94,1993,1994,Oldham,Blackburn,Loss,Home,1993-12-11,0,4,7,7,7,3,6,9,9,1,1,-2,-2,1,19.0,4.0,15.0,5
13170,13170,1993-94,1993,1994,Oldham,Coventry,Draw,Away,1993-12-18,1,3,4,7,7,3,3,3,4,0,1,4,3,0,19.0,15.0,4.0,5
13171,13171,1993-94,1993,1994,Oldham,QPR,Loss,Away,1993-12-27,0,1,4,5,8,3,4,5,5,-2,0,0,3,0,19.0,5.0,14.0,5
13172,13172,1993-94,1993,1994,Oldham,Man United,Loss,Home,1993-12-29,0,1,1,4,5,4,5,8,9,-3,-4,-4,-4,1,19.0,1.0,18.0,5
13173,13173,1993-94,1993,1994,Oldham,Sheffield United,Loss,Away,1994-01-01,0,0,1,1,4,1,1,2,2,-1,0,-1,2,0,19.0,14.0,5.0,6
13174,13174,1993-94,1993,1994,Oldham,Liverpool,Loss,Home,1994-01-15,0,0,0,1,1,4,5,6,7,-4,-5,-5,-6,1,19.0,6.0,13.0,6
13175,13175,1993-94,1993,1994,Oldham,Arsenal,Draw,Away,1994-01-22,1,0,0,0,1,2,5,8,11,-2,-5,-8,-10,0,19.0,10.0,9.0,6
13176,13176,1993-94,1993,1994,Oldham,Southampton,Win,Home,1994-02-05,3,1,1,1,1,6,6,7,10,-5,-5,-6,-9,1,19.0,18.0,1.0,7
13177,13177,1993-94,1993,1994,Oldham,Chelsea,Win,Home,1994-02-12,3,4,4,4,4,1,2,5,8,3,2,-1,-4,1,19.0,11.0,8.0,7
13178,13178,1993-94,1993,1994,Oldham,Leeds,Draw,Home,1994-02-28,1,6,7,7,7,3,3,4,5,3,4,3,2,1,19.0,17.0,2.0,7
13179,13179,1993-94,1993,1994,Oldham,Everton,Loss,Away,1994-03-05,0,4,7,8,8,2,5,5,8,2,2,3,0,0,19.0,13.0,6.0,8
13180,13180,1993-94,1993,1994,Oldham,Aston Villa,Win,Away,1994-03-19,3,1,4,7,8,0,3,4,5,1,1,3,3,0,19.0,2.0,17.0,8
13181,13181,1993-94,1993,1994,Oldham,Man City,Draw,Home,1994-03-26,1,3,4,7,10,1,2,5,6,2,2,2,4,1,19.0,9.0,10.0,8
13182,13182,1993-94,1993,1994,Oldham,Southampton,Win,Away,1994-03-30,3,4,4,5,8,1,2,3,6,3,2,2,2,0,19.0,18.0,1.0,8
13183,13183,1993-94,1993,1994,Oldham,QPR,Win,Home,1994-04-02,3,4,7,7,8,6,7,10,11,-2,0,-3,-3,1,19.0,5.0,14.0,9
13184,13184,1993-94,1993,1994,Oldham,Man United,Loss,Away,1994-04-04,0,6,7,10,10,3,4,5,8,3,3,5,2,0,19.0,1.0,18.0,9
13185,13185,1993-94,1993,1994,Oldham,West Ham,Loss,Home,1994-04-16,0,3,6,7,10,3,6,6,6,0,0,1,4,1,19.0,21.0,-2.0,9
13186,13186,1993-94,1993,1994,Oldham,Newcastle,Loss,Away,1994-04-23,0,0,3,6,7,3,4,5,8,-3,-1,1,-1,0,19.0,21.0,-2.0,9
13187,13187,1993-94,1993,1994,Oldham,Wimbledon,Loss,Away,1994-04-26,0,0,0,3,6,4,7,8,11,-4,-7,-5,-5,0,19.0,12.0,7.0,9
13188,13188,1993-94,1993,1994,Oldham,Sheffield Weds,Draw,Home,1994-04-30,1,0,0,0,3,4,7,10,13,-4,-7,-10,-10,1,19.0,7.0,12.0,9
13189,13189,1993-94,1993,1994,Oldham,Sheffield United,Draw,Home,1994-05-03,1,1,1,1,1,6,6,7,10,-5,-5,-6,-9,1,19.0,14.0,5.0,10
13190,13190,1993-94,1993,1994,Oldham,Tottenham,Loss,Home,1994-05-05,0,2,2,2,2,3,3,3,3,-1,-1,-1,-1,1,19.0,8.0,11.0,10
13191,13191,1993-94,1993,1994,Oldham,Norwich,Draw,Away,1994-05-07,1,1,2,2,2,3,4,4,5,-2,-2,-2,-3,0,19.0,3.0,16.0,10
13192,13192,2003-04,2003,2004,Portsmouth,Aston Villa,Win,Home,2003-08-16,3,0,0,0,0,3,3,4,7,-3,-3,-4,-7,1,21.0,16.0,5.0,1
13193,13193,2003-04,2003,2004,Portsmouth,Man City,Draw,Away,2003-08-23,1,3,3,3,3,3,6,6,9,0,-3,-3,-6,0,21.0,9.0,12.0,1
13194,13194,2003-04,2003,2004,Portsmouth,Bolton,Win,Home,2003-08-26,3,4,4,4,4,1,4,5,6,3,0,-1,-2,1,21.0,17.0,4.0,1
13195,13195,2003-04,2003,2004,Portsmouth,Wolves,Draw,Away,2003-08-30,1,4,7,7,7,0,0,0,0,4,7,7,7,0,21.0,21.0,0.0,1
13196,13196,2003-04,2003,2004,Portsmouth,Arsenal,Draw,Away,2003-09-13,1,4,5,8,8,6,9,12,15,-2,-4,-4,-7,0,21.0,2.0,19.0,2
13197,13197,2003-04,2003,2004,Portsmouth,Blackburn,Loss,Home,2003-09-20,0,2,5,6,9,1,1,2,5,1,4,4,4,1,21.0,6.0,15.0,2
13198,13198,2003-04,2003,2004,Portsmouth,Birmingham,Loss,Away,2003-09-27,0,1,2,5,6,4,7,8,11,-3,-5,-3,-5,0,21.0,13.0,8.0,2
13199,13199,2003-04,2003,2004,Portsmouth,Charlton,Loss,Home,2003-10-04,0,0,1,2,5,3,3,4,5,-3,-2,-2,0,1,21.0,12.0,9.0,3
13200,13200,2003-04,2003,2004,Portsmouth,Liverpool,Win,Home,2003-10-18,3,0,0,1,2,0,3,6,9,0,-3,-5,-7,1,21.0,5.0,16.0,3
13201,13201,2003-04,2003,2004,Portsmouth,Newcastle,Loss,Away,2003-10-25,0,3,3,3,4,6,9,9,10,-3,-6,-6,-6,0,21.0,3.0,18.0,3
13202,13202,2003-04,2003,2004,Portsmouth,Man United,Loss,Away,2003-11-01,0,3,3,3,3,3,6,9,10,0,-3,-6,-7,0,21.0,1.0,20.0,4
13203,13203,2003-04,2003,2004,Portsmouth,Leeds,Win,Home,2003-11-08,3,0,3,3,3,0,0,3,3,0,3,0,0,1,21.0,15.0,6.0,4
13204,13204,2003-04,2003,2004,Portsmouth,Fulham,Loss,Away,2003-11-24,0,3,3,6,6,0,3,3,4,3,0,3,2,0,21.0,14.0,7.0,4
13205,13205,2003-04,2003,2004,Portsmouth,Leicester,Loss,Home,2003-11-29,0,3,3,3,6,4,7,7,7,-1,-4,-4,-1,1,21.0,21.0,0.0,4
13206,13206,2003-04,2003,2004,Portsmouth,Middlesbrough,Draw,Away,2003-12-06,1,0,3,3,3,4,7,10,11,-4,-4,-7,-8,0,21.0,11.0,10.0,5
13207,13207,2003-04,2003,2004,Portsmouth,Everton,Loss,Home,2003-12-13,0,1,1,4,4,1,4,4,4,0,-3,0,0,1,21.0,7.0,14.0,5
13208,13208,2003-04,2003,2004,Portsmouth,Southampton,Loss,Away,2003-12-21,0,1,1,1,4,6,6,6,7,-5,-5,-5,-3,0,21.0,8.0,13.0,5
13209,13209,2003-04,2003,2004,Portsmouth,Tottenham,Win,Home,2003-12-26,3,0,1,1,1,0,3,3,6,0,-2,-2,-5,1,21.0,10.0,11.0,5
13210,13210,2003-04,2003,2004,Portsmouth,Chelsea,Loss,Away,2003-12-28,0,3,3,4,4,3,3,4,7,0,0,0,-3,0,21.0,4.0,17.0,5
13211,13211,2003-04,2003,2004,Portsmouth,Aston Villa,Loss,Away,2004-01-06,0,3,3,3,4,4,7,10,10,-1,-4,-7,-6,0,21.0,16.0,5.0,6
13212,13212,2003-04,2003,2004,Portsmouth,Man City,Win,Home,2004-01-10,3,0,3,3,3,2,2,3,3,-2,1,0,0,1,21.0,9.0,12.0,6
13213,13213,2003-04,2003,2004,Portsmouth,Bolton,Loss,Away,2004-01-17,0,3,3,6,6,3,4,4,5,0,-1,2,1,0,21.0,17.0,4.0,6
13214,13214,2003-04,2003,2004,Portsmouth,Wolves,Draw,Home,2004-01-31,1,3,3,3,6,4,4,5,8,-1,-1,-2,-2,1,21.0,21.0,0.0,6
13215,13215,2003-04,2003,2004,Portsmouth,Tottenham,Loss,Away,2004-02-07,0,1,4,4,4,3,6,9,9,-2,-2,-5,-5,0,21.0,10.0,11.0,7
13216,13216,2003-04,2003,2004,Portsmouth,Chelsea,Loss,Home,2004-02-11,0,1,1,4,4,6,7,10,10,-5,-6,-6,-6,1,21.0,4.0,17.0,7
13217,13217,2003-04,2003,2004,Portsmouth,Newcastle,Draw,Home,2004-02-29,1,0,1,1,4,4,7,8,11,-4,-6,-7,-7,1,21.0,3.0,18.0,7
13218,13218,2003-04,2003,2004,Portsmouth,Everton,Loss,Away,2004-03-13,0,1,1,2,2,4,4,4,5,-3,-3,-2,-3,0,21.0,7.0,14.0,8
13219,13219,2003-04,2003,2004,Portsmouth,Liverpool,Loss,Away,2004-03-17,0,1,1,1,2,1,4,5,6,0,-3,-4,-4,0,21.0,5.0,16.0,8
13220,13220,2003-04,2003,2004,Portsmouth,Southampton,Win,Home,2004-03-21,3,0,1,1,1,4,5,5,6,-4,-4,-4,-5,1,21.0,8.0,13.0,8
13221,13221,2003-04,2003,2004,Portsmouth,Blackburn,Win,Away,2004-03-27,3,3,3,4,4,3,4,4,5,0,-1,0,-1,0,21.0,6.0,15.0,8
13222,13222,2003-04,2003,2004,Portsmouth,Charlton,Draw,Away,2004-04-10,1,6,6,6,7,0,3,3,6,6,3,3,1,0,21.0,12.0,9.0,9
13223,13223,2003-04,2003,2004,Portsmouth,Birmingham,Win,Home,2004-04-12,3,4,7,7,7,1,4,4,4,3,3,3,3,1,21.0,13.0,8.0,9
13224,13224,2003-04,2003,2004,Portsmouth,Man United,Win,Home,2004-04-17,3,4,7,10,10,6,7,10,10,-2,0,0,0,1,21.0,1.0,20.0,9
13225,13225,2003-04,2003,2004,Portsmouth,Leeds,Win,Away,2004-04-25,3,6,7,10,13,1,4,7,7,5,3,3,6,0,21.0,15.0,6.0,9
13226,13226,2003-04,2003,2004,Portsmouth,Fulham,Draw,Home,2004-05-01,1,6,9,10,13,4,4,7,8,2,5,3,5,1,21.0,14.0,7.0,10
13227,13227,2003-04,2003,2004,Portsmouth,Arsenal,Draw,Home,2004-05-04,1,4,7,10,11,2,5,6,9,2,2,4,2,1,21.0,2.0,19.0,10
13228,13228,2003-04,2003,2004,Portsmouth,Leicester,Loss,Away,2004-05-08,0,2,5,8,11,2,2,2,2,0,3,6,9,0,21.0,21.0,0.0,10
13229,13229,2003-04,2003,2004,Portsmouth,Middlesbrough,Win,Home,2004-05-15,3,1,2,5,8,3,3,3,6,-2,-1,2,2,1,21.0,11.0,10.0,10
13230,13230,2004-05,2004,2005,Portsmouth,Birmingham,Draw,Home,2004-08-14,1,3,4,5,8,1,2,3,4,2,2,2,4,1,13.0,10.0,3.0,1
13231,13231,2004-05,2004,2005,Portsmouth,Charlton,Loss,Away,2004-08-21,0,4,4,5,6,3,4,5,5,1,0,0,1,0,13.0,7.0,6.0,1
13232,13232,2004-05,2004,2005,Portsmouth,Fulham,Win,Home,2004-08-30,3,1,4,4,5,3,4,7,7,-2,0,-3,-2,1,13.0,9.0,4.0,1
13233,13233,2004-05,2004,2005,Portsmouth,Crystal Palace,Win,Home,2004-09-11,3,3,4,7,7,0,0,1,4,3,4,6,3,1,13.0,21.0,-8.0,2
13234,13234,2004-05,2004,2005,Portsmouth,Blackburn,Loss,Away,2004-09-18,0,6,6,7,10,1,1,1,2,5,5,6,8,0,13.0,15.0,-2.0,2
13235,13235,2004-05,2004,2005,Portsmouth,Everton,Loss,Home,2004-09-26,0,3,6,6,7,6,7,10,13,-3,-1,-4,-6,1,13.0,17.0,-4.0,2
13236,13236,2004-05,2004,2005,Portsmouth,Norwich,Draw,Away,2004-10-02,1,0,3,6,6,1,2,2,3,-1,1,4,3,0,13.0,21.0,-8.0,3
13237,13237,2004-05,2004,2005,Portsmouth,Tottenham,Win,Home,2004-10-18,3,1,1,4,7,3,4,5,8,-2,-3,-1,-1,1,13.0,14.0,-1.0,3
13238,13238,2004-05,2004,2005,Portsmouth,Middlesbrough,Draw,Away,2004-10-24,1,4,4,4,7,4,4,4,7,0,0,0,0,0,13.0,11.0,2.0,3
13239,13239,2004-05,2004,2005,Portsmouth,Man United,Win,Home,2004-10-30,3,4,5,5,5,4,5,8,11,0,0,-3,-6,1,13.0,3.0,10.0,3
13240,13240,2004-05,2004,2005,Portsmouth,Aston Villa,Loss,Away,2004-11-06,0,4,7,8,8,4,4,5,6,0,3,3,2,0,13.0,6.0,7.0,4
13241,13241,2004-05,2004,2005,Portsmouth,Southampton,Loss,Away,2004-11-13,0,3,4,7,8,2,3,3,4,1,1,4,4,0,13.0,12.0,1.0,4
13242,13242,2004-05,2004,2005,Portsmouth,Man City,Loss,Home,2004-11-20,0,0,3,4,7,2,3,3,6,-2,0,1,1,1,13.0,16.0,-3.0,4
13243,13243,2004-05,2004,2005,Portsmouth,Bolton,Win,Away,2004-11-27,3,0,0,3,4,1,2,5,8,-1,-2,-2,-4,0,13.0,8.0,5.0,4
13244,13244,2004-05,2004,2005,Portsmouth,West Brom,Win,Home,2004-12-04,3,3,3,3,6,1,1,2,2,2,2,1,4,1,13.0,21.0,-8.0,5
13245,13245,2004-05,2004,2005,Portsmouth,Newcastle,Draw,Away,2004-12-11,1,6,6,6,6,1,4,4,4,5,2,2,2,0,13.0,5.0,8.0,5
13246,13246,2004-05,2004,2005,Portsmouth,Liverpool,Draw,Away,2004-12-14,1,4,7,7,7,1,4,4,7,3,3,3,0,0,13.0,4.0,9.0,5
13247,13247,2004-05,2004,2005,Portsmouth,Arsenal,Loss,Home,2004-12-19,0,2,5,8,8,4,4,5,8,-2,1,3,0,1,13.0,1.0,12.0,5
13248,13248,2004-05,2004,2005,Portsmouth,Crystal Palace,Win,Away,2004-12-26,3,1,2,5,8,1,1,2,2,0,1,3,6,0,13.0,21.0,-8.0,5
13249,13249,2004-05,2004,2005,Portsmouth,Chelsea,Loss,Home,2004-12-28,0,3,4,5,8,6,7,10,13,-3,-3,-5,-5,1,13.0,2.0,11.0,5
13250,13250,2004-05,2004,2005,Portsmouth,Norwich,Draw,Home,2005-01-01,1,3,3,4,5,0,0,3,3,3,3,1,2,1,13.0,21.0,-8.0,6
13251,13251,2004-05,2004,2005,Portsmouth,Everton,Loss,Away,2005-01-04,0,1,4,4,5,0,3,4,7,1,1,0,-2,0,13.0,17.0,-4.0,6
13252,13252,2004-05,2004,2005,Portsmouth,Blackburn,Loss,Home,2005-01-15,0,1,1,4,4,3,6,7,8,-2,-5,-3,-4,1,13.0,15.0,-2.0,6
13253,13253,2004-05,2004,2005,Portsmouth,Chelsea,Loss,Away,2005-01-22,0,0,1,1,4,6,9,12,15,-6,-8,-11,-11,0,13.0,2.0,11.0,6
13254,13254,2004-05,2004,2005,Portsmouth,Middlesbrough,Win,Home,2005-02-01,3,0,0,1,1,2,2,2,5,-2,-2,-1,-4,1,13.0,11.0,2.0,7
13255,13255,2004-05,2004,2005,Portsmouth,Tottenham,Loss,Away,2005-02-05,0,3,3,3,4,0,0,1,4,3,3,2,0,0,13.0,14.0,-1.0,7
13256,13256,2004-05,2004,2005,Portsmouth,Aston Villa,Loss,Home,2005-02-12,0,3,3,3,3,1,1,4,4,2,2,-1,-1,1,13.0,6.0,7.0,7
13257,13257,2004-05,2004,2005,Portsmouth,Man United,Loss,Away,2005-02-26,0,0,3,3,3,6,9,12,15,-6,-6,-9,-12,0,13.0,3.0,10.0,7
13258,13258,2004-05,2004,2005,Portsmouth,Arsenal,Loss,Away,2005-03-05,0,0,0,3,3,4,7,7,10,-4,-7,-4,-7,0,13.0,1.0,12.0,8
13259,13259,2004-05,2004,2005,Portsmouth,Newcastle,Draw,Home,2005-03-19,1,0,0,0,3,6,7,8,8,-6,-7,-8,-5,1,13.0,5.0,8.0,8
13260,13260,2004-05,2004,2005,Portsmouth,Fulham,Loss,Away,2005-04-03,0,1,1,1,1,1,1,1,2,0,0,0,-1,0,13.0,9.0,4.0,9
13261,13261,2004-05,2004,2005,Portsmouth,Charlton,Win,Home,2005-04-09,3,1,1,1,1,1,4,5,6,0,-3,-4,-5,1,13.0,7.0,6.0,9
13262,13262,2004-05,2004,2005,Portsmouth,Birmingham,Draw,Away,2005-04-16,1,3,4,4,4,2,5,5,5,1,-1,-1,-1,0,13.0,10.0,3.0,9
13263,13263,2004-05,2004,2005,Portsmouth,Liverpool,Loss,Home,2005-04-20,0,4,4,5,5,1,4,7,8,3,0,-2,-3,1,13.0,4.0,9.0,9
13264,13264,2004-05,2004,2005,Portsmouth,Southampton,Win,Home,2005-04-24,3,1,4,4,5,1,1,1,4,0,3,3,1,1,13.0,12.0,1.0,9
13265,13265,2004-05,2004,2005,Portsmouth,Man City,Loss,Away,2005-04-30,0,3,4,7,7,4,5,8,9,-1,-1,-1,-2,0,13.0,16.0,-3.0,9
13266,13266,2004-05,2004,2005,Portsmouth,Bolton,Draw,Home,2005-05-07,1,3,3,4,7,1,2,5,8,2,1,-1,-1,1,13.0,8.0,5.0,10
13267,13267,2004-05,2004,2005,Portsmouth,West Brom,Loss,Away,2005-05-15,0,1,4,4,5,1,2,2,3,0,2,2,2,0,13.0,21.0,-8.0,10
13268,13268,2005-06,2005,2006,Portsmouth,Tottenham,Loss,Home,2005-08-13,0,1,1,4,4,1,4,4,5,0,-3,0,-1,1,16.0,9.0,7.0,1
13269,13269,2005-06,2005,2006,Portsmouth,West Brom,Loss,Away,2005-08-20,0,0,1,1,4,4,5,5,6,-4,-4,-4,-2,0,16.0,17.0,-1.0,1
13270,13270,2005-06,2005,2006,Portsmouth,Aston Villa,Draw,Home,2005-08-23,1,0,0,1,1,1,1,1,1,-1,-1,0,0,1,16.0,10.0,6.0,1
13271,13271,2005-06,2005,2006,Portsmouth,Man City,Loss,Away,2005-08-27,0,1,1,1,2,6,7,8,11,-5,-6,-7,-9,0,16.0,8.0,8.0,1
13272,13272,2005-06,2005,2006,Portsmouth,Everton,Win,Away,2005-09-10,3,1,1,1,1,3,3,3,3,-2,-2,-2,-2,0,16.0,4.0,12.0,2
13273,13273,2005-06,2005,2006,Portsmouth,Birmingham,Draw,Home,2005-09-17,1,3,4,4,4,3,3,3,4,0,1,1,0,1,16.0,12.0,4.0,2
13274,13274,2005-06,2005,2006,Portsmouth,Bolton,Loss,Away,2005-09-24,0,4,4,5,5,4,7,10,10,0,-3,-5,-5,0,16.0,6.0,10.0,2
13275,13275,2005-06,2005,2006,Portsmouth,Newcastle,Draw,Home,2005-10-01,1,1,4,4,5,6,7,7,7,-5,-3,-3,-2,1,16.0,14.0,2.0,3
13276,13276,2005-06,2005,2006,Portsmouth,Middlesbrough,Draw,Away,2005-10-15,1,1,2,5,5,3,4,7,7,-2,-2,-2,-2,0,16.0,7.0,9.0,3
13277,13277,2005-06,2005,2006,Portsmouth,Charlton,Loss,Home,2005-10-22,0,2,2,3,6,1,4,4,7,1,-2,-1,-1,1,16.0,11.0,5.0,3
13278,13278,2005-06,2005,2006,Portsmouth,Sunderland,Win,Away,2005-10-29,3,1,2,2,3,0,1,4,5,1,1,-2,-2,0,16.0,21.0,-5.0,3
13279,13279,2005-06,2005,2006,Portsmouth,Wigan,Loss,Home,2005-11-05,0,3,4,5,5,6,9,12,15,-3,-5,-7,-10,1,16.0,21.0,-5.0,4
13280,13280,2005-06,2005,2006,Portsmouth,Liverpool,Loss,Away,2005-11-19,0,3,3,4,5,6,6,9,9,-3,-3,-5,-4,0,16.0,5.0,11.0,4
13281,13281,2005-06,2005,2006,Portsmouth,Chelsea,Loss,Home,2005-11-26,0,0,3,3,4,3,6,7,10,-3,-3,-4,-6,1,16.0,1.0,15.0,4
13282,13282,2005-06,2005,2006,Portsmouth,Man United,Loss,Away,2005-12-03,0,0,0,3,3,6,9,9,10,-6,-9,-6,-7,0,16.0,3.0,13.0,5
13283,13283,2005-06,2005,2006,Portsmouth,Tottenham,Loss,Away,2005-12-12,0,0,0,0,3,6,7,7,8,-6,-7,-7,-5,0,16.0,9.0,7.0,5
13284,13284,2005-06,2005,2006,Portsmouth,West Brom,Win,Home,2005-12-17,3,0,0,0,0,4,5,8,8,-4,-5,-8,-8,1,16.0,17.0,-1.0,5
13285,13285,2005-06,2005,2006,Portsmouth,West Ham,Draw,Home,2005-12-26,1,3,3,3,3,3,3,6,6,0,0,-3,-3,1,16.0,21.0,-5.0,5
13286,13286,2005-06,2005,2006,Portsmouth,Arsenal,Loss,Away,2005-12-28,0,4,4,4,4,3,3,3,6,1,1,1,-2,0,16.0,2.0,14.0,5
13287,13287,2005-06,2005,2006,Portsmouth,Fulham,Win,Home,2005-12-31,3,1,4,4,4,1,4,4,5,0,0,0,-1,1,16.0,13.0,3.0,5
13288,13288,2005-06,2005,2006,Portsmouth,Blackburn,Loss,Away,2006-01-02,0,3,4,7,7,6,6,9,9,-3,-2,-2,-2,0,16.0,15.0,1.0,6
13289,13289,2005-06,2005,2006,Portsmouth,Everton,Loss,Home,2006-01-14,0,3,3,4,7,6,6,6,6,-3,-3,-2,1,1,16.0,4.0,12.0,6
13290,13290,2005-06,2005,2006,Portsmouth,Birmingham,Loss,Away,2006-01-21,0,0,3,3,4,3,3,4,4,-3,0,-1,0,0,16.0,12.0,4.0,6
13291,13291,2005-06,2005,2006,Portsmouth,Bolton,Draw,Home,2006-02-01,1,0,0,3,3,4,5,5,6,-4,-5,-2,-3,1,16.0,6.0,10.0,7
13292,13292,2005-06,2005,2006,Portsmouth,Newcastle,Loss,Away,2006-02-04,0,1,1,1,4,0,0,1,1,1,1,0,3,0,16.0,14.0,2.0,7
13293,13293,2005-06,2005,2006,Portsmouth,Man United,Loss,Home,2006-02-11,0,1,1,1,1,3,6,6,7,-2,-5,-5,-6,1,16.0,3.0,13.0,7
13294,13294,2005-06,2005,2006,Portsmouth,Chelsea,Loss,Away,2006-02-25,0,0,1,1,1,3,4,5,8,-3,-3,-4,-7,0,16.0,1.0,15.0,7
13295,13295,2005-06,2005,2006,Portsmouth,Aston Villa,Loss,Away,2006-03-04,0,0,0,1,1,1,4,5,6,-1,-4,-4,-5,0,16.0,10.0,6.0,8
13296,13296,2005-06,2005,2006,Portsmouth,Man City,Win,Home,2006-03-11,3,0,0,0,1,3,6,6,9,-3,-6,-6,-8,1,16.0,8.0,8.0,8
13297,13297,2005-06,2005,2006,Portsmouth,West Ham,Win,Away,2006-03-18,3,3,3,3,3,1,4,7,10,2,-1,-4,-7,0,16.0,21.0,-5.0,8
13298,13298,2005-06,2005,2006,Portsmouth,Fulham,Win,Away,2006-04-01,3,6,6,6,6,4,4,4,4,2,2,2,2,0,16.0,13.0,3.0,9
13299,13299,2005-06,2005,2006,Portsmouth,Blackburn,Draw,Home,2006-04-08,1,6,9,9,9,4,7,10,10,2,2,-1,-1,1,16.0,15.0,1.0,9
13300,13300,2005-06,2005,2006,Portsmouth,Arsenal,Draw,Home,2006-04-12,1,4,7,10,10,3,6,9,12,1,1,1,-2,1,16.0,2.0,14.0,9
13301,13301,2005-06,2005,2006,Portsmouth,Middlesbrough,Win,Home,2006-04-15,3,2,5,8,11,3,6,6,6,-1,-1,2,5,1,16.0,7.0,9.0,9
13302,13302,2005-06,2005,2006,Portsmouth,Charlton,Loss,Away,2006-04-17,0,4,5,8,11,1,2,5,5,3,3,3,6,0,16.0,11.0,5.0,9
13303,13303,2005-06,2005,2006,Portsmouth,Sunderland,Win,Home,2006-04-22,3,3,4,5,8,1,2,2,2,2,2,3,6,1,16.0,21.0,-5.0,9
13304,13304,2005-06,2005,2006,Portsmouth,Wigan,Win,Away,2006-04-29,3,3,6,7,8,3,3,4,5,0,3,3,3,0,16.0,21.0,-5.0,9
13305,13305,2005-06,2005,2006,Portsmouth,Liverpool,Loss,Home,2006-05-07,0,6,6,9,10,6,9,12,15,0,-3,-3,-5,1,16.0,5.0,11.0,10
13306,13306,2006-07,2006,2007,Portsmouth,Blackburn,Win,Home,2006-08-19,3,3,6,6,9,6,9,9,9,-3,-3,-3,0,1,17.0,6.0,11.0,1
13307,13307,2006-07,2006,2007,Portsmouth,Man City,Draw,Away,2006-08-23,1,3,6,9,9,0,0,0,3,3,6,9,6,0,17.0,15.0,2.0,1
13308,13308,2006-07,2006,2007,Portsmouth,Middlesbrough,Win,Away,2006-08-28,3,4,4,7,10,3,3,4,5,1,1,3,5,0,17.0,14.0,3.0,1
13309,13309,2006-07,2006,2007,Portsmouth,Wigan,Win,Home,2006-09-09,3,4,7,7,10,3,3,3,3,1,4,4,7,1,17.0,10.0,7.0,2
13310,13310,2006-07,2006,2007,Portsmouth,Charlton,Win,Away,2006-09-16,3,6,7,10,10,3,3,3,3,3,4,7,7,0,17.0,13.0,4.0,2
13311,13311,2006-07,2006,2007,Portsmouth,Bolton,Loss,Home,2006-09-25,0,6,9,10,13,4,4,5,8,2,5,5,5,1,17.0,8.0,9.0,2
13312,13312,2006-07,2006,2007,Portsmouth,Tottenham,Loss,Away,2006-10-01,0,3,6,9,10,1,1,1,4,2,5,8,6,0,17.0,5.0,12.0,3
13313,13313,2006-07,2006,2007,Portsmouth,West Ham,Win,Home,2006-10-14,3,0,3,6,9,0,0,1,1,0,3,5,8,1,17.0,9.0,8.0,3
13314,13314,2006-07,2006,2007,Portsmouth,Chelsea,Loss,Away,2006-10-21,0,3,3,6,9,4,7,10,13,-1,-4,-4,-4,0,17.0,1.0,16.0,3
13315,13315,2006-07,2006,2007,Portsmouth,Reading,Win,Home,2006-10-28,3,3,3,3,6,0,3,4,7,3,0,-1,-1,1,17.0,21.0,-4.0,3
13316,13316,2006-07,2006,2007,Portsmouth,Man United,Loss,Away,2006-11-04,0,3,6,6,6,6,9,12,13,-3,-3,-6,-7,0,17.0,2.0,15.0,4
13317,13317,2006-07,2006,2007,Portsmouth,Fulham,Draw,Home,2006-11-11,1,3,3,6,6,3,4,7,8,0,-1,-1,-2,1,17.0,12.0,5.0,4
13318,13318,2006-07,2006,2007,Portsmouth,Watford,Win,Home,2006-11-18,3,1,4,4,7,3,4,5,5,-2,0,-1,2,1,17.0,21.0,-4.0,4
13319,13319,2006-07,2006,2007,Portsmouth,Newcastle,Loss,Away,2006-11-26,0,4,4,7,7,2,2,3,3,2,2,4,4,0,17.0,7.0,10.0,4
13320,13320,2006-07,2006,2007,Portsmouth,Liverpool,Draw,Away,2006-11-29,1,3,4,4,7,4,4,7,10,-1,0,-3,-3,0,17.0,3.0,14.0,4
13321,13321,2006-07,2006,2007,Portsmouth,Aston Villa,Draw,Home,2006-12-02,1,1,4,5,5,1,2,5,8,0,2,0,-3,1,17.0,16.0,1.0,5
13322,13322,2006-07,2006,2007,Portsmouth,Everton,Win,Home,2006-12-09,3,2,2,5,6,3,4,7,7,-1,-2,-2,-1,1,17.0,11.0,6.0,5
13323,13323,2006-07,2006,2007,Portsmouth,Arsenal,Draw,Away,2006-12-16,1,4,5,5,8,4,7,7,7,0,-2,-2,1,0,17.0,4.0,13.0,5
13324,13324,2006-07,2006,2007,Portsmouth,Sheffield United,Win,Home,2006-12-23,3,4,5,6,6,4,7,10,10,0,-2,-4,-4,1,17.0,21.0,-4.0,5
13325,13325,2006-07,2006,2007,Portsmouth,West Ham,Win,Away,2006-12-26,3,4,7,8,9,4,4,4,4,0,3,4,5,0,17.0,9.0,8.0,5
13326,13326,2006-07,2006,2007,Portsmouth,Bolton,Loss,Away,2006-12-30,0,6,7,10,11,6,9,12,12,0,-2,-2,-1,0,17.0,8.0,9.0,5
13327,13327,2006-07,2006,2007,Portsmouth,Tottenham,Draw,Home,2007-01-01,1,3,6,7,10,3,3,6,9,0,3,1,1,1,17.0,5.0,12.0,6
13328,13328,2006-07,2006,2007,Portsmouth,Sheffield United,Draw,Away,2007-01-13,1,1,4,7,8,3,3,3,6,-2,1,4,2,0,17.0,21.0,-4.0,6
13329,13329,2006-07,2006,2007,Portsmouth,Charlton,Loss,Home,2007-01-20,0,2,2,5,8,0,3,4,4,2,-1,1,4,1,17.0,13.0,4.0,6
13330,13330,2006-07,2006,2007,Portsmouth,Middlesbrough,Draw,Home,2007-01-30,1,1,2,2,5,6,9,9,10,-5,-7,-7,-5,1,17.0,14.0,3.0,6
13331,13331,2006-07,2006,2007,Portsmouth,Wigan,Loss,Away,2007-02-03,0,1,2,3,3,0,0,0,0,1,2,3,3,0,17.0,10.0,7.0,7
13332,13332,2006-07,2006,2007,Portsmouth,Man City,Win,Home,2007-02-10,3,1,1,2,3,0,1,4,7,1,0,-2,-4,1,17.0,15.0,2.0,7
13333,13333,2006-07,2006,2007,Portsmouth,Blackburn,Loss,Away,2007-02-25,0,3,4,4,5,3,3,3,6,0,1,1,-1,0,17.0,6.0,11.0,7
13334,13334,2006-07,2006,2007,Portsmouth,Chelsea,Loss,Home,2007-03-03,0,3,3,4,4,6,9,9,12,-3,-6,-5,-8,1,17.0,1.0,16.0,8
13335,13335,2006-07,2006,2007,Portsmouth,Reading,Draw,Away,2007-03-17,1,0,3,3,4,0,3,6,9,0,0,-3,-5,0,17.0,21.0,-4.0,8
13336,13336,2006-07,2006,2007,Portsmouth,Fulham,Draw,Away,2007-03-31,1,1,1,4,4,2,2,2,5,-1,-1,2,-1,0,17.0,12.0,5.0,8
13337,13337,2006-07,2006,2007,Portsmouth,Man United,Win,Home,2007-04-07,3,2,2,2,5,6,9,12,15,-4,-7,-10,-10,1,17.0,2.0,15.0,9
13338,13338,2006-07,2006,2007,Portsmouth,Watford,Loss,Away,2007-04-09,0,4,5,5,5,0,0,1,1,4,5,4,4,0,17.0,21.0,-4.0,9
13339,13339,2006-07,2006,2007,Portsmouth,Newcastle,Win,Home,2007-04-14,3,3,4,5,5,4,4,4,5,-1,0,1,0,1,17.0,7.0,10.0,9
13340,13340,2006-07,2006,2007,Portsmouth,Aston Villa,Draw,Away,2007-04-22,1,3,6,7,8,4,7,8,9,-1,-1,-1,-1,0,17.0,16.0,1.0,9
13341,13341,2006-07,2006,2007,Portsmouth,Liverpool,Win,Home,2007-04-28,3,4,4,7,8,6,7,10,13,-2,-3,-3,-5,1,17.0,3.0,14.0,9
13342,13342,2006-07,2006,2007,Portsmouth,Everton,Loss,Away,2007-05-05,0,4,7,7,10,0,3,4,7,4,4,3,3,0,17.0,11.0,6.0,10
13343,13343,2006-07,2006,2007,Portsmouth,Arsenal,Draw,Home,2007-05-13,1,3,4,7,7,4,5,8,11,-1,-1,-1,-4,1,17.0,4.0,13.0,10
13344,13344,2007-08,2007,2008,Portsmouth,Derby,Draw,Away,2007-08-11,1,1,4,5,8,1,1,1,1,0,3,4,7,0,9.0,21.0,-12.0,1
13345,13345,2007-08,2007,2008,Portsmouth,Man United,Draw,Home,2007-08-15,1,2,2,5,6,1,2,5,8,1,0,0,-2,1,9.0,1.0,8.0,1
13346,13346,2007-08,2007,2008,Portsmouth,Bolton,Win,Home,2007-08-18,3,2,3,3,6,0,1,1,2,2,2,2,4,1,9.0,7.0,2.0,1
13347,13347,2007-08,2007,2008,Portsmouth,Chelsea,Loss,Away,2007-08-25,0,4,5,6,6,4,7,8,9,0,-2,-2,-3,0,9.0,2.0,7.0,1
13348,13348,2007-08,2007,2008,Portsmouth,Arsenal,Loss,Away,2007-09-02,0,3,4,5,6,4,7,8,9,-1,-3,-3,-3,0,9.0,4.0,5.0,2
13349,13349,2007-08,2007,2008,Portsmouth,Liverpool,Draw,Home,2007-09-15,1,0,3,4,5,6,7,10,11,-6,-4,-6,-6,1,9.0,3.0,6.0,2
13350,13350,2007-08,2007,2008,Portsmouth,Blackburn,Win,Away,2007-09-23,3,1,1,4,5,4,5,6,9,-3,-4,-2,-4,0,9.0,10.0,-1.0,2
13351,13351,2007-08,2007,2008,Portsmouth,Reading,Win,Home,2007-09-29,3,4,4,4,7,3,3,3,6,1,1,1,1,1,9.0,8.0,1.0,2
13352,13352,2007-08,2007,2008,Portsmouth,Fulham,Win,Away,2007-10-07,3,6,7,7,7,2,3,4,4,4,4,3,3,0,9.0,16.0,-7.0,3
13353,13353,2007-08,2007,2008,Portsmouth,Wigan,Win,Away,2007-10-20,3,6,9,10,10,0,0,1,1,6,9,9,9,0,9.0,17.0,-8.0,3
13354,13354,2007-08,2007,2008,Portsmouth,West Ham,Draw,Home,2007-10-27,1,6,9,12,13,3,3,3,6,3,6,9,7,1,9.0,15.0,-6.0,3
13355,13355,2007-08,2007,2008,Portsmouth,Newcastle,Win,Away,2007-11-03,3,4,7,10,13,3,6,6,9,1,1,4,4,0,9.0,13.0,-4.0,4
13356,13356,2007-08,2007,2008,Portsmouth,Man City,Draw,Home,2007-11-11,1,4,7,10,13,3,6,9,12,1,1,1,1,1,9.0,14.0,-5.0,4
13357,13357,2007-08,2007,2008,Portsmouth,Birmingham,Win,Away,2007-11-24,3,4,5,8,11,0,3,3,3,4,2,5,8,0,9.0,21.0,-12.0,4
13358,13358,2007-08,2007,2008,Portsmouth,Everton,Draw,Home,2007-12-01,1,4,7,8,11,4,7,10,10,0,0,-2,1,1,9.0,6.0,3.0,5
13359,13359,2007-08,2007,2008,Portsmouth,Aston Villa,Win,Away,2007-12-08,3,4,5,8,9,3,6,9,12,1,-1,-1,-3,0,9.0,11.0,-2.0,5
13360,13360,2007-08,2007,2008,Portsmouth,Tottenham,Loss,Home,2007-12-15,0,4,7,8,11,3,4,7,8,1,3,1,3,1,9.0,5.0,4.0,5
13361,13361,2007-08,2007,2008,Portsmouth,Liverpool,Loss,Away,2007-12-22,0,3,4,7,8,0,3,6,9,3,1,1,-1,0,9.0,3.0,6.0,5
13362,13362,2007-08,2007,2008,Portsmouth,Arsenal,Draw,Home,2007-12-26,1,0,3,4,7,6,6,7,10,-6,-3,-3,-3,1,9.0,4.0,5.0,5
13363,13363,2007-08,2007,2008,Portsmouth,Middlesbrough,Loss,Home,2007-12-29,0,1,1,4,5,0,3,6,7,1,-2,-2,-2,1,9.0,12.0,-3.0,5
13364,13364,2007-08,2007,2008,Portsmouth,Reading,Win,Away,2008-01-01,3,1,1,1,4,1,4,5,8,0,-3,-4,-4,0,9.0,8.0,1.0,6
13365,13365,2007-08,2007,2008,Portsmouth,Sunderland,Loss,Away,2008-01-13,0,3,4,4,4,3,3,3,4,0,1,1,0,0,9.0,21.0,-12.0,6
13366,13366,2007-08,2007,2008,Portsmouth,Derby,Win,Home,2008-01-19,3,3,3,4,4,0,0,0,1,3,3,4,3,1,9.0,21.0,-12.0,6
13367,13367,2007-08,2007,2008,Portsmouth,Man United,Loss,Away,2008-01-30,0,3,6,6,7,6,9,9,12,-3,-3,-3,-5,0,9.0,1.0,8.0,6
13368,13368,2007-08,2007,2008,Portsmouth,Chelsea,Draw,Home,2008-02-02,1,3,3,6,6,6,9,12,15,-3,-6,-6,-9,1,9.0,2.0,7.0,7
13369,13369,2007-08,2007,2008,Portsmouth,Bolton,Win,Away,2008-02-09,3,1,4,4,7,4,5,5,8,-3,-1,-1,-1,0,9.0,7.0,2.0,7
13370,13370,2007-08,2007,2008,Portsmouth,Sunderland,Win,Home,2008-02-23,3,4,4,7,7,3,6,6,9,1,-2,1,-2,1,9.0,21.0,-12.0,7
13371,13371,2007-08,2007,2008,Portsmouth,Everton,Loss,Away,2008-03-02,0,6,7,7,10,6,7,8,11,0,0,-1,-1,0,9.0,6.0,3.0,8
13372,13372,2007-08,2007,2008,Portsmouth,Birmingham,Win,Home,2008-03-12,3,3,6,7,7,4,5,6,6,-1,1,1,1,1,9.0,21.0,-12.0,8
13373,13373,2007-08,2007,2008,Portsmouth,Aston Villa,Win,Home,2008-03-15,3,3,6,9,10,2,5,8,8,1,1,1,2,1,9.0,11.0,-2.0,8
13374,13374,2007-08,2007,2008,Portsmouth,Tottenham,Loss,Away,2008-03-22,0,6,6,9,12,1,4,4,7,5,2,5,5,0,9.0,5.0,4.0,8
13375,13375,2007-08,2007,2008,Portsmouth,Wigan,Win,Home,2008-03-29,3,3,6,6,9,3,4,5,8,0,2,1,1,1,9.0,17.0,-8.0,8
13376,13376,2007-08,2007,2008,Portsmouth,West Ham,Win,Away,2008-04-08,3,3,6,9,9,1,4,4,4,2,2,5,5,0,9.0,15.0,-6.0,9
13377,13377,2007-08,2007,2008,Portsmouth,Newcastle,Draw,Home,2008-04-12,1,6,6,9,12,6,9,10,10,0,-3,-1,2,1,9.0,13.0,-4.0,9
13378,13378,2007-08,2007,2008,Portsmouth,Man City,Loss,Away,2008-04-20,0,4,7,7,10,3,3,4,7,1,4,3,3,0,9.0,14.0,-5.0,9
13379,13379,2007-08,2007,2008,Portsmouth,Blackburn,Loss,Home,2008-04-27,0,1,4,7,7,1,2,3,6,0,2,4,1,1,9.0,10.0,-1.0,9
13380,13380,2007-08,2007,2008,Portsmouth,Middlesbrough,Loss,Away,2008-05-03,0,0,1,4,7,0,1,2,2,0,0,2,5,0,9.0,12.0,-3.0,10
13381,13381,2007-08,2007,2008,Portsmouth,Fulham,Loss,Home,2008-05-11,0,0,0,1,4,6,6,9,9,-6,-6,-8,-5,1,9.0,16.0,-7.0,10
13382,13382,2008-09,2008,2009,Portsmouth,Chelsea,Loss,Away,2008-08-17,0,0,0,0,1,4,7,10,11,-4,-7,-10,-10,0,8.0,2.0,6.0,1
13383,13383,2008-09,2008,2009,Portsmouth,Man United,Loss,Home,2008-08-25,0,0,0,0,0,4,7,7,8,-4,-7,-7,-8,1,8.0,1.0,7.0,1
13384,13384,2008-09,2008,2009,Portsmouth,Everton,Win,Away,2008-08-30,3,0,0,0,0,3,6,6,7,-3,-6,-6,-7,0,8.0,5.0,3.0,1
13385,13385,2008-09,2008,2009,Portsmouth,Middlesbrough,Win,Home,2008-09-13,3,3,3,3,3,3,6,9,12,0,-3,-6,-9,1,8.0,13.0,-5.0,2
13386,13386,2008-09,2008,2009,Portsmouth,Man City,Loss,Away,2008-09-21,0,6,6,6,6,3,6,6,6,3,0,0,0,0,8.0,9.0,-1.0,2
13387,13387,2008-09,2008,2009,Portsmouth,Tottenham,Win,Home,2008-09-28,3,3,6,6,6,1,2,2,2,2,4,4,4,1,8.0,11.0,-3.0,2
13388,13388,2008-09,2008,2009,Portsmouth,Stoke,Win,Home,2008-10-05,3,3,6,9,9,1,1,1,4,2,5,8,5,1,8.0,21.0,-13.0,3
13389,13389,2008-09,2008,2009,Portsmouth,Aston Villa,Draw,Away,2008-10-18,1,6,6,9,12,3,6,9,10,3,0,0,2,0,8.0,6.0,2.0,3
13390,13390,2008-09,2008,2009,Portsmouth,Fulham,Draw,Home,2008-10-26,1,4,7,7,10,1,1,1,4,3,6,6,6,1,8.0,17.0,-9.0,3
13391,13391,2008-09,2008,2009,Portsmouth,Liverpool,Loss,Away,2008-10-29,0,2,5,8,8,6,9,12,13,-4,-4,-4,-5,0,8.0,4.0,4.0,3
13392,13392,2008-09,2008,2009,Portsmouth,Wigan,Loss,Home,2008-11-01,0,1,2,5,8,0,0,0,3,1,2,5,5,1,8.0,14.0,-6.0,4
13393,13393,2008-09,2008,2009,Portsmouth,Sunderland,Win,Away,2008-11-08,3,0,1,2,5,0,3,4,5,0,-2,-2,0,0,8.0,15.0,-7.0,4
13394,13394,2008-09,2008,2009,Portsmouth,West Ham,Draw,Away,2008-11-15,1,3,3,4,5,1,1,1,1,2,2,3,4,0,8.0,10.0,-2.0,4
13395,13395,2008-09,2008,2009,Portsmouth,Hull,Draw,Home,2008-11-22,1,4,4,4,5,1,1,1,4,3,3,3,1,1,8.0,21.0,-13.0,4
13396,13396,2008-09,2008,2009,Portsmouth,Blackburn,Win,Home,2008-11-30,3,2,5,5,5,0,0,1,1,2,5,4,4,1,8.0,7.0,1.0,4
13397,13397,2008-09,2008,2009,Portsmouth,West Brom,Draw,Away,2008-12-07,1,4,5,8,8,0,0,0,1,4,5,8,7,0,8.0,21.0,-13.0,5
13398,13398,2008-09,2008,2009,Portsmouth,Newcastle,Loss,Home,2008-12-14,0,4,5,6,9,2,3,4,4,2,2,2,5,1,8.0,12.0,-4.0,5
13399,13399,2008-09,2008,2009,Portsmouth,Bolton,Loss,Away,2008-12-20,0,1,4,5,6,0,3,6,6,1,1,-1,0,0,8.0,16.0,-8.0,5
13400,13400,2008-09,2008,2009,Portsmouth,West Ham,Loss,Home,2008-12-26,0,0,1,4,5,1,1,2,5,-1,0,2,0,1,8.0,10.0,-2.0,5
13401,13401,2008-09,2008,2009,Portsmouth,Arsenal,Loss,Away,2008-12-28,0,0,0,1,4,2,3,6,9,-2,-3,-5,-5,0,8.0,3.0,5.0,5
13402,13402,2008-09,2008,2009,Portsmouth,Tottenham,Draw,Away,2009-01-18,1,0,0,0,1,0,1,1,2,0,-1,-1,-1,0,8.0,11.0,-3.0,6
13403,13403,2008-09,2008,2009,Portsmouth,Aston Villa,Loss,Home,2009-01-27,0,1,1,1,1,6,9,10,13,-5,-8,-9,-12,1,8.0,6.0,2.0,6
13404,13404,2008-09,2008,2009,Portsmouth,Fulham,Loss,Away,2009-01-31,0,1,1,1,1,0,1,2,5,1,0,-1,-4,0,8.0,17.0,-9.0,6
13405,13405,2008-09,2008,2009,Portsmouth,Liverpool,Loss,Home,2009-02-07,0,0,1,1,1,4,5,6,9,-4,-4,-5,-8,1,8.0,4.0,4.0,7
13406,13406,2008-09,2008,2009,Portsmouth,Man City,Win,Home,2009-02-14,3,0,0,1,1,3,6,9,10,-3,-6,-8,-9,1,8.0,9.0,-1.0,7
13407,13407,2008-09,2008,2009,Portsmouth,Stoke,Draw,Away,2009-02-21,1,3,3,3,4,3,3,3,4,0,0,0,0,0,8.0,21.0,-13.0,7
13408,13408,2008-09,2008,2009,Portsmouth,Chelsea,Loss,Home,2009-03-03,0,4,4,4,4,6,7,7,10,-2,-3,-3,-6,1,8.0,2.0,6.0,8
13409,13409,2008-09,2008,2009,Portsmouth,Middlesbrough,Draw,Away,2009-03-14,1,1,4,4,4,3,4,4,5,-2,0,0,-1,0,8.0,13.0,-5.0,8
13410,13410,2008-09,2008,2009,Portsmouth,Everton,Win,Home,2009-03-21,3,1,2,5,5,4,7,8,11,-3,-5,-3,-6,1,8.0,5.0,3.0,8
13411,13411,2008-09,2008,2009,Portsmouth,Hull,Draw,Away,2009-04-04,1,4,4,5,8,1,4,4,4,3,0,1,4,0,8.0,21.0,-13.0,9
13412,13412,2008-09,2008,2009,Portsmouth,West Brom,Draw,Home,2009-04-11,1,4,5,5,6,1,2,2,2,3,3,3,4,1,8.0,21.0,-13.0,9
13413,13413,2008-09,2008,2009,Portsmouth,Bolton,Win,Home,2009-04-18,3,2,5,6,6,3,4,4,4,-1,1,2,2,1,8.0,16.0,-8.0,9
13414,13414,2008-09,2008,2009,Portsmouth,Man United,Loss,Away,2009-04-22,0,4,5,8,9,6,6,6,9,-2,-1,2,0,0,8.0,1.0,7.0,9
13415,13415,2008-09,2008,2009,Portsmouth,Newcastle,Draw,Away,2009-04-27,1,3,4,5,8,1,1,1,2,2,3,4,6,0,8.0,12.0,-4.0,9
13416,13416,2008-09,2008,2009,Portsmouth,Arsenal,Loss,Home,2009-05-02,0,1,4,5,6,4,7,10,13,-3,-3,-5,-7,1,8.0,3.0,5.0,10
13417,13417,2008-09,2008,2009,Portsmouth,Blackburn,Loss,Away,2009-05-09,0,1,1,4,5,3,3,3,6,-2,-2,1,-1,0,8.0,7.0,1.0,10
13418,13418,2008-09,2008,2009,Portsmouth,Sunderland,Win,Home,2009-05-18,3,0,1,1,4,1,1,4,4,-1,0,-3,0,1,8.0,15.0,-7.0,10
13419,13419,2008-09,2008,2009,Portsmouth,Wigan,Loss,Away,2009-05-24,0,3,3,4,4,0,0,1,1,3,3,3,3,0,8.0,14.0,-6.0,10
13420,13420,2009-10,2009,2010,Portsmouth,Fulham,Loss,Home,2009-08-15,0,3,3,3,4,3,6,6,9,0,-3,-3,-5,1,14.0,7.0,7.0,1
13421,13421,2009-10,2009,2010,Portsmouth,Birmingham,Loss,Away,2009-08-19,0,0,3,3,3,3,3,4,4,-3,0,-1,-1,0,14.0,21.0,-7.0,1
13422,13422,2009-10,2009,2010,Portsmouth,Arsenal,Loss,Away,2009-08-22,0,0,0,3,3,6,7,7,10,-6,-7,-4,-7,0,14.0,4.0,10.0,1
13423,13423,2009-10,2009,2010,Portsmouth,Man City,Loss,Home,2009-08-30,0,0,0,0,3,6,9,9,9,-6,-9,-9,-6,1,14.0,10.0,4.0,1
13424,13424,2009-10,2009,2010,Portsmouth,Bolton,Loss,Home,2009-09-12,0,0,0,0,0,0,0,0,1,0,0,0,-1,1,14.0,13.0,1.0,2
13425,13425,2009-10,2009,2010,Portsmouth,Aston Villa,Loss,Away,2009-09-19,0,0,0,0,0,6,9,9,12,-6,-9,-9,-12,0,14.0,6.0,8.0,2
13426,13426,2009-10,2009,2010,Portsmouth,Everton,Loss,Home,2009-09-26,0,0,0,0,0,3,6,6,6,-3,-6,-6,-6,1,14.0,5.0,9.0,2
13427,13427,2009-10,2009,2010,Portsmouth,Wolves,Win,Away,2009-10-03,3,0,0,0,0,3,3,4,4,-3,-3,-4,-4,0,14.0,21.0,-7.0,3
13428,13428,2009-10,2009,2010,Portsmouth,Tottenham,Loss,Home,2009-10-17,0,3,3,3,3,4,4,4,7,-1,-1,-1,-4,1,14.0,8.0,6.0,3
13429,13429,2009-10,2009,2010,Portsmouth,Hull,Draw,Away,2009-10-24,1,3,3,3,3,3,3,3,3,0,0,0,0,0,14.0,17.0,-3.0,3
13430,13430,2009-10,2009,2010,Portsmouth,Wigan,Win,Home,2009-10-31,3,1,4,4,4,4,4,7,7,-3,0,-3,-3,1,14.0,11.0,3.0,3
13431,13431,2009-10,2009,2010,Portsmouth,Blackburn,Loss,Away,2009-11-07,0,4,4,7,7,0,3,3,6,4,1,4,1,0,14.0,15.0,-1.0,4
13432,13432,2009-10,2009,2010,Portsmouth,Stoke,Loss,Away,2009-11-22,0,3,4,4,7,1,4,7,8,2,0,-3,-1,0,14.0,12.0,2.0,4
13433,13433,2009-10,2009,2010,Portsmouth,Man United,Loss,Home,2009-11-28,0,0,3,4,4,3,6,6,9,-3,-3,-2,-5,1,14.0,1.0,13.0,4
13434,13434,2009-10,2009,2010,Portsmouth,Burnley,Win,Home,2009-12-05,3,0,0,3,4,1,2,5,5,-1,-2,-2,-1,1,14.0,21.0,-7.0,5
13435,13435,2009-10,2009,2010,Portsmouth,Sunderland,Draw,Away,2009-12-12,1,3,3,3,6,0,3,3,4,3,0,0,2,0,14.0,16.0,-2.0,5
13436,13436,2009-10,2009,2010,Portsmouth,Chelsea,Loss,Away,2009-12-16,0,4,4,4,4,1,4,7,10,3,0,-3,-6,0,14.0,3.0,11.0,5
13437,13437,2009-10,2009,2010,Portsmouth,Liverpool,Win,Home,2009-12-19,3,1,4,4,4,3,4,7,8,-2,0,-3,-4,1,14.0,2.0,12.0,5
13438,13438,2009-10,2009,2010,Portsmouth,West Ham,Loss,Away,2009-12-26,0,3,4,7,7,1,1,1,4,2,3,6,3,0,14.0,9.0,5.0,5
13439,13439,2009-10,2009,2010,Portsmouth,Arsenal,Loss,Home,2009-12-30,0,3,3,4,7,6,7,10,13,-3,-4,-6,-6,1,14.0,4.0,10.0,5
13440,13440,2009-10,2009,2010,Portsmouth,West Ham,Draw,Home,2010-01-26,1,0,3,3,4,1,4,5,5,-1,-1,-2,-1,1,14.0,9.0,5.0,6
13441,13441,2009-10,2009,2010,Portsmouth,Man City,Loss,Away,2010-01-31,0,1,1,4,4,3,6,9,12,-2,-5,-5,-8,0,14.0,10.0,4.0,6
13442,13442,2009-10,2009,2010,Portsmouth,Fulham,Loss,Away,2010-02-03,0,1,1,1,4,0,0,0,0,1,1,1,4,0,14.0,7.0,7.0,7
13443,13443,2009-10,2009,2010,Portsmouth,Man United,Loss,Away,2010-02-06,0,0,1,1,1,6,9,10,13,-6,-8,-9,-12,0,14.0,1.0,13.0,7
13444,13444,2009-10,2009,2010,Portsmouth,Sunderland,Draw,Home,2010-02-09,1,0,0,1,1,2,2,2,3,-2,-2,-1,-2,1,14.0,16.0,-2.0,7
13445,13445,2009-10,2009,2010,Portsmouth,Stoke,Loss,Home,2010-02-20,0,1,1,1,2,2,5,6,7,-1,-4,-5,-5,1,14.0,12.0,2.0,7
13446,13446,2009-10,2009,2010,Portsmouth,Burnley,Win,Away,2010-02-27,3,1,1,1,1,0,3,3,3,1,-2,-2,-2,0,14.0,21.0,-7.0,7
13447,13447,2009-10,2009,2010,Portsmouth,Birmingham,Loss,Home,2010-03-09,0,3,4,4,4,3,3,6,7,0,1,-2,-3,1,14.0,21.0,-7.0,8
13448,13448,2009-10,2009,2010,Portsmouth,Liverpool,Loss,Away,2010-03-15,0,3,3,4,4,3,4,4,7,0,-1,0,-3,0,14.0,2.0,12.0,8
13449,13449,2009-10,2009,2010,Portsmouth,Hull,Win,Home,2010-03-20,3,0,3,3,4,0,0,0,3,0,3,3,1,1,14.0,17.0,-3.0,8
13450,13450,2009-10,2009,2010,Portsmouth,Chelsea,Loss,Home,2010-03-24,0,3,3,6,6,4,4,7,7,-1,-1,-1,-1,1,14.0,3.0,11.0,8
13451,13451,2009-10,2009,2010,Portsmouth,Tottenham,Loss,Away,2010-03-27,0,3,3,3,6,6,9,12,12,-3,-6,-9,-6,0,14.0,8.0,6.0,8
13452,13452,2009-10,2009,2010,Portsmouth,Blackburn,Draw,Home,2010-04-03,1,0,3,3,3,6,7,7,7,-6,-4,-4,-4,1,14.0,15.0,-1.0,9
13453,13453,2009-10,2009,2010,Portsmouth,Wigan,Draw,Away,2010-04-14,1,1,1,4,4,0,3,3,3,1,-2,1,1,0,14.0,11.0,3.0,9
13454,13454,2009-10,2009,2010,Portsmouth,Aston Villa,Loss,Home,2010-04-18,0,2,2,2,5,4,4,5,6,-2,-2,-3,-1,1,14.0,6.0,8.0,9
13455,13455,2009-10,2009,2010,Portsmouth,Bolton,Draw,Away,2010-04-24,1,1,2,2,2,3,3,3,3,-2,-1,-1,-1,0,14.0,13.0,1.0,9
13456,13456,2009-10,2009,2010,Portsmouth,Wolves,Win,Home,2010-05-01,3,1,2,3,3,2,3,3,4,-1,-1,0,-1,1,14.0,21.0,-7.0,10
13457,13457,2009-10,2009,2010,Portsmouth,Everton,Loss,Away,2010-05-09,0,4,4,5,6,4,7,8,9,0,-3,-3,-3,0,14.0,5.0,9.0,10
13458,13458,1993-94,1993,1994,QPR,Aston Villa,Loss,Away,1993-08-14,0,0,0,0,0,0,0,0,0,0,0,0,0,0,5.0,2.0,3.0,1
13459,13459,1993-94,1993,1994,QPR,Liverpool,Loss,Home,1993-08-18,0,0,0,0,0,3,3,3,3,-3,-3,-3,-3,1,5.0,6.0,-1.0,1
13460,13460,1993-94,1993,1994,QPR,Southampton,Win,Home,1993-08-21,3,0,0,0,0,0,0,0,0,0,0,0,0,1,5.0,18.0,-13.0,1
13461,13461,1993-94,1993,1994,QPR,Chelsea,Loss,Away,1993-08-25,0,3,3,3,3,1,1,1,1,2,2,2,2,0,5.0,11.0,-6.0,1
13462,13462,1993-94,1993,1994,QPR,West Ham,Win,Away,1993-08-28,3,3,3,3,3,4,4,4,4,-1,-1,-1,-1,0,5.0,21.0,-16.0,1
13463,13463,1993-94,1993,1994,QPR,Sheffield United,Win,Home,1993-09-01,3,3,6,6,6,4,4,4,7,-1,2,2,-1,1,5.0,14.0,-9.0,2
13464,13464,1993-94,1993,1994,QPR,Man City,Loss,Away,1993-09-11,0,6,6,9,9,4,4,4,4,2,2,5,5,0,5.0,9.0,-4.0,2
13465,13465,1993-94,1993,1994,QPR,Norwich,Draw,Home,1993-09-18,1,3,6,6,9,1,2,5,8,2,4,1,1,1,5.0,3.0,2.0,2
13466,13466,1993-94,1993,1994,QPR,Wimbledon,Draw,Away,1993-09-27,1,1,4,7,7,6,9,10,10,-5,-5,-3,-3,0,5.0,12.0,-7.0,2
13467,13467,1993-94,1993,1994,QPR,Ipswich,Win,Home,1993-10-02,3,2,2,5,8,1,1,2,3,1,1,3,5,1,5.0,16.0,-11.0,3
13468,13468,1993-94,1993,1994,QPR,Newcastle,Win,Away,1993-10-16,3,4,5,5,8,6,7,10,11,-2,-2,-5,-3,0,5.0,21.0,-16.0,3
13469,13469,1993-94,1993,1994,QPR,Coventry,Win,Home,1993-10-23,3,6,7,8,8,1,1,2,3,5,6,6,5,1,5.0,15.0,-10.0,3
13470,13470,1993-94,1993,1994,QPR,Man United,Loss,Away,1993-10-30,0,6,9,10,11,6,9,12,15,0,0,-2,-4,0,5.0,1.0,4.0,3
13471,13471,1993-94,1993,1994,QPR,Blackburn,Win,Home,1993-11-06,3,3,6,9,10,4,5,8,9,-1,1,1,1,1,5.0,4.0,1.0,4
13472,13472,1993-94,1993,1994,QPR,Everton,Win,Away,1993-11-20,3,3,6,9,12,3,3,4,4,0,3,5,8,0,5.0,13.0,-8.0,4
13473,13473,1993-94,1993,1994,QPR,Swindon,Loss,Away,1993-11-24,0,6,6,9,12,1,1,2,3,5,5,7,9,0,5.0,21.0,-16.0,4
13474,13474,1993-94,1993,1994,QPR,Tottenham,Draw,Home,1993-11-27,1,3,6,6,9,2,2,2,3,1,4,4,6,1,5.0,8.0,-3.0,4
13475,13475,1993-94,1993,1994,QPR,Aston Villa,Draw,Home,1993-12-04,1,1,4,7,7,0,3,6,9,1,1,1,-2,1,5.0,2.0,3.0,5
13476,13476,1993-94,1993,1994,QPR,Liverpool,Loss,Away,1993-12-08,0,2,2,5,8,3,3,6,9,-1,-1,-1,-1,0,5.0,6.0,-1.0,5
13477,13477,1993-94,1993,1994,QPR,Southampton,Win,Away,1993-12-11,3,1,2,2,5,0,0,3,3,1,2,-1,2,0,5.0,18.0,-13.0,5
13478,13478,1993-94,1993,1994,QPR,Oldham,Win,Home,1993-12-27,3,3,4,5,5,1,4,5,8,2,0,0,-3,1,5.0,19.0,-14.0,5
13479,13479,1993-94,1993,1994,QPR,Leeds,Draw,Away,1993-12-29,1,6,6,7,8,4,4,7,10,2,2,0,-2,0,5.0,17.0,-12.0,5
13480,13480,1993-94,1993,1994,QPR,Sheffield Weds,Loss,Home,1994-01-01,0,4,7,7,8,4,7,7,8,0,0,0,0,1,5.0,7.0,-2.0,6
13481,13481,1993-94,1993,1994,QPR,Arsenal,Draw,Away,1994-01-03,1,1,4,7,7,6,9,9,12,-5,-5,-2,-5,0,5.0,10.0,-5.0,6
13482,13482,1993-94,1993,1994,QPR,Newcastle,Loss,Home,1994-01-16,0,1,2,5,8,6,6,7,10,-5,-4,-2,-2,1,5.0,21.0,-16.0,6
13483,13483,1993-94,1993,1994,QPR,Coventry,Win,Away,1994-01-22,3,1,1,2,5,1,4,7,8,0,-3,-5,-3,0,5.0,15.0,-10.0,6
13484,13484,1993-94,1993,1994,QPR,Man United,Loss,Home,1994-02-05,0,3,4,4,5,6,7,8,11,-3,-3,-4,-6,1,5.0,1.0,4.0,7
13485,13485,1993-94,1993,1994,QPR,Man City,Draw,Home,1994-03-05,1,3,3,4,4,4,4,5,8,-1,-1,-1,-4,1,5.0,9.0,-4.0,8
13486,13486,1993-94,1993,1994,QPR,Norwich,Win,Away,1994-03-12,3,1,4,4,5,1,2,3,4,0,2,1,1,0,5.0,3.0,2.0,8
13487,13487,1993-94,1993,1994,QPR,Sheffield United,Draw,Away,1994-03-16,1,4,4,7,7,2,2,3,3,2,2,4,4,0,5.0,14.0,-9.0,8
13488,13488,1993-94,1993,1994,QPR,Wimbledon,Win,Home,1994-03-19,3,4,5,5,8,3,6,6,9,1,-1,-1,-1,1,5.0,12.0,-7.0,8
13489,13489,1993-94,1993,1994,QPR,Ipswich,Win,Away,1994-03-26,3,4,7,8,8,1,4,4,7,3,3,4,1,0,5.0,16.0,-11.0,8
13490,13490,1993-94,1993,1994,QPR,Oldham,Loss,Away,1994-04-02,0,6,7,10,11,4,7,7,8,2,0,3,3,0,5.0,19.0,-14.0,9
13491,13491,1993-94,1993,1994,QPR,Leeds,Loss,Home,1994-04-04,0,3,6,7,10,1,4,7,8,2,2,0,2,1,5.0,17.0,-12.0,9
13492,13492,1993-94,1993,1994,QPR,Sheffield Weds,Loss,Away,1994-04-09,0,0,3,6,7,6,9,9,9,-6,-6,-3,-2,0,5.0,7.0,-2.0,9
13493,13493,1993-94,1993,1994,QPR,Chelsea,Draw,Home,1994-04-13,1,0,0,3,6,4,4,7,7,-4,-4,-4,-1,1,5.0,11.0,-6.0,9
13494,13494,1993-94,1993,1994,QPR,Everton,Win,Home,1994-04-16,3,1,1,1,4,3,3,4,4,-2,-2,-3,0,1,5.0,13.0,-8.0,9
13495,13495,1993-94,1993,1994,QPR,Blackburn,Draw,Away,1994-04-24,1,4,4,4,4,3,6,9,9,1,-2,-5,-5,0,5.0,4.0,1.0,9
13496,13496,1993-94,1993,1994,QPR,Arsenal,Draw,Home,1994-04-27,1,4,5,5,5,4,7,8,9,0,-2,-3,-4,1,5.0,10.0,-5.0,9
13497,13497,1993-94,1993,1994,QPR,Swindon,Loss,Home,1994-04-30,0,2,5,6,6,0,1,1,2,2,4,5,4,1,5.0,21.0,-16.0,9
13498,13498,1993-94,1993,1994,QPR,West Ham,Draw,Home,1994-05-03,1,1,2,5,6,3,3,6,6,-2,-1,-1,0,1,5.0,21.0,-16.0,10
13499,13499,1993-94,1993,1994,QPR,Tottenham,Win,Away,1994-05-07,3,1,2,3,6,3,6,6,6,-2,-4,-3,0,0,5.0,8.0,-3.0,10
13500,13500,1994-95,1994,1995,QPR,Man United,Loss,Away,1994-08-20,0,4,4,5,6,4,7,10,13,0,-3,-5,-7,0,9.0,1.0,8.0,1
13501,13501,1994-95,1994,1995,QPR,Sheffield Weds,Win,Home,1994-08-24,3,3,4,4,5,1,2,3,6,2,2,1,-1,1,9.0,7.0,2.0,1
13502,13502,1994-95,1994,1995,QPR,Ipswich,Loss,Home,1994-08-27,0,3,6,7,7,1,2,2,2,2,4,5,5,1,9.0,19.0,-10.0,1
13503,13503,1994-95,1994,1995,QPR,Leicester,Draw,Away,1994-08-31,1,3,3,6,7,0,0,0,0,3,3,6,7,0,9.0,21.0,-12.0,1
13504,13504,1994-95,1994,1995,QPR,Coventry,Draw,Home,1994-09-10,1,1,4,4,7,0,0,1,2,1,4,3,5,1,9.0,11.0,-2.0,2
13505,13505,1994-95,1994,1995,QPR,Everton,Draw,Away,1994-09-17,1,2,2,5,5,0,0,0,1,2,2,5,4,0,9.0,17.0,-8.0,2
13506,13506,1994-95,1994,1995,QPR,Wimbledon,Loss,Home,1994-09-24,0,2,3,3,6,4,4,4,5,-2,-1,-1,1,1,9.0,6.0,3.0,2
13507,13507,1994-95,1994,1995,QPR,Nott'm Forest,Loss,Away,1994-10-02,0,1,2,3,3,4,7,10,13,-3,-5,-7,-10,0,9.0,21.0,-12.0,3
13508,13508,1994-95,1994,1995,QPR,Tottenham,Draw,Away,1994-10-08,1,0,1,2,3,3,3,3,6,-3,-2,-1,-3,0,9.0,15.0,-6.0,3
13509,13509,1994-95,1994,1995,QPR,Man City,Loss,Home,1994-10-15,0,1,1,2,3,1,4,5,6,0,-3,-3,-3,1,9.0,16.0,-7.0,3
13510,13510,1994-95,1994,1995,QPR,Norwich,Loss,Away,1994-10-22,0,1,1,1,2,4,7,7,10,-3,-6,-6,-8,0,9.0,12.0,-3.0,3
13511,13511,1994-95,1994,1995,QPR,Aston Villa,Win,Home,1994-10-29,3,0,1,1,1,1,1,1,1,-1,0,0,0,1,9.0,10.0,-1.0,3
13512,13512,1994-95,1994,1995,QPR,Liverpool,Win,Home,1994-10-31,3,3,3,4,4,6,6,9,12,-3,-3,-5,-8,1,9.0,8.0,1.0,3
13513,13513,1994-95,1994,1995,QPR,Newcastle,Loss,Away,1994-11-05,0,6,6,6,7,3,6,7,10,3,0,-1,-3,0,9.0,3.0,6.0,4
13514,13514,1994-95,1994,1995,QPR,Leeds,Win,Home,1994-11-19,3,3,6,6,6,3,6,9,10,0,0,-3,-4,1,9.0,5.0,4.0,4
13515,13515,1994-95,1994,1995,QPR,Blackburn,Loss,Away,1994-11-26,0,3,6,9,9,6,9,12,12,-3,-3,-3,-3,0,9.0,2.0,7.0,4
13516,13516,1994-95,1994,1995,QPR,West Ham,Win,Home,1994-12-04,3,3,3,6,9,0,3,3,3,3,0,3,6,1,9.0,13.0,-4.0,5
13517,13517,1994-95,1994,1995,QPR,Man United,Loss,Home,1994-12-10,0,3,6,6,9,4,7,10,13,-1,-1,-4,-4,1,9.0,1.0,8.0,5
13518,13518,1994-95,1994,1995,QPR,Sheffield Weds,Win,Away,1994-12-17,3,3,3,6,6,3,4,7,8,0,-1,-1,-2,0,9.0,7.0,2.0,5
13519,13519,1994-95,1994,1995,QPR,Crystal Palace,Draw,Away,1994-12-26,1,3,6,6,9,1,1,2,2,2,5,4,7,0,9.0,21.0,-12.0,5
13520,13520,1994-95,1994,1995,QPR,Southampton,Draw,Home,1994-12-28,1,4,4,7,7,3,3,3,4,1,1,4,3,1,9.0,18.0,-9.0,5
13521,13521,1994-95,1994,1995,QPR,Arsenal,Win,Away,1994-12-31,3,2,5,5,8,4,4,7,8,-2,1,-2,0,0,9.0,4.0,5.0,5
13522,13522,1994-95,1994,1995,QPR,Aston Villa,Loss,Away,1995-01-14,0,4,5,8,8,2,5,6,6,2,0,2,2,0,9.0,10.0,-1.0,6
13523,13523,1994-95,1994,1995,QPR,Leeds,Loss,Away,1995-01-24,0,3,4,5,8,2,2,3,6,1,2,2,2,0,9.0,5.0,4.0,6
13524,13524,1994-95,1994,1995,QPR,Newcastle,Win,Home,1995-02-04,3,0,3,4,5,6,7,8,9,-6,-4,-4,-4,1,9.0,3.0,6.0,7
13525,13525,1994-95,1994,1995,QPR,Liverpool,Draw,Away,1995-02-11,1,3,3,6,7,2,2,5,8,1,1,1,-1,0,9.0,8.0,1.0,7
13526,13526,1994-95,1994,1995,QPR,Nott'm Forest,Draw,Home,1995-02-26,1,4,4,4,7,0,1,4,4,4,3,0,3,1,9.0,21.0,-12.0,7
13527,13527,1994-95,1994,1995,QPR,Wimbledon,Win,Away,1995-03-04,3,2,5,5,5,3,3,4,4,-1,2,1,1,0,9.0,6.0,3.0,8
13528,13528,1994-95,1994,1995,QPR,Leicester,Win,Home,1995-03-08,3,4,5,8,8,1,2,3,3,3,3,5,5,1,9.0,21.0,-12.0,8
13529,13529,1994-95,1994,1995,QPR,Norwich,Win,Home,1995-03-15,3,6,7,8,11,2,3,4,4,4,4,4,7,1,9.0,12.0,-3.0,8
13530,13530,1994-95,1994,1995,QPR,Everton,Loss,Home,1995-03-18,0,6,9,10,11,1,2,5,5,5,7,5,6,1,9.0,17.0,-8.0,8
13531,13531,1994-95,1994,1995,QPR,Chelsea,Win,Home,1995-03-22,3,3,6,9,10,0,3,4,7,3,3,5,3,1,9.0,14.0,-5.0,8
13532,13532,1994-95,1994,1995,QPR,Coventry,Win,Away,1995-04-01,3,3,6,9,12,3,4,5,6,0,2,4,6,0,9.0,11.0,-2.0,9
13533,13533,1994-95,1994,1995,QPR,Blackburn,Loss,Home,1995-04-04,0,6,6,9,12,6,7,10,13,0,-1,-1,-1,1,9.0,2.0,7.0,9
13534,13534,1994-95,1994,1995,QPR,Arsenal,Win,Home,1995-04-08,3,3,6,6,9,3,3,3,3,0,3,3,6,1,9.0,4.0,5.0,9
13535,13535,1994-95,1994,1995,QPR,Ipswich,Win,Away,1995-04-11,3,3,6,9,9,0,0,0,0,3,6,9,9,0,9.0,19.0,-10.0,9
13536,13536,1994-95,1994,1995,QPR,Southampton,Loss,Away,1995-04-15,0,6,6,9,12,3,6,9,9,3,0,0,3,0,9.0,18.0,-9.0,9
13537,13537,1994-95,1994,1995,QPR,Crystal Palace,Loss,Home,1995-04-17,0,3,6,6,9,2,5,5,8,1,1,1,1,1,9.0,21.0,-12.0,9
13538,13538,1994-95,1994,1995,QPR,Chelsea,Loss,Away,1995-04-29,0,0,3,6,6,4,4,5,6,-4,-1,1,0,0,9.0,14.0,-5.0,9
13539,13539,1994-95,1994,1995,QPR,West Ham,Draw,Away,1995-05-03,1,0,0,3,6,4,7,8,11,-4,-7,-5,-5,0,9.0,13.0,-4.0,10
13540,13540,1994-95,1994,1995,QPR,Tottenham,Win,Home,1995-05-06,3,1,1,1,4,2,5,6,9,-1,-4,-5,-5,1,9.0,15.0,-6.0,10
13541,13541,1994-95,1994,1995,QPR,Man City,Win,Away,1995-05-14,3,4,4,4,4,1,2,5,8,3,2,-1,-4,0,9.0,16.0,-7.0,10
13542,13542,1995-96,1995,1996,QPR,Blackburn,Loss,Away,1995-08-19,0,6,7,7,7,3,3,6,6,3,4,1,1,0,8.0,1.0,7.0,1
13543,13543,1995-96,1995,1996,QPR,Wimbledon,Loss,Home,1995-08-23,0,3,6,7,7,4,5,6,7,-1,1,1,0,1,8.0,9.0,-1.0,1
13544,13544,1995-96,1995,1996,QPR,Man City,Win,Home,1995-08-26,3,0,3,6,7,1,1,1,2,-1,2,5,5,1,8.0,17.0,-9.0,1
13545,13545,1995-96,1995,1996,QPR,Liverpool,Loss,Away,1995-08-30,0,3,3,6,9,3,6,9,9,0,-3,-3,0,0,8.0,4.0,4.0,1
13546,13546,1995-96,1995,1996,QPR,Sheffield Weds,Loss,Home,1995-09-09,0,3,3,3,6,1,4,4,7,2,-1,-1,-1,1,8.0,13.0,-5.0,2
13547,13547,1995-96,1995,1996,QPR,Leeds,Win,Away,1995-09-16,3,0,3,3,3,1,4,7,10,-1,-1,-4,-7,0,8.0,5.0,3.0,2
13548,13548,1995-96,1995,1996,QPR,Tottenham,Loss,Home,1995-09-25,0,3,3,6,6,6,7,7,7,-3,-4,-1,-1,1,8.0,7.0,1.0,2
13549,13549,1995-96,1995,1996,QPR,Bolton,Win,Away,1995-09-30,3,3,3,3,6,0,1,1,4,3,2,2,2,0,8.0,21.0,-13.0,2
13550,13550,1995-96,1995,1996,QPR,Newcastle,Loss,Home,1995-10-14,0,3,6,6,6,6,9,9,12,-3,-3,-3,-6,1,8.0,6.0,2.0,3
13551,13551,1995-96,1995,1996,QPR,Middlesbrough,Loss,Away,1995-10-21,0,3,3,6,6,6,9,12,13,-3,-6,-6,-7,0,8.0,21.0,-13.0,3
13552,13552,1995-96,1995,1996,QPR,Nott'm Forest,Draw,Home,1995-10-28,1,0,3,3,6,6,9,10,13,-6,-6,-7,-7,1,8.0,3.0,5.0,3
13553,13553,1995-96,1995,1996,QPR,Southampton,Loss,Away,1995-11-04,0,1,1,4,4,3,3,4,4,-2,-2,0,0,0,8.0,10.0,-2.0,4
13554,13554,1995-96,1995,1996,QPR,Coventry,Draw,Home,1995-11-19,1,1,1,1,4,0,0,1,1,1,1,0,3,1,8.0,16.0,-8.0,4
13555,13555,1995-96,1995,1996,QPR,Everton,Loss,Away,1995-11-22,0,1,2,2,2,6,6,7,8,-5,-4,-5,-6,0,8.0,15.0,-7.0,4
13556,13556,1995-96,1995,1996,QPR,West Ham,Loss,Away,1995-11-25,0,1,1,2,2,4,4,7,8,-3,-3,-5,-6,0,8.0,14.0,-6.0,4
13557,13557,1995-96,1995,1996,QPR,Middlesbrough,Draw,Home,1995-12-02,1,0,1,1,2,3,4,5,5,-3,-3,-4,-3,1,8.0,21.0,-13.0,5
13558,13558,1995-96,1995,1996,QPR,Tottenham,Loss,Away,1995-12-09,0,1,1,2,2,2,5,8,11,-1,-4,-6,-9,0,8.0,7.0,1.0,5
13559,13559,1995-96,1995,1996,QPR,Bolton,Win,Home,1995-12-16,3,1,1,1,2,1,1,1,1,0,0,0,1,1,8.0,21.0,-13.0,5
13560,13560,1995-96,1995,1996,QPR,Aston Villa,Win,Home,1995-12-23,3,3,4,4,4,4,5,5,8,-1,-1,-1,-4,1,8.0,18.0,-10.0,5
13561,13561,1995-96,1995,1996,QPR,Arsenal,Loss,Away,1995-12-26,0,6,6,7,7,1,2,3,4,5,4,4,3,0,8.0,12.0,-4.0,5
13562,13562,1995-96,1995,1996,QPR,Man United,Loss,Away,1995-12-30,0,3,6,6,7,3,3,4,5,0,3,2,2,0,8.0,2.0,6.0,5
13563,13563,1995-96,1995,1996,QPR,Chelsea,Loss,Home,1996-01-02,0,0,3,6,6,1,4,5,8,-1,-1,1,-2,1,8.0,11.0,-3.0,6
13564,13564,1995-96,1995,1996,QPR,Blackburn,Loss,Home,1996-01-13,0,0,0,3,6,4,7,8,11,-4,-7,-5,-5,1,8.0,1.0,7.0,6
13565,13565,1995-96,1995,1996,QPR,Wimbledon,Loss,Away,1996-01-20,0,0,0,0,3,0,3,6,7,0,-3,-6,-4,0,8.0,9.0,-1.0,6
13566,13566,1995-96,1995,1996,QPR,Man City,Loss,Away,1996-02-03,0,0,0,0,0,2,2,5,5,-2,-2,-5,-5,0,8.0,17.0,-9.0,7
13567,13567,1995-96,1995,1996,QPR,Liverpool,Loss,Home,1996-02-11,0,0,0,0,0,4,7,8,11,-4,-7,-8,-11,1,8.0,4.0,4.0,7
13568,13568,1995-96,1995,1996,QPR,Sheffield Weds,Win,Away,1996-02-17,3,0,0,0,0,3,3,4,7,-3,-3,-4,-7,0,8.0,13.0,-5.0,7
13569,13569,1995-96,1995,1996,QPR,Arsenal,Draw,Home,1996-03-02,1,3,3,3,3,6,7,7,10,-3,-4,-4,-7,1,8.0,12.0,-4.0,8
13570,13570,1995-96,1995,1996,QPR,Leeds,Loss,Home,1996-03-06,0,4,4,4,4,0,0,0,3,4,4,4,1,1,8.0,5.0,3.0,8
13571,13571,1995-96,1995,1996,QPR,Aston Villa,Loss,Away,1996-03-09,0,1,4,4,4,3,6,7,10,-2,-2,-3,-6,0,8.0,18.0,-10.0,8
13572,13572,1995-96,1995,1996,QPR,Man United,Draw,Home,1996-03-16,1,0,1,4,4,6,9,12,15,-6,-8,-8,-11,1,8.0,2.0,6.0,8
13573,13573,1995-96,1995,1996,QPR,Chelsea,Draw,Away,1996-03-23,1,1,1,2,5,1,2,5,5,0,-1,-3,0,0,8.0,11.0,-3.0,8
13574,13574,1995-96,1995,1996,QPR,Southampton,Win,Home,1996-03-30,3,2,2,2,3,3,3,3,3,-1,-1,-1,0,1,8.0,10.0,-2.0,8
13575,13575,1995-96,1995,1996,QPR,Newcastle,Loss,Away,1996-04-06,0,4,5,5,5,0,3,3,4,4,2,2,1,0,8.0,6.0,2.0,9
13576,13576,1995-96,1995,1996,QPR,Everton,Win,Home,1996-04-08,3,3,4,5,5,6,6,7,8,-3,-2,-2,-3,1,8.0,15.0,-7.0,9
13577,13577,1995-96,1995,1996,QPR,Coventry,Loss,Away,1996-04-13,0,3,6,7,8,3,3,3,3,0,3,4,5,0,8.0,16.0,-8.0,9
13578,13578,1995-96,1995,1996,QPR,West Ham,Win,Home,1996-04-27,3,3,3,6,7,4,4,5,8,-1,-1,1,-1,1,8.0,14.0,-6.0,9
13579,13579,1995-96,1995,1996,QPR,Nott'm Forest,Loss,Away,1996-05-04,0,3,6,6,9,1,2,2,5,2,4,4,4,0,8.0,3.0,5.0,10
13580,13580,2011-12,2011,2012,QPR,Bolton,Loss,Home,2011-08-13,0,3,3,6,6,0,0,0,0,3,3,6,6,1,21.0,14.0,7.0,1
13581,13581,2011-12,2011,2012,QPR,Everton,Win,Away,2011-08-20,3,0,3,3,6,3,6,7,7,-3,-3,-4,-1,0,21.0,7.0,14.0,1
13582,13582,2011-12,2011,2012,QPR,Wigan,Loss,Away,2011-08-27,0,3,3,6,6,2,5,8,9,1,-2,-2,-3,0,21.0,16.0,5.0,1
13583,13583,2011-12,2011,2012,QPR,Newcastle,Draw,Home,2011-09-12,1,3,3,3,6,6,7,8,9,-3,-4,-5,-3,1,21.0,12.0,9.0,2
13584,13584,2011-12,2011,2012,QPR,Wolves,Win,Away,2011-09-17,3,1,4,4,4,1,4,7,7,0,0,-3,-3,0,21.0,17.0,4.0,2
13585,13585,2011-12,2011,2012,QPR,Aston Villa,Draw,Home,2011-09-25,1,4,4,7,7,2,3,6,7,2,1,1,0,1,21.0,9.0,12.0,2
13586,13586,2011-12,2011,2012,QPR,Fulham,Loss,Away,2011-10-02,0,4,5,5,8,2,3,3,3,2,2,2,5,0,21.0,8.0,13.0,3
13587,13587,2011-12,2011,2012,QPR,Blackburn,Draw,Home,2011-10-15,1,1,4,5,5,0,3,4,4,1,1,1,1,1,21.0,15.0,6.0,3
13588,13588,2011-12,2011,2012,QPR,Chelsea,Win,Home,2011-10-23,3,1,2,5,6,6,9,9,12,-5,-7,-4,-6,1,21.0,2.0,19.0,3
13589,13589,2011-12,2011,2012,QPR,Tottenham,Loss,Away,2011-10-30,0,4,4,5,8,4,7,10,13,0,-3,-5,-5,0,21.0,5.0,16.0,3
13590,13590,2011-12,2011,2012,QPR,Man City,Loss,Home,2011-11-05,0,3,4,4,5,6,9,12,15,-3,-5,-8,-10,1,21.0,3.0,18.0,4
13591,13591,2011-12,2011,2012,QPR,Stoke,Win,Away,2011-11-19,3,0,3,4,4,0,0,3,3,0,3,1,1,0,21.0,13.0,8.0,4
13592,13592,2011-12,2011,2012,QPR,Norwich,Loss,Away,2011-11-26,0,3,3,6,7,0,1,2,5,3,2,4,2,0,21.0,21.0,0.0,4
13593,13593,2011-12,2011,2012,QPR,West Brom,Draw,Home,2011-12-03,1,3,3,3,6,3,3,3,6,0,0,0,0,1,21.0,11.0,10.0,5
13594,13594,2011-12,2011,2012,QPR,Liverpool,Loss,Away,2011-12-10,0,1,4,4,4,1,4,5,8,0,0,-1,-4,0,21.0,6.0,15.0,5
13595,13595,2011-12,2011,2012,QPR,Man United,Loss,Home,2011-12-18,0,1,1,4,4,6,7,10,13,-5,-6,-6,-9,1,21.0,1.0,20.0,5
13596,13596,2011-12,2011,2012,QPR,Sunderland,Loss,Home,2011-12-21,0,0,1,1,4,3,3,3,4,-3,-2,-2,0,1,21.0,10.0,11.0,5
13597,13597,2011-12,2011,2012,QPR,Swansea,Draw,Away,2011-12-27,1,0,0,1,1,1,4,4,5,-1,-4,-3,-4,0,21.0,21.0,0.0,5
13598,13598,2011-12,2011,2012,QPR,Arsenal,Loss,Away,2011-12-31,0,1,1,1,2,4,4,7,10,-3,-3,-6,-8,0,21.0,4.0,17.0,5
13599,13599,2011-12,2011,2012,QPR,Norwich,Loss,Home,2012-01-02,0,1,1,1,1,1,2,3,6,0,-1,-2,-5,1,21.0,21.0,0.0,6
13600,13600,2011-12,2011,2012,QPR,Newcastle,Loss,Away,2012-01-15,0,0,1,1,1,3,6,6,7,-3,-5,-5,-6,0,21.0,12.0,9.0,6
13601,13601,2011-12,2011,2012,QPR,Wigan,Win,Home,2012-01-21,3,0,0,1,1,0,1,1,2,0,-1,0,-1,1,21.0,16.0,5.0,6
13602,13602,2011-12,2011,2012,QPR,Aston Villa,Draw,Away,2012-02-01,1,3,3,3,4,4,4,7,8,-1,-1,-4,-4,0,21.0,9.0,12.0,7
13603,13603,2011-12,2011,2012,QPR,Wolves,Loss,Home,2012-02-04,0,4,4,4,4,0,1,1,2,4,3,3,2,1,21.0,17.0,4.0,7
13604,13604,2011-12,2011,2012,QPR,Blackburn,Loss,Away,2012-02-11,0,1,4,4,4,0,1,4,4,1,3,0,0,0,21.0,15.0,6.0,7
13605,13605,2011-12,2011,2012,QPR,Fulham,Loss,Home,2012-02-25,0,0,1,4,4,3,4,7,7,-3,-3,-3,-3,1,21.0,8.0,13.0,7
13606,13606,2011-12,2011,2012,QPR,Everton,Draw,Home,2012-03-03,1,0,0,1,4,4,7,8,9,-4,-7,-7,-5,1,21.0,7.0,14.0,8
13607,13607,2011-12,2011,2012,QPR,Bolton,Loss,Away,2012-03-10,0,1,1,1,2,0,0,0,1,1,1,1,1,0,21.0,14.0,7.0,8
13608,13608,2011-12,2011,2012,QPR,Liverpool,Win,Home,2012-03-21,3,1,1,1,1,3,3,3,4,-2,-2,-2,-3,1,21.0,6.0,15.0,8
13609,13609,2011-12,2011,2012,QPR,Sunderland,Loss,Away,2012-03-24,0,3,4,4,4,3,4,4,4,0,0,0,0,0,21.0,10.0,11.0,8
13610,13610,2011-12,2011,2012,QPR,Arsenal,Win,Home,2012-03-31,3,3,3,4,4,6,9,12,15,-3,-6,-8,-11,1,21.0,4.0,17.0,8
13611,13611,2011-12,2011,2012,QPR,Man United,Loss,Away,2012-04-08,0,3,6,6,7,6,9,12,15,-3,-3,-6,-8,0,21.0,1.0,20.0,9
13612,13612,2011-12,2011,2012,QPR,Swansea,Win,Home,2012-04-11,3,3,3,6,6,0,0,3,6,3,3,3,0,1,21.0,21.0,0.0,9
13613,13613,2011-12,2011,2012,QPR,West Brom,Loss,Away,2012-04-14,0,3,6,6,9,3,3,3,4,0,3,3,5,0,21.0,11.0,10.0,9
13614,13614,2011-12,2011,2012,QPR,Tottenham,Win,Home,2012-04-21,3,3,3,6,6,1,4,5,6,2,-1,1,0,1,21.0,5.0,16.0,9
13615,13615,2011-12,2011,2012,QPR,Chelsea,Loss,Away,2012-04-29,0,3,6,6,9,2,5,8,9,1,1,-2,0,0,21.0,2.0,19.0,9
13616,13616,2011-12,2011,2012,QPR,Stoke,Win,Home,2012-05-06,3,3,3,6,6,2,2,3,6,1,1,3,0,1,21.0,13.0,8.0,10
13617,13617,2011-12,2011,2012,QPR,Man City,Loss,Away,2012-05-13,0,3,6,6,9,6,9,12,15,-3,-3,-6,-6,0,21.0,3.0,18.0,10
13618,13618,2012-13,2012,2013,QPR,Swansea,Loss,Home,2012-08-18,0,3,3,6,6,3,4,5,8,0,-1,1,-2,1,17.0,11.0,6.0,1
13619,13619,2012-13,2012,2013,QPR,Norwich,Draw,Away,2012-08-25,1,0,3,3,6,3,4,4,4,-3,-1,-1,2,0,17.0,12.0,5.0,1
13620,13620,2012-13,2012,2013,QPR,Man City,Loss,Away,2012-09-01,0,1,1,4,4,4,7,10,13,-3,-6,-6,-9,0,17.0,1.0,16.0,2
13621,13621,2012-13,2012,2013,QPR,Chelsea,Draw,Home,2012-09-15,1,1,1,1,4,6,9,12,12,-5,-8,-11,-8,1,17.0,6.0,11.0,2
13622,13622,2012-13,2012,2013,QPR,Tottenham,Loss,Away,2012-09-23,0,1,2,2,2,4,5,5,8,-3,-3,-3,-6,0,17.0,4.0,13.0,2
13623,13623,2012-13,2012,2013,QPR,West Ham,Loss,Home,2012-10-01,0,1,1,2,2,2,5,5,8,-1,-4,-3,-6,1,17.0,21.0,-4.0,3
13624,13624,2012-13,2012,2013,QPR,West Brom,Loss,Away,2012-10-06,0,0,1,1,2,4,4,7,8,-4,-3,-6,-6,0,17.0,10.0,7.0,3
13625,13625,2012-13,2012,2013,QPR,Everton,Draw,Home,2012-10-21,1,0,0,1,1,4,7,8,8,-4,-7,-7,-7,1,17.0,7.0,10.0,3
13626,13626,2012-13,2012,2013,QPR,Arsenal,Loss,Away,2012-10-27,0,1,1,1,2,3,3,4,7,-2,-2,-3,-5,0,17.0,3.0,14.0,3
13627,13627,2012-13,2012,2013,QPR,Reading,Draw,Home,2012-11-04,1,1,1,1,1,1,2,3,3,0,-1,-2,-2,1,17.0,21.0,-4.0,4
13628,13628,2012-13,2012,2013,QPR,Stoke,Loss,Away,2012-11-10,0,1,2,2,2,1,1,2,5,0,1,0,-3,0,17.0,14.0,3.0,4
13629,13629,2012-13,2012,2013,QPR,Southampton,Loss,Home,2012-11-17,0,1,1,2,2,1,1,1,2,0,0,1,0,1,17.0,21.0,-4.0,4
13630,13630,2012-13,2012,2013,QPR,Man United,Loss,Away,2012-11-24,0,0,1,1,2,3,6,9,12,-3,-5,-8,-10,0,17.0,2.0,15.0,4
13631,13631,2012-13,2012,2013,QPR,Sunderland,Draw,Away,2012-11-27,1,0,0,1,1,3,3,3,4,-3,-3,-2,-3,0,17.0,13.0,4.0,4
13632,13632,2012-13,2012,2013,QPR,Aston Villa,Draw,Home,2012-12-01,1,1,1,1,2,4,4,4,7,-3,-3,-3,-5,1,17.0,16.0,1.0,5
13633,13633,2012-13,2012,2013,QPR,Wigan,Draw,Away,2012-12-08,1,2,2,2,2,0,3,3,3,2,-1,-1,-1,0,17.0,15.0,2.0,5
13634,13634,2012-13,2012,2013,QPR,Fulham,Win,Home,2012-12-15,3,2,3,3,3,3,4,4,4,-1,-1,-1,-1,1,17.0,9.0,8.0,5
13635,13635,2012-13,2012,2013,QPR,Newcastle,Loss,Away,2012-12-22,0,4,5,6,6,0,3,3,3,4,2,3,3,0,17.0,5.0,12.0,5
13636,13636,2012-13,2012,2013,QPR,West Brom,Loss,Home,2012-12-26,0,3,4,5,6,4,4,4,4,-1,0,1,2,1,17.0,10.0,7.0,5
13637,13637,2012-13,2012,2013,QPR,Liverpool,Loss,Home,2012-12-30,0,0,3,4,5,3,3,6,9,-3,0,-2,-4,1,17.0,8.0,9.0,5
13638,13638,2012-13,2012,2013,QPR,Chelsea,Win,Away,2013-01-02,3,0,0,3,4,6,9,12,12,-6,-9,-9,-8,0,17.0,6.0,11.0,6
13639,13639,2012-13,2012,2013,QPR,Tottenham,Draw,Home,2013-01-12,1,3,3,3,6,6,9,10,13,-3,-6,-7,-7,1,17.0,4.0,13.0,6
13640,13640,2012-13,2012,2013,QPR,West Ham,Draw,Away,2013-01-19,1,4,4,4,4,3,3,3,4,1,1,1,0,0,17.0,21.0,-4.0,6
13641,13641,2012-13,2012,2013,QPR,Man City,Draw,Home,2013-01-29,1,2,5,5,5,6,9,12,12,-4,-4,-7,-7,1,17.0,1.0,16.0,6
13642,13642,2012-13,2012,2013,QPR,Norwich,Draw,Home,2013-02-02,1,2,3,6,6,1,2,2,2,1,1,4,4,1,17.0,12.0,5.0,7
13643,13643,2012-13,2012,2013,QPR,Swansea,Loss,Away,2013-02-09,0,2,3,4,7,1,4,5,6,1,-1,-1,1,0,17.0,11.0,6.0,7
13644,13644,2012-13,2012,2013,QPR,Man United,Loss,Home,2013-02-23,0,1,2,3,4,6,9,10,13,-5,-7,-7,-9,1,17.0,2.0,15.0,7
13645,13645,2012-13,2012,2013,QPR,Southampton,Win,Away,2013-03-02,3,0,1,2,3,3,4,4,5,-3,-3,-2,-2,0,17.0,21.0,-4.0,8
13646,13646,2012-13,2012,2013,QPR,Sunderland,Win,Home,2013-03-09,3,3,3,4,5,1,1,1,2,2,2,3,3,1,17.0,13.0,4.0,8
13647,13647,2012-13,2012,2013,QPR,Aston Villa,Loss,Away,2013-03-16,0,6,6,6,7,3,3,6,7,3,3,0,0,0,17.0,16.0,1.0,8
13648,13648,2012-13,2012,2013,QPR,Fulham,Loss,Away,2013-04-01,0,3,6,6,6,4,7,8,8,-1,-1,-2,-2,0,17.0,9.0,8.0,9
13649,13649,2012-13,2012,2013,QPR,Wigan,Draw,Home,2013-04-07,1,0,3,6,6,6,6,9,9,-6,-3,-3,-3,1,17.0,15.0,2.0,9
13650,13650,2012-13,2012,2013,QPR,Everton,Loss,Away,2013-04-13,0,1,1,4,7,4,7,10,10,-3,-6,-6,-3,0,17.0,7.0,10.0,9
13651,13651,2012-13,2012,2013,QPR,Stoke,Loss,Home,2013-04-20,0,1,1,1,4,0,0,1,1,1,1,0,3,1,17.0,14.0,3.0,9
13652,13652,2012-13,2012,2013,QPR,Reading,Draw,Away,2013-04-28,1,0,1,1,1,1,1,1,1,-1,0,0,0,0,17.0,21.0,-4.0,9
13653,13653,2012-13,2012,2013,QPR,Arsenal,Loss,Home,2013-05-04,0,1,1,2,2,4,5,8,11,-3,-4,-6,-9,1,17.0,3.0,14.0,10
13654,13654,2012-13,2012,2013,QPR,Newcastle,Loss,Home,2013-05-12,0,1,1,1,2,1,2,2,5,0,-1,-1,-3,1,17.0,5.0,12.0,10
13655,13655,2012-13,2012,2013,QPR,Liverpool,Loss,Away,2013-05-19,0,0,1,1,1,4,7,8,9,-4,-6,-7,-8,0,17.0,8.0,9.0,10
13656,13656,2014-15,2014,2015,QPR,Hull,Loss,Home,2014-08-16,0,0,0,1,1,0,0,1,1,0,0,0,0,1,21.0,16.0,5.0,1
13657,13657,2014-15,2014,2015,QPR,Tottenham,Loss,Away,2014-08-24,0,0,0,0,1,6,6,9,12,-6,-6,-9,-11,0,21.0,6.0,15.0,1
13658,13658,2014-15,2014,2015,QPR,Sunderland,Win,Home,2014-08-30,3,0,0,0,0,2,2,5,8,-2,-2,-5,-8,1,21.0,14.0,7.0,1
13659,13659,2014-15,2014,2015,QPR,Man United,Loss,Away,2014-09-14,0,3,3,3,3,2,2,3,6,1,1,0,-3,0,21.0,7.0,14.0,2
13660,13660,2014-15,2014,2015,QPR,Stoke,Draw,Home,2014-09-20,1,3,3,3,3,3,4,4,7,0,-1,-1,-4,1,21.0,9.0,12.0,2
13661,13661,2014-15,2014,2015,QPR,Southampton,Loss,Away,2014-09-27,0,1,4,4,4,6,9,10,10,-5,-5,-6,-6,0,21.0,8.0,13.0,2
13662,13662,2014-15,2014,2015,QPR,West Ham,Loss,Away,2014-10-05,0,1,1,4,4,3,4,4,7,-2,-3,0,-3,0,21.0,13.0,8.0,3
13663,13663,2014-15,2014,2015,QPR,Liverpool,Loss,Home,2014-10-19,0,0,1,1,4,4,4,4,7,-4,-3,-3,-3,1,21.0,2.0,19.0,3
13664,13664,2014-15,2014,2015,QPR,Aston Villa,Win,Home,2014-10-27,3,0,0,1,1,0,0,0,3,0,0,1,-2,1,21.0,15.0,6.0,3
13665,13665,2014-15,2014,2015,QPR,Chelsea,Loss,Away,2014-11-01,0,3,3,3,4,4,7,10,11,-1,-4,-7,-7,0,21.0,3.0,18.0,4
13666,13666,2014-15,2014,2015,QPR,Man City,Draw,Home,2014-11-08,1,3,3,3,3,3,6,9,12,0,-3,-6,-9,1,21.0,1.0,20.0,4
13667,13667,2014-15,2014,2015,QPR,Newcastle,Loss,Away,2014-11-22,0,1,4,4,4,6,9,12,13,-5,-5,-8,-9,0,21.0,10.0,11.0,4
13668,13668,2014-15,2014,2015,QPR,Leicester,Win,Home,2014-11-29,3,1,1,4,4,1,1,1,1,0,0,3,3,1,21.0,21.0,0.0,4
13669,13669,2014-15,2014,2015,QPR,Swansea,Loss,Away,2014-12-02,0,3,4,4,7,1,4,5,8,2,0,-1,-1,0,21.0,12.0,9.0,5
13670,13670,2014-15,2014,2015,QPR,Burnley,Win,Home,2014-12-06,3,3,3,4,4,2,5,8,8,1,-2,-4,-4,1,21.0,21.0,0.0,5
13671,13671,2014-15,2014,2015,QPR,Everton,Loss,Away,2014-12-15,0,3,6,6,7,1,1,4,5,2,5,2,2,0,21.0,5.0,16.0,5
13672,13672,2014-15,2014,2015,QPR,West Brom,Win,Home,2014-12-20,3,3,3,6,6,4,4,4,4,-1,-1,2,2,1,21.0,17.0,4.0,5
13673,13673,2014-15,2014,2015,QPR,Arsenal,Loss,Away,2014-12-26,0,3,6,6,9,4,4,7,10,-1,2,-1,-1,0,21.0,4.0,17.0,5
13674,13674,2014-15,2014,2015,QPR,Crystal Palace,Draw,Home,2014-12-28,1,3,3,6,6,0,1,2,2,3,2,4,4,1,21.0,11.0,10.0,5
13675,13675,2014-15,2014,2015,QPR,Swansea,Draw,Home,2015-01-01,1,1,4,4,7,3,6,6,6,-2,-2,-2,1,1,21.0,12.0,9.0,6
13676,13676,2014-15,2014,2015,QPR,Burnley,Loss,Away,2015-01-10,0,2,2,5,5,2,2,2,5,0,0,3,0,0,21.0,21.0,0.0,6
13677,13677,2014-15,2014,2015,QPR,Man United,Loss,Home,2015-01-17,0,1,2,2,5,1,2,5,6,0,0,-3,-1,1,21.0,7.0,14.0,6
13678,13678,2014-15,2014,2015,QPR,Stoke,Loss,Away,2015-01-31,0,0,1,2,2,3,4,7,10,-3,-3,-5,-8,0,21.0,9.0,12.0,6
13679,13679,2014-15,2014,2015,QPR,Southampton,Loss,Home,2015-02-07,0,0,0,1,2,3,6,9,10,-3,-6,-8,-8,1,21.0,8.0,13.0,7
13680,13680,2014-15,2014,2015,QPR,Sunderland,Win,Away,2015-02-10,3,0,0,0,1,4,4,4,4,-4,-4,-4,-3,0,21.0,14.0,7.0,7
13681,13681,2014-15,2014,2015,QPR,Hull,Loss,Away,2015-02-21,0,3,3,3,3,4,4,4,4,-1,-1,-1,-1,0,21.0,16.0,5.0,7
13682,13682,2014-15,2014,2015,QPR,Arsenal,Loss,Home,2015-03-04,0,3,3,3,3,6,9,9,12,-3,-6,-6,-9,1,21.0,4.0,17.0,8
13683,13683,2014-15,2014,2015,QPR,Tottenham,Loss,Home,2015-03-07,0,0,3,3,3,4,4,7,10,-4,-1,-4,-7,1,21.0,6.0,15.0,8
13684,13684,2014-15,2014,2015,QPR,Crystal Palace,Loss,Away,2015-03-14,0,0,0,3,3,3,3,4,7,-3,-3,-1,-4,0,21.0,11.0,10.0,8
13685,13685,2014-15,2014,2015,QPR,Everton,Loss,Home,2015-03-22,0,0,0,0,3,3,3,4,4,-3,-3,-4,-1,1,21.0,5.0,16.0,8
13686,13686,2014-15,2014,2015,QPR,West Brom,Win,Away,2015-04-04,3,0,0,0,0,3,3,6,7,-3,-3,-6,-7,0,21.0,17.0,4.0,9
13687,13687,2014-15,2014,2015,QPR,Aston Villa,Draw,Away,2015-04-07,1,3,3,3,3,0,3,6,6,3,0,-3,-3,0,21.0,15.0,6.0,9
13688,13688,2014-15,2014,2015,QPR,Chelsea,Loss,Home,2015-04-12,0,4,4,4,4,6,7,10,11,-2,-3,-6,-7,1,21.0,3.0,18.0,9
13689,13689,2014-15,2014,2015,QPR,West Ham,Draw,Home,2015-04-25,1,1,4,4,4,1,1,4,4,0,3,0,0,1,21.0,13.0,8.0,9
13690,13690,2014-15,2014,2015,QPR,Liverpool,Loss,Away,2015-05-02,0,1,2,5,5,1,4,4,4,0,-2,1,1,0,21.0,2.0,19.0,10
13691,13691,2014-15,2014,2015,QPR,Man City,Loss,Away,2015-05-10,0,1,1,2,5,6,9,9,9,-5,-8,-7,-4,0,21.0,1.0,20.0,10
13692,13692,2014-15,2014,2015,QPR,Newcastle,Win,Home,2015-05-16,3,0,1,1,2,1,1,1,1,-1,0,0,1,1,21.0,10.0,11.0,10
13693,13693,2014-15,2014,2015,QPR,Leicester,Loss,Away,2015-05-24,0,3,3,4,4,4,7,7,10,-1,-4,-3,-6,0,21.0,21.0,0.0,10
13694,13694,2006-07,2006,2007,Reading,Middlesbrough,Win,Home,2006-08-19,3,0,0,0,0,1,2,2,5,-1,-2,-2,-5,1,21.0,14.0,7.0,1
13695,13695,2006-07,2006,2007,Reading,Aston Villa,Loss,Away,2006-08-23,0,3,3,3,3,4,4,4,4,-1,-1,-1,-1,0,21.0,16.0,5.0,1
13696,13696,2006-07,2006,2007,Reading,Wigan,Loss,Away,2006-08-26,0,3,3,3,3,0,0,0,3,3,3,3,0,0,21.0,10.0,11.0,1
13697,13697,2006-07,2006,2007,Reading,Man City,Win,Home,2006-09-11,3,0,3,3,3,4,4,4,4,-4,-1,-1,-1,1,21.0,15.0,6.0,2
13698,13698,2006-07,2006,2007,Reading,Sheffield United,Win,Away,2006-09-16,3,3,3,6,6,1,1,2,2,2,2,4,4,0,21.0,21.0,0.0,2
13699,13699,2006-07,2006,2007,Reading,Man United,Draw,Home,2006-09-23,1,6,6,6,9,3,6,9,12,3,0,-3,-3,1,21.0,2.0,19.0,2
13700,13700,2006-07,2006,2007,Reading,West Ham,Win,Away,2006-10-01,3,4,7,7,7,0,1,1,2,4,6,6,5,0,21.0,9.0,12.0,3
13701,13701,2006-07,2006,2007,Reading,Chelsea,Loss,Home,2006-10-14,0,4,7,10,10,4,7,10,13,0,0,0,-3,1,21.0,1.0,20.0,3
13702,13702,2006-07,2006,2007,Reading,Arsenal,Loss,Home,2006-10-22,0,3,4,7,10,6,9,12,13,-3,-5,-5,-3,1,21.0,4.0,17.0,3
13703,13703,2006-07,2006,2007,Reading,Portsmouth,Loss,Away,2006-10-28,0,0,3,4,7,3,3,3,6,-3,0,1,1,0,21.0,17.0,4.0,3
13704,13704,2006-07,2006,2007,Reading,Liverpool,Loss,Away,2006-11-04,0,0,0,3,4,3,4,4,7,-3,-4,-1,-3,0,21.0,3.0,18.0,4
13705,13705,2006-07,2006,2007,Reading,Tottenham,Win,Home,2006-11-12,3,0,0,0,3,4,7,8,11,-4,-7,-8,-8,1,21.0,5.0,16.0,4
13706,13706,2006-07,2006,2007,Reading,Charlton,Win,Home,2006-11-18,3,3,3,3,3,3,4,5,5,0,-1,-2,-2,1,21.0,13.0,8.0,4
13707,13707,2006-07,2006,2007,Reading,Fulham,Win,Away,2006-11-25,3,6,6,6,6,1,4,4,5,5,2,2,1,0,21.0,12.0,9.0,4
13708,13708,2006-07,2006,2007,Reading,Bolton,Win,Home,2006-12-02,3,6,9,9,9,3,3,4,4,3,6,5,5,1,21.0,8.0,13.0,5
13709,13709,2006-07,2006,2007,Reading,Newcastle,Loss,Away,2006-12-06,0,6,9,12,12,4,5,5,6,2,4,7,6,0,21.0,7.0,14.0,5
13710,13710,2006-07,2006,2007,Reading,Watford,Draw,Away,2006-12-09,1,3,6,9,12,1,1,1,4,2,5,8,8,0,21.0,21.0,0.0,5
13711,13711,2006-07,2006,2007,Reading,Blackburn,Loss,Home,2006-12-16,0,1,4,7,10,0,3,4,4,1,1,3,6,1,21.0,6.0,15.0,5
13712,13712,2006-07,2006,2007,Reading,Everton,Loss,Home,2006-12-23,0,1,1,4,7,0,3,3,4,1,-2,1,3,1,21.0,11.0,10.0,5
13713,13713,2006-07,2006,2007,Reading,Chelsea,Draw,Away,2006-12-26,1,0,1,1,4,6,9,10,13,-6,-8,-9,-9,0,21.0,1.0,20.0,5
13714,13714,2006-07,2006,2007,Reading,Man United,Loss,Away,2006-12-30,0,1,1,2,2,6,6,9,12,-5,-5,-7,-10,0,21.0,2.0,19.0,5
13715,13715,2006-07,2006,2007,Reading,West Ham,Win,Home,2007-01-01,3,1,1,1,2,0,1,4,4,1,0,-3,-2,1,21.0,9.0,12.0,6
13716,13716,2006-07,2006,2007,Reading,Everton,Draw,Away,2007-01-14,1,3,4,4,4,3,4,7,7,0,0,-3,-3,0,21.0,11.0,10.0,6
13717,13717,2006-07,2006,2007,Reading,Sheffield United,Win,Home,2007-01-20,3,4,4,5,5,1,4,4,4,3,0,1,1,1,21.0,21.0,0.0,6
13718,13718,2006-07,2006,2007,Reading,Wigan,Win,Home,2007-01-30,3,4,7,7,8,0,0,0,0,4,7,7,8,1,21.0,10.0,11.0,6
13719,13719,2006-07,2006,2007,Reading,Man City,Win,Away,2007-02-03,3,6,7,10,10,1,4,7,10,5,3,3,0,0,21.0,15.0,6.0,7
13720,13720,2006-07,2006,2007,Reading,Aston Villa,Win,Home,2007-02-10,3,6,9,10,13,3,6,6,7,3,3,4,6,1,21.0,16.0,5.0,7
13721,13721,2006-07,2006,2007,Reading,Middlesbrough,Loss,Away,2007-02-24,0,6,9,12,13,1,2,5,8,5,7,7,5,0,21.0,14.0,7.0,7
13722,13722,2006-07,2006,2007,Reading,Arsenal,Loss,Away,2007-03-03,0,3,6,9,12,4,7,10,13,-1,-1,-1,-1,0,21.0,4.0,17.0,8
13723,13723,2006-07,2006,2007,Reading,Portsmouth,Draw,Home,2007-03-17,1,0,3,6,9,0,3,3,4,0,0,3,5,1,21.0,17.0,4.0,8
13724,13724,2006-07,2006,2007,Reading,Tottenham,Loss,Away,2007-04-01,0,1,1,4,7,6,9,12,12,-5,-8,-8,-5,0,21.0,5.0,16.0,9
13725,13725,2006-07,2006,2007,Reading,Liverpool,Loss,Home,2007-04-07,0,1,1,1,4,4,4,7,7,-3,-3,-6,-3,1,21.0,3.0,18.0,9
13726,13726,2006-07,2006,2007,Reading,Charlton,Draw,Away,2007-04-09,1,0,1,1,1,4,7,8,11,-4,-6,-7,-10,0,21.0,13.0,8.0,9
13727,13727,2006-07,2006,2007,Reading,Fulham,Win,Home,2007-04-14,3,1,1,2,2,0,1,2,3,1,0,0,-1,1,21.0,12.0,9.0,9
13728,13728,2006-07,2006,2007,Reading,Bolton,Win,Away,2007-04-21,3,4,4,4,5,1,4,7,7,3,0,-3,-2,0,21.0,8.0,13.0,9
13729,13729,2006-07,2006,2007,Reading,Newcastle,Win,Home,2007-04-30,3,6,7,7,7,1,2,5,5,5,5,2,2,1,21.0,7.0,14.0,9
13730,13730,2006-07,2006,2007,Reading,Watford,Loss,Home,2007-05-05,0,6,9,10,10,1,1,4,4,5,8,6,6,1,21.0,21.0,0.0,10
13731,13731,2006-07,2006,2007,Reading,Blackburn,Draw,Away,2007-05-13,1,3,6,9,10,4,7,8,11,-1,-1,1,-1,0,21.0,6.0,15.0,10
13732,13732,2007-08,2007,2008,Reading,Man United,Draw,Away,2007-08-12,1,1,4,7,10,1,4,7,8,0,0,0,2,0,8.0,1.0,7.0,1
13733,13733,2007-08,2007,2008,Reading,Chelsea,Loss,Home,2007-08-15,0,2,2,5,8,4,5,6,7,-2,-3,-1,1,1,8.0,2.0,6.0,1
13734,13734,2007-08,2007,2008,Reading,Everton,Win,Home,2007-08-18,3,1,2,2,5,6,7,10,10,-5,-5,-8,-5,1,8.0,6.0,2.0,1
13735,13735,2007-08,2007,2008,Reading,Bolton,Loss,Away,2007-08-25,0,3,4,5,5,0,0,1,1,3,4,4,4,0,8.0,7.0,1.0,1
13736,13736,2007-08,2007,2008,Reading,West Ham,Loss,Home,2007-09-01,0,3,3,4,5,4,4,7,10,-1,-1,-3,-5,1,8.0,15.0,-7.0,2
13737,13737,2007-08,2007,2008,Reading,Sunderland,Loss,Away,2007-09-15,0,0,3,3,4,0,0,1,4,0,3,2,0,0,8.0,21.0,-13.0,2
13738,13738,2007-08,2007,2008,Reading,Wigan,Win,Home,2007-09-22,3,0,0,3,3,1,2,5,8,-1,-2,-2,-5,1,8.0,17.0,-9.0,2
13739,13739,2007-08,2007,2008,Reading,Portsmouth,Loss,Away,2007-09-29,0,3,3,3,6,4,4,4,7,-1,-1,-1,-1,0,8.0,9.0,-1.0,2
13740,13740,2007-08,2007,2008,Reading,Derby,Win,Home,2007-10-07,3,3,3,3,3,1,4,4,4,2,-1,-1,-1,1,8.0,21.0,-13.0,3
13741,13741,2007-08,2007,2008,Reading,Blackburn,Loss,Away,2007-10-20,0,3,6,6,6,6,6,7,10,-3,0,-1,-4,0,8.0,10.0,-2.0,3
13742,13742,2007-08,2007,2008,Reading,Newcastle,Win,Home,2007-10-27,3,3,3,6,6,6,6,9,9,-3,-3,-3,-3,1,8.0,13.0,-5.0,3
13743,13743,2007-08,2007,2008,Reading,Fulham,Loss,Away,2007-11-03,0,3,6,6,9,2,2,3,4,1,4,3,5,0,8.0,16.0,-8.0,4
13744,13744,2007-08,2007,2008,Reading,Arsenal,Loss,Home,2007-11-12,0,3,3,6,6,2,5,8,11,1,-2,-2,-5,1,8.0,4.0,4.0,4
13745,13745,2007-08,2007,2008,Reading,Man City,Loss,Away,2007-11-24,0,0,3,3,6,4,4,7,10,-4,-1,-4,-4,0,8.0,14.0,-6.0,4
13746,13746,2007-08,2007,2008,Reading,Middlesbrough,Draw,Home,2007-12-01,1,0,0,3,3,1,2,2,2,-1,-2,1,1,1,8.0,12.0,-4.0,5
13747,13747,2007-08,2007,2008,Reading,Liverpool,Win,Home,2007-12-08,3,1,1,1,4,6,9,10,11,-5,-8,-9,-7,1,8.0,3.0,5.0,5
13748,13748,2007-08,2007,2008,Reading,Birmingham,Draw,Away,2007-12-15,1,4,4,4,4,3,3,3,3,1,1,1,1,0,8.0,21.0,-13.0,5
13749,13749,2007-08,2007,2008,Reading,Sunderland,Win,Home,2007-12-22,3,4,5,5,5,1,4,4,5,3,1,1,0,1,8.0,21.0,-13.0,5
13750,13750,2007-08,2007,2008,Reading,West Ham,Draw,Away,2007-12-26,1,4,7,8,8,3,6,6,7,1,1,2,1,0,8.0,15.0,-7.0,5
13751,13751,2007-08,2007,2008,Reading,Tottenham,Loss,Away,2007-12-29,0,4,5,8,9,3,6,9,9,1,-1,-1,0,0,8.0,5.0,3.0,5
13752,13752,2007-08,2007,2008,Reading,Portsmouth,Loss,Home,2008-01-01,0,1,4,5,8,1,1,1,4,0,3,4,4,1,8.0,9.0,-1.0,6
13753,13753,2007-08,2007,2008,Reading,Aston Villa,Loss,Away,2008-01-12,0,0,1,4,5,6,7,8,9,-6,-6,-4,-4,0,8.0,11.0,-3.0,6
13754,13754,2007-08,2007,2008,Reading,Man United,Loss,Home,2008-01-19,0,0,0,1,4,6,6,9,12,-6,-6,-8,-8,1,8.0,1.0,7.0,6
13755,13755,2007-08,2007,2008,Reading,Chelsea,Loss,Away,2008-01-30,0,0,0,0,1,6,9,12,13,-6,-9,-12,-12,0,8.0,2.0,6.0,6
13756,13756,2007-08,2007,2008,Reading,Bolton,Loss,Home,2008-02-02,0,0,0,0,0,2,2,5,5,-2,-2,-5,-5,1,8.0,7.0,1.0,7
13757,13757,2007-08,2007,2008,Reading,Everton,Loss,Away,2008-02-09,0,0,0,0,0,2,5,8,11,-2,-5,-8,-11,0,8.0,6.0,2.0,7
13758,13758,2007-08,2007,2008,Reading,Aston Villa,Loss,Home,2008-02-24,0,0,0,0,0,3,4,5,8,-3,-4,-5,-8,1,8.0,11.0,-3.0,7
13759,13759,2007-08,2007,2008,Reading,Middlesbrough,Win,Away,2008-03-01,3,0,0,0,0,3,4,7,8,-3,-4,-7,-8,0,8.0,12.0,-4.0,8
13760,13760,2007-08,2007,2008,Reading,Man City,Win,Home,2008-03-08,3,3,3,3,3,1,4,4,5,2,-1,-1,-2,1,8.0,14.0,-6.0,8
13761,13761,2007-08,2007,2008,Reading,Liverpool,Loss,Away,2008-03-15,0,6,6,6,6,6,9,12,13,0,-3,-6,-7,0,8.0,3.0,5.0,8
13762,13762,2007-08,2007,2008,Reading,Birmingham,Win,Home,2008-03-22,3,3,6,6,6,1,4,5,6,2,2,1,0,1,8.0,21.0,-13.0,8
13763,13763,2007-08,2007,2008,Reading,Blackburn,Draw,Home,2008-03-29,1,3,6,9,9,3,4,7,10,0,2,2,-1,1,8.0,10.0,-2.0,8
13764,13764,2007-08,2007,2008,Reading,Newcastle,Loss,Away,2008-04-05,0,4,4,7,10,6,7,7,7,-2,-3,0,3,0,8.0,13.0,-5.0,9
13765,13765,2007-08,2007,2008,Reading,Fulham,Loss,Home,2008-04-12,0,1,4,4,7,1,1,4,5,0,3,0,2,1,8.0,16.0,-8.0,9
13766,13766,2007-08,2007,2008,Reading,Arsenal,Loss,Away,2008-04-19,0,0,1,4,4,1,4,4,5,-1,-3,0,-1,0,8.0,4.0,4.0,9
13767,13767,2007-08,2007,2008,Reading,Wigan,Draw,Away,2008-04-26,1,0,0,1,4,2,5,5,5,-2,-5,-4,-1,0,8.0,17.0,-9.0,9
13768,13768,2007-08,2007,2008,Reading,Tottenham,Loss,Home,2008-05-03,0,1,1,1,2,2,3,4,4,-1,-2,-3,-2,1,8.0,5.0,3.0,10
13769,13769,2007-08,2007,2008,Reading,Derby,Win,Away,2008-05-11,3,1,1,1,1,0,0,0,0,1,1,1,1,0,8.0,21.0,-13.0,10
13770,13770,2012-13,2012,2013,Reading,Stoke,Draw,Home,2012-08-18,1,3,4,4,4,1,2,3,3,2,2,1,1,1,21.0,14.0,7.0,1
13771,13771,2012-13,2012,2013,Reading,Chelsea,Loss,Away,2012-08-22,0,4,4,5,5,6,6,6,9,-2,-2,-1,-4,0,21.0,6.0,15.0,1
13772,13772,2012-13,2012,2013,Reading,Tottenham,Loss,Home,2012-09-16,0,1,4,4,5,2,2,5,6,-1,2,-1,-1,1,21.0,4.0,17.0,2
13773,13773,2012-13,2012,2013,Reading,West Brom,Loss,Away,2012-09-22,0,0,1,4,4,3,4,7,7,-3,-3,-3,-3,0,21.0,10.0,11.0,2
13774,13774,2012-13,2012,2013,Reading,Newcastle,Draw,Home,2012-09-29,1,0,0,1,4,4,5,5,8,-4,-5,-4,-4,1,21.0,5.0,16.0,2
13775,13775,2012-13,2012,2013,Reading,Swansea,Draw,Away,2012-10-06,1,1,1,1,2,0,0,1,4,1,1,0,-2,0,21.0,11.0,10.0,3
13776,13776,2012-13,2012,2013,Reading,Liverpool,Loss,Away,2012-10-20,0,2,2,2,2,4,4,5,5,-2,-2,-3,-3,0,21.0,8.0,13.0,3
13777,13777,2012-13,2012,2013,Reading,Fulham,Draw,Home,2012-10-27,1,1,2,2,2,4,4,7,10,-3,-2,-5,-8,1,21.0,9.0,12.0,3
13778,13778,2012-13,2012,2013,Reading,QPR,Draw,Away,2012-11-04,1,1,2,3,3,1,1,1,1,0,1,2,2,0,21.0,17.0,4.0,4
13779,13779,2012-13,2012,2013,Reading,Norwich,Draw,Home,2012-11-10,1,2,2,3,4,4,7,7,7,-2,-5,-4,-3,1,21.0,12.0,9.0,4
13780,13780,2012-13,2012,2013,Reading,Everton,Win,Home,2012-11-17,3,2,3,3,4,4,5,6,7,-2,-2,-3,-3,1,21.0,7.0,14.0,4
13781,13781,2012-13,2012,2013,Reading,Wigan,Loss,Away,2012-11-24,0,4,5,6,6,0,3,6,6,4,2,0,0,0,21.0,15.0,6.0,4
13782,13782,2012-13,2012,2013,Reading,Aston Villa,Loss,Away,2012-11-27,0,3,4,5,6,1,1,4,5,2,3,1,1,0,21.0,16.0,5.0,4
13783,13783,2012-13,2012,2013,Reading,Man United,Loss,Home,2012-12-01,0,0,3,4,5,6,6,9,12,-6,-3,-5,-7,1,21.0,2.0,19.0,5
13784,13784,2012-13,2012,2013,Reading,Southampton,Loss,Away,2012-12-08,0,0,0,3,4,1,4,7,8,-1,-4,-4,-4,0,21.0,21.0,0.0,5
13785,13785,2012-13,2012,2013,Reading,Sunderland,Loss,Away,2012-12-11,0,0,0,0,3,0,1,1,4,0,-1,-1,-1,0,21.0,13.0,8.0,5
13786,13786,2012-13,2012,2013,Reading,Arsenal,Loss,Home,2012-12-17,0,0,0,0,0,3,4,5,8,-3,-4,-5,-8,1,21.0,3.0,18.0,5
13787,13787,2012-13,2012,2013,Reading,Man City,Loss,Away,2012-12-22,0,0,0,0,0,3,4,7,8,-3,-4,-7,-8,0,21.0,1.0,20.0,5
13788,13788,2012-13,2012,2013,Reading,Swansea,Draw,Home,2012-12-26,1,0,0,0,0,1,1,4,7,-1,-1,-4,-7,1,21.0,11.0,10.0,5
13789,13789,2012-13,2012,2013,Reading,West Ham,Win,Home,2012-12-29,3,1,1,1,1,1,1,4,4,0,0,-3,-3,1,21.0,21.0,0.0,5
13790,13790,2012-13,2012,2013,Reading,Tottenham,Loss,Away,2013-01-01,0,4,4,4,4,6,7,10,10,-2,-3,-6,-6,0,21.0,4.0,17.0,6
13791,13791,2012-13,2012,2013,Reading,West Brom,Win,Home,2013-01-12,3,3,4,4,4,0,3,6,7,3,1,-2,-3,1,21.0,10.0,11.0,6
13792,13792,2012-13,2012,2013,Reading,Newcastle,Win,Away,2013-01-19,3,3,6,7,7,1,1,1,4,2,5,6,3,0,21.0,5.0,16.0,6
13793,13793,2012-13,2012,2013,Reading,Chelsea,Draw,Home,2013-01-30,1,6,6,9,10,4,7,7,10,2,-1,2,0,1,21.0,6.0,15.0,6
13794,13794,2012-13,2012,2013,Reading,Sunderland,Win,Home,2013-02-02,3,4,7,7,10,4,7,7,7,0,0,0,3,1,21.0,13.0,8.0,7
13795,13795,2012-13,2012,2013,Reading,Stoke,Loss,Away,2013-02-09,0,4,7,10,10,1,1,1,1,3,6,9,9,0,21.0,14.0,7.0,7
13796,13796,2012-13,2012,2013,Reading,Wigan,Loss,Home,2013-02-23,0,3,4,7,10,1,2,2,3,2,2,5,7,1,21.0,15.0,6.0,7
13797,13797,2012-13,2012,2013,Reading,Everton,Loss,Away,2013-03-02,0,0,3,4,7,0,1,4,5,0,2,0,2,0,21.0,7.0,14.0,8
13798,13798,2012-13,2012,2013,Reading,Aston Villa,Loss,Home,2013-03-09,0,0,0,3,4,0,3,4,4,0,-3,-1,0,1,21.0,16.0,5.0,8
13799,13799,2012-13,2012,2013,Reading,Man United,Loss,Away,2013-03-16,0,0,0,0,3,6,9,12,15,-6,-9,-12,-12,0,21.0,2.0,19.0,8
13800,13800,2012-13,2012,2013,Reading,Arsenal,Loss,Away,2013-03-30,0,0,0,0,0,3,6,9,12,-3,-6,-9,-12,0,21.0,3.0,18.0,8
13801,13801,2012-13,2012,2013,Reading,Southampton,Loss,Home,2013-04-06,0,0,0,0,0,6,7,7,7,-6,-7,-7,-7,1,21.0,21.0,0.0,9
13802,13802,2012-13,2012,2013,Reading,Liverpool,Draw,Home,2013-04-13,1,0,0,0,0,4,4,7,10,-4,-4,-7,-10,1,21.0,8.0,13.0,9
13803,13803,2012-13,2012,2013,Reading,Norwich,Loss,Away,2013-04-20,0,1,1,1,1,1,1,2,3,0,0,-1,-2,0,21.0,12.0,9.0,9
13804,13804,2012-13,2012,2013,Reading,QPR,Draw,Home,2013-04-28,1,1,1,1,1,0,1,1,1,1,0,0,0,1,21.0,17.0,4.0,9
13805,13805,2012-13,2012,2013,Reading,Fulham,Win,Away,2013-05-04,3,1,2,2,2,0,0,1,1,1,2,1,1,0,21.0,9.0,12.0,10
13806,13806,2012-13,2012,2013,Reading,Man City,Loss,Home,2013-05-14,0,4,4,5,5,4,7,7,10,0,-3,-2,-5,1,21.0,1.0,20.0,10
13807,13807,2012-13,2012,2013,Reading,West Ham,Loss,Away,2013-05-19,0,3,4,4,5,1,1,4,5,2,3,0,0,0,21.0,21.0,0.0,10
13808,13808,1993-94,1993,1994,Sheffield United,Swindon,Win,Home,1993-08-14,3,0,0,0,0,0,0,0,0,0,0,0,0,1,14.0,21.0,-7.0,1
13809,13809,1993-94,1993,1994,Sheffield United,Man United,Loss,Away,1993-08-18,0,3,3,3,3,3,3,3,3,0,0,0,0,0,14.0,1.0,13.0,1
13810,13810,1993-94,1993,1994,Sheffield United,Everton,Loss,Away,1993-08-21,0,3,3,3,3,6,6,6,6,-3,-3,-3,-3,0,14.0,13.0,1.0,1
13811,13811,1993-94,1993,1994,Sheffield United,Wimbledon,Win,Home,1993-08-24,3,0,3,3,3,2,5,5,5,-2,-2,-2,-2,1,14.0,12.0,2.0,1
13812,13812,1993-94,1993,1994,Sheffield United,Ipswich,Draw,Home,1993-08-28,1,3,3,6,6,3,6,9,9,0,-3,-3,-3,1,14.0,16.0,-2.0,1
13813,13813,1993-94,1993,1994,Sheffield United,QPR,Loss,Away,1993-09-01,0,4,4,4,7,3,6,6,6,1,-2,-2,1,0,14.0,5.0,9.0,2
13814,13814,1993-94,1993,1994,Sheffield United,Tottenham,Draw,Home,1993-09-11,1,1,4,4,4,1,4,7,7,0,0,-3,-3,1,14.0,8.0,6.0,2
13815,13815,1993-94,1993,1994,Sheffield United,Leeds,Loss,Away,1993-09-18,0,1,2,5,5,6,6,6,6,-5,-4,-1,-1,0,14.0,17.0,-3.0,2
13816,13816,1993-94,1993,1994,Sheffield United,Man City,Loss,Home,1993-09-25,0,1,1,2,5,3,6,7,7,-2,-5,-5,-2,1,14.0,9.0,5.0,2
13817,13817,1993-94,1993,1994,Sheffield United,Southampton,Draw,Away,1993-10-02,1,0,1,1,2,0,0,0,0,0,1,1,2,0,14.0,18.0,-4.0,3
13818,13818,1993-94,1993,1994,Sheffield United,Blackburn,Draw,Away,1993-10-18,1,1,1,2,2,4,4,7,8,-3,-3,-5,-6,0,14.0,4.0,10.0,3
13819,13819,1993-94,1993,1994,Sheffield United,Sheffield Weds,Draw,Home,1993-10-23,1,2,2,2,3,1,2,5,5,1,0,-3,-2,1,14.0,7.0,7.0,3
13820,13820,1993-94,1993,1994,Sheffield United,Coventry,Draw,Away,1993-10-31,1,2,3,3,3,1,1,1,2,1,2,2,1,0,14.0,15.0,-1.0,3
13821,13821,1993-94,1993,1994,Sheffield United,Norwich,Loss,Home,1993-11-06,0,2,3,4,4,2,5,8,11,0,-2,-4,-7,1,14.0,3.0,11.0,4
13822,13822,1993-94,1993,1994,Sheffield United,Aston Villa,Loss,Away,1993-11-20,0,1,2,3,4,6,9,10,10,-5,-7,-7,-6,0,14.0,2.0,12.0,4
13823,13823,1993-94,1993,1994,Sheffield United,Newcastle,Loss,Away,1993-11-24,0,0,1,2,3,6,9,9,9,-6,-8,-7,-6,0,14.0,21.0,-7.0,4
13824,13824,1993-94,1993,1994,Sheffield United,Chelsea,Win,Home,1993-11-27,3,0,0,1,2,1,1,1,1,-1,-1,0,1,1,14.0,11.0,3.0,4
13825,13825,1993-94,1993,1994,Sheffield United,Swindon,Draw,Away,1993-12-04,1,3,3,3,4,3,4,4,4,0,-1,-1,0,0,14.0,21.0,-7.0,5
13826,13826,1993-94,1993,1994,Sheffield United,Man United,Loss,Home,1993-12-07,0,4,4,4,4,4,5,8,11,0,-1,-4,-7,1,14.0,1.0,13.0,5
13827,13827,1993-94,1993,1994,Sheffield United,Everton,Draw,Home,1993-12-11,1,1,4,4,4,3,4,5,5,-2,0,-1,-1,1,14.0,13.0,1.0,5
13828,13828,1993-94,1993,1994,Sheffield United,Wimbledon,Loss,Away,1993-12-18,0,1,2,5,5,3,4,5,5,-2,-2,0,0,0,14.0,12.0,2.0,5
13829,13829,1993-94,1993,1994,Sheffield United,Liverpool,Draw,Home,1993-12-26,1,1,1,2,5,2,5,5,8,-1,-4,-3,-3,1,14.0,6.0,8.0,5
13830,13830,1993-94,1993,1994,Sheffield United,Arsenal,Loss,Away,1993-12-29,0,1,2,2,3,3,6,7,7,-2,-4,-5,-4,0,14.0,10.0,4.0,5
13831,13831,1993-94,1993,1994,Sheffield United,Oldham,Win,Home,1994-01-01,3,1,1,2,2,0,1,1,4,1,0,1,-2,1,14.0,19.0,-5.0,6
13832,13832,1993-94,1993,1994,Sheffield United,West Ham,Draw,Away,1994-01-03,1,3,4,4,5,3,4,4,7,0,0,0,-2,0,14.0,21.0,-7.0,6
13833,13833,1993-94,1993,1994,Sheffield United,Blackburn,Loss,Home,1994-01-15,0,4,4,5,5,6,7,10,13,-2,-3,-5,-8,1,14.0,4.0,10.0,6
13834,13834,1993-94,1993,1994,Sheffield United,Sheffield Weds,Loss,Away,1994-01-22,0,1,4,4,5,3,6,7,10,-2,-2,-3,-5,0,14.0,7.0,7.0,6
13835,13835,1993-94,1993,1994,Sheffield United,Coventry,Draw,Home,1994-02-12,1,0,1,4,4,3,3,3,4,-3,-2,1,0,1,14.0,15.0,-1.0,7
13836,13836,1993-94,1993,1994,Sheffield United,Ipswich,Loss,Away,1994-02-26,0,1,1,2,5,1,1,2,3,0,0,0,2,0,14.0,16.0,-2.0,7
13837,13837,1993-94,1993,1994,Sheffield United,Tottenham,Draw,Away,1994-03-05,1,1,1,1,2,1,1,1,1,0,0,0,1,0,14.0,8.0,6.0,8
13838,13838,1993-94,1993,1994,Sheffield United,Leeds,Draw,Home,1994-03-13,1,1,2,2,2,2,5,5,5,-1,-3,-3,-3,1,14.0,17.0,-3.0,8
13839,13839,1993-94,1993,1994,Sheffield United,QPR,Draw,Home,1994-03-16,1,2,2,3,3,4,4,7,7,-2,-2,-4,-4,1,14.0,5.0,9.0,8
13840,13840,1993-94,1993,1994,Sheffield United,Man City,Draw,Away,1994-03-19,1,2,3,3,4,1,4,5,5,1,-1,-2,-1,0,14.0,9.0,5.0,8
13841,13841,1993-94,1993,1994,Sheffield United,Southampton,Draw,Home,1994-03-26,1,2,3,4,4,1,2,5,8,1,1,-1,-4,1,14.0,18.0,-4.0,8
13842,13842,1993-94,1993,1994,Sheffield United,West Ham,Win,Home,1994-03-28,3,2,3,4,5,0,1,2,3,2,2,2,2,1,14.0,21.0,-7.0,8
13843,13843,1993-94,1993,1994,Sheffield United,Liverpool,Win,Away,1994-04-02,3,4,5,6,7,0,3,6,6,4,2,0,1,0,14.0,6.0,8.0,9
13844,13844,1993-94,1993,1994,Sheffield United,Arsenal,Draw,Home,1994-04-04,1,6,7,8,9,4,5,8,11,2,2,0,-2,1,14.0,10.0,4.0,9
13845,13845,1993-94,1993,1994,Sheffield United,Aston Villa,Loss,Home,1994-04-16,0,4,7,8,9,1,1,2,2,3,6,6,7,1,14.0,2.0,12.0,9
13846,13846,1993-94,1993,1994,Sheffield United,Norwich,Win,Away,1994-04-23,3,1,4,7,8,1,2,2,2,0,2,5,6,0,14.0,3.0,11.0,9
13847,13847,1993-94,1993,1994,Sheffield United,Newcastle,Win,Home,1994-04-30,3,3,4,7,10,6,9,9,10,-3,-5,-2,0,1,14.0,21.0,-7.0,9
13848,13848,1993-94,1993,1994,Sheffield United,Oldham,Draw,Away,1994-05-03,1,6,6,7,10,1,1,1,1,5,5,6,9,0,14.0,19.0,-5.0,10
13849,13849,1993-94,1993,1994,Sheffield United,Chelsea,Loss,Away,1994-05-07,0,4,7,7,8,1,4,5,5,3,3,2,3,0,14.0,11.0,3.0,10
13850,13850,2006-07,2006,2007,Sheffield United,Liverpool,Draw,Home,2006-08-19,1,1,4,7,7,6,9,12,15,-5,-5,-5,-8,1,21.0,3.0,18.0,1
13851,13851,2006-07,2006,2007,Sheffield United,Tottenham,Loss,Away,2006-08-22,0,1,2,5,8,0,3,4,4,1,-1,1,4,0,21.0,5.0,16.0,1
13852,13852,2006-07,2006,2007,Sheffield United,Fulham,Loss,Away,2006-08-26,0,1,1,2,5,1,4,4,7,0,-3,-2,-2,0,21.0,12.0,9.0,1
13853,13853,2006-07,2006,2007,Sheffield United,Blackburn,Draw,Home,2006-09-09,1,0,1,1,2,1,1,4,7,-1,0,-3,-5,1,21.0,6.0,15.0,2
13854,13854,2006-07,2006,2007,Sheffield United,Reading,Loss,Home,2006-09-16,0,1,1,2,2,3,3,6,6,-2,-2,-4,-4,1,21.0,21.0,0.0,2
13855,13855,2006-07,2006,2007,Sheffield United,Arsenal,Loss,Away,2006-09-23,0,1,1,1,2,4,4,5,8,-3,-3,-4,-6,0,21.0,4.0,17.0,2
13856,13856,2006-07,2006,2007,Sheffield United,Middlesbrough,Win,Home,2006-09-30,3,0,1,1,1,1,2,2,5,-1,-1,-1,-4,1,21.0,14.0,7.0,2
13857,13857,2006-07,2006,2007,Sheffield United,Man City,Draw,Away,2006-10-14,1,3,3,4,4,4,4,4,7,-1,-1,0,-3,0,21.0,15.0,6.0,3
13858,13858,2006-07,2006,2007,Sheffield United,Everton,Loss,Away,2006-10-21,0,4,4,4,5,1,2,3,6,3,2,1,-1,0,21.0,11.0,10.0,3
13859,13859,2006-07,2006,2007,Sheffield United,Chelsea,Loss,Home,2006-10-28,0,1,4,4,4,6,7,10,13,-5,-3,-6,-9,1,21.0,1.0,20.0,3
13860,13860,2006-07,2006,2007,Sheffield United,Newcastle,Win,Away,2006-11-04,3,0,1,4,4,1,1,1,2,-1,0,3,2,0,21.0,7.0,14.0,4
13861,13861,2006-07,2006,2007,Sheffield United,Bolton,Draw,Home,2006-11-11,1,3,3,4,7,0,3,6,9,3,0,-2,-2,1,21.0,8.0,13.0,4
13862,13862,2006-07,2006,2007,Sheffield United,Man United,Loss,Home,2006-11-18,0,4,4,4,5,6,9,12,15,-2,-5,-8,-10,1,21.0,2.0,19.0,4
13863,13863,2006-07,2006,2007,Sheffield United,West Ham,Loss,Away,2006-11-25,0,1,4,4,4,0,3,6,6,1,1,-2,-2,0,21.0,9.0,12.0,4
13864,13864,2006-07,2006,2007,Sheffield United,Watford,Win,Away,2006-11-28,3,0,1,4,4,0,3,4,5,0,-2,0,-1,0,21.0,21.0,0.0,4
13865,13865,2006-07,2006,2007,Sheffield United,Charlton,Win,Home,2006-12-02,3,3,3,4,7,1,1,4,5,2,2,0,2,1,21.0,13.0,8.0,5
13866,13866,2006-07,2006,2007,Sheffield United,Aston Villa,Draw,Home,2006-12-11,1,6,6,6,7,1,2,3,6,5,4,3,1,1,21.0,16.0,5.0,5
13867,13867,2006-07,2006,2007,Sheffield United,Wigan,Win,Away,2006-12-16,3,4,7,7,7,1,4,4,4,3,3,3,3,0,21.0,10.0,11.0,5
13868,13868,2006-07,2006,2007,Sheffield United,Portsmouth,Loss,Away,2006-12-23,0,4,7,10,10,4,5,6,6,0,2,4,4,0,21.0,17.0,4.0,5
13869,13869,2006-07,2006,2007,Sheffield United,Man City,Loss,Home,2006-12-26,0,3,4,7,10,0,0,1,4,3,4,6,6,1,21.0,15.0,6.0,5
13870,13870,2006-07,2006,2007,Sheffield United,Arsenal,Win,Home,2006-12-30,3,0,3,4,7,6,7,10,11,-6,-4,-6,-4,1,21.0,4.0,17.0,5
13871,13871,2006-07,2006,2007,Sheffield United,Middlesbrough,Loss,Away,2007-01-01,0,3,3,6,7,1,4,4,5,2,-1,2,2,0,21.0,14.0,7.0,6
13872,13872,2006-07,2006,2007,Sheffield United,Portsmouth,Draw,Home,2007-01-13,1,3,3,3,6,1,4,7,8,2,-1,-4,-2,1,21.0,17.0,4.0,6
13873,13873,2006-07,2006,2007,Sheffield United,Reading,Loss,Away,2007-01-20,0,1,4,4,4,4,4,5,5,-3,0,-1,-1,0,21.0,21.0,0.0,6
13874,13874,2006-07,2006,2007,Sheffield United,Fulham,Win,Home,2007-01-30,3,1,1,4,4,2,3,4,5,-1,-2,0,-1,1,21.0,12.0,9.0,6
13875,13875,2006-07,2006,2007,Sheffield United,Blackburn,Loss,Away,2007-02-03,0,3,4,4,7,0,3,3,6,3,1,1,1,0,21.0,6.0,15.0,7
13876,13876,2006-07,2006,2007,Sheffield United,Tottenham,Win,Home,2007-02-10,3,3,3,4,4,1,1,2,2,2,2,2,2,1,21.0,5.0,16.0,7
13877,13877,2006-07,2006,2007,Sheffield United,Liverpool,Loss,Away,2007-02-24,0,3,6,6,7,1,4,7,10,2,2,-1,-3,0,21.0,3.0,18.0,7
13878,13878,2006-07,2006,2007,Sheffield United,Everton,Draw,Home,2007-03-03,1,3,3,6,6,3,6,7,10,0,-3,-1,-4,1,21.0,11.0,10.0,8
13879,13879,2006-07,2006,2007,Sheffield United,Chelsea,Loss,Away,2007-03-17,0,1,4,4,7,6,9,12,15,-5,-5,-8,-8,0,21.0,1.0,20.0,8
13880,13880,2006-07,2006,2007,Sheffield United,Bolton,Loss,Away,2007-03-31,0,1,1,4,4,0,0,3,6,1,1,1,-2,0,21.0,8.0,13.0,8
13881,13881,2006-07,2006,2007,Sheffield United,Newcastle,Loss,Home,2007-04-07,0,0,1,1,4,0,1,1,4,0,0,0,0,1,21.0,7.0,14.0,9
13882,13882,2006-07,2006,2007,Sheffield United,West Ham,Win,Home,2007-04-14,3,0,0,1,1,6,9,9,9,-6,-9,-8,-8,1,21.0,9.0,12.0,9
13883,13883,2006-07,2006,2007,Sheffield United,Man United,Loss,Away,2007-04-17,0,3,3,3,4,3,6,9,12,0,-3,-6,-8,0,21.0,2.0,19.0,9
13884,13884,2006-07,2006,2007,Sheffield United,Charlton,Draw,Away,2007-04-21,1,3,3,3,3,1,2,5,8,2,1,-2,-5,0,21.0,13.0,8.0,9
13885,13885,2006-07,2006,2007,Sheffield United,Watford,Win,Home,2007-04-28,3,1,4,4,4,1,4,4,4,0,0,0,0,1,21.0,21.0,0.0,9
13886,13886,2006-07,2006,2007,Sheffield United,Aston Villa,Loss,Away,2007-05-05,0,4,4,7,7,4,7,8,11,0,-3,-1,-4,0,21.0,16.0,5.0,10
13887,13887,2006-07,2006,2007,Sheffield United,Wigan,Loss,Home,2007-05-13,0,3,4,4,7,0,0,1,2,3,4,3,5,1,21.0,10.0,11.0,10
13888,13888,1993-94,1993,1994,Sheffield Weds,Liverpool,Loss,Away,1993-08-14,0,0,0,0,0,0,0,0,0,0,0,0,0,0,7.0,6.0,1.0,1
13889,13889,1993-94,1993,1994,Sheffield Weds,Aston Villa,Draw,Home,1993-08-18,1,0,0,0,0,3,3,3,3,-3,-3,-3,-3,1,7.0,2.0,5.0,1
13890,13890,1993-94,1993,1994,Sheffield Weds,Arsenal,Loss,Home,1993-08-21,0,1,1,1,1,3,3,3,3,-2,-2,-2,-2,1,7.0,10.0,-3.0,1
13891,13891,1993-94,1993,1994,Sheffield Weds,West Ham,Loss,Away,1993-08-25,0,1,1,1,1,1,1,1,1,0,0,0,0,0,7.0,21.0,-14.0,1
13892,13892,1993-94,1993,1994,Sheffield Weds,Chelsea,Draw,Away,1993-08-28,1,0,1,1,1,3,4,4,4,-3,-3,-3,-3,0,7.0,11.0,-4.0,1
13893,13893,1993-94,1993,1994,Sheffield Weds,Norwich,Draw,Home,1993-09-01,1,1,1,2,2,4,7,10,10,-3,-6,-8,-8,1,7.0,3.0,4.0,2
13894,13894,1993-94,1993,1994,Sheffield Weds,Newcastle,Loss,Away,1993-09-13,0,2,2,2,3,2,5,6,6,0,-3,-4,-3,0,7.0,21.0,-14.0,2
13895,13895,1993-94,1993,1994,Sheffield Weds,Southampton,Win,Home,1993-09-18,3,1,2,2,2,0,0,3,3,1,2,-1,-1,1,7.0,18.0,-11.0,2
13896,13896,1993-94,1993,1994,Sheffield Weds,Blackburn,Draw,Away,1993-09-25,1,3,4,5,5,3,4,5,8,0,0,0,-3,0,7.0,4.0,3.0,2
13897,13897,1993-94,1993,1994,Sheffield Weds,Man United,Loss,Home,1993-10-02,0,4,4,5,6,6,6,9,12,-2,-2,-4,-6,1,7.0,1.0,6.0,3
13898,13898,1993-94,1993,1994,Sheffield Weds,Wimbledon,Draw,Home,1993-10-16,1,1,4,4,5,1,4,7,10,0,0,-3,-5,1,7.0,12.0,-5.0,3
13899,13899,1993-94,1993,1994,Sheffield Weds,Sheffield United,Draw,Away,1993-10-23,1,1,2,5,5,2,2,2,3,-1,0,3,2,0,7.0,14.0,-7.0,3
13900,13900,1993-94,1993,1994,Sheffield Weds,Leeds,Draw,Home,1993-10-30,1,2,2,3,6,2,5,8,11,0,-3,-5,-5,1,7.0,17.0,-10.0,3
13901,13901,1993-94,1993,1994,Sheffield Weds,Ipswich,Win,Away,1993-11-06,3,2,3,3,4,3,4,4,5,-1,-1,-1,-1,0,7.0,16.0,-9.0,4
13902,13902,1993-94,1993,1994,Sheffield Weds,Coventry,Draw,Home,1993-11-20,1,4,5,6,6,4,4,5,5,0,1,1,1,1,7.0,15.0,-8.0,4
13903,13903,1993-94,1993,1994,Sheffield Weds,Oldham,Win,Home,1993-11-24,3,4,5,6,7,0,3,4,4,4,2,2,3,1,7.0,19.0,-12.0,4
13904,13904,1993-94,1993,1994,Sheffield Weds,Man City,Win,Away,1993-11-27,3,4,7,8,9,2,2,2,3,2,5,6,6,0,7.0,9.0,-2.0,4
13905,13905,1993-94,1993,1994,Sheffield Weds,Liverpool,Win,Home,1993-12-04,3,6,7,10,11,3,6,9,10,3,1,1,1,1,7.0,6.0,1.0,5
13906,13906,1993-94,1993,1994,Sheffield Weds,Aston Villa,Draw,Away,1993-12-08,1,6,9,10,13,1,1,4,7,5,8,6,6,0,7.0,2.0,5.0,5
13907,13907,1993-94,1993,1994,Sheffield Weds,Arsenal,Loss,Away,1993-12-12,0,4,7,10,11,1,4,5,8,3,3,5,3,0,7.0,10.0,-3.0,5
13908,13908,1993-94,1993,1994,Sheffield Weds,West Ham,Win,Home,1993-12-18,3,1,4,7,10,3,6,9,10,-2,-2,-2,0,1,7.0,21.0,-14.0,5
13909,13909,1993-94,1993,1994,Sheffield Weds,Everton,Win,Away,1993-12-27,3,3,4,7,10,1,1,4,5,2,3,3,5,0,7.0,13.0,-6.0,5
13910,13910,1993-94,1993,1994,Sheffield Weds,Swindon,Draw,Home,1993-12-29,1,6,6,7,10,3,4,4,5,3,2,3,5,1,7.0,21.0,-14.0,5
13911,13911,1993-94,1993,1994,Sheffield Weds,QPR,Win,Away,1994-01-01,3,4,7,7,8,4,7,7,8,0,0,0,0,0,7.0,5.0,2.0,6
13912,13912,1993-94,1993,1994,Sheffield Weds,Tottenham,Win,Home,1994-01-03,3,4,7,10,10,3,3,4,7,1,4,6,3,1,7.0,8.0,-1.0,6
13913,13913,1993-94,1993,1994,Sheffield Weds,Wimbledon,Loss,Away,1994-01-15,0,6,7,10,13,1,1,4,7,5,6,6,6,0,7.0,12.0,-5.0,6
13914,13914,1993-94,1993,1994,Sheffield Weds,Sheffield United,Win,Home,1994-01-22,3,3,6,7,10,1,4,4,5,2,2,3,5,1,7.0,14.0,-7.0,6
13915,13915,1993-94,1993,1994,Sheffield Weds,Tottenham,Win,Away,1994-02-05,3,3,6,9,10,0,0,0,3,3,6,9,7,0,7.0,8.0,-1.0,7
13916,13916,1993-94,1993,1994,Sheffield Weds,Norwich,Draw,Away,1994-02-26,1,6,6,9,12,2,3,4,5,4,3,5,7,0,7.0,3.0,4.0,7
13917,13917,1993-94,1993,1994,Sheffield Weds,Newcastle,Loss,Home,1994-03-05,0,4,7,7,10,3,3,3,6,1,4,4,4,1,7.0,21.0,-14.0,8
13918,13918,1993-94,1993,1994,Sheffield Weds,Southampton,Draw,Away,1994-03-12,1,1,4,7,7,4,7,7,10,-3,-3,0,-3,0,7.0,18.0,-11.0,8
13919,13919,1993-94,1993,1994,Sheffield Weds,Man United,Loss,Away,1994-03-16,0,1,2,5,8,1,4,7,10,0,-2,-2,-2,0,7.0,1.0,6.0,8
13920,13920,1993-94,1993,1994,Sheffield Weds,Blackburn,Loss,Home,1994-03-20,0,1,1,2,5,3,4,7,10,-2,-3,-5,-5,1,7.0,4.0,3.0,8
13921,13921,1993-94,1993,1994,Sheffield Weds,Chelsea,Win,Home,1994-03-30,3,0,1,1,2,3,6,9,12,-3,-5,-8,-10,1,7.0,11.0,-4.0,8
13922,13922,1993-94,1993,1994,Sheffield Weds,Everton,Win,Home,1994-04-02,3,3,3,4,4,1,1,1,4,2,2,3,0,1,7.0,13.0,-6.0,9
13923,13923,1993-94,1993,1994,Sheffield Weds,Swindon,Win,Away,1994-04-04,3,6,6,6,7,1,2,2,3,5,4,4,4,0,7.0,21.0,-14.0,9
13924,13924,1993-94,1993,1994,Sheffield Weds,QPR,Win,Home,1994-04-09,3,6,9,9,9,0,3,6,7,6,6,3,2,1,7.0,5.0,2.0,9
13925,13925,1993-94,1993,1994,Sheffield Weds,Coventry,Draw,Away,1994-04-16,1,6,9,12,12,6,6,9,9,0,3,3,3,0,7.0,15.0,-8.0,9
13926,13926,1993-94,1993,1994,Sheffield Weds,Ipswich,Win,Home,1994-04-23,3,4,7,10,13,1,1,1,2,3,6,9,11,1,7.0,16.0,-9.0,9
13927,13927,1993-94,1993,1994,Sheffield Weds,Oldham,Draw,Away,1994-04-30,1,4,7,10,13,0,0,0,3,4,7,10,10,0,7.0,19.0,-12.0,9
13928,13928,1993-94,1993,1994,Sheffield Weds,Leeds,Draw,Away,1994-05-03,1,4,5,8,11,3,4,7,10,1,1,1,1,0,7.0,17.0,-10.0,10
13929,13929,1993-94,1993,1994,Sheffield Weds,Man City,Draw,Home,1994-05-07,1,2,5,6,9,1,2,5,8,1,3,1,1,1,7.0,9.0,-2.0,10
13930,13930,1994-95,1994,1995,Sheffield Weds,Tottenham,Loss,Home,1994-08-20,0,2,3,6,7,3,3,6,6,-1,0,0,1,1,7.0,15.0,-8.0,1
13931,13931,1994-95,1994,1995,Sheffield Weds,QPR,Loss,Away,1994-08-24,0,1,2,3,6,3,4,4,5,-2,-2,-1,1,0,7.0,9.0,-2.0,1
13932,13932,1994-95,1994,1995,Sheffield Weds,Wimbledon,Win,Away,1994-08-27,3,0,1,2,3,2,2,5,8,-2,-1,-3,-5,0,7.0,6.0,1.0,1
13933,13933,1994-95,1994,1995,Sheffield Weds,Norwich,Draw,Home,1994-08-31,1,3,3,4,5,4,4,5,8,-1,-1,-1,-3,1,7.0,12.0,-5.0,1
13934,13934,1994-95,1994,1995,Sheffield Weds,Nott'm Forest,Loss,Away,1994-09-10,0,4,4,4,5,6,7,10,10,-2,-3,-6,-5,0,7.0,21.0,-14.0,2
13935,13935,1994-95,1994,1995,Sheffield Weds,Man City,Draw,Home,1994-09-17,1,1,4,4,4,1,4,7,7,0,0,-3,-3,1,7.0,16.0,-9.0,2
13936,13936,1994-95,1994,1995,Sheffield Weds,Leeds,Draw,Home,1994-09-26,1,1,2,5,5,3,6,6,9,-2,-4,-1,-4,1,7.0,5.0,2.0,2
13937,13937,1994-95,1994,1995,Sheffield Weds,Liverpool,Loss,Away,1994-10-01,0,2,2,3,6,1,2,5,8,1,0,-2,-2,0,7.0,8.0,-1.0,3
13938,13938,1994-95,1994,1995,Sheffield Weds,Man United,Win,Home,1994-10-08,3,1,2,2,3,3,6,6,9,-2,-4,-4,-6,1,7.0,1.0,6.0,3
13939,13939,1994-95,1994,1995,Sheffield Weds,Ipswich,Win,Away,1994-10-16,3,3,4,5,5,0,3,3,3,3,1,2,2,0,7.0,19.0,-12.0,3
13940,13940,1994-95,1994,1995,Sheffield Weds,Newcastle,Loss,Away,1994-10-22,0,6,6,7,8,4,7,8,11,2,-1,-1,-3,0,7.0,3.0,4.0,3
13941,13941,1994-95,1994,1995,Sheffield Weds,Chelsea,Draw,Home,1994-10-29,1,3,6,6,7,3,6,6,9,0,0,0,-2,1,7.0,14.0,-7.0,3
13942,13942,1994-95,1994,1995,Sheffield Weds,Blackburn,Loss,Home,1994-11-02,0,1,4,7,7,3,6,7,7,-2,-2,0,0,1,7.0,2.0,5.0,4
13943,13943,1994-95,1994,1995,Sheffield Weds,Arsenal,Draw,Away,1994-11-06,1,1,1,4,7,4,7,10,10,-3,-6,-6,-3,0,7.0,4.0,3.0,4
13944,13944,1994-95,1994,1995,Sheffield Weds,West Ham,Win,Home,1994-11-19,3,1,2,2,5,3,3,6,6,-2,-1,-4,-1,1,7.0,13.0,-6.0,4
13945,13945,1994-95,1994,1995,Sheffield Weds,Aston Villa,Draw,Away,1994-11-27,1,4,4,5,5,3,3,3,3,1,1,2,2,0,7.0,10.0,-3.0,4
13946,13946,1994-95,1994,1995,Sheffield Weds,Crystal Palace,Win,Home,1994-12-03,3,4,5,5,6,1,4,7,10,3,1,-2,-4,1,7.0,21.0,-14.0,5
13947,13947,1994-95,1994,1995,Sheffield Weds,Tottenham,Loss,Away,1994-12-10,0,4,7,8,8,4,5,5,5,0,2,3,3,0,7.0,15.0,-8.0,5
13948,13948,1994-95,1994,1995,Sheffield Weds,QPR,Loss,Home,1994-12-17,0,3,4,7,8,3,3,6,6,0,1,1,2,1,7.0,9.0,-2.0,5
13949,13949,1994-95,1994,1995,Sheffield Weds,Everton,Win,Away,1994-12-26,3,0,3,4,7,2,5,8,11,-2,-2,-4,-4,0,7.0,17.0,-10.0,5
13950,13950,1994-95,1994,1995,Sheffield Weds,Coventry,Win,Home,1994-12-28,3,3,3,6,7,2,2,3,6,1,1,3,1,1,7.0,11.0,-4.0,5
13951,13951,1994-95,1994,1995,Sheffield Weds,Leicester,Win,Away,1994-12-31,3,6,6,6,9,1,2,2,3,5,4,4,6,0,7.0,21.0,-14.0,5
13952,13952,1994-95,1994,1995,Sheffield Weds,Southampton,Draw,Home,1995-01-02,1,6,9,9,9,2,2,5,5,4,7,4,4,1,7.0,18.0,-11.0,6
13953,13953,1994-95,1994,1995,Sheffield Weds,Chelsea,Draw,Away,1995-01-14,1,4,7,10,10,1,1,2,2,3,6,8,8,0,7.0,14.0,-7.0,6
13954,13954,1994-95,1994,1995,Sheffield Weds,Newcastle,Draw,Home,1995-01-21,1,2,5,8,11,2,2,3,4,0,3,5,7,1,7.0,3.0,4.0,6
13955,13955,1994-95,1994,1995,Sheffield Weds,West Ham,Win,Away,1995-01-23,3,2,3,6,9,0,3,3,4,2,0,3,5,0,7.0,13.0,-6.0,6
13956,13956,1994-95,1994,1995,Sheffield Weds,Arsenal,Win,Home,1995-02-04,3,4,5,6,9,4,5,5,5,0,0,1,4,1,7.0,4.0,3.0,7
13957,13957,1994-95,1994,1995,Sheffield Weds,Blackburn,Loss,Away,1995-02-12,0,6,7,8,9,1,4,4,7,5,3,4,2,0,7.0,2.0,5.0,7
13958,13958,1994-95,1994,1995,Sheffield Weds,Aston Villa,Loss,Home,1995-02-18,0,3,6,7,8,3,6,9,12,0,0,-2,-4,1,7.0,10.0,-3.0,7
13959,13959,1994-95,1994,1995,Sheffield Weds,Liverpool,Loss,Home,1995-02-25,0,0,3,6,7,2,3,3,6,-2,0,3,1,1,7.0,8.0,-1.0,7
13960,13960,1994-95,1994,1995,Sheffield Weds,Leeds,Win,Away,1995-03-04,3,0,0,3,6,4,5,6,9,-4,-5,-3,-3,0,7.0,5.0,2.0,8
13961,13961,1994-95,1994,1995,Sheffield Weds,Norwich,Draw,Away,1995-03-08,1,3,3,3,6,2,2,3,3,1,1,0,3,0,7.0,12.0,-5.0,8
13962,13962,1994-95,1994,1995,Sheffield Weds,Wimbledon,Loss,Home,1995-03-11,0,4,4,4,4,0,3,3,3,4,1,1,1,1,7.0,6.0,1.0,8
13963,13963,1994-95,1994,1995,Sheffield Weds,Crystal Palace,Loss,Away,1995-03-14,0,1,4,4,4,1,1,4,5,0,3,0,-1,0,7.0,21.0,-14.0,8
13964,13964,1994-95,1994,1995,Sheffield Weds,Man City,Loss,Away,1995-03-18,0,0,1,4,4,1,2,3,6,-1,-1,1,-2,0,7.0,16.0,-9.0,8
13965,13965,1994-95,1994,1995,Sheffield Weds,Nott'm Forest,Loss,Home,1995-04-01,0,0,0,1,4,6,9,12,13,-6,-9,-11,-9,1,7.0,21.0,-14.0,9
13966,13966,1994-95,1994,1995,Sheffield Weds,Leicester,Win,Home,1995-04-08,3,0,0,0,1,3,3,3,3,-3,-3,-3,-2,1,7.0,21.0,-14.0,9
13967,13967,1994-95,1994,1995,Sheffield Weds,Coventry,Loss,Away,1995-04-15,0,3,3,3,3,0,3,4,5,3,0,-1,-2,0,7.0,11.0,-4.0,9
13968,13968,1994-95,1994,1995,Sheffield Weds,Everton,Draw,Home,1995-04-17,1,3,3,3,3,3,6,7,7,0,-3,-4,-4,1,7.0,17.0,-10.0,9
13969,13969,1994-95,1994,1995,Sheffield Weds,Southampton,Draw,Away,1995-04-29,1,1,4,4,4,6,9,9,12,-5,-5,-5,-8,0,7.0,18.0,-11.0,9
13970,13970,1994-95,1994,1995,Sheffield Weds,Man United,Loss,Away,1995-05-07,0,2,2,5,5,4,7,8,11,-2,-5,-3,-6,0,7.0,1.0,6.0,10
13971,13971,1994-95,1994,1995,Sheffield Weds,Ipswich,Win,Home,1995-05-14,3,1,2,2,5,3,3,4,4,-2,-1,-2,1,1,7.0,19.0,-12.0,10
13972,13972,1995-96,1995,1996,Sheffield Weds,Liverpool,Loss,Away,1995-08-19,0,3,4,5,5,3,3,4,7,0,1,1,-2,0,13.0,4.0,9.0,1
13973,13973,1995-96,1995,1996,Sheffield Weds,Blackburn,Win,Home,1995-08-23,3,3,3,4,5,3,6,6,9,0,-3,-2,-4,1,13.0,1.0,12.0,1
13974,13974,1995-96,1995,1996,Sheffield Weds,Newcastle,Loss,Home,1995-08-27,0,3,6,6,7,6,9,9,10,-3,-3,-3,-3,1,13.0,6.0,7.0,1
13975,13975,1995-96,1995,1996,Sheffield Weds,Wimbledon,Draw,Away,1995-08-30,1,3,3,6,6,3,6,7,8,0,-3,-1,-2,0,13.0,9.0,4.0,1
13976,13976,1995-96,1995,1996,Sheffield Weds,QPR,Win,Away,1995-09-09,3,1,4,4,7,3,3,3,6,-2,1,1,1,0,13.0,8.0,5.0,2
13977,13977,1995-96,1995,1996,Sheffield Weds,Tottenham,Loss,Home,1995-09-16,0,4,4,7,7,4,4,4,5,0,0,3,2,1,13.0,7.0,6.0,2
13978,13978,1995-96,1995,1996,Sheffield Weds,Man United,Draw,Home,1995-09-23,1,3,4,4,7,6,9,12,15,-3,-5,-8,-8,1,13.0,2.0,11.0,2
13979,13979,1995-96,1995,1996,Sheffield Weds,Leeds,Loss,Away,1995-09-30,0,1,4,5,5,3,3,4,7,-2,1,1,-2,0,13.0,5.0,8.0,2
13980,13980,1995-96,1995,1996,Sheffield Weds,Middlesbrough,Loss,Home,1995-10-15,0,1,1,4,5,6,9,10,11,-5,-8,-6,-6,1,13.0,21.0,-8.0,3
13981,13981,1995-96,1995,1996,Sheffield Weds,Coventry,Win,Away,1995-10-21,3,0,1,1,4,1,1,1,2,-1,0,0,2,0,13.0,16.0,-3.0,3
13982,13982,1995-96,1995,1996,Sheffield Weds,West Ham,Loss,Home,1995-10-28,0,3,3,4,4,4,5,8,8,-1,-2,-4,-4,1,13.0,14.0,-1.0,3
13983,13983,1995-96,1995,1996,Sheffield Weds,Chelsea,Draw,Away,1995-11-04,1,3,3,3,4,0,3,6,6,3,0,-3,-2,0,13.0,11.0,2.0,4
13984,13984,1995-96,1995,1996,Sheffield Weds,Man City,Draw,Home,1995-11-18,1,1,4,4,4,3,4,4,4,-2,0,0,0,1,13.0,17.0,-4.0,4
13985,13985,1995-96,1995,1996,Sheffield Weds,Arsenal,Loss,Away,1995-11-21,0,2,2,5,5,3,3,6,9,-1,-1,-1,-4,0,13.0,12.0,1.0,4
13986,13986,1995-96,1995,1996,Sheffield Weds,Everton,Draw,Away,1995-11-25,1,1,2,2,5,6,9,9,10,-5,-7,-7,-5,0,13.0,15.0,-2.0,4
13987,13987,1995-96,1995,1996,Sheffield Weds,Coventry,Win,Home,1995-12-04,3,1,2,3,3,1,2,2,2,0,0,1,1,1,13.0,16.0,-3.0,5
13988,13988,1995-96,1995,1996,Sheffield Weds,Man United,Draw,Away,1995-12-09,1,4,4,5,6,2,5,8,8,2,-1,-3,-2,0,13.0,2.0,11.0,5
13989,13989,1995-96,1995,1996,Sheffield Weds,Leeds,Win,Home,1995-12-16,3,4,5,5,6,1,1,4,5,3,4,1,1,1,13.0,5.0,8.0,5
13990,13990,1995-96,1995,1996,Sheffield Weds,Southampton,Draw,Home,1995-12-23,1,4,7,8,8,1,2,5,5,3,5,3,3,1,13.0,10.0,3.0,5
13991,13991,1995-96,1995,1996,Sheffield Weds,Nott'm Forest,Loss,Away,1995-12-26,0,4,5,8,9,1,2,3,4,3,3,5,5,0,13.0,3.0,10.0,5
13992,13992,1995-96,1995,1996,Sheffield Weds,Bolton,Win,Home,1996-01-01,3,1,4,5,8,0,1,1,1,1,3,4,7,1,13.0,21.0,-8.0,6
13993,13993,1995-96,1995,1996,Sheffield Weds,Liverpool,Draw,Home,1996-01-13,1,3,4,7,8,4,7,10,13,-1,-3,-3,-5,1,13.0,4.0,9.0,6
13994,13994,1995-96,1995,1996,Sheffield Weds,Blackburn,Loss,Away,1996-01-20,0,4,4,5,8,4,7,10,11,0,-3,-5,-3,0,13.0,1.0,12.0,6
13995,13995,1995-96,1995,1996,Sheffield Weds,Newcastle,Loss,Away,1996-02-03,0,1,4,4,5,6,9,9,12,-5,-5,-5,-7,0,13.0,6.0,7.0,7
13996,13996,1995-96,1995,1996,Sheffield Weds,Wimbledon,Win,Home,1996-02-10,3,0,1,4,4,3,3,3,6,-3,-2,1,-2,1,13.0,9.0,4.0,7
13997,13997,1995-96,1995,1996,Sheffield Weds,QPR,Loss,Home,1996-02-17,0,3,3,4,7,0,0,0,0,3,3,4,7,1,13.0,8.0,5.0,7
13998,13998,1995-96,1995,1996,Sheffield Weds,Tottenham,Loss,Away,1996-02-24,0,3,3,3,4,1,1,4,7,2,2,-1,-3,0,13.0,7.0,6.0,7
13999,13999,1995-96,1995,1996,Sheffield Weds,Nott'm Forest,Loss,Home,1996-03-02,0,0,3,3,3,0,0,3,3,0,3,0,0,1,13.0,3.0,10.0,8
14000,14000,1995-96,1995,1996,Sheffield Weds,Aston Villa,Loss,Away,1996-03-06,0,0,0,3,3,3,4,7,10,-3,-4,-4,-7,0,13.0,18.0,-5.0,8
14001,14001,1995-96,1995,1996,Sheffield Weds,Aston Villa,Win,Home,1996-03-16,3,0,0,0,3,6,6,9,10,-6,-6,-9,-7,1,13.0,18.0,-5.0,8
14002,14002,1995-96,1995,1996,Sheffield Weds,Southampton,Win,Away,1996-03-20,3,3,3,3,3,0,0,1,2,3,3,2,1,0,13.0,10.0,3.0,8
14003,14003,1995-96,1995,1996,Sheffield Weds,Bolton,Loss,Away,1996-03-23,0,6,6,6,6,3,6,6,9,3,0,0,-3,0,13.0,21.0,-8.0,8
14004,14004,1995-96,1995,1996,Sheffield Weds,Middlesbrough,Loss,Away,1996-04-05,0,3,6,6,6,4,5,5,5,-1,1,1,1,0,13.0,21.0,-8.0,9
14005,14005,1995-96,1995,1996,Sheffield Weds,Arsenal,Win,Home,1996-04-08,3,0,3,6,6,6,6,9,12,-6,-3,-3,-6,1,13.0,12.0,1.0,9
14006,14006,1995-96,1995,1996,Sheffield Weds,Man City,Loss,Away,1996-04-13,0,3,3,6,9,0,1,1,4,3,2,5,5,0,13.0,17.0,-4.0,9
14007,14007,1995-96,1995,1996,Sheffield Weds,Chelsea,Draw,Home,1996-04-17,1,3,3,3,6,3,3,4,4,0,0,-1,2,1,13.0,11.0,2.0,9
14008,14008,1995-96,1995,1996,Sheffield Weds,Everton,Loss,Home,1996-04-27,0,1,4,4,4,1,4,7,7,0,0,-3,-3,1,13.0,15.0,-2.0,9
14009,14009,1995-96,1995,1996,Sheffield Weds,West Ham,Draw,Away,1996-05-04,1,1,1,4,4,1,4,4,5,0,-3,0,-1,0,13.0,14.0,-1.0,10
14010,14010,1996-97,1996,1997,Sheffield Weds,Aston Villa,Win,Home,1996-08-17,3,1,2,2,5,0,1,1,4,1,1,1,1,1,15.0,4.0,11.0,1
14011,14011,1996-97,1996,1997,Sheffield Weds,Leeds,Win,Away,1996-08-20,3,4,4,5,5,2,2,2,2,2,2,3,3,0,15.0,13.0,2.0,1
14012,14012,1996-97,1996,1997,Sheffield Weds,Newcastle,Win,Away,1996-08-24,3,6,7,7,8,3,4,5,8,3,3,2,0,0,15.0,2.0,13.0,1
14013,14013,1996-97,1996,1997,Sheffield Weds,Leicester,Win,Home,1996-09-02,3,6,9,10,10,3,4,5,6,3,5,5,4,1,15.0,21.0,-6.0,2
14014,14014,1996-97,1996,1997,Sheffield Weds,Chelsea,Loss,Home,1996-09-07,0,6,9,12,13,4,7,8,8,2,2,4,5,1,15.0,11.0,4.0,2
14015,14015,1996-97,1996,1997,Sheffield Weds,Arsenal,Loss,Away,1996-09-16,0,3,6,9,12,2,5,5,8,1,1,4,4,0,15.0,5.0,10.0,2
14016,14016,1996-97,1996,1997,Sheffield Weds,Derby,Draw,Home,1996-09-21,1,0,3,6,9,6,7,7,8,-6,-4,-1,1,1,15.0,21.0,-6.0,2
14017,14017,1996-97,1996,1997,Sheffield Weds,Everton,Loss,Away,1996-09-28,0,1,1,4,7,1,1,1,2,0,0,3,5,0,15.0,6.0,9.0,2
14018,14018,1996-97,1996,1997,Sheffield Weds,Wimbledon,Loss,Away,1996-10-12,0,1,1,1,4,6,9,12,15,-5,-8,-11,-11,0,15.0,14.0,1.0,3
14019,14019,1996-97,1996,1997,Sheffield Weds,Blackburn,Draw,Home,1996-10-19,1,0,1,1,1,1,2,2,2,-1,-1,-1,-1,1,15.0,7.0,8.0,3
14020,14020,1996-97,1996,1997,Sheffield Weds,Coventry,Draw,Away,1996-10-26,1,1,1,2,2,2,3,3,6,-1,-2,-1,-4,0,15.0,16.0,-1.0,3
14021,14021,1996-97,1996,1997,Sheffield Weds,Southampton,Draw,Home,1996-11-02,1,2,2,2,3,6,7,10,10,-4,-5,-8,-7,1,15.0,17.0,-2.0,4
14022,14022,1996-97,1996,1997,Sheffield Weds,Nott'm Forest,Win,Home,1996-11-18,3,2,3,3,3,0,1,1,2,2,2,2,1,1,15.0,9.0,6.0,4
14023,14023,1996-97,1996,1997,Sheffield Weds,Sunderland,Draw,Away,1996-11-23,1,4,5,6,6,0,3,3,4,4,2,3,2,0,15.0,21.0,-6.0,4
14024,14024,1996-97,1996,1997,Sheffield Weds,West Ham,Draw,Home,1996-11-30,1,4,5,6,7,2,2,5,8,2,3,1,-1,1,15.0,10.0,5.0,4
14025,14025,1996-97,1996,1997,Sheffield Weds,Liverpool,Win,Away,1996-12-07,3,2,5,6,7,4,5,8,8,-2,0,-2,-1,0,15.0,3.0,12.0,5
14026,14026,1996-97,1996,1997,Sheffield Weds,Man United,Draw,Home,1996-12-18,1,4,5,8,9,4,5,8,8,0,0,0,1,1,15.0,1.0,14.0,5
14027,14027,1996-97,1996,1997,Sheffield Weds,Tottenham,Draw,Away,1996-12-21,1,4,5,6,9,4,4,4,7,0,1,2,2,0,15.0,8.0,7.0,5
14028,14028,1996-97,1996,1997,Sheffield Weds,Arsenal,Draw,Home,1996-12-26,1,2,5,6,7,1,4,7,10,1,1,-1,-3,1,15.0,5.0,10.0,5
14029,14029,1996-97,1996,1997,Sheffield Weds,Chelsea,Draw,Away,1996-12-28,1,2,3,6,7,6,6,7,7,-4,-3,-1,0,0,15.0,11.0,4.0,5
14030,14030,1996-97,1996,1997,Sheffield Weds,Everton,Win,Home,1997-01-11,3,2,3,4,7,0,0,1,4,2,3,3,3,1,15.0,6.0,9.0,6
14031,14031,1996-97,1996,1997,Sheffield Weds,Middlesbrough,Loss,Away,1997-01-18,0,4,5,6,7,0,0,3,3,4,5,3,4,0,15.0,12.0,3.0,6
14032,14032,1996-97,1996,1997,Sheffield Weds,Aston Villa,Win,Away,1997-01-29,3,3,4,5,6,1,2,3,3,2,2,2,3,0,15.0,4.0,11.0,6
14033,14033,1996-97,1996,1997,Sheffield Weds,Coventry,Draw,Home,1997-02-01,1,3,6,7,8,3,3,4,7,0,3,3,1,1,15.0,16.0,-1.0,7
14034,14034,1996-97,1996,1997,Sheffield Weds,Derby,Draw,Away,1997-02-19,1,4,4,7,8,3,4,4,5,1,0,3,3,0,15.0,21.0,-6.0,7
14035,14035,1996-97,1996,1997,Sheffield Weds,Southampton,Win,Away,1997-02-22,3,2,5,5,8,1,4,4,4,1,1,1,4,0,15.0,17.0,-2.0,7
14036,14036,1996-97,1996,1997,Sheffield Weds,Middlesbrough,Win,Home,1997-03-01,3,4,5,8,8,1,4,4,4,3,1,4,4,1,15.0,12.0,3.0,8
14037,14037,1996-97,1996,1997,Sheffield Weds,Nott'm Forest,Win,Away,1997-03-05,3,6,7,8,11,4,4,4,7,2,3,4,4,0,15.0,9.0,6.0,8
14038,14038,1996-97,1996,1997,Sheffield Weds,Sunderland,Win,Home,1997-03-12,3,6,9,10,11,3,3,3,3,3,6,7,8,1,15.0,21.0,-6.0,8
14039,14039,1996-97,1996,1997,Sheffield Weds,Man United,Loss,Away,1997-03-15,0,6,9,12,13,3,4,7,10,3,5,5,3,0,15.0,1.0,14.0,8
14040,14040,1996-97,1996,1997,Sheffield Weds,Leeds,Draw,Home,1997-03-22,1,3,6,9,12,1,4,7,10,2,2,2,2,1,15.0,13.0,2.0,8
14041,14041,1996-97,1996,1997,Sheffield Weds,Tottenham,Win,Home,1997-04-09,3,1,4,7,10,3,4,7,10,-2,0,0,0,1,15.0,8.0,7.0,9
14042,14042,1996-97,1996,1997,Sheffield Weds,Newcastle,Draw,Home,1997-04-13,1,4,4,7,10,2,5,5,5,2,-1,2,5,1,15.0,2.0,13.0,9
14043,14043,1996-97,1996,1997,Sheffield Weds,Wimbledon,Win,Home,1997-04-19,3,4,5,5,8,3,3,4,5,1,2,1,3,1,15.0,14.0,1.0,9
14044,14044,1996-97,1996,1997,Sheffield Weds,Blackburn,Loss,Away,1997-04-22,0,4,7,8,8,1,2,2,2,3,5,6,6,0,15.0,7.0,8.0,9
14045,14045,1996-97,1996,1997,Sheffield Weds,West Ham,Loss,Away,1997-05-03,0,3,4,7,8,4,4,5,8,-1,0,2,0,0,15.0,10.0,5.0,10
14046,14046,1996-97,1996,1997,Sheffield Weds,Leicester,Loss,Away,1997-05-07,0,0,3,4,7,1,1,1,2,-1,2,3,5,0,15.0,21.0,-6.0,10
14047,14047,1996-97,1996,1997,Sheffield Weds,Liverpool,Draw,Home,1997-05-11,1,0,0,3,4,3,3,4,7,-3,-3,-1,-3,1,15.0,3.0,12.0,10
14048,14048,1997-98,1997,1998,Sheffield Weds,Newcastle,Loss,Away,1997-08-09,0,1,1,1,4,4,5,8,11,-3,-4,-7,-7,0,7.0,2.0,5.0,1
14049,14049,1997-98,1997,1998,Sheffield Weds,Leeds,Loss,Home,1997-08-13,0,1,1,1,1,2,3,4,5,-1,-2,-3,-4,1,7.0,11.0,-4.0,1
14050,14050,1997-98,1997,1998,Sheffield Weds,Wimbledon,Draw,Away,1997-08-23,1,0,1,1,1,4,7,8,8,-4,-6,-7,-7,0,7.0,8.0,-1.0,1
14051,14051,1997-98,1997,1998,Sheffield Weds,Blackburn,Loss,Away,1997-08-25,0,1,1,2,2,4,7,7,8,-3,-6,-5,-6,0,7.0,13.0,-6.0,1
14052,14052,1997-98,1997,1998,Sheffield Weds,Leicester,Win,Home,1997-08-30,3,1,1,1,2,2,5,8,11,-1,-4,-7,-9,1,7.0,9.0,-2.0,1
14053,14053,1997-98,1997,1998,Sheffield Weds,Liverpool,Loss,Away,1997-09-13,0,3,4,4,4,4,4,5,6,-1,0,-1,-2,0,7.0,4.0,3.0,2
14054,14054,1997-98,1997,1998,Sheffield Weds,Coventry,Draw,Home,1997-09-20,1,3,3,4,4,3,4,5,5,0,-1,-1,-1,1,7.0,17.0,-10.0,2
14055,14055,1997-98,1997,1998,Sheffield Weds,Derby,Loss,Home,1997-09-24,0,1,4,4,5,3,6,6,6,-2,-2,-2,-1,1,7.0,12.0,-5.0,2
14056,14056,1997-98,1997,1998,Sheffield Weds,Aston Villa,Draw,Away,1997-09-27,1,1,1,4,4,3,6,9,9,-2,-5,-5,-5,0,7.0,5.0,2.0,2
14057,14057,1997-98,1997,1998,Sheffield Weds,Everton,Win,Home,1997-10-04,3,1,2,2,5,1,4,4,5,0,-2,-2,0,1,7.0,15.0,-8.0,3
14058,14058,1997-98,1997,1998,Sheffield Weds,Tottenham,Loss,Away,1997-10-19,0,4,4,5,5,1,2,3,3,3,2,2,2,0,7.0,10.0,-3.0,3
14059,14059,1997-98,1997,1998,Sheffield Weds,Crystal Palace,Loss,Home,1997-10-25,0,3,4,4,5,1,2,3,6,2,2,1,-1,1,7.0,21.0,-14.0,3
14060,14060,1997-98,1997,1998,Sheffield Weds,Man United,Loss,Away,1997-11-01,0,0,3,4,4,4,7,7,8,-4,-4,-3,-4,0,7.0,1.0,6.0,4
14061,14061,1997-98,1997,1998,Sheffield Weds,Bolton,Win,Home,1997-11-08,3,0,0,3,4,4,4,4,5,-4,-4,-1,-1,1,7.0,21.0,-14.0,4
14062,14062,1997-98,1997,1998,Sheffield Weds,Arsenal,Win,Home,1997-11-22,3,3,3,3,6,3,4,5,8,0,-1,-2,-2,1,7.0,3.0,4.0,4
14063,14063,1997-98,1997,1998,Sheffield Weds,Southampton,Win,Away,1997-11-29,3,6,6,6,6,3,6,9,9,3,0,-3,-3,0,7.0,16.0,-9.0,4
14064,14064,1997-98,1997,1998,Sheffield Weds,Barnsley,Win,Home,1997-12-08,3,6,9,9,9,3,3,4,4,3,6,5,5,1,7.0,21.0,-14.0,5
14065,14065,1997-98,1997,1998,Sheffield Weds,West Ham,Loss,Away,1997-12-13,0,6,9,12,12,3,6,6,6,3,3,6,6,0,7.0,14.0,-7.0,5
14066,14066,1997-98,1997,1998,Sheffield Weds,Chelsea,Loss,Home,1997-12-20,0,3,6,9,12,4,7,10,10,-1,-1,-1,2,1,7.0,6.0,1.0,5
14067,14067,1997-98,1997,1998,Sheffield Weds,Blackburn,Draw,Home,1997-12-26,1,0,3,6,9,6,9,9,12,-6,-6,-3,-3,1,7.0,13.0,-6.0,5
14068,14068,1997-98,1997,1998,Sheffield Weds,Leicester,Draw,Away,1997-12-28,1,1,1,4,7,0,0,1,4,1,1,3,3,0,7.0,9.0,-2.0,5
14069,14069,1997-98,1997,1998,Sheffield Weds,Newcastle,Win,Home,1998-01-10,3,2,2,2,5,0,0,1,2,2,2,1,3,1,7.0,2.0,5.0,6
14070,14070,1997-98,1997,1998,Sheffield Weds,Leeds,Win,Away,1998-01-17,3,4,5,5,5,1,1,4,5,3,4,1,0,0,7.0,11.0,-4.0,6
14071,14071,1997-98,1997,1998,Sheffield Weds,Wimbledon,Draw,Home,1998-01-31,1,6,7,8,8,1,1,2,3,5,6,6,5,1,7.0,8.0,-1.0,6
14072,14072,1997-98,1997,1998,Sheffield Weds,Coventry,Loss,Away,1998-02-07,0,4,7,8,9,4,4,7,7,0,3,1,2,0,7.0,17.0,-10.0,7
14073,14073,1997-98,1997,1998,Sheffield Weds,Liverpool,Draw,Home,1998-02-14,1,1,4,7,8,1,4,5,8,0,0,2,0,1,7.0,4.0,3.0,7
14074,14074,1997-98,1997,1998,Sheffield Weds,Tottenham,Win,Home,1998-02-21,3,1,2,5,8,4,4,7,7,-3,-2,-2,1,1,7.0,10.0,-3.0,7
14075,14075,1997-98,1997,1998,Sheffield Weds,Derby,Loss,Away,1998-02-28,0,4,4,5,8,3,3,6,7,1,1,-1,1,0,7.0,12.0,-5.0,7
14076,14076,1997-98,1997,1998,Sheffield Weds,Man United,Win,Home,1998-03-07,3,3,4,4,5,6,9,10,10,-3,-5,-6,-5,1,7.0,1.0,6.0,8
14077,14077,1997-98,1997,1998,Sheffield Weds,Bolton,Loss,Away,1998-03-14,0,3,6,7,7,0,1,2,2,3,5,5,5,0,7.0,21.0,-14.0,8
14078,14078,1997-98,1997,1998,Sheffield Weds,Arsenal,Loss,Away,1998-03-28,0,3,3,6,7,6,7,10,13,-3,-4,-4,-6,0,7.0,3.0,4.0,8
14079,14079,1997-98,1997,1998,Sheffield Weds,Southampton,Win,Home,1998-04-04,3,0,3,3,6,3,6,9,12,-3,-3,-6,-6,1,7.0,16.0,-9.0,9
14080,14080,1997-98,1997,1998,Sheffield Weds,Barnsley,Loss,Away,1998-04-11,0,3,3,6,6,0,0,3,6,3,3,3,0,0,7.0,21.0,-14.0,9
14081,14081,1997-98,1997,1998,Sheffield Weds,West Ham,Draw,Home,1998-04-13,1,3,3,3,6,1,4,7,8,2,-1,-4,-2,1,7.0,14.0,-7.0,9
14082,14082,1997-98,1997,1998,Sheffield Weds,Chelsea,Loss,Away,1998-04-19,0,1,4,4,4,3,6,6,9,-2,-2,-2,-5,0,7.0,6.0,1.0,9
14083,14083,1997-98,1997,1998,Sheffield Weds,Everton,Win,Away,1998-04-25,3,1,1,4,4,2,5,6,6,-1,-4,-2,-2,0,7.0,15.0,-8.0,9
14084,14084,1997-98,1997,1998,Sheffield Weds,Aston Villa,Loss,Home,1998-05-02,0,3,4,4,7,3,6,9,12,0,-2,-5,-5,1,7.0,5.0,2.0,10
14085,14085,1997-98,1997,1998,Sheffield Weds,Crystal Palace,Loss,Away,1998-05-10,0,3,3,4,4,1,1,4,4,2,2,0,0,0,7.0,21.0,-14.0,10
14086,14086,1998-99,1998,1999,Sheffield Weds,West Ham,Loss,Home,1998-08-15,0,0,3,3,4,4,4,4,7,-4,-1,-1,-3,1,16.0,8.0,8.0,1
14087,14087,1998-99,1998,1999,Sheffield Weds,Tottenham,Win,Away,1998-08-22,3,0,0,3,3,1,4,7,8,-1,-4,-4,-5,0,16.0,14.0,2.0,1
14088,14088,1998-99,1998,1999,Sheffield Weds,Aston Villa,Loss,Home,1998-08-29,0,3,3,3,6,4,7,10,10,-1,-4,-7,-4,1,16.0,7.0,9.0,1
14089,14089,1998-99,1998,1999,Sheffield Weds,Derby,Loss,Away,1998-09-09,0,3,3,3,3,2,3,6,9,1,0,-3,-6,0,16.0,9.0,7.0,2
14090,14090,1998-99,1998,1999,Sheffield Weds,Blackburn,Win,Home,1998-09-12,3,0,3,3,3,3,3,4,7,-3,0,-1,-4,1,16.0,6.0,10.0,2
14091,14091,1998-99,1998,1999,Sheffield Weds,Wimbledon,Loss,Away,1998-09-19,0,3,3,6,6,3,4,5,8,0,-1,1,-2,0,16.0,15.0,1.0,2
14092,14092,1998-99,1998,1999,Sheffield Weds,Arsenal,Win,Home,1998-09-26,3,3,3,3,6,4,5,6,7,-1,-2,-3,-1,1,16.0,1.0,15.0,2
14093,14093,1998-99,1998,1999,Sheffield Weds,Middlesbrough,Loss,Away,1998-10-03,0,3,6,6,6,1,4,7,8,2,2,-1,-2,0,16.0,21.0,-5.0,3
14094,14094,1998-99,1998,1999,Sheffield Weds,Coventry,Loss,Away,1998-10-18,0,3,3,6,6,1,1,1,1,2,2,5,5,0,16.0,11.0,5.0,3
14095,14095,1998-99,1998,1999,Sheffield Weds,Everton,Draw,Home,1998-10-24,1,0,3,3,6,4,5,6,7,-4,-2,-3,-1,1,16.0,17.0,-1.0,3
14096,14096,1998-99,1998,1999,Sheffield Weds,Southampton,Draw,Home,1998-10-31,1,1,1,4,4,4,4,4,5,-3,-3,0,-1,1,16.0,12.0,4.0,3
14097,14097,1998-99,1998,1999,Sheffield Weds,Leeds,Loss,Away,1998-11-08,0,2,2,2,5,2,3,3,4,0,-1,-1,1,0,16.0,5.0,11.0,4
14098,14098,1998-99,1998,1999,Sheffield Weds,Newcastle,Draw,Away,1998-11-14,1,1,2,2,2,1,1,4,4,0,1,-2,-2,0,16.0,13.0,3.0,4
14099,14099,1998-99,1998,1999,Sheffield Weds,Man United,Win,Home,1998-11-21,3,1,2,3,3,4,7,8,11,-3,-5,-5,-8,1,16.0,2.0,14.0,4
14100,14100,1998-99,1998,1999,Sheffield Weds,Chelsea,Draw,Away,1998-11-28,1,4,4,5,6,6,7,8,11,-2,-3,-3,-5,0,16.0,4.0,12.0,4
14101,14101,1998-99,1998,1999,Sheffield Weds,Nott'm Forest,Win,Home,1998-12-07,3,4,5,5,6,1,2,2,3,3,3,3,3,1,16.0,21.0,-5.0,5
14102,14102,1998-99,1998,1999,Sheffield Weds,Charlton,Win,Home,1998-12-12,3,4,7,8,8,0,0,1,2,4,7,7,6,1,16.0,21.0,-5.0,5
14103,14103,1998-99,1998,1999,Sheffield Weds,Liverpool,Loss,Away,1998-12-19,0,6,7,10,11,0,3,6,6,6,4,4,5,0,16.0,3.0,13.0,5
14104,14104,1998-99,1998,1999,Sheffield Weds,Leicester,Loss,Home,1998-12-26,0,3,6,7,10,3,6,7,7,0,0,0,3,1,16.0,10.0,6.0,5
14105,14105,1998-99,1998,1999,Sheffield Weds,Aston Villa,Loss,Away,1998-12-28,0,0,3,6,7,3,6,6,7,-3,-3,0,0,0,16.0,7.0,9.0,5
14106,14106,1998-99,1998,1999,Sheffield Weds,Tottenham,Draw,Home,1999-01-09,1,0,0,3,6,4,4,5,8,-4,-4,-2,-2,1,16.0,14.0,2.0,6
14107,14107,1998-99,1998,1999,Sheffield Weds,West Ham,Win,Away,1999-01-16,3,1,1,1,4,3,3,6,6,-2,-2,-5,-2,0,16.0,8.0,8.0,6
14108,14108,1998-99,1998,1999,Sheffield Weds,Derby,Loss,Home,1999-01-30,0,4,4,4,4,3,6,7,8,1,-2,-3,-4,1,16.0,9.0,7.0,6
14109,14109,1998-99,1998,1999,Sheffield Weds,Leicester,Win,Away,1999-02-06,3,3,4,4,4,1,2,3,6,2,2,1,-2,0,16.0,10.0,6.0,7
14110,14110,1998-99,1998,1999,Sheffield Weds,Blackburn,Win,Away,1999-02-20,3,3,6,7,7,4,5,5,8,-1,1,2,-1,0,16.0,6.0,10.0,7
14111,14111,1998-99,1998,1999,Sheffield Weds,Middlesbrough,Win,Home,1999-02-27,3,6,6,9,10,1,1,2,2,5,5,7,8,1,16.0,21.0,-5.0,7
14112,14112,1998-99,1998,1999,Sheffield Weds,Wimbledon,Loss,Home,1999-03-03,0,6,9,9,12,2,2,3,4,4,7,6,8,1,16.0,15.0,1.0,8
14113,14113,1998-99,1998,1999,Sheffield Weds,Arsenal,Loss,Away,1999-03-09,0,3,6,9,9,4,5,8,11,-1,1,1,-2,0,16.0,1.0,15.0,8
14114,14114,1998-99,1998,1999,Sheffield Weds,Leeds,Loss,Home,1999-03-13,0,0,3,6,9,6,9,12,12,-6,-6,-6,-3,1,16.0,5.0,11.0,8
14115,14115,1998-99,1998,1999,Sheffield Weds,Southampton,Loss,Away,1999-03-20,0,0,0,3,6,3,3,3,6,-3,-3,0,0,0,16.0,12.0,4.0,8
14116,14116,1998-99,1998,1999,Sheffield Weds,Coventry,Loss,Home,1999-04-03,0,0,0,0,3,1,4,7,7,-1,-4,-7,-4,1,16.0,11.0,5.0,9
14117,14117,1998-99,1998,1999,Sheffield Weds,Everton,Win,Away,1999-04-05,3,0,0,0,0,0,0,3,4,0,0,-3,-4,0,16.0,17.0,-1.0,9
14118,14118,1998-99,1998,1999,Sheffield Weds,Man United,Loss,Away,1999-04-17,0,3,3,3,3,4,7,10,13,-1,-4,-7,-10,0,16.0,2.0,14.0,9
14119,14119,1998-99,1998,1999,Sheffield Weds,Newcastle,Draw,Home,1999-04-21,1,3,3,3,3,1,4,4,4,2,-1,-1,-1,1,16.0,13.0,3.0,9
14120,14120,1998-99,1998,1999,Sheffield Weds,Chelsea,Draw,Home,1999-04-25,1,1,4,4,4,2,5,8,11,-1,-1,-4,-7,1,16.0,4.0,12.0,9
14121,14121,1998-99,1998,1999,Sheffield Weds,Nott'm Forest,Loss,Away,1999-05-01,0,2,2,5,5,0,0,1,1,2,2,4,4,0,16.0,21.0,-5.0,10
14122,14122,1998-99,1998,1999,Sheffield Weds,Liverpool,Win,Home,1999-05-08,3,1,2,2,5,4,7,7,7,-3,-5,-5,-2,1,16.0,3.0,13.0,10
14123,14123,1998-99,1998,1999,Sheffield Weds,Charlton,Win,Away,1999-05-16,3,3,4,5,5,4,4,4,5,-1,0,1,0,0,16.0,21.0,-5.0,10
14124,14124,1999-00,1999,2000,Sheffield Weds,Liverpool,Loss,Home,1999-08-07,0,6,6,7,8,3,4,7,10,3,2,0,-2,1,12.0,7.0,5.0,1
14125,14125,1999-00,1999,2000,Sheffield Weds,Man United,Loss,Away,1999-08-11,0,3,6,6,7,4,5,8,9,-1,1,-2,-2,0,12.0,1.0,11.0,1
14126,14126,1999-00,1999,2000,Sheffield Weds,Bradford,Draw,Away,1999-08-14,1,0,3,6,6,3,3,3,3,-3,0,3,3,0,12.0,21.0,-9.0,1
14127,14127,1999-00,1999,2000,Sheffield Weds,Tottenham,Loss,Home,1999-08-21,0,1,1,4,7,6,6,6,7,-5,-5,-2,0,1,12.0,11.0,1.0,1
14128,14128,1999-00,1999,2000,Sheffield Weds,Derby,Loss,Home,1999-08-25,0,1,1,1,4,0,0,1,1,1,1,0,3,1,12.0,8.0,4.0,1
14129,14129,1999-00,1999,2000,Sheffield Weds,Southampton,Loss,Away,1999-08-28,0,0,1,1,1,3,3,6,9,-3,-2,-5,-8,0,12.0,17.0,-5.0,1
14130,14130,1999-00,1999,2000,Sheffield Weds,Everton,Loss,Home,1999-09-11,0,0,0,1,1,3,6,6,6,-3,-6,-5,-5,1,12.0,14.0,-2.0,2
14131,14131,1999-00,1999,2000,Sheffield Weds,Newcastle,Loss,Away,1999-09-19,0,0,0,0,1,0,0,1,1,0,0,-1,0,0,12.0,13.0,-1.0,2
14132,14132,1999-00,1999,2000,Sheffield Weds,Sunderland,Loss,Away,1999-09-25,0,0,0,0,0,6,7,10,10,-6,-7,-10,-10,0,12.0,21.0,-9.0,2
14133,14133,1999-00,1999,2000,Sheffield Weds,Wimbledon,Win,Home,1999-10-02,3,0,0,0,0,2,3,3,3,-2,-3,-3,-3,1,12.0,16.0,-4.0,3
14134,14134,1999-00,1999,2000,Sheffield Weds,Leeds,Loss,Away,1999-10-16,0,3,3,3,3,6,9,12,15,-3,-6,-9,-12,0,12.0,4.0,8.0,3
14135,14135,1999-00,1999,2000,Sheffield Weds,Coventry,Draw,Home,1999-10-23,1,3,3,3,3,4,7,7,7,-1,-4,-4,-4,1,12.0,15.0,-3.0,3
14136,14136,1999-00,1999,2000,Sheffield Weds,Leicester,Loss,Away,1999-10-30,0,1,4,4,4,3,6,9,10,-2,-2,-5,-6,0,12.0,10.0,2.0,3
14137,14137,1999-00,1999,2000,Sheffield Weds,Watford,Draw,Home,1999-11-06,1,1,1,4,4,0,0,0,0,1,1,4,4,1,12.0,21.0,-9.0,4
14138,14138,1999-00,1999,2000,Sheffield Weds,West Ham,Loss,Away,1999-11-21,0,1,2,2,5,1,1,2,2,0,1,0,3,0,12.0,5.0,7.0,4
14139,14139,1999-00,1999,2000,Sheffield Weds,Liverpool,Loss,Away,1999-12-05,0,1,1,2,2,3,6,9,12,-2,-5,-7,-10,0,12.0,7.0,5.0,5
14140,14140,1999-00,1999,2000,Sheffield Weds,Aston Villa,Loss,Away,1999-12-18,0,0,1,1,2,1,1,1,1,-1,0,0,1,0,12.0,6.0,6.0,5
14141,14141,1999-00,1999,2000,Sheffield Weds,Middlesbrough,Win,Home,1999-12-26,3,0,0,1,1,4,5,5,6,-4,-5,-4,-5,1,12.0,9.0,3.0,5
14142,14142,1999-00,1999,2000,Sheffield Weds,Chelsea,Loss,Away,1999-12-29,0,3,3,3,4,3,3,6,7,0,0,-3,-3,0,12.0,3.0,9.0,5
14143,14143,1999-00,1999,2000,Sheffield Weds,Arsenal,Draw,Home,2000-01-03,1,3,3,3,3,3,4,7,10,0,-1,-4,-7,1,12.0,2.0,10.0,6
14144,14144,1999-00,1999,2000,Sheffield Weds,Bradford,Win,Home,2000-01-15,3,1,4,4,4,1,2,2,5,0,2,2,-1,1,12.0,21.0,-9.0,6
14145,14145,1999-00,1999,2000,Sheffield Weds,Tottenham,Win,Away,2000-01-22,3,4,4,7,7,1,4,5,8,3,0,2,-1,0,12.0,11.0,1.0,6
14146,14146,1999-00,1999,2000,Sheffield Weds,Man United,Loss,Home,2000-02-02,0,6,7,7,10,4,5,8,11,2,2,-1,-1,1,12.0,1.0,11.0,7
14147,14147,1999-00,1999,2000,Sheffield Weds,Derby,Draw,Away,2000-02-05,1,3,6,7,7,4,7,8,8,-1,-1,-1,-1,0,12.0,8.0,4.0,7
14148,14148,1999-00,1999,2000,Sheffield Weds,Southampton,Loss,Home,2000-02-12,0,1,4,7,8,6,6,9,9,-5,-2,-2,-1,1,12.0,17.0,-5.0,7
14149,14149,1999-00,1999,2000,Sheffield Weds,Newcastle,Loss,Home,2000-02-26,0,1,1,4,7,4,4,7,8,-3,-3,-3,-1,1,12.0,13.0,-1.0,7
14150,14150,1999-00,1999,2000,Sheffield Weds,Everton,Draw,Away,2000-03-04,1,0,1,1,4,6,9,9,10,-6,-8,-8,-6,0,12.0,14.0,-2.0,8
14151,14151,1999-00,1999,2000,Sheffield Weds,West Ham,Win,Home,2000-03-11,3,1,1,2,2,6,6,9,9,-5,-5,-7,-7,1,12.0,5.0,7.0,8
14152,14152,1999-00,1999,2000,Sheffield Weds,Watford,Loss,Away,2000-03-18,0,4,4,4,5,0,0,1,1,4,4,3,4,0,12.0,21.0,-9.0,8
14153,14153,1999-00,1999,2000,Sheffield Weds,Middlesbrough,Loss,Away,2000-03-25,0,3,4,4,4,4,5,6,9,-1,-1,-2,-5,0,12.0,9.0,3.0,8
14154,14154,1999-00,1999,2000,Sheffield Weds,Aston Villa,Loss,Home,2000-04-05,0,0,3,4,4,3,4,7,8,-3,-1,-3,-4,1,12.0,6.0,6.0,9
14155,14155,1999-00,1999,2000,Sheffield Weds,Wimbledon,Win,Away,2000-04-12,3,0,0,3,4,0,0,0,3,0,0,3,1,0,12.0,16.0,-4.0,9
14156,14156,1999-00,1999,2000,Sheffield Weds,Chelsea,Win,Home,2000-04-15,3,3,3,3,6,6,7,8,9,-3,-4,-5,-3,1,12.0,3.0,9.0,9
14157,14157,1999-00,1999,2000,Sheffield Weds,Sunderland,Loss,Home,2000-04-22,0,6,6,6,6,3,6,9,10,3,0,-3,-4,1,12.0,21.0,-9.0,9
14158,14158,1999-00,1999,2000,Sheffield Weds,Leeds,Loss,Home,2000-04-30,0,3,6,6,6,1,1,1,1,2,5,5,5,1,12.0,4.0,8.0,9
14159,14159,1999-00,1999,2000,Sheffield Weds,Coventry,Loss,Away,2000-05-06,0,0,3,6,6,0,3,3,3,0,0,3,3,0,12.0,15.0,-3.0,10
14160,14160,1999-00,1999,2000,Sheffield Weds,Arsenal,Draw,Away,2000-05-09,1,0,0,3,6,6,9,12,15,-6,-9,-9,-9,0,12.0,2.0,10.0,10
14161,14161,1999-00,1999,2000,Sheffield Weds,Leicester,Win,Home,2000-05-14,3,1,1,1,4,6,9,10,10,-5,-8,-9,-6,1,12.0,10.0,2.0,10
14162,14162,1993-94,1993,1994,Southampton,Everton,Loss,Home,1993-08-14,0,0,0,0,0,0,0,0,0,0,0,0,0,1,18.0,13.0,5.0,1
14163,14163,1993-94,1993,1994,Southampton,Ipswich,Loss,Away,1993-08-17,0,0,0,0,0,3,3,3,3,-3,-3,-3,-3,0,18.0,16.0,2.0,1
14164,14164,1993-94,1993,1994,Southampton,QPR,Loss,Away,1993-08-21,0,0,0,0,0,0,0,0,0,0,0,0,0,0,18.0,5.0,13.0,1
14165,14165,1993-94,1993,1994,Southampton,Swindon,Win,Home,1993-08-25,3,0,0,0,0,0,0,0,0,0,0,0,0,1,18.0,21.0,-3.0,1
14166,14166,1993-94,1993,1994,Southampton,Man United,Loss,Home,1993-08-28,0,3,3,3,3,4,7,10,10,-1,-4,-7,-7,1,18.0,1.0,17.0,1
14167,14167,1993-94,1993,1994,Southampton,Wimbledon,Loss,Away,1993-08-31,0,3,3,3,3,1,2,3,6,2,1,0,-3,0,18.0,12.0,6.0,1
14168,14168,1993-94,1993,1994,Southampton,Leeds,Loss,Home,1993-09-11,0,0,3,3,3,3,3,3,6,-3,0,0,-3,1,18.0,17.0,1.0,2
14169,14169,1993-94,1993,1994,Southampton,Sheffield Weds,Loss,Away,1993-09-18,0,0,0,3,3,1,2,2,2,-1,-2,1,1,0,18.0,7.0,11.0,2
14170,14170,1993-94,1993,1994,Southampton,Arsenal,Loss,Away,1993-09-25,0,0,0,0,3,3,4,7,10,-3,-4,-7,-7,0,18.0,10.0,8.0,2
14171,14171,1993-94,1993,1994,Southampton,Sheffield United,Draw,Home,1993-10-02,1,0,0,0,0,0,1,1,2,0,-1,-1,-2,1,18.0,14.0,4.0,3
14172,14172,1993-94,1993,1994,Southampton,Coventry,Draw,Away,1993-10-16,1,1,1,1,1,0,1,2,5,1,0,-1,-4,0,18.0,15.0,3.0,3
14173,14173,1993-94,1993,1994,Southampton,Newcastle,Win,Home,1993-10-24,3,2,2,2,2,3,6,7,10,-1,-4,-5,-8,1,18.0,21.0,-3.0,3
14174,14174,1993-94,1993,1994,Southampton,Liverpool,Loss,Away,1993-10-30,0,4,5,5,5,4,5,5,5,0,0,0,0,0,18.0,6.0,12.0,3
14175,14175,1993-94,1993,1994,Southampton,Tottenham,Win,Home,1993-11-06,3,3,4,5,5,1,1,4,5,2,3,1,0,1,18.0,8.0,10.0,4
14176,14176,1993-94,1993,1994,Southampton,Blackburn,Loss,Away,1993-11-20,0,3,6,7,8,3,4,5,8,0,2,2,0,0,18.0,4.0,14.0,4
14177,14177,1993-94,1993,1994,Southampton,Aston Villa,Win,Away,1993-11-24,3,3,3,6,7,6,9,12,13,-3,-6,-6,-6,0,18.0,2.0,16.0,4
14178,14178,1993-94,1993,1994,Southampton,West Ham,Loss,Home,1993-11-29,0,3,6,6,9,4,4,7,8,-1,2,-1,1,1,18.0,21.0,-3.0,4
14179,14179,1993-94,1993,1994,Southampton,Everton,Loss,Away,1993-12-04,0,3,3,6,6,2,2,2,5,1,1,4,1,0,18.0,13.0,5.0,5
14180,14180,1993-94,1993,1994,Southampton,Ipswich,Loss,Home,1993-12-08,0,0,3,3,6,4,5,6,6,-4,-2,-3,0,1,18.0,16.0,2.0,5
14181,14181,1993-94,1993,1994,Southampton,QPR,Loss,Home,1993-12-11,0,0,0,3,3,1,2,2,5,-1,-2,1,-2,1,18.0,5.0,13.0,5
14182,14182,1993-94,1993,1994,Southampton,Swindon,Loss,Away,1993-12-18,0,0,0,0,3,1,2,2,5,-1,-2,-2,-2,0,18.0,21.0,-3.0,5
14183,14183,1993-94,1993,1994,Southampton,Chelsea,Win,Home,1993-12-27,3,0,0,0,0,1,1,2,2,-1,-1,-2,-2,1,18.0,11.0,7.0,5
14184,14184,1993-94,1993,1994,Southampton,Man City,Draw,Away,1993-12-28,1,3,3,3,3,0,3,3,3,3,0,0,0,0,18.0,9.0,9.0,5
14185,14185,1993-94,1993,1994,Southampton,Norwich,Loss,Home,1994-01-01,0,4,4,4,4,3,3,6,7,1,1,-2,-3,1,18.0,3.0,15.0,6
14186,14186,1993-94,1993,1994,Southampton,Coventry,Win,Home,1994-01-15,3,1,4,4,4,4,7,8,8,-3,-3,-4,-4,1,18.0,15.0,3.0,6
14187,14187,1993-94,1993,1994,Southampton,Newcastle,Win,Away,1994-01-22,3,3,4,7,7,6,9,9,10,-3,-5,-2,-3,0,18.0,21.0,-3.0,6
14188,14188,1993-94,1993,1994,Southampton,Oldham,Loss,Away,1994-02-05,0,6,6,7,10,1,1,1,1,5,5,6,9,0,18.0,19.0,-1.0,7
14189,14189,1993-94,1993,1994,Southampton,Liverpool,Win,Home,1994-02-14,3,3,6,6,7,4,7,8,11,-1,-1,-2,-4,1,18.0,6.0,12.0,7
14190,14190,1993-94,1993,1994,Southampton,Wimbledon,Win,Home,1994-02-26,3,3,6,9,9,3,4,7,7,0,2,2,2,1,18.0,12.0,6.0,7
14191,14191,1993-94,1993,1994,Southampton,Leeds,Draw,Away,1994-03-05,1,6,6,9,12,4,4,4,5,2,2,5,7,0,18.0,17.0,1.0,8
14192,14192,1993-94,1993,1994,Southampton,Sheffield Weds,Draw,Home,1994-03-12,1,4,7,7,10,1,4,7,7,3,3,0,3,1,18.0,7.0,11.0,8
14193,14193,1993-94,1993,1994,Southampton,Arsenal,Loss,Home,1994-03-19,0,2,5,8,8,6,7,8,9,-4,-2,0,-1,1,18.0,10.0,8.0,8
14194,14194,1993-94,1993,1994,Southampton,Sheffield United,Draw,Away,1994-03-26,1,1,2,5,8,2,3,4,4,-1,-1,1,4,0,18.0,14.0,4.0,8
14195,14195,1993-94,1993,1994,Southampton,Oldham,Loss,Home,1994-03-30,0,1,2,3,6,4,4,5,8,-3,-2,-2,-2,1,18.0,19.0,-1.0,8
14196,14196,1993-94,1993,1994,Southampton,Chelsea,Loss,Away,1994-04-02,0,1,1,2,3,3,3,6,9,-2,-2,-4,-6,0,18.0,11.0,7.0,9
14197,14197,1993-94,1993,1994,Southampton,Man City,Loss,Home,1994-04-04,0,0,1,1,2,4,5,6,6,-4,-4,-5,-4,1,18.0,9.0,9.0,9
14198,14198,1993-94,1993,1994,Southampton,Norwich,Win,Away,1994-04-09,3,0,0,1,1,1,1,1,4,-1,-1,0,-3,0,18.0,3.0,15.0,9
14199,14199,1993-94,1993,1994,Southampton,Blackburn,Win,Home,1994-04-16,3,3,3,3,4,6,9,9,12,-3,-6,-6,-8,1,18.0,4.0,14.0,9
14200,14200,1993-94,1993,1994,Southampton,Tottenham,Loss,Away,1994-04-23,0,6,6,6,6,0,0,3,6,6,6,3,0,0,18.0,8.0,10.0,9
14201,14201,1993-94,1993,1994,Southampton,Aston Villa,Win,Home,1994-04-30,3,3,6,6,6,0,3,3,4,3,3,3,2,1,18.0,2.0,16.0,9
14202,14202,1993-94,1993,1994,Southampton,Man United,Loss,Away,1994-05-04,0,3,6,9,9,6,9,9,12,-3,-3,0,-3,0,18.0,1.0,17.0,10
14203,14203,1993-94,1993,1994,Southampton,West Ham,Draw,Away,1994-05-07,1,3,3,6,9,4,4,4,7,-1,-1,2,2,0,18.0,21.0,-3.0,10
14204,14204,1994-95,1994,1995,Southampton,Blackburn,Draw,Home,1994-08-20,1,1,4,4,7,1,4,5,5,0,0,-1,2,1,18.0,2.0,16.0,1
14205,14205,1994-95,1994,1995,Southampton,Aston Villa,Draw,Away,1994-08-24,1,2,2,5,5,4,4,4,4,-2,-2,1,1,0,18.0,10.0,8.0,1
14206,14206,1994-95,1994,1995,Southampton,Newcastle,Loss,Away,1994-08-27,0,2,3,3,6,6,9,9,12,-4,-6,-6,-6,0,18.0,3.0,15.0,1
14207,14207,1994-95,1994,1995,Southampton,Liverpool,Loss,Home,1994-08-31,0,1,2,3,3,6,6,6,9,-5,-4,-3,-6,1,18.0,8.0,10.0,1
14208,14208,1994-95,1994,1995,Southampton,Tottenham,Win,Away,1994-09-12,3,0,1,2,3,3,6,9,9,-3,-5,-7,-6,0,18.0,15.0,3.0,2
14209,14209,1994-95,1994,1995,Southampton,Nott'm Forest,Draw,Home,1994-09-17,1,3,3,4,5,6,9,10,13,-3,-6,-6,-8,1,18.0,21.0,-3.0,2
14210,14210,1994-95,1994,1995,Southampton,Coventry,Win,Away,1994-09-24,3,4,4,4,5,4,4,4,4,0,0,0,1,0,18.0,11.0,7.0,2
14211,14211,1994-95,1994,1995,Southampton,Ipswich,Win,Home,1994-10-01,3,4,7,7,7,3,3,3,6,1,4,4,1,1,18.0,19.0,-1.0,3
14212,14212,1994-95,1994,1995,Southampton,Everton,Win,Home,1994-10-08,3,6,7,10,10,1,2,2,2,5,5,8,8,1,18.0,17.0,1.0,3
14213,14213,1994-95,1994,1995,Southampton,Leicester,Loss,Away,1994-10-15,0,6,9,10,13,1,2,5,5,5,7,5,8,0,18.0,21.0,-3.0,3
14214,14214,1994-95,1994,1995,Southampton,West Ham,Loss,Away,1994-10-22,0,3,6,9,10,3,6,6,9,0,0,3,1,0,18.0,13.0,5.0,3
14215,14215,1994-95,1994,1995,Southampton,Leeds,Loss,Home,1994-10-29,0,0,3,6,9,4,4,7,8,-4,-1,-1,1,1,18.0,5.0,13.0,3
14216,14216,1994-95,1994,1995,Southampton,Norwich,Draw,Home,1994-11-02,1,0,0,3,6,3,4,7,10,-3,-4,-4,-4,1,18.0,12.0,6.0,4
14217,14217,1994-95,1994,1995,Southampton,Man City,Draw,Away,1994-11-05,1,1,1,1,4,3,6,7,7,-2,-5,-6,-3,0,18.0,16.0,2.0,4
14218,14218,1994-95,1994,1995,Southampton,Arsenal,Win,Home,1994-11-19,3,2,2,2,2,2,5,8,11,0,-3,-6,-9,1,18.0,4.0,14.0,4
14219,14219,1994-95,1994,1995,Southampton,Crystal Palace,Draw,Away,1994-11-26,1,4,5,5,5,3,6,9,12,1,-1,-4,-7,0,18.0,21.0,-3.0,4
14220,14220,1994-95,1994,1995,Southampton,Chelsea,Loss,Home,1994-12-03,0,4,5,6,6,1,4,4,5,3,1,2,1,1,18.0,14.0,4.0,5
14221,14221,1994-95,1994,1995,Southampton,Blackburn,Loss,Away,1994-12-10,0,1,4,5,6,6,9,12,15,-5,-5,-7,-9,0,18.0,2.0,16.0,5
14222,14222,1994-95,1994,1995,Southampton,Aston Villa,Win,Home,1994-12-19,3,0,1,4,5,2,3,6,6,-2,-2,-2,-1,1,18.0,10.0,8.0,5
14223,14223,1994-95,1994,1995,Southampton,Wimbledon,Loss,Home,1994-12-26,0,3,3,4,7,4,4,4,7,-1,-1,0,0,1,18.0,6.0,12.0,5
14224,14224,1994-95,1994,1995,Southampton,QPR,Draw,Away,1994-12-28,1,3,3,3,4,4,4,7,7,-1,-1,-4,-3,0,18.0,9.0,9.0,5
14225,14225,1994-95,1994,1995,Southampton,Man United,Draw,Home,1994-12-31,1,1,4,4,4,4,4,7,10,-3,0,-3,-6,1,18.0,1.0,17.0,5
14226,14226,1994-95,1994,1995,Southampton,Sheffield Weds,Draw,Away,1995-01-02,1,2,2,5,5,6,9,9,9,-4,-7,-4,-4,0,18.0,7.0,11.0,6
14227,14227,1994-95,1994,1995,Southampton,Leeds,Draw,Away,1995-01-14,1,2,3,3,6,1,2,5,6,1,1,-2,0,0,18.0,5.0,13.0,6
14228,14228,1994-95,1994,1995,Southampton,Arsenal,Draw,Away,1995-01-24,1,2,3,4,4,4,4,4,7,-2,-1,0,-3,0,18.0,4.0,14.0,6
14229,14229,1994-95,1994,1995,Southampton,Man City,Draw,Home,1995-02-04,1,2,3,4,5,1,2,3,3,1,1,1,2,1,18.0,16.0,2.0,7
14230,14230,1994-95,1994,1995,Southampton,Norwich,Draw,Away,1995-02-11,1,2,3,4,5,1,1,1,4,1,2,3,1,0,18.0,12.0,6.0,7
14231,14231,1994-95,1994,1995,Southampton,Ipswich,Loss,Away,1995-02-25,0,2,3,4,5,0,0,1,4,2,3,3,1,0,18.0,19.0,-1.0,7
14232,14232,1994-95,1994,1995,Southampton,Coventry,Draw,Home,1995-03-04,1,1,2,3,4,6,9,10,11,-5,-7,-7,-7,1,18.0,11.0,7.0,8
14233,14233,1994-95,1994,1995,Southampton,West Ham,Draw,Home,1995-03-15,1,1,2,3,4,1,4,4,4,0,-2,-1,0,1,18.0,13.0,5.0,8
14234,14234,1994-95,1994,1995,Southampton,Nott'm Forest,Loss,Away,1995-03-18,0,2,2,3,4,6,7,8,8,-4,-5,-5,-4,0,18.0,21.0,-3.0,8
14235,14235,1994-95,1994,1995,Southampton,Newcastle,Win,Home,1995-03-22,3,1,2,2,3,6,6,9,12,-5,-4,-7,-9,1,18.0,3.0,15.0,8
14236,14236,1994-95,1994,1995,Southampton,Tottenham,Win,Home,1995-04-02,3,3,4,5,5,4,5,8,9,-1,-1,-3,-4,1,18.0,15.0,3.0,9
14237,14237,1994-95,1994,1995,Southampton,Liverpool,Loss,Away,1995-04-05,0,6,6,7,8,4,4,7,10,2,2,0,-2,0,18.0,8.0,10.0,9
14238,14238,1994-95,1994,1995,Southampton,Chelsea,Win,Away,1995-04-12,3,3,6,6,7,2,2,2,2,1,4,4,5,0,18.0,14.0,4.0,9
14239,14239,1994-95,1994,1995,Southampton,QPR,Win,Home,1995-04-15,3,3,6,9,9,6,6,9,12,-3,0,0,-3,1,18.0,9.0,9.0,9
14240,14240,1994-95,1994,1995,Southampton,Wimbledon,Win,Away,1995-04-17,3,6,6,9,12,1,4,7,10,5,2,2,2,0,18.0,6.0,12.0,9
14241,14241,1994-95,1994,1995,Southampton,Sheffield Weds,Draw,Home,1995-04-29,1,6,9,9,12,1,4,4,4,5,5,5,8,1,18.0,7.0,11.0,9
14242,14242,1994-95,1994,1995,Southampton,Crystal Palace,Win,Home,1995-05-03,3,4,7,10,10,0,3,4,5,4,4,6,5,1,18.0,21.0,-3.0,10
14243,14243,1994-95,1994,1995,Southampton,Everton,Draw,Away,1995-05-06,1,4,7,10,13,2,3,6,6,2,4,4,7,0,18.0,17.0,1.0,10
14244,14244,1994-95,1994,1995,Southampton,Man United,Loss,Away,1995-05-10,0,4,5,8,11,6,7,10,11,-2,-2,-2,0,0,18.0,1.0,17.0,10
14245,14245,1994-95,1994,1995,Southampton,Leicester,Draw,Home,1995-05-14,1,1,4,5,8,4,4,4,4,-3,0,1,4,1,18.0,21.0,-3.0,10
14246,14246,1995-96,1995,1996,Southampton,Nott'm Forest,Loss,Home,1995-08-19,0,1,2,5,6,4,7,10,13,-3,-5,-5,-7,1,10.0,3.0,7.0,1
14247,14247,1995-96,1995,1996,Southampton,Everton,Loss,Away,1995-08-26,0,1,1,2,5,1,2,5,6,0,-1,-3,-1,0,10.0,15.0,-5.0,1
14248,14248,1995-96,1995,1996,Southampton,Leeds,Draw,Home,1995-08-30,1,0,1,1,2,6,9,10,13,-6,-8,-9,-11,1,10.0,5.0,5.0,1
14249,14249,1995-96,1995,1996,Southampton,Newcastle,Win,Home,1995-09-09,3,1,1,2,2,6,9,12,15,-5,-8,-10,-13,1,10.0,6.0,4.0,2
14250,14250,1995-96,1995,1996,Southampton,Middlesbrough,Draw,Away,1995-09-12,1,4,4,4,5,1,4,5,5,3,0,-1,0,0,10.0,21.0,-11.0,2
14251,14251,1995-96,1995,1996,Southampton,Chelsea,Loss,Away,1995-09-16,0,4,5,5,5,4,4,5,6,0,1,0,-1,0,10.0,11.0,-1.0,2
14252,14252,1995-96,1995,1996,Southampton,Arsenal,Loss,Away,1995-09-23,0,1,4,5,5,6,7,8,11,-5,-3,-3,-6,0,10.0,12.0,-2.0,2
14253,14253,1995-96,1995,1996,Southampton,West Ham,Draw,Home,1995-10-02,1,0,1,4,5,3,3,4,5,-3,-2,0,0,1,10.0,14.0,-4.0,3
14254,14254,1995-96,1995,1996,Southampton,Blackburn,Loss,Away,1995-10-14,0,1,1,2,5,3,3,4,4,-2,-2,-2,1,0,10.0,1.0,9.0,3
14255,14255,1995-96,1995,1996,Southampton,Liverpool,Loss,Home,1995-10-22,0,1,1,1,2,2,5,8,8,-1,-4,-7,-6,1,10.0,4.0,6.0,3
14256,14256,1995-96,1995,1996,Southampton,Wimbledon,Win,Away,1995-10-28,3,0,1,1,1,0,0,0,0,0,1,1,1,0,10.0,9.0,1.0,3
14257,14257,1995-96,1995,1996,Southampton,QPR,Win,Home,1995-11-04,3,3,3,4,4,1,1,4,4,2,2,0,0,1,10.0,8.0,2.0,4
14258,14258,1995-96,1995,1996,Southampton,Man United,Loss,Away,1995-11-18,0,6,6,6,7,3,6,9,10,3,0,-3,-3,0,10.0,2.0,8.0,4
14259,14259,1995-96,1995,1996,Southampton,Aston Villa,Loss,Home,1995-11-20,0,3,6,6,6,4,7,7,7,-1,-1,-1,-1,1,10.0,18.0,-8.0,4
14260,14260,1995-96,1995,1996,Southampton,Bolton,Win,Home,1995-11-25,3,0,3,6,6,0,0,3,3,0,3,3,3,1,10.0,21.0,-11.0,4
14261,14261,1995-96,1995,1996,Southampton,Liverpool,Draw,Away,1995-12-02,1,3,3,6,9,1,1,1,4,2,2,5,5,0,10.0,4.0,6.0,5
14262,14262,1995-96,1995,1996,Southampton,Arsenal,Draw,Home,1995-12-09,1,4,4,4,7,2,5,5,8,2,-1,-1,-1,1,10.0,12.0,-2.0,5
14263,14263,1995-96,1995,1996,Southampton,West Ham,Loss,Away,1995-12-16,0,2,5,5,5,0,3,4,7,2,2,1,-2,0,10.0,14.0,-4.0,5
14264,14264,1995-96,1995,1996,Southampton,Sheffield Weds,Draw,Away,1995-12-23,1,1,2,5,5,4,7,8,8,-3,-5,-3,-3,0,10.0,13.0,-3.0,5
14265,14265,1995-96,1995,1996,Southampton,Tottenham,Draw,Home,1995-12-26,1,1,2,3,6,4,7,8,9,-3,-5,-5,-3,1,10.0,7.0,3.0,5
14266,14266,1995-96,1995,1996,Southampton,Coventry,Draw,Away,1996-01-01,1,2,2,3,4,6,6,9,9,-4,-4,-6,-5,0,10.0,16.0,-6.0,6
14267,14267,1995-96,1995,1996,Southampton,Nott'm Forest,Loss,Away,1996-01-13,0,2,3,3,4,3,6,6,7,-1,-3,-3,-3,0,10.0,3.0,7.0,6
14268,14268,1995-96,1995,1996,Southampton,Middlesbrough,Win,Home,1996-01-20,3,1,2,3,3,0,0,0,3,1,2,3,0,1,10.0,21.0,-11.0,6
14269,14269,1995-96,1995,1996,Southampton,Man City,Draw,Home,1996-01-31,1,3,4,5,6,1,4,4,4,2,0,1,2,1,10.0,17.0,-7.0,6
14270,14270,1995-96,1995,1996,Southampton,Everton,Draw,Home,1996-02-03,1,4,4,5,6,4,7,10,13,0,-3,-5,-7,1,10.0,15.0,-5.0,7
14271,14271,1995-96,1995,1996,Southampton,Chelsea,Loss,Home,1996-02-24,0,2,5,5,6,0,3,6,7,2,2,-1,-1,1,10.0,11.0,-1.0,7
14272,14272,1995-96,1995,1996,Southampton,Tottenham,Loss,Away,1996-03-02,0,1,2,5,5,3,4,4,7,-2,-2,1,-2,0,10.0,7.0,3.0,8
14273,14273,1995-96,1995,1996,Southampton,Man City,Loss,Away,1996-03-16,0,0,1,2,5,1,2,3,3,-1,-1,-1,2,0,10.0,17.0,-7.0,8
14274,14274,1995-96,1995,1996,Southampton,Sheffield Weds,Loss,Home,1996-03-20,0,0,0,1,2,3,3,3,3,-3,-3,-2,-1,1,10.0,13.0,-3.0,8
14275,14275,1995-96,1995,1996,Southampton,Coventry,Win,Home,1996-03-25,3,0,0,0,1,1,2,3,6,-1,-2,-3,-5,1,10.0,16.0,-6.0,8
14276,14276,1995-96,1995,1996,Southampton,QPR,Loss,Away,1996-03-30,0,3,3,3,3,2,2,2,3,1,1,1,0,0,10.0,8.0,2.0,8
14277,14277,1995-96,1995,1996,Southampton,Leeds,Loss,Away,1996-04-03,0,3,3,3,3,1,1,4,4,2,2,-1,-1,0,10.0,5.0,5.0,9
14278,14278,1995-96,1995,1996,Southampton,Blackburn,Win,Home,1996-04-06,3,0,3,3,3,3,6,7,7,-3,-3,-4,-4,1,10.0,1.0,9.0,9
14279,14279,1995-96,1995,1996,Southampton,Aston Villa,Loss,Away,1996-04-08,0,3,3,6,6,4,4,7,10,-1,-1,-1,-4,0,10.0,18.0,-8.0,9
14280,14280,1995-96,1995,1996,Southampton,Man United,Win,Home,1996-04-13,3,3,3,3,6,6,9,12,13,-3,-6,-9,-7,1,10.0,2.0,8.0,9
14281,14281,1995-96,1995,1996,Southampton,Newcastle,Loss,Away,1996-04-17,0,3,6,6,6,3,6,6,6,0,0,0,0,0,10.0,6.0,4.0,9
14282,14282,1995-96,1995,1996,Southampton,Bolton,Win,Away,1996-04-27,3,3,3,6,6,3,3,4,7,0,0,2,-1,0,10.0,21.0,-11.0,9
14283,14283,1995-96,1995,1996,Southampton,Wimbledon,Draw,Home,1996-05-04,1,3,6,6,9,0,3,6,7,3,3,0,2,1,10.0,9.0,1.0,10
14284,14284,1996-97,1996,1997,Southampton,Chelsea,Draw,Home,1996-08-18,1,4,4,7,7,1,2,5,5,3,2,2,2,1,17.0,11.0,6.0,1
14285,14285,1996-97,1996,1997,Southampton,Leicester,Loss,Away,1996-08-21,0,2,5,5,8,2,3,6,6,0,2,-1,2,0,17.0,21.0,-4.0,1
14286,14286,1996-97,1996,1997,Southampton,West Ham,Loss,Away,1996-08-24,0,1,2,5,5,1,2,2,3,0,0,3,2,0,17.0,10.0,7.0,1
14287,14287,1996-97,1996,1997,Southampton,Nott'm Forest,Draw,Home,1996-09-04,1,0,1,2,5,1,4,7,8,-1,-3,-5,-3,1,17.0,9.0,8.0,2
14288,14288,1996-97,1996,1997,Southampton,Liverpool,Loss,Away,1996-09-07,0,1,1,2,3,4,7,8,9,-3,-6,-6,-6,0,17.0,3.0,14.0,2
14289,14289,1996-97,1996,1997,Southampton,Tottenham,Loss,Home,1996-09-14,0,1,1,1,2,0,1,2,5,1,0,-1,-3,1,17.0,8.0,9.0,2
14290,14290,1996-97,1996,1997,Southampton,Wimbledon,Loss,Away,1996-09-23,0,0,1,1,1,6,9,9,9,-6,-8,-8,-8,0,17.0,14.0,3.0,2
14291,14291,1996-97,1996,1997,Southampton,Middlesbrough,Win,Home,1996-09-28,3,0,0,1,1,3,6,9,10,-3,-6,-8,-9,1,17.0,12.0,5.0,2
14292,14292,1996-97,1996,1997,Southampton,Coventry,Draw,Away,1996-10-13,1,3,3,3,4,1,4,4,4,2,-1,-1,0,0,17.0,16.0,1.0,3
14293,14293,1996-97,1996,1997,Southampton,Sunderland,Win,Home,1996-10-19,3,4,4,4,4,1,4,4,5,3,0,0,-1,1,17.0,21.0,-4.0,3
14294,14294,1996-97,1996,1997,Southampton,Man United,Win,Home,1996-10-26,3,4,7,7,7,3,6,7,10,1,1,0,-3,1,17.0,1.0,16.0,3
14295,14295,1996-97,1996,1997,Southampton,Sheffield Weds,Draw,Away,1996-11-02,1,6,7,10,10,2,2,2,3,4,5,8,7,0,17.0,15.0,2.0,4
14296,14296,1996-97,1996,1997,Southampton,Everton,Loss,Away,1996-11-16,0,4,7,8,11,4,7,10,11,0,0,-2,0,0,17.0,6.0,11.0,4
14297,14297,1996-97,1996,1997,Southampton,Leeds,Loss,Home,1996-11-23,0,1,4,7,8,3,3,3,6,-2,1,4,2,1,17.0,13.0,4.0,4
14298,14298,1996-97,1996,1997,Southampton,Blackburn,Loss,Away,1996-11-30,0,0,1,4,7,2,5,5,6,-2,-4,-1,1,0,17.0,7.0,10.0,4
14299,14299,1996-97,1996,1997,Southampton,Arsenal,Loss,Away,1996-12-04,0,0,0,1,4,6,6,7,10,-6,-6,-6,-6,0,17.0,5.0,12.0,5
14300,14300,1996-97,1996,1997,Southampton,Aston Villa,Loss,Home,1996-12-07,0,0,0,0,1,6,9,9,12,-6,-9,-9,-11,1,17.0,4.0,13.0,5
14301,14301,1996-97,1996,1997,Southampton,Derby,Win,Home,1996-12-21,3,0,0,0,0,1,4,5,8,-1,-4,-5,-8,1,17.0,21.0,-4.0,5
14302,14302,1996-97,1996,1997,Southampton,Tottenham,Loss,Away,1996-12-26,0,3,3,3,3,2,5,5,5,1,-2,-2,-2,0,17.0,8.0,9.0,5
14303,14303,1996-97,1996,1997,Southampton,Liverpool,Loss,Home,1996-12-29,0,3,3,3,3,2,5,8,8,1,-2,-5,-5,1,17.0,3.0,14.0,5
14304,14304,1996-97,1996,1997,Southampton,Middlesbrough,Win,Away,1997-01-11,3,0,3,3,3,0,3,3,4,0,0,0,-1,0,17.0,12.0,5.0,6
14305,14305,1996-97,1996,1997,Southampton,Newcastle,Draw,Home,1997-01-18,1,3,3,6,6,4,7,7,8,-1,-4,-1,-2,1,17.0,2.0,15.0,6
14306,14306,1996-97,1996,1997,Southampton,Man United,Loss,Away,1997-02-01,0,4,4,4,7,6,9,10,13,-2,-5,-6,-6,0,17.0,1.0,16.0,7
14307,14307,1996-97,1996,1997,Southampton,Sheffield Weds,Loss,Home,1997-02-22,0,1,4,4,4,2,5,5,8,-1,-1,-1,-4,1,17.0,15.0,2.0,7
14308,14308,1996-97,1996,1997,Southampton,Wimbledon,Draw,Home,1997-02-26,1,0,1,4,4,4,4,4,5,-4,-3,0,-1,1,17.0,14.0,3.0,7
14309,14309,1996-97,1996,1997,Southampton,Newcastle,Win,Away,1997-03-01,3,1,1,2,5,6,9,10,11,-5,-8,-8,-6,0,17.0,2.0,15.0,8
14310,14310,1996-97,1996,1997,Southampton,Everton,Draw,Home,1997-03-05,1,4,4,4,5,1,4,4,4,3,0,0,1,1,17.0,6.0,11.0,8
14311,14311,1996-97,1996,1997,Southampton,Leeds,Draw,Away,1997-03-12,1,4,5,5,5,6,9,9,10,-2,-4,-4,-5,0,17.0,13.0,4.0,8
14312,14312,1996-97,1996,1997,Southampton,Arsenal,Loss,Home,1997-03-15,0,2,5,6,6,6,6,6,7,-4,-1,0,-1,1,17.0,5.0,12.0,8
14313,14313,1996-97,1996,1997,Southampton,Chelsea,Loss,Away,1997-03-19,0,1,2,5,6,3,4,4,5,-2,-2,1,1,0,17.0,11.0,6.0,8
14314,14314,1996-97,1996,1997,Southampton,Leicester,Draw,Home,1997-03-22,1,0,1,2,5,1,2,5,8,-1,-1,-3,-3,1,17.0,21.0,-4.0,8
14315,14315,1996-97,1996,1997,Southampton,Nott'm Forest,Win,Away,1997-04-05,3,1,1,2,3,2,3,4,4,-1,-2,-2,-1,0,17.0,9.0,8.0,9
14316,14316,1996-97,1996,1997,Southampton,Derby,Draw,Away,1997-04-09,1,4,4,4,5,6,6,6,9,-2,-2,-2,-4,0,17.0,21.0,-4.0,9
14317,14317,1996-97,1996,1997,Southampton,West Ham,Win,Home,1997-04-12,3,4,5,5,5,4,5,6,9,0,0,-1,-4,1,17.0,10.0,7.0,9
14318,14318,1996-97,1996,1997,Southampton,Coventry,Draw,Home,1997-04-19,1,4,7,8,8,6,6,6,7,-2,1,2,1,1,17.0,16.0,1.0,9
14319,14319,1996-97,1996,1997,Southampton,Sunderland,Win,Away,1997-04-22,3,4,5,8,9,3,4,5,5,1,1,3,4,0,17.0,21.0,-4.0,9
14320,14320,1996-97,1996,1997,Southampton,Blackburn,Win,Home,1997-05-03,3,4,7,8,11,4,4,5,5,0,3,3,6,1,17.0,7.0,10.0,10
14321,14321,1996-97,1996,1997,Southampton,Aston Villa,Loss,Away,1997-05-11,0,6,7,10,11,1,2,2,5,5,5,8,6,0,17.0,4.0,13.0,10
14322,14322,1997-98,1997,1998,Southampton,Bolton,Loss,Home,1997-08-09,0,3,6,7,10,0,0,3,3,3,6,4,7,1,16.0,21.0,-5.0,1
14323,14323,1997-98,1997,1998,Southampton,Man United,Loss,Away,1997-08-13,0,0,3,6,7,6,7,8,9,-6,-4,-2,-2,0,16.0,1.0,15.0,1
14324,14324,1997-98,1997,1998,Southampton,Arsenal,Loss,Home,1997-08-23,0,0,0,3,6,4,7,7,8,-4,-7,-4,-2,1,16.0,3.0,13.0,1
14325,14325,1997-98,1997,1998,Southampton,Crystal Palace,Win,Home,1997-08-27,3,0,0,0,3,3,6,6,6,-3,-6,-6,-3,1,16.0,21.0,-5.0,1
14326,14326,1997-98,1997,1998,Southampton,Chelsea,Loss,Away,1997-08-30,0,3,3,3,3,6,6,9,10,-3,-3,-6,-7,0,16.0,6.0,10.0,1
14327,14327,1997-98,1997,1998,Southampton,Coventry,Loss,Away,1997-09-13,0,3,3,3,3,1,2,2,5,2,1,1,-2,0,16.0,17.0,-1.0,2
14328,14328,1997-98,1997,1998,Southampton,Liverpool,Draw,Home,1997-09-20,1,0,3,3,3,6,7,7,8,-6,-4,-4,-5,1,16.0,4.0,12.0,2
14329,14329,1997-98,1997,1998,Southampton,Leeds,Loss,Home,1997-09-24,0,1,1,4,4,3,3,3,3,-2,-2,1,1,1,16.0,11.0,5.0,2
14330,14330,1997-98,1997,1998,Southampton,Derby,Loss,Away,1997-09-27,0,1,1,1,4,3,6,9,9,-2,-5,-8,-5,0,16.0,12.0,4.0,2
14331,14331,1997-98,1997,1998,Southampton,West Ham,Win,Home,1997-10-04,3,0,1,1,1,3,3,3,6,-3,-2,-2,-5,1,16.0,14.0,2.0,3
14332,14332,1997-98,1997,1998,Southampton,Blackburn,Loss,Away,1997-10-18,0,3,3,4,4,4,5,6,6,-1,-2,-2,-2,0,16.0,13.0,3.0,3
14333,14333,1997-98,1997,1998,Southampton,Tottenham,Win,Home,1997-10-25,3,3,3,3,4,3,4,5,6,0,-1,-2,-2,1,16.0,10.0,6.0,3
14334,14334,1997-98,1997,1998,Southampton,Everton,Win,Away,1997-11-02,3,3,6,6,6,4,4,5,5,-1,2,1,1,0,16.0,15.0,1.0,4
14335,14335,1997-98,1997,1998,Southampton,Barnsley,Win,Home,1997-11-08,3,6,6,9,9,1,4,4,4,5,2,5,5,1,16.0,21.0,-5.0,4
14336,14336,1997-98,1997,1998,Southampton,Newcastle,Loss,Away,1997-11-22,0,6,9,9,12,2,3,3,6,4,6,6,6,0,16.0,2.0,14.0,4
14337,14337,1997-98,1997,1998,Southampton,Sheffield Weds,Loss,Home,1997-11-29,0,3,6,9,9,6,6,6,6,-3,0,3,3,1,16.0,7.0,9.0,4
14338,14338,1997-98,1997,1998,Southampton,Wimbledon,Loss,Away,1997-12-07,0,0,3,6,9,0,3,3,6,0,0,3,3,0,16.0,8.0,8.0,5
14339,14339,1997-98,1997,1998,Southampton,Leicester,Win,Home,1997-12-13,3,0,0,3,6,4,5,5,6,-4,-5,-2,0,1,16.0,9.0,7.0,5
14340,14340,1997-98,1997,1998,Southampton,Aston Villa,Draw,Away,1997-12-20,1,3,3,3,6,3,3,6,7,0,0,-3,-1,0,16.0,5.0,11.0,5
14341,14341,1997-98,1997,1998,Southampton,Crystal Palace,Draw,Away,1997-12-26,1,4,4,4,4,1,2,2,2,3,2,2,2,0,16.0,21.0,-5.0,5
14342,14342,1997-98,1997,1998,Southampton,Chelsea,Win,Home,1997-12-29,3,2,5,5,5,4,5,8,11,-2,0,-3,-6,1,16.0,6.0,10.0,5
14343,14343,1997-98,1997,1998,Southampton,Bolton,Draw,Away,1998-01-10,1,4,5,8,8,1,1,2,2,3,4,6,6,0,16.0,21.0,-5.0,6
14344,14344,1997-98,1997,1998,Southampton,Man United,Win,Home,1998-01-19,3,4,5,6,9,3,6,9,12,1,-1,-3,-3,1,16.0,1.0,15.0,6
14345,14345,1997-98,1997,1998,Southampton,Arsenal,Loss,Away,1998-01-31,0,4,7,8,9,4,5,8,8,0,2,0,1,0,16.0,3.0,13.0,6
14346,14346,1997-98,1997,1998,Southampton,Liverpool,Win,Away,1998-02-07,3,3,4,7,8,4,5,8,11,-1,-1,-1,-3,0,16.0,4.0,12.0,7
14347,14347,1997-98,1997,1998,Southampton,Coventry,Loss,Home,1998-02-18,0,3,6,7,10,6,7,7,10,-3,-1,0,0,1,16.0,17.0,-1.0,7
14348,14348,1997-98,1997,1998,Southampton,Blackburn,Win,Home,1998-02-21,3,3,3,6,7,1,4,4,5,2,-1,2,2,1,16.0,13.0,3.0,7
14349,14349,1997-98,1997,1998,Southampton,Leeds,Win,Away,1998-02-28,3,3,6,6,9,1,4,4,4,2,2,2,5,0,16.0,11.0,5.0,7
14350,14350,1997-98,1997,1998,Southampton,Everton,Win,Home,1998-03-07,3,6,6,9,9,2,2,3,4,4,4,6,5,1,16.0,15.0,1.0,8
14351,14351,1997-98,1997,1998,Southampton,Barnsley,Loss,Away,1998-03-14,0,6,9,9,12,6,6,7,7,0,3,2,5,0,16.0,21.0,-5.0,8
14352,14352,1997-98,1997,1998,Southampton,Newcastle,Win,Home,1998-03-28,3,3,6,9,9,1,2,3,3,2,4,6,6,1,16.0,2.0,14.0,8
14353,14353,1997-98,1997,1998,Southampton,Sheffield Weds,Loss,Away,1998-04-04,0,3,6,9,12,0,3,3,6,3,3,6,6,0,16.0,7.0,9.0,9
14354,14354,1997-98,1997,1998,Southampton,Wimbledon,Loss,Home,1998-04-11,0,3,3,6,9,2,2,5,5,1,1,1,4,1,16.0,8.0,8.0,9
14355,14355,1997-98,1997,1998,Southampton,Leicester,Draw,Away,1998-04-14,1,0,3,3,6,4,4,4,4,-4,-1,-1,2,0,16.0,9.0,7.0,9
14356,14356,1997-98,1997,1998,Southampton,Aston Villa,Loss,Home,1998-04-18,0,1,1,4,4,6,9,12,12,-5,-8,-8,-8,1,16.0,5.0,11.0,9
14357,14357,1997-98,1997,1998,Southampton,West Ham,Win,Away,1998-04-25,3,1,1,1,4,4,5,5,8,-3,-4,-4,-4,0,16.0,14.0,2.0,9
14358,14358,1997-98,1997,1998,Southampton,Derby,Loss,Home,1998-05-02,0,3,4,4,4,0,0,3,4,3,4,1,0,1,16.0,12.0,4.0,10
14359,14359,1997-98,1997,1998,Southampton,Tottenham,Draw,Away,1998-05-10,1,3,3,4,4,6,7,8,8,-3,-4,-4,-4,0,16.0,10.0,6.0,10
14360,14360,1998-99,1998,1999,Southampton,Liverpool,Loss,Home,1998-08-16,0,1,4,4,5,3,6,6,7,-2,-2,-2,-2,1,12.0,3.0,9.0,1
14361,14361,1998-99,1998,1999,Southampton,Charlton,Loss,Away,1998-08-22,0,1,1,4,4,1,1,1,1,0,0,3,3,0,12.0,21.0,-9.0,1
14362,14362,1998-99,1998,1999,Southampton,Nott'm Forest,Loss,Home,1998-08-29,0,0,1,1,4,3,3,4,5,-3,-2,-3,-1,1,12.0,21.0,-9.0,1
14363,14363,1998-99,1998,1999,Southampton,Leeds,Loss,Away,1998-09-08,0,0,0,1,1,4,5,6,6,-4,-5,-5,-5,0,12.0,5.0,7.0,2
14364,14364,1998-99,1998,1999,Southampton,Newcastle,Loss,Away,1998-09-12,0,0,0,0,1,0,1,2,2,0,-1,-2,-1,0,12.0,13.0,-1.0,2
14365,14365,1998-99,1998,1999,Southampton,Tottenham,Draw,Home,1998-09-19,1,0,0,0,0,3,6,6,6,-3,-6,-6,-6,1,12.0,14.0,-2.0,2
14366,14366,1998-99,1998,1999,Southampton,West Ham,Loss,Away,1998-09-28,0,1,1,1,1,4,4,5,6,-3,-3,-4,-5,0,12.0,8.0,4.0,2
14367,14367,1998-99,1998,1999,Southampton,Man United,Loss,Home,1998-10-03,0,1,1,1,1,3,6,9,10,-2,-5,-8,-9,1,12.0,2.0,10.0,3
14368,14368,1998-99,1998,1999,Southampton,Arsenal,Draw,Away,1998-10-17,1,0,1,1,1,3,6,7,8,-3,-5,-6,-7,0,12.0,1.0,11.0,3
14369,14369,1998-99,1998,1999,Southampton,Coventry,Win,Home,1998-10-24,3,1,1,2,2,3,4,4,4,-2,-3,-2,-2,1,12.0,11.0,1.0,3
14370,14370,1998-99,1998,1999,Southampton,Sheffield Weds,Draw,Away,1998-10-31,1,4,4,4,5,1,1,4,4,3,3,0,1,0,12.0,16.0,-4.0,3
14371,14371,1998-99,1998,1999,Southampton,Middlesbrough,Draw,Home,1998-11-07,1,4,5,5,5,2,5,8,8,2,0,-3,-3,1,12.0,21.0,-9.0,4
14372,14372,1998-99,1998,1999,Southampton,Aston Villa,Loss,Home,1998-11-14,0,2,5,6,6,4,5,8,11,-2,0,-2,-5,1,12.0,7.0,5.0,4
14373,14373,1998-99,1998,1999,Southampton,Blackburn,Win,Away,1998-11-21,3,1,2,5,6,0,1,1,1,1,1,4,5,0,12.0,6.0,6.0,4
14374,14374,1998-99,1998,1999,Southampton,Derby,Loss,Home,1998-11-28,0,3,4,5,8,1,4,5,6,2,0,0,2,1,12.0,9.0,3.0,4
14375,14375,1998-99,1998,1999,Southampton,Leicester,Loss,Away,1998-12-05,0,3,3,4,5,1,1,2,5,2,2,2,0,0,12.0,10.0,2.0,5
14376,14376,1998-99,1998,1999,Southampton,Everton,Loss,Away,1998-12-12,0,0,3,3,4,4,7,7,7,-4,-4,-4,-3,0,12.0,17.0,-5.0,5
14377,14377,1998-99,1998,1999,Southampton,Wimbledon,Win,Home,1998-12-19,3,0,0,3,3,6,6,9,9,-6,-6,-6,-6,1,12.0,15.0,-3.0,5
14378,14378,1998-99,1998,1999,Southampton,Chelsea,Loss,Home,1998-12-26,0,3,3,3,6,4,5,8,9,-1,-2,-5,-3,1,12.0,4.0,8.0,5
14379,14379,1998-99,1998,1999,Southampton,Nott'm Forest,Draw,Away,1998-12-28,1,3,3,3,3,1,1,1,2,2,2,2,1,0,12.0,21.0,-9.0,5
14380,14380,1998-99,1998,1999,Southampton,Charlton,Win,Home,1999-01-09,3,1,4,4,4,0,0,0,0,1,4,4,4,1,12.0,21.0,-9.0,6
14381,14381,1998-99,1998,1999,Southampton,Liverpool,Loss,Away,1999-01-16,0,4,4,7,7,4,7,10,10,0,-3,-3,-3,0,12.0,3.0,9.0,6
14382,14382,1998-99,1998,1999,Southampton,Leeds,Win,Home,1999-01-30,3,3,4,4,7,3,4,7,7,0,0,-3,0,1,12.0,5.0,7.0,6
14383,14383,1998-99,1998,1999,Southampton,Chelsea,Loss,Away,1999-02-06,0,3,6,7,7,3,6,7,10,0,0,0,-3,0,12.0,4.0,8.0,7
14384,14384,1998-99,1998,1999,Southampton,Newcastle,Win,Home,1999-02-20,3,3,3,6,7,6,9,10,10,-3,-6,-4,-3,1,12.0,13.0,-1.0,7
14385,14385,1998-99,1998,1999,Southampton,Man United,Loss,Away,1999-02-27,0,3,6,6,9,4,7,10,13,-1,-1,-4,-4,0,12.0,2.0,10.0,7
14386,14386,1998-99,1998,1999,Southampton,Tottenham,Loss,Away,1999-03-02,0,3,3,6,6,2,3,4,5,1,0,2,1,0,12.0,14.0,-2.0,8
14387,14387,1998-99,1998,1999,Southampton,West Ham,Win,Home,1999-03-06,3,0,3,3,6,4,7,7,8,-4,-4,-4,-2,1,12.0,8.0,4.0,8
14388,14388,1998-99,1998,1999,Southampton,Middlesbrough,Loss,Away,1999-03-14,0,3,3,6,6,1,1,1,2,2,2,5,4,0,12.0,21.0,-9.0,8
14389,14389,1998-99,1998,1999,Southampton,Sheffield Weds,Win,Home,1999-03-20,3,3,3,3,6,0,0,3,6,3,3,0,0,1,12.0,16.0,-4.0,8
14390,14390,1998-99,1998,1999,Southampton,Arsenal,Draw,Home,1999-04-03,1,3,6,6,6,6,9,10,13,-3,-3,-4,-7,1,12.0,1.0,11.0,9
14391,14391,1998-99,1998,1999,Southampton,Coventry,Loss,Away,1999-04-05,0,4,4,7,7,3,4,7,10,1,0,0,-3,0,12.0,11.0,1.0,9
14392,14392,1998-99,1998,1999,Southampton,Aston Villa,Loss,Away,1999-04-10,0,1,4,4,7,2,2,2,2,-1,2,2,5,0,12.0,7.0,5.0,9
14393,14393,1998-99,1998,1999,Southampton,Blackburn,Draw,Home,1999-04-17,1,0,1,4,4,1,4,5,5,-1,-3,-1,-1,1,12.0,6.0,6.0,9
14394,14394,1998-99,1998,1999,Southampton,Derby,Draw,Away,1999-04-24,1,1,1,2,5,3,3,3,6,-2,-2,-1,-1,0,12.0,9.0,3.0,9
14395,14395,1998-99,1998,1999,Southampton,Leicester,Win,Home,1999-05-01,3,2,2,2,3,6,7,8,9,-4,-5,-6,-6,1,12.0,10.0,2.0,10
14396,14396,1998-99,1998,1999,Southampton,Wimbledon,Win,Away,1999-05-08,3,4,5,5,5,1,1,1,1,3,4,4,4,0,12.0,15.0,-3.0,10
14397,14397,1998-99,1998,1999,Southampton,Everton,Win,Home,1999-05-16,3,6,7,8,8,3,6,9,12,3,1,-1,-4,1,12.0,17.0,-5.0,10
14398,14398,1999-00,1999,2000,Southampton,Coventry,Win,Away,1999-08-07,3,6,9,10,11,2,5,5,5,4,4,5,6,0,17.0,15.0,2.0,1
14399,14399,1999-00,1999,2000,Southampton,Leeds,Loss,Home,1999-08-11,0,6,9,12,13,2,5,5,8,4,4,7,5,1,17.0,4.0,13.0,1
14400,14400,1999-00,1999,2000,Southampton,Newcastle,Win,Home,1999-08-15,3,3,6,9,12,0,1,1,2,3,5,8,10,1,17.0,13.0,4.0,1
14401,14401,1999-00,1999,2000,Southampton,Everton,Loss,Away,1999-08-21,0,3,6,9,12,0,1,1,4,3,5,8,8,0,17.0,14.0,3.0,1
14402,14402,1999-00,1999,2000,Southampton,Sheffield Weds,Win,Home,1999-08-28,3,3,3,6,9,0,1,1,1,3,2,5,8,1,17.0,12.0,5.0,1
14403,14403,1999-00,1999,2000,Southampton,Middlesbrough,Loss,Away,1999-09-11,0,3,6,6,9,0,3,6,9,3,3,0,0,0,17.0,9.0,8.0,2
14404,14404,1999-00,1999,2000,Southampton,Arsenal,Loss,Home,1999-09-18,0,3,3,6,6,3,6,6,7,0,-3,0,-1,1,17.0,2.0,15.0,2
14405,14405,1999-00,1999,2000,Southampton,Man United,Draw,Away,1999-09-25,1,0,3,3,6,4,7,10,13,-4,-4,-7,-7,0,17.0,1.0,16.0,2
14406,14406,1999-00,1999,2000,Southampton,Derby,Draw,Home,1999-10-04,1,1,1,4,4,0,1,4,7,1,0,0,-3,1,17.0,8.0,9.0,3
14407,14407,1999-00,1999,2000,Southampton,Leicester,Loss,Away,1999-10-16,0,2,2,2,5,6,7,7,10,-4,-5,-5,-5,0,17.0,10.0,7.0,3
14408,14408,1999-00,1999,2000,Southampton,Liverpool,Draw,Home,1999-10-23,1,1,2,2,2,4,4,5,5,-3,-2,-3,-3,1,17.0,7.0,10.0,3
14409,14409,1999-00,1999,2000,Southampton,Wimbledon,Draw,Away,1999-10-30,1,1,2,3,3,4,4,5,6,-3,-2,-2,-3,0,17.0,16.0,1.0,3
14410,14410,1999-00,1999,2000,Southampton,Aston Villa,Win,Away,1999-11-06,3,2,2,3,4,1,1,2,2,1,1,1,2,0,17.0,6.0,11.0,4
14411,14411,1999-00,1999,2000,Southampton,Tottenham,Loss,Home,1999-11-20,0,4,5,5,6,3,6,9,9,1,-1,-4,-3,1,17.0,11.0,6.0,4
14412,14412,1999-00,1999,2000,Southampton,Leeds,Loss,Away,1999-11-28,0,3,4,5,5,3,6,7,10,0,-2,-2,-5,0,17.0,4.0,13.0,4
14413,14413,1999-00,1999,2000,Southampton,Coventry,Draw,Home,1999-12-04,1,0,3,4,5,3,4,7,8,-3,-1,-3,-3,1,17.0,15.0,2.0,5
14414,14414,1999-00,1999,2000,Southampton,Sunderland,Loss,Away,1999-12-18,0,1,1,4,5,6,6,7,10,-5,-5,-3,-5,0,17.0,21.0,-4.0,5
14415,14415,1999-00,1999,2000,Southampton,Chelsea,Loss,Home,1999-12-26,0,1,1,1,4,0,3,4,5,1,-2,-3,-1,1,17.0,3.0,14.0,5
14416,14416,1999-00,1999,2000,Southampton,Watford,Loss,Away,1999-12-28,0,0,1,1,1,0,0,0,1,0,1,1,0,0,17.0,21.0,-4.0,5
14417,14417,1999-00,1999,2000,Southampton,Bradford,Win,Home,2000-01-03,3,0,0,1,1,1,4,5,5,-1,-4,-4,-4,1,17.0,21.0,-4.0,6
14418,14418,1999-00,1999,2000,Southampton,Newcastle,Loss,Away,2000-01-16,0,3,3,3,4,4,5,5,8,-1,-2,-2,-4,0,17.0,13.0,4.0,6
14419,14419,1999-00,1999,2000,Southampton,Everton,Win,Home,2000-01-22,3,3,3,3,3,2,3,6,9,1,0,-3,-6,1,17.0,14.0,3.0,6
14420,14420,1999-00,1999,2000,Southampton,West Ham,Win,Home,2000-02-05,3,3,6,6,6,4,5,6,7,-1,1,0,-1,1,17.0,5.0,12.0,7
14421,14421,1999-00,1999,2000,Southampton,Sheffield Weds,Win,Away,2000-02-12,3,6,6,9,9,1,4,7,8,5,2,2,1,0,17.0,12.0,5.0,7
14422,14422,1999-00,1999,2000,Southampton,Arsenal,Loss,Away,2000-02-26,0,6,9,9,12,0,1,4,5,6,8,5,7,0,17.0,2.0,15.0,7
14423,14423,1999-00,1999,2000,Southampton,Middlesbrough,Draw,Home,2000-03-04,1,3,6,9,9,4,4,4,4,-1,2,5,5,1,17.0,9.0,8.0,8
14424,14424,1999-00,1999,2000,Southampton,West Ham,Loss,Away,2000-03-08,0,1,4,7,10,3,6,6,9,-2,-2,1,1,0,17.0,5.0,12.0,8
14425,14425,1999-00,1999,2000,Southampton,Tottenham,Loss,Away,2000-03-11,0,1,1,4,7,4,4,4,4,-3,-3,0,3,0,17.0,11.0,6.0,8
14426,14426,1999-00,1999,2000,Southampton,Aston Villa,Win,Home,2000-03-18,3,0,1,1,4,4,5,6,9,-4,-4,-5,-5,1,17.0,6.0,11.0,8
14427,14427,1999-00,1999,2000,Southampton,Chelsea,Draw,Away,2000-03-25,1,3,3,4,4,2,5,8,11,1,-2,-4,-7,0,17.0,3.0,14.0,8
14428,14428,1999-00,1999,2000,Southampton,Sunderland,Loss,Home,2000-04-01,0,4,4,4,5,4,5,5,6,0,-1,-1,-1,1,17.0,21.0,-4.0,9
14429,14429,1999-00,1999,2000,Southampton,Bradford,Win,Away,2000-04-08,3,1,4,4,4,0,0,0,1,1,4,4,3,0,17.0,21.0,-4.0,9
14430,14430,1999-00,1999,2000,Southampton,Watford,Win,Home,2000-04-15,3,3,4,7,7,1,2,5,5,2,2,2,2,1,17.0,21.0,-4.0,9
14431,14431,1999-00,1999,2000,Southampton,Man United,Loss,Home,2000-04-22,0,6,6,7,10,6,9,12,15,0,-3,-5,-5,1,17.0,1.0,16.0,9
14432,14432,1999-00,1999,2000,Southampton,Derby,Loss,Away,2000-04-24,0,3,6,6,7,1,2,5,5,2,4,1,2,0,17.0,8.0,9.0,9
14433,14433,1999-00,1999,2000,Southampton,Leicester,Loss,Home,2000-04-29,0,0,3,6,6,1,4,5,5,-1,-1,1,1,1,17.0,10.0,7.0,9
14434,14434,1999-00,1999,2000,Southampton,Liverpool,Draw,Away,2000-05-07,1,0,0,3,6,0,1,4,7,0,-1,-1,-1,0,17.0,7.0,10.0,10
14435,14435,1999-00,1999,2000,Southampton,Wimbledon,Win,Home,2000-05-14,3,1,1,1,4,1,1,1,1,0,0,0,3,1,17.0,16.0,1.0,10
14436,14436,2000-01,2000,2001,Southampton,Derby,Draw,Away,2000-08-19,1,4,4,4,4,1,2,5,6,3,2,-1,-2,0,15.0,16.0,-1.0,1
14437,14437,2000-01,2000,2001,Southampton,Coventry,Loss,Home,2000-08-23,0,4,5,5,5,0,3,3,3,4,2,2,2,1,15.0,14.0,1.0,1
14438,14438,2000-01,2000,2001,Southampton,Liverpool,Draw,Home,2000-08-26,1,1,4,5,5,3,3,4,4,-2,1,1,1,1,15.0,4.0,11.0,1
14439,14439,2000-01,2000,2001,Southampton,Charlton,Draw,Away,2000-09-06,1,1,2,5,6,0,3,3,6,1,-1,2,0,0,15.0,21.0,-6.0,2
14440,14440,2000-01,2000,2001,Southampton,Leicester,Loss,Away,2000-09-09,0,2,2,3,6,4,7,8,8,-2,-5,-5,-2,0,15.0,8.0,7.0,2
14441,14441,2000-01,2000,2001,Southampton,Newcastle,Win,Home,2000-09-16,3,1,2,2,3,4,7,10,10,-3,-5,-8,-7,1,15.0,11.0,4.0,2
14442,14442,2000-01,2000,2001,Southampton,Bradford,Win,Away,2000-09-23,3,3,4,5,5,1,1,2,5,2,3,3,0,0,15.0,17.0,-2.0,2
14443,14443,2000-01,2000,2001,Southampton,Middlesbrough,Loss,Home,2000-09-30,0,6,6,7,8,2,2,3,3,4,4,4,5,1,15.0,12.0,3.0,2
14444,14444,2000-01,2000,2001,Southampton,Everton,Draw,Away,2000-10-14,1,3,6,6,7,1,1,4,4,2,5,2,3,0,15.0,13.0,2.0,3
14445,14445,2000-01,2000,2001,Southampton,Man City,Loss,Home,2000-10-23,0,1,4,7,7,3,4,5,5,-2,0,2,2,1,15.0,21.0,-6.0,3
14446,14446,2000-01,2000,2001,Southampton,Man United,Loss,Away,2000-10-28,0,1,1,4,7,6,6,7,10,-5,-5,-3,-3,0,15.0,1.0,14.0,3
14447,14447,2000-01,2000,2001,Southampton,Chelsea,Win,Home,2000-11-04,3,0,1,1,4,6,6,9,10,-6,-5,-8,-6,1,15.0,5.0,10.0,4
14448,14448,2000-01,2000,2001,Southampton,Sunderland,Draw,Away,2000-11-11,1,3,3,4,4,3,4,7,8,0,-1,-3,-4,0,15.0,7.0,8.0,4
14449,14449,2000-01,2000,2001,Southampton,Aston Villa,Win,Home,2000-11-18,3,4,4,4,5,6,9,10,10,-2,-5,-6,-5,1,15.0,6.0,9.0,4
14450,14450,2000-01,2000,2001,Southampton,West Ham,Loss,Home,2000-11-25,0,4,7,7,7,6,7,10,10,-2,0,-3,-3,1,15.0,9.0,6.0,4
14451,14451,2000-01,2000,2001,Southampton,Arsenal,Loss,Away,2000-12-02,0,3,4,7,7,0,1,4,7,3,3,3,0,0,15.0,2.0,13.0,5
14452,14452,2000-01,2000,2001,Southampton,Leeds,Win,Home,2000-12-09,3,0,3,4,7,3,3,4,7,-3,0,0,0,1,15.0,3.0,12.0,5
14453,14453,2000-01,2000,2001,Southampton,Ipswich,Loss,Away,2000-12-16,0,3,3,6,7,3,6,9,12,0,-3,-3,-5,0,15.0,21.0,-6.0,5
14454,14454,2000-01,2000,2001,Southampton,Coventry,Draw,Away,2000-12-22,1,3,3,3,6,3,3,4,4,0,0,-1,2,0,15.0,14.0,1.0,5
14455,14455,2000-01,2000,2001,Southampton,Tottenham,Win,Home,2000-12-27,3,1,4,4,4,2,3,3,6,-1,1,1,-2,1,15.0,10.0,5.0,5
14456,14456,2000-01,2000,2001,Southampton,Derby,Win,Home,2000-12-30,3,4,4,7,7,4,7,7,10,0,-3,0,-3,1,15.0,16.0,-1.0,5
14457,14457,2000-01,2000,2001,Southampton,Liverpool,Loss,Away,2001-01-01,0,6,7,7,10,3,6,6,9,3,1,1,1,0,15.0,4.0,11.0,6
14458,14458,2000-01,2000,2001,Southampton,Charlton,Draw,Home,2001-01-13,1,3,6,7,7,6,6,9,9,-3,0,-2,-2,1,15.0,21.0,-6.0,6
14459,14459,2000-01,2000,2001,Southampton,Tottenham,Draw,Away,2001-01-20,1,1,4,7,8,4,4,4,5,-3,0,3,3,0,15.0,10.0,5.0,6
14460,14460,2000-01,2000,2001,Southampton,Leicester,Win,Home,2001-01-31,3,2,2,5,8,1,1,1,4,1,1,4,4,1,15.0,8.0,7.0,6
14461,14461,2000-01,2000,2001,Southampton,Bradford,Win,Home,2001-02-10,3,4,5,5,8,0,1,1,4,4,4,4,4,1,15.0,17.0,-2.0,7
14462,14462,2000-01,2000,2001,Southampton,Middlesbrough,Win,Away,2001-02-24,3,6,7,8,8,2,3,4,7,4,4,4,1,0,15.0,12.0,3.0,7
14463,14463,2000-01,2000,2001,Southampton,Man City,Win,Away,2001-03-03,3,6,9,10,11,3,4,5,6,3,5,5,5,0,15.0,21.0,-6.0,8
14464,14464,2000-01,2000,2001,Southampton,Everton,Win,Home,2001-03-17,3,6,9,12,13,1,4,5,5,5,5,7,8,1,15.0,13.0,2.0,8
14465,14465,2000-01,2000,2001,Southampton,Ipswich,Loss,Home,2001-04-02,0,6,9,12,15,3,6,9,9,3,3,3,6,1,15.0,21.0,-6.0,9
14466,14466,2000-01,2000,2001,Southampton,Leeds,Loss,Away,2001-04-07,0,3,6,9,12,6,7,10,11,-3,-1,-1,1,0,15.0,3.0,12.0,9
14467,14467,2000-01,2000,2001,Southampton,Chelsea,Loss,Away,2001-04-14,0,0,3,6,9,6,6,9,10,-6,-3,-3,-1,0,15.0,5.0,10.0,9
14468,14468,2000-01,2000,2001,Southampton,Aston Villa,Draw,Away,2001-04-21,1,0,0,3,6,4,5,8,11,-4,-5,-5,-5,0,15.0,6.0,9.0,9
14469,14469,2000-01,2000,2001,Southampton,Sunderland,Loss,Home,2001-04-28,0,1,1,1,4,1,1,2,2,0,0,-1,2,1,15.0,7.0,8.0,9
14470,14470,2000-01,2000,2001,Southampton,Newcastle,Draw,Away,2001-05-01,1,1,1,1,1,4,7,7,8,-3,-6,-6,-7,0,15.0,11.0,4.0,10
14471,14471,2000-01,2000,2001,Southampton,West Ham,Loss,Away,2001-05-05,0,1,2,2,2,0,0,3,4,1,2,-1,-2,0,15.0,9.0,6.0,10
14472,14472,2000-01,2000,2001,Southampton,Man United,Win,Home,2001-05-13,3,1,1,2,2,3,4,7,10,-2,-3,-5,-8,1,15.0,1.0,14.0,10
14473,14473,2000-01,2000,2001,Southampton,Arsenal,Win,Home,2001-05-19,3,3,4,4,5,4,7,10,10,-1,-3,-6,-5,1,15.0,2.0,13.0,10
14474,14474,2001-02,2001,2002,Southampton,Leeds,Loss,Away,2001-08-18,0,6,6,7,7,6,6,9,12,0,0,-2,-5,0,10.0,4.0,6.0,1
14475,14475,2001-02,2001,2002,Southampton,Chelsea,Loss,Home,2001-08-25,0,3,6,6,7,4,5,8,8,-1,1,-2,-1,1,10.0,6.0,4.0,1
14476,14476,2001-02,2001,2002,Southampton,Tottenham,Loss,Away,2001-09-09,0,0,3,6,6,1,2,5,5,-1,1,1,1,0,10.0,12.0,-2.0,2
14477,14477,2001-02,2001,2002,Southampton,Bolton,Win,Away,2001-09-15,3,0,0,3,6,4,7,10,10,-4,-7,-7,-4,0,10.0,21.0,-11.0,2
14478,14478,2001-02,2001,2002,Southampton,Aston Villa,Loss,Home,2001-09-24,0,3,3,3,6,4,5,6,6,-1,-2,-3,0,1,10.0,8.0,2.0,2
14479,14479,2001-02,2001,2002,Southampton,Middlesbrough,Win,Away,2001-09-29,3,3,3,3,3,4,7,7,7,-1,-4,-4,-4,0,10.0,14.0,-4.0,2
14480,14480,2001-02,2001,2002,Southampton,Arsenal,Loss,Home,2001-10-13,0,3,6,6,6,4,7,8,11,-1,-1,-2,-5,1,10.0,2.0,8.0,3
14481,14481,2001-02,2001,2002,Southampton,West Ham,Loss,Away,2001-10-20,0,3,3,6,6,0,3,3,4,3,0,3,2,0,10.0,15.0,-5.0,3
14482,14482,2001-02,2001,2002,Southampton,Ipswich,Draw,Home,2001-10-24,1,0,3,3,6,2,2,2,3,-2,1,1,3,1,10.0,5.0,5.0,3
14483,14483,2001-02,2001,2002,Southampton,Fulham,Loss,Away,2001-10-27,0,1,1,4,4,1,2,3,3,0,-1,1,1,0,10.0,21.0,-11.0,3
14484,14484,2001-02,2001,2002,Southampton,Blackburn,Loss,Home,2001-11-03,0,1,1,1,4,2,5,5,8,-1,-4,-4,-4,1,10.0,21.0,-11.0,4
14485,14485,2001-02,2001,2002,Southampton,Derby,Loss,Away,2001-11-17,0,0,1,1,1,1,2,2,2,-1,-1,-1,-1,0,10.0,17.0,-7.0,4
14486,14486,2001-02,2001,2002,Southampton,Charlton,Win,Home,2001-11-24,3,0,0,1,1,4,4,4,5,-4,-4,-3,-4,1,10.0,9.0,1.0,4
14487,14487,2001-02,2001,2002,Southampton,Everton,Loss,Away,2001-12-02,0,3,3,3,4,2,3,3,6,1,0,0,-2,0,10.0,16.0,-6.0,5
14488,14488,2001-02,2001,2002,Southampton,Leicester,Win,Away,2001-12-08,3,3,3,3,3,4,4,7,8,-1,-1,-4,-5,0,10.0,13.0,-3.0,5
14489,14489,2001-02,2001,2002,Southampton,Sunderland,Win,Home,2001-12-15,3,3,6,6,6,4,4,7,7,-1,2,-1,-1,1,10.0,7.0,3.0,5
14490,14490,2001-02,2001,2002,Southampton,Man United,Loss,Away,2001-12-22,0,6,6,9,9,6,6,6,6,0,0,3,3,0,10.0,1.0,9.0,5
14491,14491,2001-02,2001,2002,Southampton,Tottenham,Win,Home,2001-12-26,3,3,6,6,9,3,3,6,9,0,3,0,0,1,10.0,12.0,-2.0,5
14492,14492,2001-02,2001,2002,Southampton,Leeds,Loss,Home,2001-12-29,0,3,6,9,9,3,6,7,10,0,0,2,-1,1,10.0,4.0,6.0,5
14493,14493,2001-02,2001,2002,Southampton,Chelsea,Win,Away,2002-01-01,3,3,3,6,9,3,6,9,10,0,-3,-3,-1,0,10.0,6.0,4.0,6
14494,14494,2001-02,2001,2002,Southampton,Liverpool,Win,Home,2002-01-09,3,3,6,6,9,2,5,5,5,1,1,1,4,1,10.0,3.0,7.0,6
14495,14495,2001-02,2001,2002,Southampton,Man United,Loss,Home,2002-01-13,0,6,6,9,9,6,9,12,15,0,-3,-3,-6,1,10.0,1.0,9.0,6
14496,14496,2001-02,2001,2002,Southampton,Liverpool,Draw,Away,2002-01-19,1,3,6,6,9,1,2,3,6,2,4,3,3,0,10.0,3.0,7.0,6
14497,14497,2001-02,2001,2002,Southampton,West Ham,Win,Home,2002-01-30,3,1,4,7,7,3,3,4,7,-2,1,3,0,1,10.0,15.0,-5.0,6
14498,14498,2001-02,2001,2002,Southampton,Arsenal,Draw,Away,2002-02-02,1,4,4,7,10,6,7,8,11,-2,-3,-1,-1,0,10.0,2.0,8.0,7
14499,14499,2001-02,2001,2002,Southampton,Newcastle,Loss,Away,2002-02-09,0,4,5,5,8,6,7,10,10,-2,-2,-5,-2,0,10.0,11.0,-1.0,7
14500,14500,2001-02,2001,2002,Southampton,Bolton,Draw,Home,2002-02-23,1,1,4,5,5,3,3,4,5,-2,1,1,0,1,10.0,21.0,-11.0,7
14501,14501,2001-02,2001,2002,Southampton,Ipswich,Win,Away,2002-03-02,3,1,2,5,6,3,6,9,12,-2,-4,-4,-6,0,10.0,5.0,5.0,8
14502,14502,2001-02,2001,2002,Southampton,Middlesbrough,Draw,Home,2002-03-06,1,4,4,5,8,3,6,7,8,1,-2,-2,0,1,10.0,14.0,-4.0,8
14503,14503,2001-02,2001,2002,Southampton,Leicester,Draw,Home,2002-03-16,1,4,5,5,6,1,1,1,1,3,4,4,5,1,10.0,13.0,-3.0,8
14504,14504,2001-02,2001,2002,Southampton,Sunderland,Draw,Away,2002-03-23,1,2,5,6,6,3,3,3,6,-1,2,3,0,0,10.0,7.0,3.0,8
14505,14505,2001-02,2001,2002,Southampton,Fulham,Draw,Home,2002-03-30,1,2,3,6,7,0,0,0,0,2,3,6,7,1,10.0,21.0,-11.0,8
14506,14506,2001-02,2001,2002,Southampton,Blackburn,Loss,Away,2002-04-01,0,2,3,4,7,0,3,6,7,2,0,-2,0,0,10.0,21.0,-11.0,9
14507,14507,2001-02,2001,2002,Southampton,Derby,Win,Home,2002-04-06,3,1,2,3,4,0,0,3,3,1,2,0,1,1,10.0,17.0,-7.0,9
14508,14508,2001-02,2001,2002,Southampton,Charlton,Draw,Away,2002-04-13,1,3,4,5,6,0,0,0,3,3,4,5,3,0,10.0,9.0,1.0,9
14509,14509,2001-02,2001,2002,Southampton,Everton,Loss,Home,2002-04-20,0,4,4,5,6,1,4,4,7,3,0,1,-1,1,10.0,16.0,-6.0,9
14510,14510,2001-02,2001,2002,Southampton,Aston Villa,Loss,Away,2002-04-27,0,1,4,4,5,1,1,2,2,0,3,2,3,0,10.0,8.0,2.0,9
14511,14511,2001-02,2001,2002,Southampton,Newcastle,Win,Home,2002-05-11,3,0,1,4,4,4,7,10,11,-4,-6,-6,-7,1,10.0,11.0,-1.0,10
14512,14512,2002-03,2002,2003,Southampton,Middlesbrough,Draw,Home,2002-08-17,1,3,3,4,7,0,0,0,0,3,3,4,7,1,11.0,12.0,-1.0,1
14513,14513,2002-03,2002,2003,Southampton,Liverpool,Loss,Away,2002-08-24,0,4,4,4,5,6,9,9,12,-2,-5,-5,-7,0,11.0,2.0,9.0,1
14514,14514,2002-03,2002,2003,Southampton,Chelsea,Draw,Home,2002-08-28,1,1,4,4,4,4,4,7,7,-3,0,-3,-3,1,11.0,6.0,5.0,1
14515,14515,2002-03,2002,2003,Southampton,Tottenham,Loss,Away,2002-08-31,0,1,2,5,5,6,7,7,10,-5,-5,-2,-5,0,11.0,9.0,2.0,1
14516,14516,2002-03,2002,2003,Southampton,Everton,Win,Home,2002-09-11,3,1,1,2,5,1,4,5,5,0,-3,-3,0,1,11.0,15.0,-4.0,2
14517,14517,2002-03,2002,2003,Southampton,West Brom,Loss,Away,2002-09-14,0,3,4,4,5,6,6,6,6,-3,-2,-2,-1,0,11.0,21.0,-10.0,2
14518,14518,2002-03,2002,2003,Southampton,Charlton,Draw,Home,2002-09-21,1,3,3,4,4,0,3,3,6,3,0,1,-2,1,11.0,14.0,-3.0,2
14519,14519,2002-03,2002,2003,Southampton,Bolton,Draw,Away,2002-09-28,1,1,4,4,5,0,3,6,6,1,1,-2,-1,0,11.0,16.0,-5.0,2
14520,14520,2002-03,2002,2003,Southampton,Man City,Win,Home,2002-10-05,3,2,2,5,5,1,2,2,5,1,0,3,0,1,11.0,21.0,-10.0,3
14521,14521,2002-03,2002,2003,Southampton,Aston Villa,Win,Away,2002-10-21,3,4,5,5,8,1,4,4,7,3,1,1,1,0,11.0,8.0,3.0,3
14522,14522,2002-03,2002,2003,Southampton,Fulham,Win,Home,2002-10-27,3,6,7,8,8,1,4,4,5,5,3,4,3,1,11.0,13.0,-2.0,3
14523,14523,2002-03,2002,2003,Southampton,Man United,Loss,Away,2002-11-02,0,6,9,10,11,2,5,8,11,4,4,2,0,0,11.0,3.0,8.0,4
14524,14524,2002-03,2002,2003,Southampton,Blackburn,Draw,Home,2002-11-09,1,3,6,9,10,4,7,7,10,-1,-1,2,0,1,11.0,10.0,1.0,4
14525,14525,2002-03,2002,2003,Southampton,Newcastle,Loss,Away,2002-11-16,0,1,4,7,10,3,6,6,9,-2,-2,1,1,0,11.0,4.0,7.0,4
14526,14526,2002-03,2002,2003,Southampton,Arsenal,Win,Home,2002-11-23,3,1,1,4,7,6,9,9,9,-5,-8,-5,-2,1,11.0,1.0,10.0,4
14527,14527,2002-03,2002,2003,Southampton,West Ham,Win,Away,2002-12-02,3,3,4,4,7,1,1,1,1,2,3,3,6,0,11.0,7.0,4.0,5
14528,14528,2002-03,2002,2003,Southampton,Birmingham,Win,Home,2002-12-07,3,6,6,7,7,4,5,5,8,2,1,2,-1,1,11.0,21.0,-10.0,5
14529,14529,2002-03,2002,2003,Southampton,Newcastle,Draw,Home,2002-12-14,1,6,9,9,10,6,6,9,9,0,3,0,1,1,11.0,4.0,7.0,5
14530,14530,2002-03,2002,2003,Southampton,Leeds,Draw,Away,2002-12-21,1,4,7,10,10,3,3,3,3,1,4,7,7,0,11.0,5.0,6.0,5
14531,14531,2002-03,2002,2003,Southampton,Chelsea,Draw,Away,2002-12-26,1,2,5,8,11,4,7,10,11,-2,-2,-2,0,0,11.0,6.0,5.0,5
14532,14532,2002-03,2002,2003,Southampton,Sunderland,Win,Home,2002-12-28,3,2,3,6,9,1,4,4,4,1,-1,2,5,1,11.0,17.0,-6.0,5
14533,14533,2002-03,2002,2003,Southampton,Tottenham,Win,Home,2003-01-01,3,4,5,6,9,1,4,5,8,3,1,1,1,1,11.0,9.0,2.0,6
14534,14534,2002-03,2002,2003,Southampton,Middlesbrough,Draw,Away,2003-01-11,1,6,7,8,9,0,3,3,4,6,4,5,5,0,11.0,12.0,-1.0,6
14535,14535,2002-03,2002,2003,Southampton,Liverpool,Loss,Home,2003-01-18,0,4,7,8,9,1,2,3,4,3,5,5,5,1,11.0,2.0,9.0,6
14536,14536,2002-03,2002,2003,Southampton,Sunderland,Win,Away,2003-01-28,3,1,4,7,8,1,1,1,1,0,3,6,7,0,11.0,17.0,-6.0,6
14537,14537,2002-03,2002,2003,Southampton,Man United,Loss,Home,2003-02-01,0,3,4,7,10,6,9,12,12,-3,-5,-5,-2,1,11.0,3.0,8.0,7
14538,14538,2002-03,2002,2003,Southampton,Blackburn,Loss,Away,2003-02-08,0,3,3,4,7,0,1,2,5,3,2,2,2,0,11.0,10.0,1.0,7
14539,14539,2002-03,2002,2003,Southampton,Everton,Loss,Away,2003-02-22,0,0,3,3,4,3,6,9,9,-3,-3,-6,-5,0,11.0,15.0,-4.0,7
14540,14540,2002-03,2002,2003,Southampton,West Brom,Win,Home,2003-03-01,3,0,0,3,3,0,1,4,4,0,-1,-1,-1,1,11.0,21.0,-10.0,8
14541,14541,2002-03,2002,2003,Southampton,Fulham,Draw,Away,2003-03-15,1,3,3,3,6,4,7,10,10,-1,-4,-7,-4,0,11.0,13.0,-2.0,8
14542,14542,2002-03,2002,2003,Southampton,Aston Villa,Draw,Home,2003-03-22,1,4,4,4,4,0,0,0,3,4,4,4,1,1,11.0,8.0,3.0,8
14543,14543,2002-03,2002,2003,Southampton,West Ham,Draw,Home,2003-04-05,1,2,5,5,5,4,7,10,10,-2,-2,-5,-5,1,11.0,7.0,4.0,9
14544,14544,2002-03,2002,2003,Southampton,Leeds,Win,Home,2003-04-19,3,2,3,6,6,4,4,4,4,-2,-1,2,2,1,11.0,5.0,6.0,9
14545,14545,2002-03,2002,2003,Southampton,Birmingham,Loss,Away,2003-04-21,0,4,5,6,9,6,6,9,9,-2,-1,-3,0,0,11.0,21.0,-10.0,9
14546,14546,2002-03,2002,2003,Southampton,Charlton,Loss,Away,2003-04-26,0,3,4,5,6,0,0,0,1,3,4,5,5,0,11.0,14.0,-3.0,9
14547,14547,2002-03,2002,2003,Southampton,Bolton,Draw,Home,2003-05-03,1,0,3,4,5,2,5,5,8,-2,-2,-1,-3,1,11.0,16.0,-5.0,10
14548,14548,2002-03,2002,2003,Southampton,Arsenal,Loss,Away,2003-05-07,0,1,1,4,5,1,4,5,6,0,-3,-1,-1,0,11.0,1.0,10.0,10
14549,14549,2002-03,2002,2003,Southampton,Man City,Win,Away,2003-05-11,3,1,1,1,4,3,6,9,10,-2,-5,-8,-6,0,11.0,21.0,-10.0,10
14550,14550,2003-04,2003,2004,Southampton,Leicester,Draw,Away,2003-08-16,1,3,4,4,4,4,5,6,6,-1,-1,-2,-2,0,8.0,21.0,-13.0,1
14551,14551,2003-04,2003,2004,Southampton,Birmingham,Draw,Home,2003-08-23,1,4,4,5,5,4,4,7,10,0,0,-2,-5,1,8.0,13.0,-5.0,1
14552,14552,2003-04,2003,2004,Southampton,Leeds,Draw,Away,2003-08-26,1,2,5,5,6,1,4,7,7,1,1,-2,-1,0,8.0,15.0,-7.0,1
14553,14553,2003-04,2003,2004,Southampton,Man United,Win,Home,2003-08-31,3,2,3,6,6,6,9,12,15,-4,-6,-6,-9,1,8.0,1.0,7.0,1
14554,14554,2003-04,2003,2004,Southampton,Wolves,Win,Home,2003-09-13,3,4,5,6,9,1,1,1,1,3,4,5,8,1,8.0,21.0,-13.0,2
14555,14555,2003-04,2003,2004,Southampton,Tottenham,Win,Away,2003-09-20,3,6,7,8,9,0,1,4,4,6,6,4,5,0,8.0,10.0,-2.0,2
14556,14556,2003-04,2003,2004,Southampton,Middlesbrough,Loss,Home,2003-09-27,0,6,9,10,11,3,3,4,4,3,6,6,7,1,8.0,11.0,-3.0,2
14557,14557,2003-04,2003,2004,Southampton,Newcastle,Loss,Away,2003-10-04,0,3,6,9,10,1,2,2,2,2,4,7,8,0,8.0,3.0,5.0,3
14558,14558,2003-04,2003,2004,Southampton,Everton,Draw,Away,2003-10-19,1,0,3,6,9,3,3,4,4,-3,0,2,5,0,8.0,7.0,1.0,3
14559,14559,2003-04,2003,2004,Southampton,Blackburn,Win,Home,2003-10-25,3,1,1,4,7,0,0,3,3,1,1,1,4,1,8.0,6.0,2.0,3
14560,14560,2003-04,2003,2004,Southampton,Man City,Loss,Home,2003-11-01,0,4,4,4,7,3,3,4,5,1,1,0,2,1,8.0,9.0,-1.0,4
14561,14561,2003-04,2003,2004,Southampton,Bolton,Draw,Away,2003-11-08,1,3,4,4,4,3,3,4,5,0,1,0,-1,0,8.0,17.0,-9.0,4
14562,14562,2003-04,2003,2004,Southampton,Chelsea,Loss,Home,2003-11-22,0,1,4,5,5,6,9,9,10,-5,-5,-4,-5,1,8.0,4.0,4.0,4
14563,14563,2003-04,2003,2004,Southampton,Aston Villa,Loss,Away,2003-11-29,0,1,1,4,5,0,1,2,3,1,0,2,2,0,8.0,16.0,-8.0,4
14564,14564,2003-04,2003,2004,Southampton,Charlton,Win,Home,2003-12-07,3,0,1,1,4,1,4,7,8,-1,-3,-6,-4,1,8.0,12.0,-4.0,5
14565,14565,2003-04,2003,2004,Southampton,Liverpool,Win,Away,2003-12-13,3,3,3,4,4,4,5,5,8,-1,-2,-1,-4,0,8.0,5.0,3.0,5
14566,14566,2003-04,2003,2004,Southampton,Portsmouth,Win,Home,2003-12-21,3,6,6,6,7,1,1,1,4,5,5,5,3,1,8.0,21.0,-13.0,5
14567,14567,2003-04,2003,2004,Southampton,Fulham,Loss,Away,2003-12-26,0,6,9,9,9,0,3,4,7,6,6,5,2,0,8.0,14.0,-6.0,5
14568,14568,2003-04,2003,2004,Southampton,Arsenal,Loss,Home,2003-12-29,0,3,6,9,9,4,7,8,9,-1,-1,1,0,1,8.0,2.0,6.0,5
14569,14569,2003-04,2003,2004,Southampton,Leicester,Draw,Home,2004-01-07,1,0,3,6,9,2,2,2,3,-2,1,4,6,1,8.0,21.0,-13.0,6
14570,14570,2003-04,2003,2004,Southampton,Birmingham,Loss,Away,2004-01-10,0,1,1,4,7,0,3,6,6,1,-2,-2,1,0,8.0,13.0,-5.0,6
14571,14571,2003-04,2003,2004,Southampton,Leeds,Win,Home,2004-01-17,3,1,1,1,4,0,0,1,2,1,1,0,2,1,8.0,15.0,-7.0,6
14572,14572,2003-04,2003,2004,Southampton,Man United,Loss,Away,2004-01-31,0,3,4,4,4,1,4,7,10,2,0,-3,-6,0,8.0,1.0,7.0,6
14573,14573,2003-04,2003,2004,Southampton,Fulham,Draw,Home,2004-02-07,1,3,3,4,4,3,6,6,6,0,-3,-2,-2,1,8.0,14.0,-6.0,7
14574,14574,2003-04,2003,2004,Southampton,Arsenal,Loss,Away,2004-02-10,0,1,4,4,5,6,9,12,13,-5,-5,-8,-8,0,8.0,2.0,6.0,7
14575,14575,2003-04,2003,2004,Southampton,Everton,Draw,Home,2004-02-21,1,1,1,4,4,0,1,1,1,1,0,3,3,1,8.0,7.0,1.0,7
14576,14576,2003-04,2003,2004,Southampton,Blackburn,Draw,Away,2004-02-28,1,1,2,2,5,1,4,4,5,0,-2,-2,0,0,8.0,6.0,2.0,7
14577,14577,2003-04,2003,2004,Southampton,Liverpool,Win,Home,2004-03-14,3,2,2,3,3,4,5,6,7,-2,-3,-3,-4,1,8.0,5.0,3.0,8
14578,14578,2003-04,2003,2004,Southampton,Portsmouth,Loss,Away,2004-03-21,0,4,5,5,6,0,1,1,1,4,4,4,5,0,8.0,21.0,-13.0,8
14579,14579,2003-04,2003,2004,Southampton,Tottenham,Win,Home,2004-03-27,3,3,4,5,5,3,3,4,7,0,1,1,-2,1,8.0,10.0,-2.0,8
14580,14580,2003-04,2003,2004,Southampton,Wolves,Win,Away,2004-04-03,3,3,6,7,8,0,0,1,4,3,6,6,4,0,8.0,21.0,-13.0,9
14581,14581,2003-04,2003,2004,Southampton,Middlesbrough,Loss,Away,2004-04-12,0,6,6,9,10,4,5,8,8,2,1,1,2,0,8.0,11.0,-3.0,9
14582,14582,2003-04,2003,2004,Southampton,Man City,Win,Away,2004-04-17,3,3,6,6,9,2,3,4,4,1,3,2,5,0,8.0,9.0,-1.0,9
14583,14583,2003-04,2003,2004,Southampton,Bolton,Loss,Home,2004-04-24,0,3,6,9,9,6,7,7,10,-3,-1,2,-1,1,8.0,17.0,-9.0,9
14584,14584,2003-04,2003,2004,Southampton,Chelsea,Loss,Away,2004-05-01,0,3,3,6,9,1,1,2,5,2,2,4,4,0,8.0,4.0,4.0,10
14585,14585,2003-04,2003,2004,Southampton,Aston Villa,Draw,Home,2004-05-08,1,0,3,3,6,6,7,10,11,-6,-4,-7,-5,1,8.0,16.0,-8.0,10
14586,14586,2003-04,2003,2004,Southampton,Newcastle,Draw,Home,2004-05-12,1,1,1,4,4,1,4,5,6,0,-3,-1,-2,1,8.0,3.0,5.0,10
14587,14587,2003-04,2003,2004,Southampton,Charlton,Loss,Away,2004-05-15,0,2,2,2,5,2,2,2,3,0,0,0,2,0,8.0,12.0,-4.0,10
14588,14588,2004-05,2004,2005,Southampton,Aston Villa,Loss,Away,2004-08-14,0,1,2,2,2,1,4,7,8,0,-2,-5,-6,0,12.0,6.0,6.0,1
14589,14589,2004-05,2004,2005,Southampton,Blackburn,Win,Home,2004-08-21,3,0,1,2,2,2,2,5,8,-2,-1,-3,-6,1,12.0,15.0,-3.0,1
14590,14590,2004-05,2004,2005,Southampton,Bolton,Loss,Home,2004-08-25,0,3,3,4,5,3,3,6,9,0,0,-2,-4,1,12.0,8.0,4.0,1
14591,14591,2004-05,2004,2005,Southampton,Chelsea,Loss,Away,2004-08-28,0,3,3,3,4,6,9,12,13,-3,-6,-9,-9,0,12.0,2.0,10.0,1
14592,14592,2004-05,2004,2005,Southampton,Charlton,Draw,Away,2004-09-13,1,0,3,3,3,3,6,6,9,-3,-3,-3,-6,0,12.0,7.0,5.0,2
14593,14593,2004-05,2004,2005,Southampton,Newcastle,Loss,Home,2004-09-19,0,1,1,4,4,3,4,4,5,-2,-3,0,-1,1,12.0,5.0,7.0,2
14594,14594,2004-05,2004,2005,Southampton,Fulham,Loss,Away,2004-09-25,0,1,1,1,4,1,1,1,4,0,0,0,0,0,12.0,9.0,3.0,2
14595,14595,2004-05,2004,2005,Southampton,Man City,Draw,Home,2004-10-02,1,0,1,1,1,3,3,6,6,-3,-2,-5,-5,1,12.0,16.0,-4.0,3
14596,14596,2004-05,2004,2005,Southampton,Everton,Loss,Away,2004-10-16,0,1,1,2,2,3,6,9,10,-2,-5,-7,-8,0,12.0,17.0,-5.0,3
14597,14597,2004-05,2004,2005,Southampton,Birmingham,Draw,Home,2004-10-24,1,1,1,1,2,2,3,4,4,-1,-2,-3,-2,1,12.0,10.0,2.0,3
14598,14598,2004-05,2004,2005,Southampton,Arsenal,Draw,Away,2004-10-30,1,1,2,2,2,3,6,9,10,-2,-4,-7,-8,0,12.0,1.0,11.0,3
14599,14599,2004-05,2004,2005,Southampton,West Brom,Draw,Home,2004-11-06,1,2,2,3,3,0,1,4,4,2,1,-1,-1,1,12.0,21.0,-9.0,4
14600,14600,2004-05,2004,2005,Southampton,Portsmouth,Win,Home,2004-11-13,3,2,3,3,4,3,4,7,8,-1,-1,-4,-4,1,12.0,13.0,-1.0,4
14601,14601,2004-05,2004,2005,Southampton,Norwich,Loss,Away,2004-11-20,0,4,5,6,6,1,2,2,3,3,3,4,3,0,12.0,21.0,-9.0,4
14602,14602,2004-05,2004,2005,Southampton,Crystal Palace,Draw,Home,2004-11-27,1,3,4,5,6,0,1,4,7,3,3,1,-1,1,12.0,21.0,-9.0,4
14603,14603,2004-05,2004,2005,Southampton,Man United,Loss,Away,2004-12-04,0,1,4,5,6,6,9,10,10,-5,-5,-5,-4,0,12.0,3.0,9.0,5
14604,14604,2004-05,2004,2005,Southampton,Middlesbrough,Draw,Home,2004-12-11,1,1,1,4,5,3,6,9,10,-2,-5,-5,-5,1,12.0,11.0,1.0,5
14605,14605,2004-05,2004,2005,Southampton,Tottenham,Loss,Away,2004-12-18,0,1,2,2,5,6,9,9,9,-5,-7,-7,-4,0,12.0,14.0,-2.0,5
14606,14606,2004-05,2004,2005,Southampton,Charlton,Draw,Home,2004-12-26,1,1,1,2,2,6,9,9,9,-5,-8,-7,-7,1,12.0,7.0,5.0,5
14607,14607,2004-05,2004,2005,Southampton,Liverpool,Loss,Away,2004-12-28,0,1,2,2,3,6,7,7,8,-5,-5,-5,-5,0,12.0,4.0,8.0,5
14608,14608,2004-05,2004,2005,Southampton,Man City,Loss,Away,2005-01-01,0,1,1,2,2,1,4,4,4,0,-3,-2,-2,0,12.0,16.0,-4.0,6
14609,14609,2004-05,2004,2005,Southampton,Fulham,Draw,Home,2005-01-05,1,0,1,1,2,3,3,3,4,-3,-2,-2,-2,1,12.0,9.0,3.0,6
14610,14610,2004-05,2004,2005,Southampton,Newcastle,Loss,Away,2005-01-15,0,1,1,2,2,4,4,5,5,-3,-3,-3,-3,0,12.0,5.0,7.0,6
14611,14611,2004-05,2004,2005,Southampton,Liverpool,Win,Home,2005-01-22,3,1,1,1,2,3,3,6,9,-2,-2,-5,-7,1,12.0,4.0,8.0,6
14612,14612,2004-05,2004,2005,Southampton,Birmingham,Loss,Away,2005-02-02,0,3,4,4,4,0,0,0,3,3,4,4,1,0,12.0,10.0,2.0,7
14613,14613,2004-05,2004,2005,Southampton,Everton,Draw,Home,2005-02-06,1,3,3,4,4,3,4,7,7,0,-1,-3,-3,1,12.0,17.0,-5.0,7
14614,14614,2004-05,2004,2005,Southampton,West Brom,Draw,Away,2005-02-22,1,1,4,4,5,1,4,4,5,0,0,0,0,0,12.0,21.0,-9.0,7
14615,14615,2004-05,2004,2005,Southampton,Arsenal,Draw,Home,2005-02-26,1,2,2,5,5,6,6,9,9,-4,-4,-4,-4,1,12.0,1.0,11.0,7
14616,14616,2004-05,2004,2005,Southampton,Tottenham,Win,Home,2005-03-05,3,2,3,3,6,6,6,6,6,-4,-3,-3,0,1,12.0,14.0,-2.0,8
14617,14617,2004-05,2004,2005,Southampton,Middlesbrough,Win,Away,2005-03-20,3,4,5,6,6,1,2,5,5,3,3,1,1,0,12.0,11.0,1.0,8
14618,14618,2004-05,2004,2005,Southampton,Chelsea,Loss,Home,2005-04-02,0,6,7,8,9,6,9,12,13,0,-2,-4,-4,1,12.0,2.0,10.0,9
14619,14619,2004-05,2004,2005,Southampton,Blackburn,Loss,Away,2005-04-09,0,3,6,7,8,1,2,5,8,2,4,2,0,0,12.0,15.0,-3.0,9
14620,14620,2004-05,2004,2005,Southampton,Aston Villa,Loss,Home,2005-04-16,0,0,3,6,7,4,4,7,7,-4,-1,-1,0,1,12.0,6.0,6.0,9
14621,14621,2004-05,2004,2005,Southampton,Bolton,Draw,Away,2005-04-19,1,0,0,3,6,6,6,9,12,-6,-6,-6,-6,0,12.0,8.0,4.0,9
14622,14622,2004-05,2004,2005,Southampton,Portsmouth,Loss,Away,2005-04-24,0,1,1,1,4,1,4,4,5,0,-3,-3,-1,0,12.0,13.0,-1.0,9
14623,14623,2004-05,2004,2005,Southampton,Norwich,Win,Home,2005-04-30,3,1,1,1,1,6,7,10,10,-5,-6,-9,-9,1,12.0,21.0,-9.0,9
14624,14624,2004-05,2004,2005,Southampton,Crystal Palace,Draw,Away,2005-05-07,1,3,4,4,4,4,4,5,5,-1,0,-1,-1,0,12.0,21.0,-9.0,10
14625,14625,2004-05,2004,2005,Southampton,Man United,Loss,Home,2005-05-15,0,4,4,5,5,1,4,7,7,3,0,-2,-2,1,12.0,3.0,9.0,10
14626,14626,2012-13,2012,2013,Southampton,Man City,Loss,Away,2012-08-19,0,1,4,4,5,6,9,12,15,-5,-5,-8,-10,0,21.0,1.0,20.0,1
14627,14627,2012-13,2012,2013,Southampton,Wigan,Loss,Home,2012-08-25,0,0,1,4,4,3,6,9,9,-3,-5,-5,-5,1,21.0,15.0,6.0,1
14628,14628,2012-13,2012,2013,Southampton,Man United,Loss,Home,2012-09-02,0,0,0,1,4,3,6,9,9,-3,-6,-8,-5,1,21.0,2.0,19.0,2
14629,14629,2012-13,2012,2013,Southampton,Arsenal,Loss,Away,2012-09-15,0,0,0,0,1,4,5,8,9,-4,-5,-8,-8,0,21.0,3.0,18.0,2
14630,14630,2012-13,2012,2013,Southampton,Aston Villa,Win,Home,2012-09-22,3,0,0,0,0,4,4,4,4,-4,-4,-4,-4,1,21.0,16.0,5.0,2
14631,14631,2012-13,2012,2013,Southampton,Everton,Loss,Away,2012-09-29,0,3,3,3,3,4,4,7,10,-1,-1,-4,-7,0,21.0,7.0,14.0,2
14632,14632,2012-13,2012,2013,Southampton,Fulham,Draw,Home,2012-10-07,1,3,3,3,3,3,6,6,6,0,-3,-3,-3,1,21.0,9.0,12.0,3
14633,14633,2012-13,2012,2013,Southampton,West Ham,Loss,Away,2012-10-20,0,1,4,4,4,3,4,5,8,-2,0,-1,-4,0,21.0,21.0,0.0,3
14634,14634,2012-13,2012,2013,Southampton,Tottenham,Loss,Home,2012-10-28,0,1,1,4,4,3,6,9,12,-2,-5,-5,-8,1,21.0,4.0,17.0,3
14635,14635,2012-13,2012,2013,Southampton,West Brom,Loss,Away,2012-11-05,0,0,1,1,4,0,3,4,7,0,-2,-3,-3,0,21.0,10.0,11.0,4
14636,14636,2012-13,2012,2013,Southampton,Swansea,Draw,Home,2012-11-10,1,0,0,1,1,1,4,5,5,-1,-4,-4,-4,1,21.0,11.0,10.0,4
14637,14637,2012-13,2012,2013,Southampton,QPR,Win,Away,2012-11-17,3,1,1,1,2,1,1,2,2,0,0,-1,0,0,21.0,17.0,4.0,4
14638,14638,2012-13,2012,2013,Southampton,Newcastle,Win,Home,2012-11-25,3,4,4,4,4,0,1,4,5,4,3,0,-1,1,21.0,5.0,16.0,4
14639,14639,2012-13,2012,2013,Southampton,Norwich,Draw,Home,2012-11-28,1,6,7,7,7,4,5,8,9,2,2,-1,-2,1,21.0,12.0,9.0,4
14640,14640,2012-13,2012,2013,Southampton,Liverpool,Loss,Away,2012-12-01,0,4,7,8,8,1,4,5,6,3,3,3,2,0,21.0,8.0,13.0,5
14641,14641,2012-13,2012,2013,Southampton,Reading,Win,Home,2012-12-08,3,1,4,7,8,0,0,3,4,1,4,4,4,1,21.0,21.0,0.0,5
14642,14642,2012-13,2012,2013,Southampton,Sunderland,Loss,Home,2012-12-22,0,3,4,7,10,3,3,3,4,0,1,4,6,1,21.0,13.0,8.0,5
14643,14643,2012-13,2012,2013,Southampton,Fulham,Draw,Away,2012-12-26,1,3,3,4,7,0,3,3,4,3,0,1,3,0,21.0,9.0,12.0,5
14644,14644,2012-13,2012,2013,Southampton,Stoke,Draw,Away,2012-12-29,1,1,4,4,5,4,5,6,9,-3,-1,-2,-4,0,21.0,14.0,7.0,5
14645,14645,2012-13,2012,2013,Southampton,Arsenal,Draw,Home,2013-01-01,1,2,2,5,5,6,9,12,12,-4,-7,-7,-7,1,21.0,3.0,18.0,6
14646,14646,2012-13,2012,2013,Southampton,Aston Villa,Win,Away,2013-01-12,3,2,3,3,6,1,1,1,4,1,2,2,2,0,21.0,16.0,5.0,6
14647,14647,2012-13,2012,2013,Southampton,Chelsea,Draw,Away,2013-01-16,1,4,5,6,6,3,6,9,12,1,-1,-3,-6,0,21.0,6.0,15.0,6
14648,14648,2012-13,2012,2013,Southampton,Everton,Draw,Home,2013-01-21,1,4,5,6,7,4,4,7,10,0,1,-1,-3,1,21.0,7.0,14.0,6
14649,14649,2012-13,2012,2013,Southampton,Man United,Loss,Away,2013-01-30,0,2,5,6,7,4,7,10,13,-2,-2,-4,-6,0,21.0,2.0,19.0,6
14650,14650,2012-13,2012,2013,Southampton,Wigan,Draw,Away,2013-02-02,1,1,2,5,6,1,2,2,5,0,0,3,1,0,21.0,15.0,6.0,7
14651,14651,2012-13,2012,2013,Southampton,Man City,Win,Home,2013-02-09,3,1,2,3,6,2,5,8,11,-1,-3,-5,-5,1,21.0,1.0,20.0,7
14652,14652,2012-13,2012,2013,Southampton,Newcastle,Loss,Away,2013-02-24,0,4,4,5,6,3,6,6,7,1,-2,-1,-1,0,21.0,5.0,16.0,7
14653,14653,2012-13,2012,2013,Southampton,QPR,Loss,Home,2013-03-02,0,3,4,4,5,0,1,2,3,3,3,2,2,1,21.0,17.0,4.0,8
14654,14654,2012-13,2012,2013,Southampton,Norwich,Draw,Away,2013-03-09,1,0,3,4,4,3,4,5,6,-3,-1,-1,-2,0,21.0,12.0,9.0,8
14655,14655,2012-13,2012,2013,Southampton,Liverpool,Win,Home,2013-03-16,3,1,1,4,5,6,9,9,10,-5,-8,-5,-5,1,21.0,8.0,13.0,8
14656,14656,2012-13,2012,2013,Southampton,Chelsea,Win,Home,2013-03-30,3,4,4,4,7,6,6,9,9,-2,-2,-5,-2,1,21.0,6.0,15.0,8
14657,14657,2012-13,2012,2013,Southampton,Reading,Win,Away,2013-04-06,3,6,7,7,7,0,0,0,0,6,7,7,7,0,21.0,21.0,0.0,9
14658,14658,2012-13,2012,2013,Southampton,West Ham,Draw,Home,2013-04-13,1,6,9,10,10,4,4,7,7,2,5,3,3,1,21.0,21.0,0.0,9
14659,14659,2012-13,2012,2013,Southampton,Swansea,Draw,Away,2013-04-20,1,4,7,10,11,1,1,1,4,3,6,9,7,0,21.0,11.0,10.0,9
14660,14660,2012-13,2012,2013,Southampton,West Brom,Loss,Home,2013-04-27,0,2,5,8,11,1,1,2,5,1,4,6,6,1,21.0,10.0,11.0,9
14661,14661,2012-13,2012,2013,Southampton,Tottenham,Loss,Away,2013-05-04,0,1,2,5,8,4,5,8,8,-3,-3,-3,0,0,21.0,4.0,17.0,10
14662,14662,2012-13,2012,2013,Southampton,Sunderland,Draw,Away,2013-05-12,1,0,1,2,5,1,4,7,7,-1,-3,-5,-2,0,21.0,13.0,8.0,10
14663,14663,2012-13,2012,2013,Southampton,Stoke,Draw,Home,2013-05-19,1,1,1,2,3,1,4,7,7,0,-3,-5,-4,1,21.0,14.0,7.0,10
14664,14664,2013-14,2013,2014,Southampton,West Brom,Win,Away,2013-08-17,3,2,2,2,3,1,1,1,4,1,1,1,-1,0,14.0,8.0,6.0,1
14665,14665,2013-14,2013,2014,Southampton,Sunderland,Draw,Home,2013-08-24,1,4,5,5,5,0,1,2,2,4,4,3,3,1,14.0,17.0,-3.0,1
14666,14666,2013-14,2013,2014,Southampton,Norwich,Loss,Away,2013-08-31,0,4,5,6,6,1,4,7,7,3,1,-1,-1,0,14.0,11.0,3.0,1
14667,14667,2013-14,2013,2014,Southampton,West Ham,Draw,Home,2013-09-15,1,1,4,5,6,1,4,7,7,0,0,-2,-1,1,14.0,10.0,4.0,2
14668,14668,2013-14,2013,2014,Southampton,Liverpool,Win,Away,2013-09-21,3,1,2,5,6,4,7,10,13,-3,-5,-5,-7,0,14.0,7.0,7.0,2
14669,14669,2013-14,2013,2014,Southampton,Crystal Palace,Win,Home,2013-09-28,3,4,4,5,8,0,3,3,3,4,1,2,5,1,14.0,21.0,-7.0,2
14670,14670,2013-14,2013,2014,Southampton,Swansea,Win,Home,2013-10-06,3,6,7,7,8,3,4,7,7,3,3,0,1,1,14.0,9.0,5.0,3
14671,14671,2013-14,2013,2014,Southampton,Man United,Draw,Away,2013-10-19,1,6,9,10,10,3,3,6,6,3,6,4,4,0,14.0,1.0,13.0,3
14672,14672,2013-14,2013,2014,Southampton,Fulham,Win,Home,2013-10-26,3,4,7,10,11,6,6,6,7,-2,1,4,4,1,14.0,12.0,2.0,3
14673,14673,2013-14,2013,2014,Southampton,Stoke,Draw,Away,2013-11-02,1,4,7,10,13,1,1,1,1,3,6,9,12,0,14.0,13.0,1.0,4
14674,14674,2013-14,2013,2014,Southampton,Hull,Win,Home,2013-11-09,3,4,5,8,11,3,3,4,7,1,2,4,4,1,14.0,21.0,-7.0,4
14675,14675,2013-14,2013,2014,Southampton,Arsenal,Loss,Away,2013-11-23,0,4,7,8,11,3,6,9,10,1,1,-1,1,0,14.0,4.0,10.0,4
14676,14676,2013-14,2013,2014,Southampton,Chelsea,Loss,Away,2013-12-01,0,3,4,7,8,4,4,7,10,-1,0,0,-2,0,14.0,3.0,11.0,5
14677,14677,2013-14,2013,2014,Southampton,Aston Villa,Loss,Home,2013-12-04,0,0,3,4,7,2,5,6,6,-2,-2,-2,1,1,14.0,15.0,-1.0,5
14678,14678,2013-14,2013,2014,Southampton,Man City,Draw,Home,2013-12-07,1,0,0,3,4,6,9,9,12,-6,-9,-6,-8,1,14.0,2.0,12.0,5
14679,14679,2013-14,2013,2014,Southampton,Newcastle,Draw,Away,2013-12-14,1,1,1,1,4,3,6,9,12,-2,-5,-8,-8,0,14.0,16.0,-2.0,5
14680,14680,2013-14,2013,2014,Southampton,Tottenham,Loss,Home,2013-12-22,0,2,2,2,2,3,6,7,7,-1,-4,-5,-5,1,14.0,5.0,9.0,5
14681,14681,2013-14,2013,2014,Southampton,Cardiff,Win,Away,2013-12-26,3,1,2,2,2,3,3,4,4,-2,-1,-2,-2,0,14.0,21.0,-7.0,5
14682,14682,2013-14,2013,2014,Southampton,Everton,Loss,Away,2013-12-29,0,3,4,5,5,3,6,7,10,0,-2,-2,-5,0,14.0,6.0,8.0,5
14683,14683,2013-14,2013,2014,Southampton,Chelsea,Loss,Home,2014-01-01,0,3,3,4,5,6,7,10,10,-3,-4,-6,-5,1,14.0,3.0,11.0,6
14684,14684,2013-14,2013,2014,Southampton,West Brom,Win,Home,2014-01-11,3,0,3,3,4,4,5,6,6,-4,-2,-3,-2,1,14.0,8.0,6.0,6
14685,14685,2013-14,2013,2014,Southampton,Sunderland,Draw,Away,2014-01-18,1,3,3,6,6,3,4,7,8,0,-1,-1,-2,0,14.0,17.0,-3.0,6
14686,14686,2013-14,2013,2014,Southampton,Arsenal,Draw,Home,2014-01-28,1,4,4,4,7,6,9,12,15,-2,-5,-8,-8,1,14.0,4.0,10.0,6
14687,14687,2013-14,2013,2014,Southampton,Fulham,Win,Away,2014-02-01,3,2,5,5,5,0,0,3,3,2,5,2,2,0,14.0,12.0,2.0,7
14688,14688,2013-14,2013,2014,Southampton,Stoke,Draw,Home,2014-02-08,1,4,5,8,8,3,3,3,4,1,2,5,4,1,14.0,13.0,1.0,7
14689,14689,2013-14,2013,2014,Southampton,Hull,Win,Away,2014-02-11,3,4,5,6,9,4,4,4,4,0,1,2,5,0,14.0,21.0,-7.0,7
14690,14690,2013-14,2013,2014,Southampton,West Ham,Loss,Away,2014-02-22,0,4,7,8,9,6,9,10,10,-2,-2,-2,-1,0,14.0,10.0,4.0,7
14691,14691,2013-14,2013,2014,Southampton,Liverpool,Loss,Home,2014-03-01,0,3,4,7,8,6,9,10,13,-3,-5,-3,-5,1,14.0,7.0,7.0,8
14692,14692,2013-14,2013,2014,Southampton,Crystal Palace,Win,Away,2014-03-08,3,0,3,4,7,1,4,4,7,-1,-1,0,0,0,14.0,21.0,-7.0,8
14693,14693,2013-14,2013,2014,Southampton,Norwich,Win,Home,2014-03-15,3,3,3,6,7,1,4,4,5,2,-1,2,2,1,14.0,11.0,3.0,8
14694,14694,2013-14,2013,2014,Southampton,Tottenham,Loss,Away,2014-03-23,0,6,6,6,9,0,3,3,6,6,3,3,3,0,14.0,5.0,9.0,8
14695,14695,2013-14,2013,2014,Southampton,Newcastle,Win,Home,2014-03-29,3,3,6,6,6,3,3,6,9,0,3,0,-3,1,14.0,16.0,-2.0,8
14696,14696,2013-14,2013,2014,Southampton,Man City,Loss,Away,2014-04-05,0,3,6,9,9,4,7,10,13,-1,-1,-1,-4,0,14.0,2.0,12.0,9
14697,14697,2013-14,2013,2014,Southampton,Cardiff,Loss,Home,2014-04-12,0,3,3,6,9,1,1,1,4,2,2,5,5,1,14.0,21.0,-7.0,9
14698,14698,2013-14,2013,2014,Southampton,Aston Villa,Draw,Away,2014-04-19,1,0,3,3,6,0,0,0,3,0,3,3,3,0,14.0,15.0,-1.0,9
14699,14699,2013-14,2013,2014,Southampton,Everton,Win,Home,2014-04-26,3,1,1,4,4,3,6,9,12,-2,-5,-5,-8,1,14.0,6.0,8.0,9
14700,14700,2013-14,2013,2014,Southampton,Swansea,Win,Away,2014-05-03,3,4,4,4,7,6,6,6,9,-2,-2,-2,-2,0,14.0,9.0,5.0,10
14701,14701,2013-14,2013,2014,Southampton,Man United,Draw,Home,2014-05-11,1,6,7,7,7,3,6,6,9,3,1,1,-2,1,14.0,1.0,13.0,10
14702,14702,2014-15,2014,2015,Southampton,Liverpool,Loss,Away,2014-08-17,0,4,7,8,8,4,4,7,10,0,3,1,-2,0,8.0,2.0,6.0,1
14703,14703,2014-15,2014,2015,Southampton,West Brom,Draw,Home,2014-08-23,1,1,4,7,8,1,1,1,4,0,3,6,4,1,8.0,17.0,-9.0,1
14704,14704,2014-15,2014,2015,Southampton,West Ham,Win,Away,2014-08-30,3,1,2,5,8,3,3,6,6,-2,-1,-1,2,0,8.0,13.0,-5.0,1
14705,14705,2014-15,2014,2015,Southampton,Newcastle,Win,Home,2014-09-13,3,4,4,5,8,2,2,2,5,2,2,3,3,1,8.0,10.0,-2.0,2
14706,14706,2014-15,2014,2015,Southampton,Swansea,Win,Away,2014-09-20,3,6,7,7,8,3,6,9,12,3,1,-2,-4,0,8.0,12.0,-4.0,2
14707,14707,2014-15,2014,2015,Southampton,QPR,Win,Home,2014-09-27,3,6,9,10,10,1,4,4,4,5,5,6,6,1,8.0,21.0,-13.0,2
14708,14708,2014-15,2014,2015,Southampton,Tottenham,Loss,Away,2014-10-05,0,6,9,12,13,1,2,2,5,5,7,10,8,0,8.0,6.0,2.0,3
14709,14709,2014-15,2014,2015,Southampton,Sunderland,Win,Home,2014-10-18,3,3,6,9,12,4,5,6,6,-1,1,3,6,1,8.0,14.0,-6.0,3
14710,14710,2014-15,2014,2015,Southampton,Stoke,Win,Home,2014-10-25,3,3,6,9,12,3,6,7,7,0,0,2,5,1,8.0,9.0,-1.0,3
14711,14711,2014-15,2014,2015,Southampton,Hull,Win,Away,2014-11-01,3,6,6,9,12,2,5,5,6,4,1,4,6,0,8.0,16.0,-8.0,4
14712,14712,2014-15,2014,2015,Southampton,Leicester,Win,Home,2014-11-08,3,6,9,9,12,0,0,1,1,6,9,8,11,1,8.0,21.0,-13.0,4
14713,14713,2014-15,2014,2015,Southampton,Aston Villa,Draw,Away,2014-11-24,1,6,9,12,12,1,1,1,1,5,8,11,11,0,8.0,15.0,-7.0,4
14714,14714,2014-15,2014,2015,Southampton,Man City,Loss,Home,2014-11-30,0,4,7,10,13,4,7,7,10,0,0,3,3,1,8.0,1.0,7.0,4
14715,14715,2014-15,2014,2015,Southampton,Arsenal,Loss,Away,2014-12-03,0,1,4,7,10,3,3,6,9,-2,1,1,1,0,8.0,4.0,4.0,5
14716,14716,2014-15,2014,2015,Southampton,Man United,Loss,Home,2014-12-08,0,0,1,4,7,6,9,12,12,-6,-8,-8,-5,1,8.0,7.0,1.0,5
14717,14717,2014-15,2014,2015,Southampton,Burnley,Loss,Away,2014-12-13,0,0,0,1,4,1,2,5,8,-1,-2,-4,-4,0,8.0,21.0,-13.0,5
14718,14718,2014-15,2014,2015,Southampton,Everton,Win,Home,2014-12-20,3,0,0,0,1,3,4,4,7,-3,-4,-4,-6,1,8.0,5.0,3.0,5
14719,14719,2014-15,2014,2015,Southampton,Crystal Palace,Win,Away,2014-12-26,3,3,3,3,3,1,2,2,3,2,1,1,0,0,8.0,11.0,-3.0,5
14720,14720,2014-15,2014,2015,Southampton,Chelsea,Draw,Home,2014-12-28,1,6,6,6,6,6,9,9,12,0,-3,-3,-6,1,8.0,3.0,5.0,5
14721,14721,2014-15,2014,2015,Southampton,Arsenal,Win,Home,2015-01-01,3,4,7,7,7,6,7,10,10,-2,0,-3,-3,1,8.0,4.0,4.0,6
14722,14722,2014-15,2014,2015,Southampton,Man United,Win,Away,2015-01-11,3,4,7,10,10,2,5,6,9,2,2,4,1,0,8.0,7.0,1.0,6
14723,14723,2014-15,2014,2015,Southampton,Newcastle,Win,Away,2015-01-17,3,6,7,10,13,1,4,4,4,5,3,6,9,0,8.0,10.0,-2.0,6
14724,14724,2014-15,2014,2015,Southampton,Swansea,Loss,Home,2015-02-01,0,6,9,10,13,1,2,2,5,5,7,8,8,1,8.0,12.0,-4.0,7
14725,14725,2014-15,2014,2015,Southampton,QPR,Win,Away,2015-02-07,3,3,6,9,10,0,0,1,2,3,6,8,8,0,8.0,21.0,-13.0,7
14726,14726,2014-15,2014,2015,Southampton,West Ham,Draw,Home,2015-02-11,1,3,6,9,12,1,4,5,6,2,2,4,6,1,8.0,13.0,-5.0,7
14727,14727,2014-15,2014,2015,Southampton,Liverpool,Loss,Home,2015-02-22,0,4,4,7,10,4,7,10,13,0,-3,-3,-3,1,8.0,2.0,6.0,7
14728,14728,2014-15,2014,2015,Southampton,West Brom,Loss,Away,2015-02-28,0,1,4,4,7,4,5,5,6,-3,-1,-1,1,0,8.0,17.0,-9.0,7
14729,14729,2014-15,2014,2015,Southampton,Crystal Palace,Win,Home,2015-03-03,3,0,1,4,4,3,4,7,7,-3,-3,-3,-3,1,8.0,11.0,-3.0,8
14730,14730,2014-15,2014,2015,Southampton,Chelsea,Draw,Away,2015-03-15,1,3,3,4,7,4,7,10,11,-1,-4,-6,-4,0,8.0,3.0,5.0,8
14731,14731,2014-15,2014,2015,Southampton,Burnley,Win,Home,2015-03-21,3,4,4,4,5,3,3,4,4,1,1,0,1,1,8.0,21.0,-13.0,8
14732,14732,2014-15,2014,2015,Southampton,Everton,Loss,Away,2015-04-04,0,4,7,7,7,6,6,6,7,-2,1,1,0,0,8.0,5.0,3.0,9
14733,14733,2014-15,2014,2015,Southampton,Hull,Win,Home,2015-04-11,3,3,4,7,7,0,1,2,2,3,3,5,5,1,8.0,16.0,-8.0,9
14734,14734,2014-15,2014,2015,Southampton,Stoke,Loss,Away,2015-04-18,0,3,6,7,10,1,1,1,4,2,5,6,6,0,8.0,9.0,-1.0,9
14735,14735,2014-15,2014,2015,Southampton,Tottenham,Draw,Home,2015-04-25,1,3,3,6,7,3,4,7,7,0,-1,-1,0,1,8.0,6.0,2.0,9
14736,14736,2014-15,2014,2015,Southampton,Sunderland,Loss,Away,2015-05-02,0,1,4,4,7,1,4,4,4,0,0,0,3,0,8.0,14.0,-6.0,10
14737,14737,2014-15,2014,2015,Southampton,Leicester,Loss,Away,2015-05-09,0,1,1,4,4,3,6,9,12,-2,-5,-5,-8,0,8.0,21.0,-13.0,10
14738,14738,2014-15,2014,2015,Southampton,Aston Villa,Win,Home,2015-05-16,3,0,1,1,4,6,6,9,10,-6,-5,-8,-6,1,8.0,15.0,-7.0,10
14739,14739,2014-15,2014,2015,Southampton,Man City,Loss,Away,2015-05-24,0,3,3,4,4,6,9,12,15,-3,-6,-8,-11,0,8.0,1.0,7.0,10
14740,14740,2015-16,2015,2016,Southampton,Newcastle,Draw,Away,2015-08-09,1,3,3,3,4,3,4,4,4,0,-1,-1,0,0,7.0,15.0,-8.0,1
14741,14741,2015-16,2015,2016,Southampton,Everton,Loss,Home,2015-08-15,0,1,4,4,4,1,4,4,4,0,0,0,0,1,7.0,11.0,-4.0,1
14742,14742,2015-16,2015,2016,Southampton,Watford,Draw,Away,2015-08-23,1,1,1,4,4,2,3,6,6,-1,-2,-2,-2,0,7.0,21.0,-14.0,1
14743,14743,2015-16,2015,2016,Southampton,Norwich,Win,Home,2015-08-30,3,1,2,2,5,4,4,4,5,-3,-2,-2,0,1,7.0,21.0,-14.0,1
14744,14744,2015-16,2015,2016,Southampton,West Brom,Draw,Away,2015-09-12,1,4,4,5,5,3,4,4,4,1,0,1,1,0,7.0,13.0,-6.0,2
14745,14745,2015-16,2015,2016,Southampton,Man United,Loss,Home,2015-09-20,0,4,5,5,6,3,4,7,10,1,1,-2,-4,1,7.0,4.0,3.0,2
14746,14746,2015-16,2015,2016,Southampton,Swansea,Win,Home,2015-09-26,3,1,4,5,5,1,4,5,8,0,0,0,-3,1,7.0,8.0,-1.0,2
14747,14747,2015-16,2015,2016,Southampton,Chelsea,Win,Away,2015-10-03,3,3,4,7,8,4,4,4,7,-1,0,3,1,0,7.0,1.0,6.0,3
14748,14748,2015-16,2015,2016,Southampton,Leicester,Draw,Home,2015-10-17,1,6,6,7,10,3,4,7,8,3,2,0,2,1,7.0,14.0,-7.0,3
14749,14749,2015-16,2015,2016,Southampton,Liverpool,Draw,Away,2015-10-25,1,4,7,7,8,2,5,6,6,2,2,1,2,0,7.0,6.0,1.0,3
14750,14750,2015-16,2015,2016,Southampton,Bournemouth,Win,Home,2015-11-01,3,2,5,8,8,0,1,1,4,2,4,7,4,1,7.0,21.0,-14.0,4
14751,14751,2015-16,2015,2016,Southampton,Sunderland,Win,Away,2015-11-07,3,4,5,8,11,3,3,4,4,1,2,4,7,0,7.0,16.0,-9.0,4
14752,14752,2015-16,2015,2016,Southampton,Stoke,Loss,Home,2015-11-21,0,6,7,8,11,4,4,7,10,2,3,1,1,1,7.0,9.0,-2.0,4
14753,14753,2015-16,2015,2016,Southampton,Man City,Loss,Away,2015-11-28,0,3,6,7,8,1,4,5,8,2,2,2,0,0,7.0,2.0,5.0,4
14754,14754,2015-16,2015,2016,Southampton,Aston Villa,Draw,Home,2015-12-05,1,0,3,6,7,0,1,1,1,0,2,5,6,1,7.0,17.0,-10.0,5
14755,14755,2015-16,2015,2016,Southampton,Crystal Palace,Loss,Away,2015-12-12,0,1,1,4,7,4,4,7,8,-3,-3,-3,-1,0,7.0,10.0,-3.0,5
14756,14756,2015-16,2015,2016,Southampton,Tottenham,Loss,Home,2015-12-19,0,1,1,1,4,1,2,5,6,0,-1,-4,-2,1,7.0,5.0,2.0,5
14757,14757,2015-16,2015,2016,Southampton,Arsenal,Win,Home,2015-12-26,3,0,1,1,1,6,9,10,10,-6,-8,-9,-9,1,7.0,3.0,4.0,5
14758,14758,2015-16,2015,2016,Southampton,West Ham,Loss,Away,2015-12-28,0,3,3,4,4,2,3,4,5,1,0,0,-1,0,7.0,12.0,-5.0,5
14759,14759,2015-16,2015,2016,Southampton,Norwich,Loss,Away,2016-01-02,0,3,3,3,4,3,6,7,7,0,-3,-4,-3,0,7.0,21.0,-14.0,6
14760,14760,2015-16,2015,2016,Southampton,Watford,Win,Home,2016-01-13,3,0,3,3,3,0,1,4,7,0,2,-1,-4,1,7.0,21.0,-14.0,6
14761,14761,2015-16,2015,2016,Southampton,West Brom,Win,Home,2016-01-16,3,3,3,6,6,4,7,7,7,-1,-4,-1,-1,1,7.0,13.0,-6.0,6
14762,14762,2015-16,2015,2016,Southampton,Man United,Win,Away,2016-01-23,3,6,6,6,9,4,7,8,8,2,-1,-2,1,0,7.0,4.0,3.0,6
14763,14763,2015-16,2015,2016,Southampton,Arsenal,Draw,Away,2016-02-02,1,6,9,9,9,1,2,5,8,5,7,4,1,0,7.0,3.0,4.0,7
14764,14764,2015-16,2015,2016,Southampton,West Ham,Win,Home,2016-02-06,3,4,7,10,10,4,4,7,10,0,3,3,0,1,7.0,12.0,-5.0,7
14765,14765,2015-16,2015,2016,Southampton,Swansea,Win,Away,2016-02-13,3,4,7,10,13,2,5,8,8,2,2,2,5,0,7.0,8.0,-1.0,7
14766,14766,2015-16,2015,2016,Southampton,Chelsea,Loss,Home,2016-02-27,0,6,7,10,13,4,5,8,9,2,2,2,4,1,7.0,1.0,6.0,7
14767,14767,2015-16,2015,2016,Southampton,Bournemouth,Loss,Away,2016-03-01,0,3,6,7,10,1,1,4,5,2,5,3,5,0,7.0,21.0,-14.0,8
14768,14768,2015-16,2015,2016,Southampton,Sunderland,Draw,Home,2016-03-05,1,0,3,6,7,1,4,5,5,-1,-1,1,2,1,7.0,16.0,-9.0,8
14769,14769,2015-16,2015,2016,Southampton,Stoke,Win,Away,2016-03-12,3,1,1,4,7,4,7,10,10,-3,-6,-6,-3,0,7.0,9.0,-2.0,8
14770,14770,2015-16,2015,2016,Southampton,Liverpool,Win,Home,2016-03-20,3,4,4,4,7,6,9,10,10,-2,-5,-6,-3,1,7.0,6.0,1.0,8
14771,14771,2015-16,2015,2016,Southampton,Leicester,Loss,Away,2016-04-03,0,6,7,7,7,6,9,10,13,0,-2,-3,-6,0,7.0,14.0,-7.0,9
14772,14772,2015-16,2015,2016,Southampton,Newcastle,Win,Home,2016-04-09,3,3,6,7,7,1,1,1,1,2,5,6,6,1,7.0,15.0,-8.0,9
14773,14773,2015-16,2015,2016,Southampton,Everton,Draw,Away,2016-04-16,1,3,6,9,10,2,2,2,2,1,4,7,8,0,7.0,11.0,-4.0,9
14774,14774,2015-16,2015,2016,Southampton,Aston Villa,Win,Away,2016-04-23,3,4,4,7,10,0,0,0,0,4,4,7,10,0,7.0,17.0,-10.0,9
14775,14775,2015-16,2015,2016,Southampton,Man City,Win,Home,2016-05-01,3,4,7,7,10,4,7,10,13,0,0,-3,-3,1,7.0,2.0,5.0,10
14776,14776,2015-16,2015,2016,Southampton,Tottenham,Win,Away,2016-05-08,3,6,7,10,10,2,5,8,9,4,2,2,1,0,7.0,5.0,2.0,10
14777,14777,2015-16,2015,2016,Southampton,Crystal Palace,Win,Home,2016-05-15,3,6,9,10,13,3,3,4,5,3,6,6,8,1,7.0,10.0,-3.0,10
14778,14778,2016-17,2016,2017,Southampton,Watford,Draw,Home,2016-08-13,1,6,9,12,13,1,1,4,4,5,8,8,9,1,6.0,13.0,-7.0,1
14779,14779,2016-17,2016,2017,Southampton,Man United,Loss,Away,2016-08-19,0,4,7,10,13,6,6,9,10,-2,1,1,3,0,6.0,5.0,1.0,1
14780,14780,2016-17,2016,2017,Southampton,Sunderland,Draw,Home,2016-08-27,1,1,4,7,10,0,1,4,7,1,3,3,3,1,6.0,17.0,-11.0,1
14781,14781,2016-17,2016,2017,Southampton,Arsenal,Loss,Away,2016-09-10,0,1,2,5,8,4,4,7,8,-3,-2,-2,0,0,6.0,2.0,4.0,2
14782,14782,2016-17,2016,2017,Southampton,Swansea,Win,Home,2016-09-18,3,1,1,2,5,1,1,4,5,0,0,-2,0,1,6.0,12.0,-6.0,2
14783,14783,2016-17,2016,2017,Southampton,West Ham,Win,Away,2016-09-25,3,3,4,4,5,0,0,3,3,3,4,1,2,0,6.0,7.0,-1.0,2
14784,14784,2016-17,2016,2017,Southampton,Leicester,Draw,Away,2016-10-02,1,6,6,7,7,3,3,6,7,3,3,1,0,0,6.0,1.0,5.0,3
14785,14785,2016-17,2016,2017,Southampton,Burnley,Win,Home,2016-10-16,3,4,7,7,8,3,3,4,4,1,4,3,4,1,6.0,21.0,-15.0,3
14786,14786,2016-17,2016,2017,Southampton,Man City,Draw,Away,2016-10-23,1,4,7,10,10,1,4,7,10,3,3,3,0,0,6.0,4.0,2.0,3
14787,14787,2016-17,2016,2017,Southampton,Chelsea,Loss,Home,2016-10-30,0,4,5,8,11,6,9,9,9,-2,-4,-1,2,1,6.0,10.0,-4.0,3
14788,14788,2016-17,2016,2017,Southampton,Hull,Loss,Away,2016-11-06,0,1,4,5,8,0,0,0,0,1,4,5,8,0,6.0,21.0,-15.0,4
14789,14789,2016-17,2016,2017,Southampton,Liverpool,Draw,Home,2016-11-19,1,0,1,4,5,6,9,10,13,-6,-8,-6,-8,1,6.0,8.0,-2.0,4
14790,14790,2016-17,2016,2017,Southampton,Everton,Win,Home,2016-11-27,3,1,1,2,5,1,4,4,5,0,-3,-2,0,1,6.0,11.0,-5.0,4
14791,14791,2016-17,2016,2017,Southampton,Crystal Palace,Loss,Away,2016-12-03,0,4,4,4,5,0,0,0,0,4,4,4,5,0,6.0,15.0,-9.0,5
14792,14792,2016-17,2016,2017,Southampton,Middlesbrough,Win,Home,2016-12-11,3,3,4,4,4,4,4,5,8,-1,0,-1,-4,1,6.0,21.0,-15.0,5
14793,14793,2016-17,2016,2017,Southampton,Stoke,Draw,Away,2016-12-14,1,3,6,7,7,3,6,6,7,0,0,1,0,0,6.0,9.0,-3.0,5
14794,14794,2016-17,2016,2017,Southampton,Bournemouth,Win,Away,2016-12-18,3,4,4,7,8,3,6,6,9,1,-2,1,-1,0,6.0,16.0,-10.0,5
14795,14795,2016-17,2016,2017,Southampton,Tottenham,Loss,Home,2016-12-28,0,4,7,7,10,6,6,9,9,-2,1,-2,1,1,6.0,3.0,3.0,5
14796,14796,2016-17,2016,2017,Southampton,West Brom,Loss,Home,2016-12-31,0,3,4,7,7,0,3,3,6,3,1,4,1,1,6.0,14.0,-8.0,5
14797,14797,2016-17,2016,2017,Southampton,Everton,Loss,Away,2017-01-02,0,0,3,4,7,4,4,7,7,-4,-1,-3,0,0,6.0,11.0,-5.0,6
14798,14798,2016-17,2016,2017,Southampton,Burnley,Loss,Away,2017-01-14,0,0,0,3,4,3,6,6,6,-3,-6,-3,-2,0,6.0,21.0,-15.0,6
14799,14799,2016-17,2016,2017,Southampton,Leicester,Win,Home,2017-01-22,3,0,0,0,3,1,4,4,5,-1,-4,-4,-2,1,6.0,1.0,5.0,6
14800,14800,2016-17,2016,2017,Southampton,Swansea,Loss,Away,2017-01-31,0,3,3,3,3,3,6,6,6,0,-3,-3,-3,0,6.0,12.0,-6.0,6
14801,14801,2016-17,2016,2017,Southampton,West Ham,Loss,Home,2017-02-04,0,3,3,3,3,3,6,6,6,0,-3,-3,-3,1,6.0,7.0,-1.0,7
14802,14802,2016-17,2016,2017,Southampton,Sunderland,Win,Away,2017-02-11,3,0,3,3,3,4,4,4,5,-4,-1,-1,-2,0,6.0,17.0,-11.0,7
14803,14803,2016-17,2016,2017,Southampton,Watford,Win,Away,2017-03-04,3,3,3,6,6,1,4,7,8,2,-1,-1,-2,0,6.0,13.0,-7.0,8
14804,14804,2016-17,2016,2017,Southampton,Tottenham,Loss,Away,2017-03-19,0,6,6,6,9,6,6,9,10,0,0,-3,-1,0,6.0,3.0,3.0,8
14805,14805,2016-17,2016,2017,Southampton,Bournemouth,Draw,Home,2017-04-01,1,3,6,6,6,6,7,7,7,-3,-1,-1,-1,1,6.0,16.0,-10.0,9
14806,14806,2016-17,2016,2017,Southampton,Crystal Palace,Win,Home,2017-04-05,3,1,4,7,7,6,9,12,12,-5,-5,-5,-5,1,6.0,15.0,-9.0,9
14807,14807,2016-17,2016,2017,Southampton,West Brom,Win,Away,2017-04-08,3,4,4,7,10,1,4,4,4,3,0,3,6,0,6.0,14.0,-8.0,9
14808,14808,2016-17,2016,2017,Southampton,Man City,Loss,Home,2017-04-15,0,6,7,7,10,3,4,5,6,3,3,2,4,1,6.0,4.0,2.0,9
14809,14809,2016-17,2016,2017,Southampton,Chelsea,Loss,Away,2017-04-25,0,3,6,7,7,3,6,6,9,0,0,1,-2,0,6.0,10.0,-4.0,9
14810,14810,2016-17,2016,2017,Southampton,Hull,Draw,Home,2017-04-29,1,0,3,6,7,3,3,6,9,-3,0,0,-2,1,6.0,21.0,-15.0,9
14811,14811,2016-17,2016,2017,Southampton,Liverpool,Draw,Away,2017-05-07,1,1,1,4,7,3,6,9,10,-2,-5,-5,-3,0,6.0,8.0,-2.0,10
14812,14812,2016-17,2016,2017,Southampton,Arsenal,Loss,Home,2017-05-10,0,2,2,2,5,3,6,9,9,-1,-4,-7,-4,1,6.0,2.0,4.0,10
14813,14813,2016-17,2016,2017,Southampton,Middlesbrough,Win,Away,2017-05-13,3,1,2,2,2,1,4,4,4,0,-2,-2,-2,0,6.0,21.0,-15.0,10
14814,14814,2016-17,2016,2017,Southampton,Man United,Draw,Home,2017-05-17,1,3,4,5,5,0,1,2,5,3,3,3,0,1,6.0,5.0,1.0,10
14815,14815,2016-17,2016,2017,Southampton,Stoke,Loss,Home,2017-05-21,0,4,4,5,6,1,2,2,5,3,2,3,1,1,6.0,9.0,-3.0,10
14816,14816,2017-18,2017,2018,Southampton,Swansea,Draw,Home,2017-08-12,1,1,4,4,5,6,9,10,13,-5,-5,-6,-8,1,8.0,15.0,-7.0,1
14817,14817,2017-18,2017,2018,Southampton,West Ham,Win,Home,2017-08-19,3,1,2,5,5,3,3,6,7,-2,-1,-1,-2,1,8.0,11.0,-3.0,1
14818,14818,2017-18,2017,2018,Southampton,Huddersfield,Draw,Away,2017-08-26,1,4,4,5,8,6,6,6,6,-2,-2,-1,2,0,8.0,21.0,-13.0,1
14819,14819,2017-18,2017,2018,Southampton,Watford,Loss,Home,2017-09-09,0,4,5,5,6,4,5,5,5,0,0,0,1,1,8.0,17.0,-9.0,2
14820,14820,2017-18,2017,2018,Southampton,Crystal Palace,Win,Away,2017-09-16,3,1,4,5,5,0,0,0,0,1,4,5,5,0,8.0,14.0,-6.0,2
14821,14821,2017-18,2017,2018,Southampton,Man United,Loss,Home,2017-09-23,0,3,4,7,8,4,7,10,13,-1,-3,-3,-5,1,8.0,6.0,2.0,2
14822,14822,2017-18,2017,2018,Southampton,Stoke,Loss,Away,2017-09-30,0,3,3,4,7,0,1,2,5,3,2,2,2,0,8.0,13.0,-5.0,2
14823,14823,2017-18,2017,2018,Southampton,Newcastle,Draw,Home,2017-10-15,1,0,3,3,4,1,4,7,10,-1,-1,-4,-6,1,8.0,21.0,-13.0,3
14824,14824,2017-18,2017,2018,Southampton,West Brom,Win,Home,2017-10-21,3,1,1,4,4,2,2,3,3,-1,-1,1,1,1,8.0,10.0,-2.0,3
14825,14825,2017-18,2017,2018,Southampton,Brighton,Draw,Away,2017-10-29,1,4,4,4,7,4,4,7,7,0,0,-3,0,0,8.0,21.0,-13.0,3
14826,14826,2017-18,2017,2018,Southampton,Burnley,Loss,Home,2017-11-04,0,4,5,5,5,3,4,7,8,1,1,-2,-3,1,8.0,16.0,-8.0,4
14827,14827,2017-18,2017,2018,Southampton,Liverpool,Loss,Away,2017-11-18,0,1,4,5,5,6,6,7,8,-5,-2,-2,-3,0,8.0,4.0,4.0,4
14828,14828,2017-18,2017,2018,Southampton,Everton,Win,Home,2017-11-26,3,0,1,4,5,4,4,4,5,-4,-3,0,0,1,8.0,7.0,1.0,4
14829,14829,2017-18,2017,2018,Southampton,Man City,Loss,Away,2017-11-29,0,3,3,4,7,6,9,12,15,-3,-6,-8,-8,0,8.0,3.0,5.0,4
14830,14830,2017-18,2017,2018,Southampton,Bournemouth,Draw,Away,2017-12-03,1,3,3,3,4,1,4,7,7,2,-1,-4,-3,0,8.0,9.0,-1.0,5
14831,14831,2017-18,2017,2018,Southampton,Arsenal,Draw,Home,2017-12-10,1,1,4,4,4,3,6,9,9,-2,-2,-5,-5,1,8.0,5.0,3.0,5
14832,14832,2017-18,2017,2018,Southampton,Leicester,Loss,Home,2017-12-13,0,2,2,5,5,6,9,10,10,-4,-7,-5,-5,1,8.0,12.0,-4.0,5
14833,14833,2017-18,2017,2018,Southampton,Chelsea,Loss,Away,2017-12-16,0,1,2,2,5,3,6,9,10,-2,-4,-7,-5,0,8.0,1.0,7.0,5
14834,14834,2017-18,2017,2018,Southampton,Huddersfield,Draw,Home,2017-12-23,1,0,1,2,2,3,6,6,6,-3,-5,-4,-4,1,8.0,21.0,-13.0,5
14835,14835,2017-18,2017,2018,Southampton,Tottenham,Loss,Away,2017-12-26,0,1,1,2,3,3,6,9,10,-2,-5,-7,-7,0,8.0,2.0,6.0,5
14836,14836,2017-18,2017,2018,Southampton,Man United,Draw,Away,2017-12-30,1,1,1,1,2,2,5,8,8,-1,-4,-7,-6,0,8.0,6.0,2.0,5
14837,14837,2017-18,2017,2018,Southampton,Crystal Palace,Loss,Home,2018-01-02,0,1,2,2,2,1,2,5,8,0,0,-3,-6,1,8.0,14.0,-6.0,6
14838,14838,2017-18,2017,2018,Southampton,Watford,Draw,Away,2018-01-13,1,1,1,2,2,0,3,3,3,1,-2,-1,-1,0,8.0,17.0,-9.0,6
14839,14839,2017-18,2017,2018,Southampton,Tottenham,Draw,Home,2018-01-21,1,1,2,2,3,4,7,10,13,-3,-5,-8,-10,1,8.0,2.0,6.0,6
14840,14840,2017-18,2017,2018,Southampton,Brighton,Draw,Home,2018-01-31,1,2,2,3,3,0,1,2,2,2,1,1,1,1,8.0,21.0,-13.0,6
14841,14841,2017-18,2017,2018,Southampton,West Brom,Win,Away,2018-02-03,3,2,3,3,4,1,4,4,5,1,-1,-1,-1,0,8.0,10.0,-2.0,7
14842,14842,2017-18,2017,2018,Southampton,Liverpool,Loss,Home,2018-02-11,0,4,5,6,6,4,4,7,10,0,1,-1,-4,1,8.0,4.0,4.0,7
14843,14843,2017-18,2017,2018,Southampton,Burnley,Draw,Away,2018-02-24,1,3,4,5,6,1,2,2,2,2,2,3,4,0,8.0,16.0,-8.0,7
14844,14844,2017-18,2017,2018,Southampton,Stoke,Draw,Home,2018-03-03,1,1,4,5,6,2,2,3,6,-1,2,2,0,1,8.0,13.0,-5.0,8
14845,14845,2017-18,2017,2018,Southampton,Newcastle,Loss,Away,2018-03-10,0,2,2,5,6,1,4,5,6,1,-2,0,0,0,8.0,21.0,-13.0,8
14846,14846,2017-18,2017,2018,Southampton,West Ham,Loss,Away,2018-03-31,0,1,2,2,5,0,0,3,3,1,2,-1,2,0,8.0,11.0,-3.0,8
14847,14847,2017-18,2017,2018,Southampton,Arsenal,Loss,Away,2018-04-08,0,0,1,2,2,6,6,6,6,-6,-5,-4,-4,0,8.0,5.0,3.0,9
14848,14848,2017-18,2017,2018,Southampton,Chelsea,Loss,Home,2018-04-14,0,0,0,1,2,1,4,4,4,-1,-4,-3,-2,1,8.0,1.0,7.0,9
14849,14849,2017-18,2017,2018,Southampton,Leicester,Draw,Away,2018-04-19,1,0,0,0,1,0,3,6,7,0,-3,-6,-6,0,8.0,12.0,-4.0,9
14850,14850,2017-18,2017,2018,Southampton,Bournemouth,Win,Home,2018-04-28,3,1,1,1,1,0,1,2,5,1,0,-1,-4,1,8.0,9.0,-1.0,9
14851,14851,2017-18,2017,2018,Southampton,Everton,Draw,Away,2018-05-05,1,4,4,4,4,6,7,8,8,-2,-3,-4,-4,0,8.0,7.0,1.0,10
14852,14852,2017-18,2017,2018,Southampton,Swansea,Win,Away,2018-05-08,3,4,5,5,5,0,0,1,2,4,5,4,3,0,8.0,15.0,-7.0,10
14853,14853,2017-18,2017,2018,Southampton,Man City,Loss,Home,2018-05-13,0,4,7,8,8,4,7,10,13,0,0,-2,-5,1,8.0,3.0,5.0,10
14854,14854,2008-09,2008,2009,Stoke,Bolton,Loss,Away,2008-08-16,0,0,0,0,0,4,5,8,11,-4,-5,-8,-11,0,21.0,16.0,5.0,1
14855,14855,2008-09,2008,2009,Stoke,Aston Villa,Win,Home,2008-08-23,3,0,0,0,0,4,4,5,8,-4,-4,-5,-8,1,21.0,6.0,15.0,1
14856,14856,2008-09,2008,2009,Stoke,Middlesbrough,Loss,Away,2008-08-30,0,3,3,3,3,3,6,9,9,0,-3,-6,-6,0,21.0,13.0,8.0,1
14857,14857,2008-09,2008,2009,Stoke,Everton,Loss,Home,2008-09-14,0,3,3,3,3,3,3,6,6,0,0,-3,-3,1,21.0,5.0,16.0,2
14858,14858,2008-09,2008,2009,Stoke,Liverpool,Draw,Away,2008-09-20,1,0,3,3,3,4,7,10,13,-4,-4,-7,-10,0,21.0,4.0,17.0,2
14859,14859,2008-09,2008,2009,Stoke,Chelsea,Loss,Home,2008-09-27,0,1,1,4,4,4,5,8,11,-3,-4,-4,-7,1,21.0,2.0,19.0,2
14860,14860,2008-09,2008,2009,Stoke,Portsmouth,Loss,Away,2008-10-05,0,1,1,1,4,3,6,9,9,-2,-5,-8,-5,0,21.0,8.0,13.0,3
14861,14861,2008-09,2008,2009,Stoke,Tottenham,Win,Home,2008-10-19,3,0,1,1,1,0,1,1,2,0,0,0,-1,1,21.0,11.0,10.0,3
14862,14862,2008-09,2008,2009,Stoke,Man City,Loss,Away,2008-10-26,0,3,3,4,4,1,1,4,4,2,2,0,0,0,21.0,9.0,12.0,3
14863,14863,2008-09,2008,2009,Stoke,Sunderland,Win,Home,2008-10-29,3,3,3,3,4,4,5,5,8,-1,-2,-2,-4,1,21.0,15.0,6.0,3
14864,14864,2008-09,2008,2009,Stoke,Arsenal,Win,Home,2008-11-01,3,3,6,6,6,4,7,8,8,-1,-1,-2,-2,1,21.0,3.0,18.0,4
14865,14865,2008-09,2008,2009,Stoke,Wigan,Draw,Away,2008-11-08,1,6,6,9,9,3,3,3,3,3,3,6,6,0,21.0,14.0,7.0,4
14866,14866,2008-09,2008,2009,Stoke,Man United,Loss,Away,2008-11-15,0,4,7,7,10,3,6,7,10,1,1,0,0,0,21.0,1.0,20.0,4
14867,14867,2008-09,2008,2009,Stoke,West Brom,Win,Home,2008-11-22,3,1,4,7,7,0,1,1,1,1,3,6,6,1,21.0,21.0,0.0,4
14868,14868,2008-09,2008,2009,Stoke,Hull,Draw,Home,2008-11-29,1,3,4,7,10,2,2,2,2,1,2,5,8,1,21.0,21.0,0.0,4
14869,14869,2008-09,2008,2009,Stoke,Newcastle,Draw,Away,2008-12-06,1,4,4,5,8,2,3,3,6,2,1,2,2,0,21.0,12.0,9.0,5
14870,14870,2008-09,2008,2009,Stoke,Fulham,Draw,Home,2008-12-13,1,2,5,5,6,2,3,6,9,0,2,-1,-3,1,21.0,17.0,4.0,5
14871,14871,2008-09,2008,2009,Stoke,Blackburn,Loss,Away,2008-12-20,0,2,3,6,6,0,0,0,0,2,3,6,6,0,21.0,7.0,14.0,5
14872,14872,2008-09,2008,2009,Stoke,Man United,Loss,Home,2008-12-26,0,1,2,3,6,4,7,8,11,-3,-5,-5,-5,1,21.0,1.0,20.0,5
14873,14873,2008-09,2008,2009,Stoke,West Ham,Loss,Away,2008-12-28,0,0,1,2,3,3,4,4,5,-3,-3,-2,-2,0,21.0,10.0,11.0,5
14874,14874,2008-09,2008,2009,Stoke,Liverpool,Draw,Home,2009-01-10,1,0,0,1,2,6,7,8,11,-6,-7,-7,-9,1,21.0,4.0,17.0,6
14875,14875,2008-09,2008,2009,Stoke,Chelsea,Loss,Away,2009-01-17,0,1,1,1,2,1,4,5,6,0,-3,-4,-4,0,21.0,2.0,19.0,6
14876,14876,2008-09,2008,2009,Stoke,Tottenham,Loss,Away,2009-01-27,0,1,1,1,1,1,1,2,2,0,0,-1,-1,0,21.0,11.0,10.0,6
14877,14877,2008-09,2008,2009,Stoke,Man City,Win,Home,2009-01-31,3,0,1,1,1,6,7,10,10,-6,-6,-9,-9,1,21.0,9.0,12.0,6
14878,14878,2008-09,2008,2009,Stoke,Sunderland,Loss,Away,2009-02-07,0,3,3,4,4,4,4,5,5,-1,-1,-1,-1,0,21.0,15.0,6.0,7
14879,14879,2008-09,2008,2009,Stoke,Portsmouth,Draw,Home,2009-02-21,1,3,3,3,4,3,3,3,4,0,0,0,0,1,21.0,8.0,13.0,7
14880,14880,2008-09,2008,2009,Stoke,Aston Villa,Draw,Away,2009-03-01,1,1,4,4,4,3,4,7,10,-2,0,-3,-6,0,21.0,6.0,15.0,8
14881,14881,2008-09,2008,2009,Stoke,Bolton,Win,Home,2009-03-04,3,2,2,5,5,6,6,9,10,-4,-4,-4,-5,1,21.0,16.0,5.0,8
14882,14882,2008-09,2008,2009,Stoke,Everton,Loss,Away,2009-03-14,0,4,5,5,8,4,5,8,8,0,0,-3,0,0,21.0,5.0,16.0,8
14883,14883,2008-09,2008,2009,Stoke,Middlesbrough,Win,Home,2009-03-21,3,3,4,5,5,1,4,5,5,2,0,0,0,1,21.0,13.0,8.0,8
14884,14884,2008-09,2008,2009,Stoke,West Brom,Win,Away,2009-04-04,3,3,6,7,8,2,2,2,2,1,4,5,6,0,21.0,21.0,0.0,9
14885,14885,2008-09,2008,2009,Stoke,Newcastle,Draw,Home,2009-04-11,1,6,6,9,10,0,1,1,1,6,5,8,9,1,21.0,12.0,9.0,9
14886,14886,2008-09,2008,2009,Stoke,Blackburn,Win,Home,2009-04-18,3,4,7,7,10,3,4,4,7,1,3,3,3,1,21.0,7.0,14.0,9
14887,14887,2008-09,2008,2009,Stoke,Fulham,Loss,Away,2009-04-25,0,4,7,10,10,4,4,7,10,0,3,3,0,0,21.0,17.0,4.0,9
14888,14888,2008-09,2008,2009,Stoke,West Ham,Loss,Home,2009-05-02,0,3,4,7,10,1,1,4,5,2,3,3,5,1,21.0,10.0,11.0,10
14889,14889,2008-09,2008,2009,Stoke,Hull,Win,Away,2009-05-09,3,0,3,4,7,0,0,0,1,0,3,4,6,0,21.0,21.0,0.0,10
14890,14890,2008-09,2008,2009,Stoke,Wigan,Win,Home,2009-05-16,3,3,3,6,7,0,1,1,1,3,2,5,6,1,21.0,14.0,7.0,10
14891,14891,2008-09,2008,2009,Stoke,Arsenal,Loss,Away,2009-05-24,0,6,6,6,9,1,4,7,8,5,2,-1,1,0,21.0,3.0,18.0,10
14892,14892,2009-10,2009,2010,Stoke,Burnley,Win,Home,2009-08-15,3,3,6,6,6,0,0,0,0,3,6,6,6,1,12.0,21.0,-9.0,1
14893,14893,2009-10,2009,2010,Stoke,Liverpool,Loss,Away,2009-08-19,0,3,6,9,9,3,6,9,12,0,0,0,-3,0,12.0,2.0,10.0,1
14894,14894,2009-10,2009,2010,Stoke,Birmingham,Draw,Away,2009-08-22,1,3,3,6,9,3,6,6,7,0,-3,0,2,0,12.0,21.0,-9.0,1
14895,14895,2009-10,2009,2010,Stoke,Sunderland,Win,Home,2009-08-29,3,1,4,4,7,3,6,6,6,-2,-2,-2,1,1,12.0,16.0,-4.0,1
14896,14896,2009-10,2009,2010,Stoke,Chelsea,Loss,Home,2009-09-12,0,4,4,7,7,6,9,12,15,-2,-5,-5,-8,1,12.0,3.0,9.0,2
14897,14897,2009-10,2009,2010,Stoke,Bolton,Draw,Away,2009-09-19,1,3,4,4,7,3,3,3,3,0,1,1,4,0,12.0,13.0,-1.0,2
14898,14898,2009-10,2009,2010,Stoke,Man United,Loss,Home,2009-09-26,0,1,4,5,5,6,9,12,12,-5,-5,-7,-7,1,12.0,1.0,11.0,2
14899,14899,2009-10,2009,2010,Stoke,Everton,Draw,Away,2009-10-04,1,1,1,4,5,6,6,9,9,-5,-5,-5,-4,0,12.0,5.0,7.0,3
14900,14900,2009-10,2009,2010,Stoke,West Ham,Win,Home,2009-10-17,3,1,2,2,5,1,1,1,2,0,1,1,3,1,12.0,9.0,3.0,3
14901,14901,2009-10,2009,2010,Stoke,Tottenham,Win,Away,2009-10-24,3,4,4,5,5,4,7,7,7,0,-3,-2,-2,0,12.0,8.0,4.0,3
14902,14902,2009-10,2009,2010,Stoke,Wolves,Draw,Home,2009-10-31,1,6,7,7,8,2,2,2,5,4,5,5,3,1,12.0,21.0,-9.0,3
14903,14903,2009-10,2009,2010,Stoke,Hull,Loss,Away,2009-11-08,0,4,7,8,8,1,1,4,4,3,6,4,4,0,12.0,17.0,-5.0,4
14904,14904,2009-10,2009,2010,Stoke,Portsmouth,Win,Home,2009-11-22,3,1,4,7,8,3,4,4,7,-2,0,3,1,1,12.0,14.0,-2.0,4
14905,14905,2009-10,2009,2010,Stoke,Blackburn,Draw,Away,2009-11-28,1,3,4,7,10,3,6,6,6,0,-2,1,4,0,12.0,15.0,-3.0,4
14906,14906,2009-10,2009,2010,Stoke,Arsenal,Loss,Away,2009-12-05,0,4,4,5,8,0,3,6,7,4,1,-1,1,0,12.0,4.0,8.0,5
14907,14907,2009-10,2009,2010,Stoke,Wigan,Draw,Home,2009-12-12,1,1,4,4,5,3,3,4,4,-2,1,0,1,1,12.0,11.0,1.0,5
14908,14908,2009-10,2009,2010,Stoke,Aston Villa,Loss,Away,2009-12-19,0,1,2,5,5,6,9,10,11,-5,-7,-5,-6,0,12.0,6.0,6.0,5
14909,14909,2009-10,2009,2010,Stoke,Man City,Loss,Away,2009-12-26,0,1,1,2,5,3,4,7,8,-2,-3,-5,-3,0,12.0,10.0,2.0,5
14910,14910,2009-10,2009,2010,Stoke,Birmingham,Loss,Home,2009-12-28,0,0,1,1,2,2,5,8,11,-2,-4,-7,-9,1,12.0,21.0,-9.0,5
14911,14911,2009-10,2009,2010,Stoke,Fulham,Win,Home,2010-01-05,3,0,0,1,1,1,4,5,8,-1,-4,-4,-7,1,12.0,7.0,5.0,6
14912,14912,2009-10,2009,2010,Stoke,Liverpool,Draw,Home,2010-01-16,1,3,3,3,4,6,6,9,9,-3,-3,-6,-5,1,12.0,2.0,10.0,6
14913,14913,2009-10,2009,2010,Stoke,Sunderland,Draw,Away,2010-02-01,1,4,4,4,4,0,1,2,2,4,3,2,2,0,12.0,16.0,-4.0,7
14914,14914,2009-10,2009,2010,Stoke,Blackburn,Win,Home,2010-02-06,3,2,5,5,5,4,7,7,8,-2,-2,-2,-3,1,12.0,15.0,-3.0,7
14915,14915,2009-10,2009,2010,Stoke,Wigan,Draw,Away,2010-02-09,1,4,5,8,8,1,1,4,4,3,4,4,4,0,12.0,11.0,1.0,7
14916,14916,2009-10,2009,2010,Stoke,Man City,Draw,Home,2010-02-16,1,4,5,6,9,3,6,6,9,1,-1,0,0,1,12.0,10.0,2.0,7
14917,14917,2009-10,2009,2010,Stoke,Portsmouth,Win,Away,2010-02-20,3,2,5,6,7,1,1,1,2,1,4,5,5,0,12.0,14.0,-2.0,7
14918,14918,2009-10,2009,2010,Stoke,Arsenal,Loss,Home,2010-02-27,0,4,5,8,9,6,6,6,7,-2,-1,2,2,1,12.0,4.0,8.0,7
14919,14919,2009-10,2009,2010,Stoke,Burnley,Draw,Away,2010-03-10,1,3,4,5,8,0,0,0,3,3,4,5,5,0,12.0,21.0,-9.0,8
14920,14920,2009-10,2009,2010,Stoke,Aston Villa,Draw,Home,2010-03-13,1,1,4,5,6,4,5,8,9,-3,-1,-3,-3,1,12.0,6.0,6.0,8
14921,14921,2009-10,2009,2010,Stoke,Tottenham,Loss,Home,2010-03-20,0,2,2,5,6,6,9,9,10,-4,-7,-4,-4,1,12.0,8.0,4.0,8
14922,14922,2009-10,2009,2010,Stoke,West Ham,Win,Away,2010-03-27,3,1,2,2,5,0,0,0,0,1,2,2,5,0,12.0,9.0,3.0,8
14923,14923,2009-10,2009,2010,Stoke,Hull,Win,Home,2010-04-03,3,3,4,5,5,3,3,3,3,0,1,2,2,1,12.0,17.0,-5.0,9
14924,14924,2009-10,2009,2010,Stoke,Wolves,Draw,Away,2010-04-11,1,6,6,7,8,1,4,5,8,5,2,2,0,0,12.0,21.0,-9.0,9
14925,14925,2009-10,2009,2010,Stoke,Bolton,Loss,Home,2010-04-17,0,4,7,7,8,0,0,0,3,4,7,7,5,1,12.0,13.0,-1.0,9
14926,14926,2009-10,2009,2010,Stoke,Chelsea,Loss,Away,2010-04-25,0,1,4,7,7,3,6,9,12,-2,-2,-2,-5,0,12.0,3.0,9.0,9
14927,14927,2009-10,2009,2010,Stoke,Everton,Draw,Home,2010-05-01,1,0,1,4,7,6,7,8,9,-6,-6,-4,-2,1,12.0,5.0,7.0,10
14928,14928,2009-10,2009,2010,Stoke,Fulham,Win,Away,2010-05-05,3,1,1,2,5,3,4,5,8,-2,-3,-3,-3,0,12.0,7.0,5.0,10
14929,14929,2009-10,2009,2010,Stoke,Man United,Loss,Away,2010-05-09,0,4,4,4,5,6,9,10,10,-2,-5,-6,-5,0,12.0,1.0,11.0,10
14930,14930,2010-11,2010,2011,Stoke,Wolves,Loss,Away,2010-08-14,0,3,4,4,4,3,4,5,6,0,0,-1,-2,0,11.0,15.0,-4.0,1
14931,14931,2010-11,2010,2011,Stoke,Tottenham,Loss,Home,2010-08-21,0,0,3,4,4,1,4,7,7,-1,-1,-3,-3,1,11.0,4.0,7.0,1
14932,14932,2010-11,2010,2011,Stoke,Chelsea,Loss,Away,2010-08-28,0,0,0,3,4,6,9,12,15,-6,-9,-9,-11,0,11.0,1.0,10.0,1
14933,14933,2010-11,2010,2011,Stoke,Aston Villa,Win,Home,2010-09-13,3,0,0,0,3,3,6,6,6,-3,-6,-6,-3,1,11.0,6.0,5.0,2
14934,14934,2010-11,2010,2011,Stoke,West Ham,Draw,Home,2010-09-18,1,3,3,3,3,0,0,0,1,3,3,3,2,1,11.0,17.0,-6.0,2
14935,14935,2010-11,2010,2011,Stoke,Newcastle,Win,Away,2010-09-26,3,4,4,4,4,3,4,7,7,1,0,-3,-3,0,11.0,21.0,-10.0,2
14936,14936,2010-11,2010,2011,Stoke,Blackburn,Win,Home,2010-10-02,3,4,7,7,7,4,5,5,5,0,2,2,2,1,11.0,10.0,1.0,3
14937,14937,2010-11,2010,2011,Stoke,Bolton,Loss,Away,2010-10-16,0,6,7,10,10,2,3,3,4,4,4,7,6,0,11.0,14.0,-3.0,3
14938,14938,2010-11,2010,2011,Stoke,Man United,Loss,Home,2010-10-24,0,3,6,7,10,2,3,6,7,1,3,1,3,1,11.0,2.0,9.0,3
14939,14939,2010-11,2010,2011,Stoke,Everton,Loss,Away,2010-10-30,0,0,3,6,7,4,7,8,8,-4,-4,-2,-1,0,11.0,8.0,3.0,3
14940,14940,2010-11,2010,2011,Stoke,Sunderland,Loss,Away,2010-11-06,0,0,0,3,6,3,4,5,6,-3,-4,-2,0,0,11.0,13.0,-2.0,4
14941,14941,2010-11,2010,2011,Stoke,Birmingham,Win,Home,2010-11-09,3,0,0,0,3,2,5,5,5,-2,-5,-5,-2,1,11.0,9.0,2.0,4
14942,14942,2010-11,2010,2011,Stoke,Liverpool,Win,Home,2010-11-13,3,3,3,3,3,4,7,10,10,-1,-4,-7,-7,1,11.0,7.0,4.0,4
14943,14943,2010-11,2010,2011,Stoke,West Brom,Win,Away,2010-11-20,3,6,6,6,6,1,1,1,4,5,5,5,2,0,11.0,21.0,-10.0,4
14944,14944,2010-11,2010,2011,Stoke,Man City,Draw,Home,2010-11-27,1,6,9,9,9,4,5,8,8,2,4,1,1,1,11.0,5.0,6.0,4
14945,14945,2010-11,2010,2011,Stoke,Wigan,Draw,Away,2010-12-04,1,4,7,10,10,0,3,4,4,4,4,6,6,0,11.0,16.0,-5.0,5
14946,14946,2010-11,2010,2011,Stoke,Blackpool,Loss,Home,2010-12-11,0,2,5,8,11,4,5,5,6,-2,0,3,5,1,11.0,21.0,-10.0,5
14947,14947,2010-11,2010,2011,Stoke,Blackburn,Win,Away,2010-12-26,3,1,2,5,8,1,4,4,7,0,-2,1,1,0,11.0,10.0,1.0,5
14948,14948,2010-11,2010,2011,Stoke,Fulham,Loss,Home,2010-12-28,0,3,4,5,8,1,1,2,2,2,3,3,6,1,11.0,12.0,-1.0,5
14949,14949,2010-11,2010,2011,Stoke,Everton,Win,Home,2011-01-01,3,3,3,4,5,4,5,6,6,-1,-2,-2,-1,1,11.0,8.0,3.0,6
14950,14950,2010-11,2010,2011,Stoke,Man United,Loss,Away,2011-01-04,0,3,6,6,7,4,7,10,13,-1,-1,-4,-6,0,11.0,2.0,9.0,6
14951,14951,2010-11,2010,2011,Stoke,Bolton,Win,Home,2011-01-15,3,3,3,6,6,1,1,4,4,2,2,2,2,1,11.0,14.0,-3.0,6
14952,14952,2010-11,2010,2011,Stoke,Fulham,Loss,Away,2011-01-22,0,3,6,6,9,4,4,7,7,-1,2,-1,2,0,11.0,12.0,-1.0,6
14953,14953,2010-11,2010,2011,Stoke,Liverpool,Loss,Away,2011-02-02,0,3,3,6,6,6,7,7,7,-3,-4,-1,-1,0,11.0,7.0,4.0,7
14954,14954,2010-11,2010,2011,Stoke,Sunderland,Win,Home,2011-02-05,3,0,3,3,6,3,4,7,10,-3,-1,-4,-4,1,11.0,13.0,-2.0,7
14955,14955,2010-11,2010,2011,Stoke,Birmingham,Loss,Away,2011-02-12,0,3,3,6,6,4,4,5,8,-1,-1,1,-2,0,11.0,9.0,2.0,7
14956,14956,2010-11,2010,2011,Stoke,Arsenal,Loss,Away,2011-02-23,0,3,3,3,6,4,7,10,13,-1,-4,-7,-7,0,11.0,3.0,8.0,7
14957,14957,2010-11,2010,2011,Stoke,West Brom,Draw,Home,2011-02-28,1,0,3,3,3,2,2,3,3,-2,1,0,0,1,11.0,21.0,-10.0,7
14958,14958,2010-11,2010,2011,Stoke,West Ham,Loss,Away,2011-03-05,0,1,1,4,4,4,4,7,8,-3,-3,-3,-4,0,11.0,17.0,-6.0,8
14959,14959,2010-11,2010,2011,Stoke,Newcastle,Win,Home,2011-03-19,3,1,1,1,4,1,4,5,6,0,-3,-4,-2,1,11.0,21.0,-10.0,8
14960,14960,2010-11,2010,2011,Stoke,Chelsea,Draw,Home,2011-04-02,1,3,4,4,4,6,9,10,10,-3,-5,-6,-6,1,11.0,1.0,10.0,9
14961,14961,2010-11,2010,2011,Stoke,Tottenham,Loss,Away,2011-04-09,0,4,4,5,5,2,3,3,6,2,1,2,-1,0,11.0,4.0,7.0,9
14962,14962,2010-11,2010,2011,Stoke,Aston Villa,Draw,Away,2011-04-23,1,1,4,4,5,6,7,7,7,-5,-3,-3,-2,0,11.0,6.0,5.0,9
14963,14963,2010-11,2010,2011,Stoke,Wolves,Win,Home,2011-04-26,3,1,2,5,5,1,1,4,5,0,1,1,0,1,11.0,15.0,-4.0,9
14964,14964,2010-11,2010,2011,Stoke,Blackpool,Draw,Away,2011-04-30,1,4,4,5,8,1,1,1,2,3,3,4,6,0,11.0,21.0,-10.0,9
14965,14965,2010-11,2010,2011,Stoke,Arsenal,Win,Home,2011-05-08,3,4,5,5,6,3,4,5,8,1,1,0,-2,1,11.0,3.0,8.0,10
14966,14966,2010-11,2010,2011,Stoke,Man City,Loss,Away,2011-05-17,0,4,7,8,8,3,6,9,9,1,1,-1,-1,0,11.0,5.0,6.0,10
14967,14967,2010-11,2010,2011,Stoke,Wigan,Loss,Home,2011-05-22,0,3,4,7,8,4,5,5,8,-1,-1,2,0,1,11.0,16.0,-5.0,10
14968,14968,2011-12,2011,2012,Stoke,Chelsea,Draw,Home,2011-08-14,1,0,3,4,7,1,1,4,7,-1,2,0,0,1,13.0,2.0,11.0,1
14969,14969,2011-12,2011,2012,Stoke,Norwich,Draw,Away,2011-08-21,1,1,1,4,5,1,4,4,7,0,-3,0,-2,0,13.0,21.0,-8.0,1
14970,14970,2011-12,2011,2012,Stoke,West Brom,Win,Away,2011-08-28,3,2,2,2,5,0,1,4,4,2,1,-2,1,0,13.0,11.0,2.0,1
14971,14971,2011-12,2011,2012,Stoke,Liverpool,Win,Home,2011-09-10,3,4,5,5,5,6,7,7,7,-2,-2,-2,-2,1,13.0,6.0,7.0,2
14972,14972,2011-12,2011,2012,Stoke,Sunderland,Loss,Away,2011-09-18,0,6,7,8,8,1,1,2,5,5,6,6,3,0,13.0,10.0,3.0,2
14973,14973,2011-12,2011,2012,Stoke,Man United,Draw,Home,2011-09-24,1,3,6,7,8,6,9,12,15,-3,-3,-5,-7,1,13.0,1.0,12.0,2
14974,14974,2011-12,2011,2012,Stoke,Swansea,Loss,Away,2011-10-02,0,1,4,7,8,3,3,4,5,-2,1,3,3,0,13.0,21.0,-8.0,3
14975,14975,2011-12,2011,2012,Stoke,Fulham,Win,Home,2011-10-15,3,1,1,4,7,4,5,6,6,-3,-4,-2,1,1,13.0,8.0,5.0,3
14976,14976,2011-12,2011,2012,Stoke,Arsenal,Loss,Away,2011-10-23,0,3,4,4,7,3,6,6,9,0,-2,-2,-2,0,13.0,4.0,9.0,3
14977,14977,2011-12,2011,2012,Stoke,Newcastle,Loss,Home,2011-10-31,0,3,3,4,4,4,7,10,11,-1,-4,-6,-7,1,13.0,12.0,1.0,3
14978,14978,2011-12,2011,2012,Stoke,Bolton,Loss,Away,2011-11-06,0,0,3,3,4,0,3,3,3,0,0,0,1,0,13.0,14.0,-1.0,4
14979,14979,2011-12,2011,2012,Stoke,QPR,Loss,Home,2011-11-19,0,0,0,3,3,0,3,4,4,0,-3,-1,-1,1,13.0,21.0,-8.0,4
14980,14980,2011-12,2011,2012,Stoke,Blackburn,Win,Home,2011-11-26,3,0,0,0,3,1,2,2,3,-1,-2,-2,0,1,13.0,15.0,-2.0,4
14981,14981,2011-12,2011,2012,Stoke,Everton,Win,Away,2011-12-04,3,3,3,3,3,6,6,6,9,-3,-3,-3,-6,0,13.0,7.0,6.0,5
14982,14982,2011-12,2011,2012,Stoke,Tottenham,Win,Home,2011-12-11,3,6,6,6,6,6,9,12,15,0,-3,-6,-9,1,13.0,5.0,8.0,5
14983,14983,2011-12,2011,2012,Stoke,Wolves,Win,Away,2011-12-17,3,6,9,9,9,3,3,3,6,3,6,6,3,0,13.0,17.0,-4.0,5
14984,14984,2011-12,2011,2012,Stoke,Man City,Loss,Away,2011-12-21,0,6,9,12,12,3,6,7,10,3,3,5,2,0,13.0,3.0,10.0,5
14985,14985,2011-12,2011,2012,Stoke,Aston Villa,Draw,Home,2011-12-26,1,3,6,9,12,0,3,3,4,3,3,6,8,1,13.0,9.0,4.0,5
14986,14986,2011-12,2011,2012,Stoke,Wigan,Draw,Home,2011-12-31,1,1,4,7,10,1,2,5,5,0,2,2,5,1,13.0,16.0,-3.0,5
14987,14987,2011-12,2011,2012,Stoke,Blackburn,Win,Away,2012-01-02,3,2,2,5,8,4,4,4,4,-2,-2,1,4,0,13.0,15.0,-2.0,6
14988,14988,2011-12,2011,2012,Stoke,Liverpool,Draw,Away,2012-01-14,1,4,5,5,8,3,4,5,8,1,1,0,0,0,13.0,6.0,7.0,6
14989,14989,2011-12,2011,2012,Stoke,West Brom,Loss,Home,2012-01-21,0,4,5,6,6,0,0,1,4,4,5,5,2,1,13.0,11.0,2.0,6
14990,14990,2011-12,2011,2012,Stoke,Man United,Loss,Away,2012-01-31,0,1,4,5,6,6,6,6,9,-5,-2,-1,-3,0,13.0,1.0,12.0,6
14991,14991,2011-12,2011,2012,Stoke,Sunderland,Loss,Home,2012-02-04,0,0,1,4,5,6,6,9,12,-6,-5,-5,-7,1,13.0,10.0,3.0,7
14992,14992,2011-12,2011,2012,Stoke,Fulham,Loss,Away,2012-02-11,0,0,0,1,4,1,4,4,7,-1,-4,-3,-3,0,13.0,8.0,5.0,7
14993,14993,2011-12,2011,2012,Stoke,Swansea,Win,Home,2012-02-26,3,0,0,0,1,3,4,4,7,-3,-4,-4,-6,1,13.0,21.0,-8.0,7
14994,14994,2011-12,2011,2012,Stoke,Norwich,Win,Home,2012-03-03,3,3,3,3,3,3,6,6,7,0,-3,-3,-4,1,13.0,21.0,-8.0,8
14995,14995,2011-12,2011,2012,Stoke,Chelsea,Loss,Away,2012-03-10,0,6,6,6,6,3,3,4,5,3,3,2,1,0,13.0,2.0,11.0,8
14996,14996,2011-12,2011,2012,Stoke,Tottenham,Draw,Away,2012-03-21,1,3,6,6,6,0,0,3,4,3,6,3,2,0,13.0,5.0,8.0,8
14997,14997,2011-12,2011,2012,Stoke,Man City,Draw,Home,2012-03-24,1,1,4,7,7,3,6,9,12,-2,-2,-2,-5,1,13.0,3.0,10.0,8
14998,14998,2011-12,2011,2012,Stoke,Wigan,Loss,Away,2012-03-31,0,2,2,5,8,4,5,5,6,-2,-3,0,2,0,13.0,16.0,-3.0,8
14999,14999,2011-12,2011,2012,Stoke,Wolves,Win,Home,2012-04-07,3,1,2,2,5,0,0,0,0,1,2,2,5,1,13.0,17.0,-4.0,9
15000,15000,2011-12,2011,2012,Stoke,Aston Villa,Draw,Away,2012-04-09,1,3,4,5,5,1,1,4,5,2,3,1,0,0,13.0,9.0,4.0,9
15001,15001,2011-12,2011,2012,Stoke,Newcastle,Loss,Away,2012-04-21,0,4,4,5,6,6,9,12,15,-2,-5,-7,-9,0,13.0,12.0,1.0,9
15002,15002,2011-12,2011,2012,Stoke,Arsenal,Draw,Home,2012-04-28,1,1,4,4,5,1,4,7,7,0,0,-3,-2,1,13.0,4.0,9.0,9
15003,15003,2011-12,2011,2012,Stoke,Everton,Draw,Home,2012-05-01,1,1,2,5,5,4,7,8,11,-3,-5,-3,-6,1,13.0,7.0,6.0,10
15004,15004,2011-12,2011,2012,Stoke,QPR,Loss,Away,2012-05-06,0,2,2,3,6,3,3,6,6,-1,-1,-3,0,0,13.0,21.0,-8.0,10
15005,15005,2011-12,2011,2012,Stoke,Bolton,Draw,Home,2012-05-13,1,1,2,2,3,1,2,5,6,0,0,-3,-3,1,13.0,14.0,-1.0,10
15006,15006,2012-13,2012,2013,Stoke,Reading,Draw,Away,2012-08-18,1,1,2,3,3,3,4,4,4,-2,-2,-1,-1,0,14.0,21.0,-7.0,1
15007,15007,2012-13,2012,2013,Stoke,Arsenal,Draw,Home,2012-08-26,1,2,2,3,4,4,5,6,7,-2,-3,-3,-3,1,14.0,3.0,11.0,1
15008,15008,2012-13,2012,2013,Stoke,Wigan,Draw,Away,2012-09-01,1,2,3,3,4,3,6,9,12,-1,-3,-6,-8,0,14.0,15.0,-1.0,2
15009,15009,2012-13,2012,2013,Stoke,Man City,Draw,Home,2012-09-15,1,2,3,4,4,4,7,10,13,-2,-4,-6,-9,1,14.0,1.0,13.0,2
15010,15010,2012-13,2012,2013,Stoke,Chelsea,Loss,Away,2012-09-22,0,2,3,4,5,4,7,10,13,-2,-4,-6,-8,0,14.0,6.0,8.0,2
15011,15011,2012-13,2012,2013,Stoke,Swansea,Win,Home,2012-09-29,3,1,2,3,4,0,1,4,7,1,1,-1,-3,1,14.0,11.0,3.0,2
15012,15012,2012-13,2012,2013,Stoke,Liverpool,Draw,Away,2012-10-07,1,3,4,5,6,3,4,4,5,0,0,1,1,0,14.0,8.0,6.0,3
15013,15013,2012-13,2012,2013,Stoke,Man United,Loss,Away,2012-10-20,0,4,4,5,6,3,6,9,12,1,-2,-4,-6,0,14.0,2.0,12.0,3
15014,15014,2012-13,2012,2013,Stoke,Sunderland,Draw,Home,2012-10-27,1,1,4,4,5,1,4,5,6,0,0,-1,-1,1,14.0,13.0,1.0,3
15015,15015,2012-13,2012,2013,Stoke,Norwich,Loss,Away,2012-11-03,0,1,2,5,5,4,4,4,4,-3,-2,1,1,0,14.0,12.0,2.0,4
15016,15016,2012-13,2012,2013,Stoke,QPR,Win,Home,2012-11-10,3,1,1,2,5,1,2,2,2,0,-1,0,3,1,14.0,17.0,-3.0,4
15017,15017,2012-13,2012,2013,Stoke,West Ham,Draw,Away,2012-11-19,1,3,4,4,5,4,4,7,7,-1,0,-3,-2,0,14.0,21.0,-7.0,4
15018,15018,2012-13,2012,2013,Stoke,Fulham,Win,Home,2012-11-24,3,4,4,5,5,1,2,3,6,3,2,2,-1,1,14.0,9.0,5.0,4
15019,15019,2012-13,2012,2013,Stoke,Newcastle,Win,Home,2012-11-28,3,4,7,7,8,0,0,1,4,4,7,6,4,1,14.0,5.0,9.0,4
15020,15020,2012-13,2012,2013,Stoke,West Brom,Win,Away,2012-12-01,3,6,7,10,10,3,6,9,12,3,1,1,-2,0,14.0,10.0,4.0,5
15021,15021,2012-13,2012,2013,Stoke,Aston Villa,Draw,Away,2012-12-08,1,6,9,10,13,4,5,5,5,2,4,5,8,0,14.0,16.0,-2.0,5
15022,15022,2012-13,2012,2013,Stoke,Everton,Draw,Home,2012-12-15,1,4,7,10,11,4,5,6,6,0,2,4,5,1,14.0,7.0,7.0,5
15023,15023,2012-13,2012,2013,Stoke,Tottenham,Draw,Away,2012-12-22,1,2,5,8,11,3,6,9,12,-1,-1,-1,-1,0,14.0,4.0,10.0,5
15024,15024,2012-13,2012,2013,Stoke,Liverpool,Win,Home,2012-12-26,3,2,3,6,9,3,6,9,9,-1,-3,-3,0,1,14.0,8.0,6.0,5
15025,15025,2012-13,2012,2013,Stoke,Southampton,Draw,Home,2012-12-29,1,4,5,6,9,1,4,4,5,3,1,2,4,1,14.0,21.0,-7.0,5
15026,15026,2012-13,2012,2013,Stoke,Man City,Loss,Away,2013-01-01,0,4,5,6,7,3,6,9,9,1,-1,-3,-2,0,14.0,1.0,13.0,6
15027,15027,2012-13,2012,2013,Stoke,Chelsea,Loss,Home,2013-01-12,0,1,4,5,6,3,6,9,12,-2,-2,-4,-6,1,14.0,6.0,8.0,6
15028,15028,2012-13,2012,2013,Stoke,Swansea,Loss,Away,2013-01-19,0,0,1,4,5,2,5,6,7,-2,-4,-2,-2,0,14.0,11.0,3.0,6
15029,15029,2012-13,2012,2013,Stoke,Wigan,Draw,Home,2013-01-29,1,0,0,1,4,1,1,4,4,-1,-1,-3,0,1,14.0,15.0,-1.0,6
15030,15030,2012-13,2012,2013,Stoke,Arsenal,Loss,Away,2013-02-02,0,1,1,1,2,4,4,4,5,-3,-3,-3,-3,0,14.0,3.0,11.0,7
15031,15031,2012-13,2012,2013,Stoke,Reading,Win,Home,2013-02-09,3,1,1,1,1,4,7,10,10,-3,-6,-9,-9,1,14.0,21.0,-7.0,7
15032,15032,2012-13,2012,2013,Stoke,Fulham,Loss,Away,2013-02-23,0,3,4,4,4,1,4,4,5,2,0,0,-1,0,14.0,9.0,5.0,7
15033,15033,2012-13,2012,2013,Stoke,West Ham,Loss,Home,2013-03-02,0,3,3,4,4,0,3,3,3,3,0,1,1,1,14.0,21.0,-7.0,8
15034,15034,2012-13,2012,2013,Stoke,Newcastle,Loss,Away,2013-03-10,0,0,3,3,4,3,3,6,9,-3,0,-3,-5,0,14.0,5.0,9.0,8
15035,15035,2012-13,2012,2013,Stoke,West Brom,Draw,Home,2013-03-16,1,0,0,3,3,3,6,9,9,-3,-6,-6,-6,1,14.0,10.0,4.0,8
15036,15036,2012-13,2012,2013,Stoke,Everton,Loss,Away,2013-03-30,0,1,1,1,4,6,6,6,7,-5,-5,-5,-3,0,14.0,7.0,7.0,8
15037,15037,2012-13,2012,2013,Stoke,Aston Villa,Loss,Home,2013-04-06,0,1,1,1,1,3,6,6,6,-2,-5,-5,-5,1,14.0,16.0,-2.0,9
15038,15038,2012-13,2012,2013,Stoke,Man United,Loss,Home,2013-04-14,0,0,1,1,1,3,6,9,12,-3,-5,-8,-11,1,14.0,2.0,12.0,9
15039,15039,2012-13,2012,2013,Stoke,QPR,Win,Away,2013-04-20,3,0,0,1,1,1,1,1,4,-1,-1,0,-3,0,14.0,17.0,-3.0,9
15040,15040,2012-13,2012,2013,Stoke,Norwich,Win,Home,2013-04-27,3,3,3,3,4,3,4,4,5,0,-1,-1,-1,1,14.0,12.0,2.0,9
15041,15041,2012-13,2012,2013,Stoke,Sunderland,Draw,Away,2013-05-06,1,6,6,6,6,3,6,6,6,3,0,0,0,0,14.0,13.0,1.0,10
15042,15042,2012-13,2012,2013,Stoke,Tottenham,Loss,Home,2013-05-12,0,4,7,7,7,4,5,8,9,0,2,-1,-2,1,14.0,4.0,10.0,10
15043,15043,2012-13,2012,2013,Stoke,Southampton,Draw,Away,2013-05-19,1,1,4,7,7,1,1,2,3,0,3,5,4,0,14.0,21.0,-7.0,10
15044,15044,2013-14,2013,2014,Stoke,Liverpool,Loss,Away,2013-08-17,0,1,2,5,8,6,7,10,11,-5,-5,-5,-3,0,13.0,7.0,6.0,1
15045,15045,2013-14,2013,2014,Stoke,Crystal Palace,Win,Home,2013-08-24,3,1,1,2,5,1,2,3,6,0,-1,-1,-1,1,13.0,21.0,-8.0,1
15046,15046,2013-14,2013,2014,Stoke,West Ham,Win,Away,2013-08-31,3,3,4,4,5,4,7,7,8,-1,-3,-3,-3,0,13.0,10.0,3.0,1
15047,15047,2013-14,2013,2014,Stoke,Man City,Draw,Home,2013-09-14,1,6,6,7,7,3,6,6,9,3,0,1,-2,1,13.0,2.0,11.0,2
15048,15048,2013-14,2013,2014,Stoke,Arsenal,Loss,Away,2013-09-22,0,4,7,7,8,6,9,9,12,-2,-2,-2,-4,0,13.0,4.0,9.0,2
15049,15049,2013-14,2013,2014,Stoke,Norwich,Loss,Home,2013-09-29,0,1,4,7,7,0,3,3,4,1,1,4,3,1,13.0,11.0,2.0,2
15050,15050,2013-14,2013,2014,Stoke,Fulham,Loss,Away,2013-10-05,0,0,1,4,7,0,1,1,1,0,0,3,6,0,13.0,12.0,1.0,3
15051,15051,2013-14,2013,2014,Stoke,West Brom,Draw,Home,2013-10-19,1,0,0,1,4,4,7,8,8,-4,-7,-7,-4,1,13.0,8.0,5.0,3
15052,15052,2013-14,2013,2014,Stoke,Man United,Loss,Away,2013-10-26,0,1,1,1,2,4,4,4,7,-3,-3,-3,-5,0,13.0,1.0,12.0,3
15053,15053,2013-14,2013,2014,Stoke,Southampton,Draw,Home,2013-11-02,1,1,1,1,1,4,7,10,13,-3,-6,-9,-12,1,13.0,14.0,-1.0,4
15054,15054,2013-14,2013,2014,Stoke,Swansea,Draw,Away,2013-11-10,1,1,2,2,2,1,4,4,4,0,-2,-2,-2,0,13.0,9.0,4.0,4
15055,15055,2013-14,2013,2014,Stoke,Sunderland,Win,Home,2013-11-23,3,2,2,3,3,3,6,6,6,-1,-4,-3,-3,1,13.0,17.0,-4.0,4
15056,15056,2013-14,2013,2014,Stoke,Everton,Loss,Away,2013-11-30,0,4,5,5,6,2,3,6,9,2,2,-1,-3,0,13.0,6.0,7.0,4
15057,15057,2013-14,2013,2014,Stoke,Cardiff,Draw,Home,2013-12-04,1,3,4,5,5,1,1,4,5,2,3,1,0,1,13.0,21.0,-8.0,5
15058,15058,2013-14,2013,2014,Stoke,Chelsea,Win,Home,2013-12-07,3,1,4,5,6,6,9,10,10,-5,-5,-5,-4,1,13.0,3.0,10.0,5
15059,15059,2013-14,2013,2014,Stoke,Hull,Draw,Away,2013-12-14,1,4,4,7,8,1,4,4,4,3,0,3,4,0,13.0,21.0,-8.0,5
15060,15060,2013-14,2013,2014,Stoke,Aston Villa,Win,Home,2013-12-21,3,4,5,5,8,0,3,4,5,4,2,1,3,1,13.0,15.0,-2.0,5
15061,15061,2013-14,2013,2014,Stoke,Newcastle,Loss,Away,2013-12-26,0,4,7,8,8,4,7,7,10,0,0,1,-2,0,13.0,16.0,-3.0,5
15062,15062,2013-14,2013,2014,Stoke,Tottenham,Loss,Away,2013-12-29,0,3,4,7,8,4,4,7,10,-1,0,0,-2,0,13.0,5.0,8.0,5
15063,15063,2013-14,2013,2014,Stoke,Everton,Draw,Home,2014-01-01,1,0,3,4,7,3,6,9,10,-3,-3,-5,-3,1,13.0,6.0,7.0,6
15064,15064,2013-14,2013,2014,Stoke,Liverpool,Loss,Home,2014-01-12,0,1,1,4,5,3,3,6,9,-2,-2,-2,-4,1,13.0,7.0,6.0,6
15065,15065,2013-14,2013,2014,Stoke,Crystal Palace,Loss,Away,2014-01-18,0,1,1,1,4,1,1,4,4,0,0,-3,0,0,13.0,21.0,-8.0,6
15066,15066,2013-14,2013,2014,Stoke,Sunderland,Loss,Away,2014-01-29,0,0,1,1,1,4,4,5,8,-4,-3,-4,-7,0,13.0,17.0,-4.0,6
15067,15067,2013-14,2013,2014,Stoke,Man United,Win,Home,2014-02-01,3,0,0,1,1,3,6,6,9,-3,-6,-5,-8,1,13.0,1.0,12.0,7
15068,15068,2013-14,2013,2014,Stoke,Southampton,Draw,Away,2014-02-08,1,3,3,3,4,4,5,8,8,-1,-2,-5,-4,0,13.0,14.0,-1.0,7
15069,15069,2013-14,2013,2014,Stoke,Swansea,Draw,Home,2014-02-12,1,4,4,4,4,3,6,6,6,1,-2,-2,-2,1,13.0,9.0,4.0,7
15070,15070,2013-14,2013,2014,Stoke,Man City,Loss,Away,2014-02-22,0,2,5,5,5,1,4,7,10,1,1,-2,-5,0,13.0,2.0,11.0,7
15071,15071,2013-14,2013,2014,Stoke,Arsenal,Win,Home,2014-03-01,3,1,2,5,5,4,4,7,8,-3,-2,-2,-3,1,13.0,4.0,9.0,8
15072,15072,2013-14,2013,2014,Stoke,Norwich,Draw,Away,2014-03-08,1,3,4,5,8,3,3,4,4,0,1,1,4,0,13.0,11.0,2.0,8
15073,15073,2013-14,2013,2014,Stoke,West Ham,Win,Home,2014-03-15,3,4,4,5,6,3,6,9,12,1,-2,-4,-6,1,13.0,10.0,3.0,8
15074,15074,2013-14,2013,2014,Stoke,Aston Villa,Win,Away,2014-03-23,3,4,7,7,8,6,6,7,7,-2,1,0,1,0,13.0,15.0,-2.0,8
15075,15075,2013-14,2013,2014,Stoke,Hull,Win,Home,2014-03-29,3,6,7,10,10,3,3,3,6,3,4,7,4,1,13.0,21.0,-8.0,8
15076,15076,2013-14,2013,2014,Stoke,Chelsea,Loss,Away,2014-04-05,0,6,9,10,13,3,3,6,9,3,6,4,4,0,13.0,3.0,10.0,9
15077,15077,2013-14,2013,2014,Stoke,Newcastle,Win,Home,2014-04-12,3,3,6,9,10,0,0,3,3,3,6,6,7,1,13.0,16.0,-3.0,9
15078,15078,2013-14,2013,2014,Stoke,Cardiff,Draw,Away,2014-04-19,1,3,6,9,12,3,4,4,4,0,2,5,8,0,13.0,21.0,-8.0,9
15079,15079,2013-14,2013,2014,Stoke,Tottenham,Loss,Home,2014-04-26,0,4,4,7,10,4,7,7,10,0,-3,0,0,1,13.0,5.0,8.0,9
15080,15080,2013-14,2013,2014,Stoke,Fulham,Win,Home,2014-05-03,3,1,4,4,7,1,4,7,7,0,0,-3,0,1,13.0,12.0,1.0,10
15081,15081,2013-14,2013,2014,Stoke,West Brom,Win,Away,2014-05-11,3,3,4,7,7,0,3,3,4,3,1,4,3,0,13.0,8.0,5.0,10
15082,15082,2014-15,2014,2015,Stoke,Aston Villa,Loss,Home,2014-08-16,0,6,6,7,10,0,3,3,4,6,3,4,6,1,9.0,15.0,-6.0,1
15083,15083,2014-15,2014,2015,Stoke,Hull,Draw,Away,2014-08-24,1,3,6,6,7,3,3,3,4,0,3,3,3,0,9.0,16.0,-7.0,1
15084,15084,2014-15,2014,2015,Stoke,Man City,Win,Away,2014-08-30,3,1,4,7,7,6,9,12,15,-5,-5,-5,-8,0,9.0,1.0,8.0,1
15085,15085,2014-15,2014,2015,Stoke,Leicester,Loss,Home,2014-09-13,0,4,4,7,10,1,2,2,5,3,2,5,5,1,9.0,21.0,-12.0,2
15086,15086,2014-15,2014,2015,Stoke,QPR,Draw,Away,2014-09-20,1,3,4,4,7,3,3,3,3,0,1,1,4,0,9.0,21.0,-12.0,2
15087,15087,2014-15,2014,2015,Stoke,Newcastle,Win,Home,2014-09-29,3,1,4,5,5,1,2,3,3,0,2,2,2,1,9.0,10.0,-1.0,2
15088,15088,2014-15,2014,2015,Stoke,Sunderland,Loss,Away,2014-10-04,0,4,4,7,8,2,3,3,4,2,1,4,4,0,9.0,14.0,-5.0,3
15089,15089,2014-15,2014,2015,Stoke,Swansea,Win,Home,2014-10-19,3,3,4,4,7,2,2,2,5,1,2,2,2,1,9.0,12.0,-3.0,3
15090,15090,2014-15,2014,2015,Stoke,Southampton,Loss,Away,2014-10-25,0,3,6,7,7,3,6,9,12,0,0,-2,-5,0,9.0,8.0,1.0,3
15091,15091,2014-15,2014,2015,Stoke,West Ham,Draw,Home,2014-11-01,1,3,3,6,7,6,9,9,12,-3,-6,-3,-5,1,9.0,13.0,-4.0,4
15092,15092,2014-15,2014,2015,Stoke,Tottenham,Win,Away,2014-11-09,3,1,4,4,7,3,3,6,7,-2,1,-2,0,0,9.0,6.0,3.0,4
15093,15093,2014-15,2014,2015,Stoke,Burnley,Loss,Home,2014-11-22,0,4,4,7,7,3,3,3,4,1,1,4,3,1,9.0,21.0,-12.0,4
15094,15094,2014-15,2014,2015,Stoke,Liverpool,Loss,Away,2014-11-29,0,3,4,4,7,0,0,1,4,3,4,3,3,0,9.0,2.0,7.0,4
15095,15095,2014-15,2014,2015,Stoke,Man United,Loss,Away,2014-12-02,0,0,3,4,4,6,9,9,10,-6,-6,-5,-6,0,9.0,7.0,2.0,5
15096,15096,2014-15,2014,2015,Stoke,Arsenal,Win,Home,2014-12-06,3,0,0,3,4,6,6,6,9,-6,-6,-3,-5,1,9.0,4.0,5.0,5
15097,15097,2014-15,2014,2015,Stoke,Crystal Palace,Draw,Away,2014-12-13,1,3,3,3,6,1,2,5,5,2,1,-2,1,0,9.0,11.0,-2.0,5
15098,15098,2014-15,2014,2015,Stoke,Chelsea,Loss,Home,2014-12-22,0,4,4,4,4,3,6,7,10,1,-2,-3,-6,1,9.0,3.0,6.0,5
15099,15099,2014-15,2014,2015,Stoke,Everton,Win,Away,2014-12-26,3,1,4,4,4,3,3,4,4,-2,1,0,0,0,9.0,5.0,4.0,5
15100,15100,2014-15,2014,2015,Stoke,West Brom,Win,Home,2014-12-28,3,3,4,7,7,0,3,4,4,3,1,3,3,1,9.0,17.0,-8.0,5
15101,15101,2014-15,2014,2015,Stoke,Man United,Draw,Home,2015-01-01,1,6,6,7,10,4,5,8,11,2,1,-1,-1,1,9.0,7.0,2.0,6
15102,15102,2014-15,2014,2015,Stoke,Arsenal,Loss,Away,2015-01-11,0,4,7,7,8,3,6,7,10,1,1,0,-2,0,9.0,4.0,5.0,6
15103,15103,2014-15,2014,2015,Stoke,Leicester,Win,Away,2015-01-17,3,1,4,7,7,4,7,7,7,-3,-3,0,0,0,9.0,21.0,-12.0,6
15104,15104,2014-15,2014,2015,Stoke,QPR,Win,Home,2015-01-31,3,3,4,7,10,0,1,2,2,3,3,5,8,1,9.0,21.0,-12.0,6
15105,15105,2014-15,2014,2015,Stoke,Newcastle,Draw,Away,2015-02-08,1,6,6,7,10,3,3,4,7,3,3,3,3,0,9.0,10.0,-1.0,7
15106,15106,2014-15,2014,2015,Stoke,Man City,Loss,Home,2015-02-11,0,4,7,7,8,2,2,3,6,2,5,4,2,1,9.0,1.0,8.0,7
15107,15107,2014-15,2014,2015,Stoke,Aston Villa,Win,Away,2015-02-21,3,1,4,7,7,0,0,0,0,1,4,7,7,0,9.0,15.0,-6.0,7
15108,15108,2014-15,2014,2015,Stoke,Hull,Win,Home,2015-02-28,3,3,4,7,10,6,7,7,7,-3,-3,0,3,1,9.0,16.0,-7.0,7
15109,15109,2014-15,2014,2015,Stoke,Everton,Win,Home,2015-03-04,3,6,6,7,10,1,1,2,5,5,5,5,5,1,9.0,5.0,4.0,8
15110,15110,2014-15,2014,2015,Stoke,West Brom,Loss,Away,2015-03-14,0,6,9,9,10,3,4,7,8,3,5,2,2,0,9.0,17.0,-8.0,8
15111,15111,2014-15,2014,2015,Stoke,Crystal Palace,Loss,Home,2015-03-21,0,3,6,9,9,3,6,6,7,0,0,3,2,1,9.0,11.0,-2.0,8
15112,15112,2014-15,2014,2015,Stoke,Chelsea,Loss,Away,2015-04-04,0,0,3,6,9,4,7,8,11,-4,-4,-2,-2,0,9.0,3.0,6.0,9
15113,15113,2014-15,2014,2015,Stoke,West Ham,Draw,Away,2015-04-11,1,0,0,3,6,3,3,3,3,-3,-3,0,3,0,9.0,13.0,-4.0,9
15114,15114,2014-15,2014,2015,Stoke,Southampton,Win,Home,2015-04-18,3,1,1,1,4,3,6,7,10,-2,-5,-6,-6,1,9.0,8.0,1.0,9
15115,15115,2014-15,2014,2015,Stoke,Sunderland,Draw,Home,2015-04-25,1,4,4,4,4,3,3,3,4,1,1,1,0,1,9.0,14.0,-5.0,9
15116,15116,2014-15,2014,2015,Stoke,Swansea,Loss,Away,2015-05-02,0,4,5,5,5,3,4,7,10,1,1,-2,-5,0,9.0,12.0,-3.0,10
15117,15117,2014-15,2014,2015,Stoke,Tottenham,Win,Home,2015-05-09,3,1,4,5,5,1,4,4,5,0,0,1,0,1,9.0,6.0,3.0,10
15118,15118,2014-15,2014,2015,Stoke,Burnley,Draw,Away,2015-05-16,1,3,4,7,8,3,3,3,3,0,1,4,5,0,9.0,21.0,-12.0,10
15119,15119,2014-15,2014,2015,Stoke,Liverpool,Win,Home,2015-05-24,3,4,4,5,8,1,4,4,5,3,0,1,3,1,9.0,2.0,7.0,10
15120,15120,2015-16,2015,2016,Stoke,Liverpool,Loss,Home,2015-08-09,0,4,7,7,8,0,1,4,4,4,6,3,4,1,9.0,6.0,3.0,1
15121,15121,2015-16,2015,2016,Stoke,Tottenham,Draw,Away,2015-08-15,1,3,4,7,7,3,6,6,6,0,-2,1,1,0,9.0,5.0,4.0,1
15122,15122,2015-16,2015,2016,Stoke,Norwich,Draw,Away,2015-08-22,1,1,4,5,8,3,3,4,4,-2,1,1,4,0,9.0,21.0,-12.0,1
15123,15123,2015-16,2015,2016,Stoke,West Brom,Loss,Home,2015-08-29,0,2,2,5,6,1,1,1,4,1,1,4,2,1,9.0,13.0,-4.0,1
15124,15124,2015-16,2015,2016,Stoke,Arsenal,Loss,Away,2015-09-12,0,1,2,2,5,4,7,7,10,-3,-5,-5,-5,0,9.0,3.0,6.0,2
15125,15125,2015-16,2015,2016,Stoke,Leicester,Draw,Home,2015-09-19,1,0,1,2,2,4,5,8,11,-4,-4,-6,-9,1,9.0,14.0,-5.0,2
15126,15126,2015-16,2015,2016,Stoke,Bournemouth,Win,Home,2015-09-26,3,1,1,2,3,3,4,7,7,-2,-3,-5,-4,1,9.0,21.0,-12.0,2
15127,15127,2015-16,2015,2016,Stoke,Aston Villa,Win,Away,2015-10-03,3,4,4,4,5,0,0,1,1,4,4,3,4,0,9.0,17.0,-8.0,3
15128,15128,2015-16,2015,2016,Stoke,Swansea,Win,Away,2015-10-19,3,6,7,7,7,1,2,2,5,5,5,5,2,0,9.0,8.0,1.0,3
15129,15129,2015-16,2015,2016,Stoke,Watford,Loss,Home,2015-10-24,0,6,9,10,10,1,1,4,7,5,8,6,3,1,9.0,21.0,-12.0,3
15130,15130,2015-16,2015,2016,Stoke,Newcastle,Draw,Away,2015-10-31,1,3,6,9,10,3,3,4,4,0,3,5,6,0,9.0,15.0,-6.0,3
15131,15131,2015-16,2015,2016,Stoke,Chelsea,Win,Home,2015-11-07,3,1,4,7,10,0,3,3,4,1,1,4,6,1,9.0,1.0,8.0,4
15132,15132,2015-16,2015,2016,Stoke,Southampton,Win,Away,2015-11-21,3,4,4,7,10,6,7,8,11,-2,-3,-1,-1,0,9.0,7.0,2.0,4
15133,15133,2015-16,2015,2016,Stoke,Sunderland,Loss,Away,2015-11-28,0,6,7,7,10,3,3,6,6,3,4,1,4,0,9.0,16.0,-7.0,4
15134,15134,2015-16,2015,2016,Stoke,Man City,Win,Home,2015-12-05,3,3,6,7,7,3,4,7,8,0,2,0,-1,1,9.0,2.0,7.0,5
15135,15135,2015-16,2015,2016,Stoke,West Ham,Draw,Away,2015-12-12,1,3,6,9,10,2,2,3,3,1,4,6,7,0,9.0,12.0,-3.0,5
15136,15136,2015-16,2015,2016,Stoke,Crystal Palace,Loss,Home,2015-12-19,0,4,4,7,10,4,7,7,10,0,-3,0,0,1,9.0,10.0,-1.0,5
15137,15137,2015-16,2015,2016,Stoke,Man United,Win,Home,2015-12-26,3,1,4,4,7,0,1,2,5,1,3,2,2,1,9.0,4.0,5.0,5
15138,15138,2015-16,2015,2016,Stoke,Everton,Win,Away,2015-12-28,3,3,4,7,7,3,4,5,6,0,0,2,1,0,9.0,11.0,-2.0,5
15139,15139,2015-16,2015,2016,Stoke,West Brom,Loss,Away,2016-01-02,0,6,6,7,10,3,3,4,5,3,3,3,5,0,9.0,13.0,-4.0,6
15140,15140,2015-16,2015,2016,Stoke,Norwich,Win,Home,2016-01-13,3,3,6,6,7,6,6,9,10,-3,0,-3,-3,1,9.0,21.0,-12.0,6
15141,15141,2015-16,2015,2016,Stoke,Arsenal,Draw,Home,2016-01-17,1,3,6,9,9,4,7,7,10,-1,-1,2,-1,1,9.0,3.0,6.0,6
15142,15142,2015-16,2015,2016,Stoke,Leicester,Loss,Away,2016-01-23,0,4,4,7,10,4,5,6,6,0,-1,1,4,0,9.0,14.0,-5.0,6
15143,15143,2015-16,2015,2016,Stoke,Man United,Loss,Away,2016-02-02,0,1,4,4,7,3,4,7,8,-2,0,-3,-1,0,9.0,4.0,5.0,7
15144,15144,2015-16,2015,2016,Stoke,Everton,Loss,Home,2016-02-06,0,0,1,4,4,3,4,5,6,-3,-3,-1,-2,1,9.0,11.0,-2.0,7
15145,15145,2015-16,2015,2016,Stoke,Bournemouth,Win,Away,2016-02-13,3,0,0,1,4,3,4,7,7,-3,-4,-6,-3,0,9.0,21.0,-12.0,7
15146,15146,2015-16,2015,2016,Stoke,Aston Villa,Win,Home,2016-02-27,3,3,3,3,4,3,3,4,5,0,0,-1,-1,1,9.0,17.0,-8.0,7
15147,15147,2015-16,2015,2016,Stoke,Newcastle,Win,Home,2016-03-02,3,6,6,6,6,3,3,3,6,3,3,3,0,1,9.0,15.0,-6.0,8
15148,15148,2015-16,2015,2016,Stoke,Chelsea,Draw,Away,2016-03-05,1,6,9,9,9,6,9,10,11,0,0,-1,-2,0,9.0,1.0,8.0,8
15149,15149,2015-16,2015,2016,Stoke,Southampton,Loss,Home,2016-03-12,0,4,7,10,10,1,1,4,7,3,6,6,3,1,9.0,7.0,2.0,8
15150,15150,2015-16,2015,2016,Stoke,Watford,Win,Away,2016-03-19,3,1,4,7,10,0,1,4,4,1,3,3,6,0,9.0,21.0,-12.0,8
15151,15151,2015-16,2015,2016,Stoke,Swansea,Draw,Home,2016-04-02,1,3,4,7,10,3,6,9,9,0,-2,-2,1,1,9.0,8.0,1.0,9
15152,15152,2015-16,2015,2016,Stoke,Liverpool,Loss,Away,2016-04-10,0,4,4,5,8,1,4,7,10,3,0,-2,-2,0,9.0,6.0,3.0,9
15153,15153,2015-16,2015,2016,Stoke,Tottenham,Loss,Home,2016-04-18,0,1,4,4,5,4,7,10,11,-3,-3,-6,-6,1,9.0,5.0,4.0,9
15154,15154,2015-16,2015,2016,Stoke,Man City,Loss,Away,2016-04-23,0,0,1,4,4,4,7,10,10,-4,-6,-6,-6,0,9.0,2.0,7.0,9
15155,15155,2015-16,2015,2016,Stoke,Sunderland,Draw,Home,2016-04-30,1,0,0,1,4,4,4,5,6,-4,-4,-4,-2,1,9.0,16.0,-7.0,9
15156,15156,2015-16,2015,2016,Stoke,Crystal Palace,Loss,Away,2016-05-07,0,1,1,1,2,0,1,2,5,1,0,-1,-3,0,9.0,10.0,-1.0,10
15157,15157,2015-16,2015,2016,Stoke,West Ham,Win,Home,2016-05-15,3,1,1,1,1,3,6,9,10,-2,-5,-8,-9,1,9.0,12.0,-3.0,10
15158,15158,2016-17,2016,2017,Stoke,Middlesbrough,Draw,Away,2016-08-13,1,3,4,4,4,1,1,1,1,2,3,3,3,0,9.0,21.0,-12.0,1
15159,15159,2016-17,2016,2017,Stoke,Man City,Loss,Home,2016-08-20,0,4,4,5,5,4,5,5,8,0,-1,0,-3,1,9.0,4.0,5.0,1
15160,15160,2016-17,2016,2017,Stoke,Everton,Loss,Away,2016-08-27,0,1,4,4,5,4,7,7,7,-3,-3,-3,-2,0,9.0,11.0,-2.0,1
15161,15161,2016-17,2016,2017,Stoke,Tottenham,Loss,Home,2016-09-10,0,0,1,4,4,4,5,5,5,-4,-4,-1,-1,1,9.0,3.0,6.0,2
15162,15162,2016-17,2016,2017,Stoke,Crystal Palace,Loss,Away,2016-09-18,0,0,0,1,4,4,4,4,4,-4,-4,-3,0,0,9.0,15.0,-6.0,2
15163,15163,2016-17,2016,2017,Stoke,West Brom,Draw,Home,2016-09-24,1,0,0,0,1,3,4,4,7,-3,-4,-4,-6,1,9.0,14.0,-5.0,2
15164,15164,2016-17,2016,2017,Stoke,Man United,Draw,Away,2016-10-02,1,1,1,1,1,3,3,6,9,-2,-2,-5,-8,0,9.0,5.0,4.0,3
15165,15165,2016-17,2016,2017,Stoke,Sunderland,Win,Home,2016-10-15,3,2,2,2,2,1,1,1,2,1,1,1,0,1,9.0,17.0,-8.0,3
15166,15166,2016-17,2016,2017,Stoke,Hull,Win,Away,2016-10-22,3,4,5,5,5,0,0,0,1,4,5,5,4,0,9.0,21.0,-12.0,3
15167,15167,2016-17,2016,2017,Stoke,Swansea,Win,Home,2016-10-31,3,6,7,8,8,1,1,1,1,5,6,7,7,1,9.0,12.0,-3.0,3
15168,15168,2016-17,2016,2017,Stoke,West Ham,Draw,Away,2016-11-05,1,6,9,10,11,3,6,7,7,3,3,3,4,0,9.0,7.0,2.0,4
15169,15169,2016-17,2016,2017,Stoke,Bournemouth,Loss,Home,2016-11-19,0,4,7,10,11,0,1,4,5,4,6,6,6,1,9.0,16.0,-7.0,4
15170,15170,2016-17,2016,2017,Stoke,Watford,Win,Away,2016-11-27,3,1,4,7,10,3,6,7,10,-2,-2,0,0,0,9.0,13.0,-4.0,4
15171,15171,2016-17,2016,2017,Stoke,Burnley,Win,Home,2016-12-03,3,3,4,7,10,0,3,4,7,3,1,3,3,1,9.0,21.0,-12.0,5
15172,15172,2016-17,2016,2017,Stoke,Arsenal,Loss,Away,2016-12-10,0,6,6,7,10,6,7,8,11,0,-1,-1,-1,0,9.0,2.0,7.0,5
15173,15173,2016-17,2016,2017,Stoke,Southampton,Draw,Home,2016-12-14,1,3,6,6,7,3,6,7,7,0,0,-1,0,1,9.0,6.0,3.0,5
15174,15174,2016-17,2016,2017,Stoke,Leicester,Draw,Home,2016-12-17,1,1,4,7,7,3,3,4,4,-2,1,3,3,1,9.0,1.0,8.0,5
15175,15175,2016-17,2016,2017,Stoke,Liverpool,Loss,Away,2016-12-27,0,2,2,5,8,6,7,7,10,-4,-5,-2,-2,0,9.0,8.0,1.0,5
15176,15176,2016-17,2016,2017,Stoke,Chelsea,Loss,Away,2016-12-31,0,1,2,2,5,6,9,12,15,-5,-7,-10,-10,0,9.0,10.0,-1.0,5
15177,15177,2016-17,2016,2017,Stoke,Watford,Win,Home,2017-01-03,3,0,1,2,2,1,1,1,4,-1,0,1,-2,1,9.0,13.0,-4.0,6
15178,15178,2016-17,2016,2017,Stoke,Sunderland,Win,Away,2017-01-14,3,3,3,4,5,1,1,4,4,2,2,0,1,0,9.0,17.0,-8.0,6
15179,15179,2016-17,2016,2017,Stoke,Man United,Draw,Home,2017-01-21,1,6,6,6,7,4,7,10,13,2,-1,-4,-6,1,9.0,5.0,4.0,6
15180,15180,2016-17,2016,2017,Stoke,Everton,Draw,Home,2017-02-01,1,4,7,7,7,6,9,10,13,-2,-2,-3,-6,1,9.0,11.0,-2.0,7
15181,15181,2016-17,2016,2017,Stoke,West Brom,Loss,Away,2017-02-04,0,2,5,8,8,4,4,7,10,-2,1,1,-2,0,9.0,14.0,-5.0,7
15182,15182,2016-17,2016,2017,Stoke,Crystal Palace,Win,Home,2017-02-11,3,1,2,5,8,3,3,3,3,-2,-1,2,5,1,9.0,15.0,-6.0,7
15183,15183,2016-17,2016,2017,Stoke,Tottenham,Loss,Away,2017-02-26,0,3,4,5,8,3,4,5,8,0,0,0,0,0,9.0,3.0,6.0,7
15184,15184,2016-17,2016,2017,Stoke,Middlesbrough,Win,Home,2017-03-04,3,3,3,4,5,1,1,2,2,2,2,2,3,1,9.0,21.0,-12.0,8
15185,15185,2016-17,2016,2017,Stoke,Man City,Draw,Away,2017-03-08,1,3,6,6,7,6,9,12,13,-3,-3,-6,-6,0,9.0,4.0,5.0,8
15186,15186,2016-17,2016,2017,Stoke,Chelsea,Loss,Home,2017-03-18,0,4,4,7,7,6,7,10,11,-2,-3,-3,-4,1,9.0,10.0,-1.0,8
15187,15187,2016-17,2016,2017,Stoke,Leicester,Loss,Away,2017-04-01,0,1,4,4,7,6,9,9,9,-5,-5,-5,-2,0,9.0,1.0,8.0,9
15188,15188,2016-17,2016,2017,Stoke,Burnley,Loss,Away,2017-04-04,0,0,1,4,4,1,1,1,2,-1,0,3,2,0,9.0,21.0,-12.0,9
15189,15189,2016-17,2016,2017,Stoke,Liverpool,Loss,Home,2017-04-08,0,0,0,1,4,4,5,8,11,-4,-5,-7,-7,1,9.0,8.0,1.0,9
15190,15190,2016-17,2016,2017,Stoke,Hull,Win,Home,2017-04-15,3,0,0,0,1,3,6,6,9,-3,-6,-6,-8,1,9.0,21.0,-12.0,9
15191,15191,2016-17,2016,2017,Stoke,Swansea,Loss,Away,2017-04-22,0,3,3,3,3,0,0,1,1,3,3,2,2,0,9.0,12.0,-3.0,9
15192,15192,2016-17,2016,2017,Stoke,West Ham,Draw,Home,2017-04-29,1,3,3,3,3,2,5,5,5,1,-2,-2,-2,1,9.0,7.0,2.0,9
15193,15193,2016-17,2016,2017,Stoke,Bournemouth,Draw,Away,2017-05-06,1,1,4,4,4,6,6,6,7,-5,-2,-2,-3,0,9.0,16.0,-7.0,10
15194,15194,2016-17,2016,2017,Stoke,Arsenal,Loss,Home,2017-05-13,0,2,2,5,5,6,6,9,12,-4,-4,-4,-7,1,9.0,2.0,7.0,10
15195,15195,2016-17,2016,2017,Stoke,Southampton,Win,Away,2017-05-21,3,1,2,2,5,4,4,5,6,-3,-2,-3,-1,0,9.0,6.0,3.0,10
15196,15196,2017-18,2017,2018,Stoke,Everton,Loss,Away,2017-08-12,0,3,4,5,5,3,3,3,4,0,1,2,1,0,13.0,7.0,6.0,1
15197,15197,2017-18,2017,2018,Stoke,Arsenal,Win,Home,2017-08-19,3,3,3,4,5,6,9,12,15,-3,-6,-8,-10,1,13.0,5.0,8.0,1
15198,15198,2017-18,2017,2018,Stoke,West Brom,Draw,Away,2017-08-27,1,3,6,6,7,6,6,6,6,-3,0,0,1,0,13.0,10.0,3.0,1
15199,15199,2017-18,2017,2018,Stoke,Man United,Draw,Home,2017-09-09,1,4,4,7,7,6,9,12,13,-2,-5,-5,-6,1,13.0,6.0,7.0,2
15200,15200,2017-18,2017,2018,Stoke,Newcastle,Loss,Away,2017-09-16,0,2,5,5,8,6,6,6,9,-4,-1,-1,-1,0,13.0,21.0,-8.0,2
15201,15201,2017-18,2017,2018,Stoke,Chelsea,Loss,Home,2017-09-23,0,1,2,5,5,4,7,10,10,-3,-5,-5,-5,1,13.0,1.0,12.0,2
15202,15202,2017-18,2017,2018,Stoke,Southampton,Win,Home,2017-09-30,3,0,1,2,5,3,3,4,7,-3,-2,-2,-2,1,13.0,8.0,5.0,2
15203,15203,2017-18,2017,2018,Stoke,Man City,Loss,Away,2017-10-14,0,3,3,4,5,6,9,12,15,-3,-6,-8,-10,0,13.0,3.0,10.0,3
15204,15204,2017-18,2017,2018,Stoke,Bournemouth,Loss,Home,2017-10-21,0,3,3,3,4,1,1,4,4,2,2,-1,0,1,13.0,9.0,4.0,3
15205,15205,2017-18,2017,2018,Stoke,Watford,Win,Away,2017-10-28,3,0,3,3,3,3,4,7,7,-3,-1,-4,-4,0,13.0,17.0,-4.0,3
15206,15206,2017-18,2017,2018,Stoke,Leicester,Draw,Home,2017-11-04,1,3,3,6,6,6,7,8,8,-3,-4,-2,-2,1,13.0,12.0,1.0,4
15207,15207,2017-18,2017,2018,Stoke,Brighton,Draw,Away,2017-11-20,1,4,4,4,7,4,7,8,8,0,-3,-4,-1,0,13.0,21.0,-8.0,4
15208,15208,2017-18,2017,2018,Stoke,Crystal Palace,Loss,Away,2017-11-25,0,2,5,5,5,1,2,2,5,1,3,3,0,0,13.0,14.0,-1.0,4
15209,15209,2017-18,2017,2018,Stoke,Liverpool,Loss,Home,2017-11-29,0,1,2,5,5,4,7,10,10,-3,-5,-5,-5,1,13.0,4.0,9.0,4
15210,15210,2017-18,2017,2018,Stoke,Swansea,Win,Home,2017-12-02,3,0,1,2,5,1,1,1,1,-1,0,1,4,1,13.0,15.0,-2.0,5
15211,15211,2017-18,2017,2018,Stoke,Tottenham,Loss,Away,2017-12-09,0,3,3,4,5,1,2,2,5,2,1,2,0,0,13.0,2.0,11.0,5
15212,15212,2017-18,2017,2018,Stoke,Burnley,Loss,Away,2017-12-12,0,3,3,3,4,3,6,6,9,0,-3,-3,-5,0,13.0,16.0,-3.0,5
15213,15213,2017-18,2017,2018,Stoke,West Ham,Loss,Home,2017-12-16,0,0,3,3,3,4,4,4,5,-4,-1,-1,-2,1,13.0,11.0,2.0,5
15214,15214,2017-18,2017,2018,Stoke,West Brom,Win,Home,2017-12-23,3,0,0,3,3,1,1,2,3,-1,-1,1,0,1,13.0,10.0,3.0,5
15215,15215,2017-18,2017,2018,Stoke,Huddersfield,Draw,Away,2017-12-26,1,3,3,3,6,4,4,7,7,-1,-1,-4,-1,0,13.0,21.0,-8.0,5
15216,15216,2017-18,2017,2018,Stoke,Chelsea,Loss,Away,2017-12-30,0,4,4,4,4,4,7,10,10,0,-3,-6,-6,0,13.0,1.0,12.0,5
15217,15217,2017-18,2017,2018,Stoke,Newcastle,Loss,Home,2018-01-01,0,1,4,4,4,1,4,4,4,0,0,0,0,1,13.0,21.0,-8.0,6
15218,15218,2017-18,2017,2018,Stoke,Man United,Loss,Away,2018-01-15,0,0,1,4,4,4,5,6,9,-4,-4,-2,-5,0,13.0,6.0,7.0,6
15219,15219,2017-18,2017,2018,Stoke,Huddersfield,Win,Home,2018-01-20,3,0,0,1,4,0,1,2,3,0,-1,-1,1,1,13.0,21.0,-8.0,6
15220,15220,2017-18,2017,2018,Stoke,Watford,Draw,Home,2018-01-31,1,3,3,3,4,1,1,1,4,2,2,2,0,1,13.0,17.0,-4.0,6
15221,15221,2017-18,2017,2018,Stoke,Bournemouth,Loss,Away,2018-02-03,0,4,4,4,4,4,7,8,11,0,-3,-4,-7,0,13.0,9.0,4.0,7
15222,15222,2017-18,2017,2018,Stoke,Brighton,Draw,Home,2018-02-10,1,1,4,4,4,4,4,4,5,-3,0,0,-1,1,13.0,21.0,-8.0,7
15223,15223,2017-18,2017,2018,Stoke,Leicester,Draw,Away,2018-02-24,1,1,2,5,5,1,1,4,5,0,1,1,0,0,13.0,12.0,1.0,7
15224,15224,2017-18,2017,2018,Stoke,Southampton,Draw,Away,2018-03-03,1,2,2,3,6,1,4,5,6,1,-2,-2,0,0,13.0,8.0,5.0,8
15225,15225,2017-18,2017,2018,Stoke,Man City,Loss,Home,2018-03-12,0,2,3,3,4,6,9,10,13,-4,-6,-7,-9,1,13.0,3.0,10.0,8
15226,15226,2017-18,2017,2018,Stoke,Everton,Loss,Home,2018-03-17,0,1,2,3,3,3,3,6,6,-2,-1,-3,-3,1,13.0,7.0,6.0,8
15227,15227,2017-18,2017,2018,Stoke,Arsenal,Loss,Away,2018-04-01,0,0,1,2,3,3,3,3,6,-3,-2,-1,-3,0,13.0,5.0,8.0,9
15228,15228,2017-18,2017,2018,Stoke,Tottenham,Loss,Home,2018-04-07,0,0,0,1,2,6,9,12,15,-6,-9,-11,-13,1,13.0,2.0,11.0,9
15229,15229,2017-18,2017,2018,Stoke,West Ham,Draw,Away,2018-04-16,1,0,0,0,1,4,4,4,4,-4,-4,-4,-3,0,13.0,11.0,2.0,9
15230,15230,2017-18,2017,2018,Stoke,Burnley,Draw,Home,2018-04-22,1,1,1,1,1,3,6,9,12,-2,-5,-8,-11,1,13.0,16.0,-3.0,9
15231,15231,2017-18,2017,2018,Stoke,Liverpool,Draw,Away,2018-04-28,1,2,2,2,2,4,5,8,11,-2,-3,-6,-9,0,13.0,4.0,9.0,9
15232,15232,2017-18,2017,2018,Stoke,Crystal Palace,Loss,Home,2018-05-05,0,2,3,3,3,4,7,8,8,-2,-4,-5,-5,1,13.0,14.0,-1.0,10
15233,15233,2017-18,2017,2018,Stoke,Swansea,Win,Away,2018-05-13,3,1,2,3,3,0,0,0,1,1,2,3,2,0,13.0,15.0,-2.0,10
15234,15234,1996-97,1996,1997,Sunderland,Leicester,Draw,Home,1996-08-17,1,0,0,0,0,2,5,5,5,-2,-5,-5,-5,1,21.0,21.0,0.0,1
15235,15235,1996-97,1996,1997,Sunderland,Nott'm Forest,Win,Away,1996-08-21,3,1,1,1,1,6,7,7,8,-5,-6,-6,-7,0,21.0,9.0,12.0,1
15236,15236,1996-97,1996,1997,Sunderland,Liverpool,Draw,Away,1996-08-24,1,4,4,4,4,4,5,6,9,0,-1,-2,-5,0,21.0,3.0,18.0,1
15237,15237,1996-97,1996,1997,Sunderland,Newcastle,Loss,Home,1996-09-04,0,4,5,5,5,3,3,4,5,1,2,1,0,1,21.0,2.0,19.0,2
15238,15238,1996-97,1996,1997,Sunderland,West Ham,Draw,Home,1996-09-08,1,1,4,5,5,3,4,4,5,-2,0,1,0,1,21.0,10.0,11.0,2
15239,15239,1996-97,1996,1997,Sunderland,Derby,Loss,Away,1996-09-14,0,1,2,5,6,4,4,5,6,-3,-2,0,0,0,21.0,21.0,0.0,2
15240,15240,1996-97,1996,1997,Sunderland,Coventry,Win,Home,1996-09-21,3,1,1,2,5,3,3,3,4,-2,-2,-1,1,1,21.0,16.0,5.0,2
15241,15241,1996-97,1996,1997,Sunderland,Arsenal,Loss,Away,1996-09-28,0,3,4,4,5,6,7,8,11,-3,-3,-4,-6,0,21.0,5.0,16.0,2
15242,15242,1996-97,1996,1997,Sunderland,Middlesbrough,Draw,Home,1996-10-14,1,3,3,4,4,0,3,6,9,3,0,-2,-5,1,21.0,12.0,9.0,3
15243,15243,1996-97,1996,1997,Sunderland,Southampton,Loss,Away,1996-10-19,0,1,4,4,5,4,4,4,4,-3,0,0,1,0,21.0,17.0,4.0,3
15244,15244,1996-97,1996,1997,Sunderland,Aston Villa,Win,Home,1996-10-26,3,1,1,4,4,3,3,4,5,-2,-2,0,-1,1,21.0,4.0,17.0,3
15245,15245,1996-97,1996,1997,Sunderland,Leeds,Loss,Away,1996-11-02,0,3,4,4,7,0,3,3,3,3,1,1,4,0,21.0,13.0,8.0,4
15246,15246,1996-97,1996,1997,Sunderland,Tottenham,Loss,Away,1996-11-16,0,3,3,4,4,3,6,9,9,0,-3,-5,-5,0,21.0,8.0,13.0,4
15247,15247,1996-97,1996,1997,Sunderland,Sheffield Weds,Draw,Home,1996-11-23,1,0,3,3,4,4,5,6,6,-4,-2,-3,-2,1,21.0,15.0,6.0,4
15248,15248,1996-97,1996,1997,Sunderland,Everton,Win,Away,1996-11-30,3,1,1,4,4,4,7,8,11,-3,-6,-4,-7,0,21.0,6.0,15.0,4
15249,15249,1996-97,1996,1997,Sunderland,Wimbledon,Loss,Home,1996-12-07,0,4,4,4,7,4,5,6,7,0,-1,-2,0,1,21.0,14.0,7.0,5
15250,15250,1996-97,1996,1997,Sunderland,Chelsea,Win,Home,1996-12-15,3,3,4,4,4,1,2,3,6,2,2,1,-2,1,21.0,11.0,10.0,5
15251,15251,1996-97,1996,1997,Sunderland,Man United,Loss,Away,1996-12-21,0,3,6,7,7,2,5,6,9,1,1,1,-2,0,21.0,1.0,20.0,5
15252,15252,1996-97,1996,1997,Sunderland,Derby,Win,Home,1996-12-26,3,3,3,6,7,0,1,4,5,3,2,2,2,1,21.0,21.0,0.0,5
15253,15253,1996-97,1996,1997,Sunderland,West Ham,Loss,Away,1996-12-28,0,3,6,6,9,1,1,2,3,2,5,4,6,0,21.0,10.0,11.0,5
15254,15254,1996-97,1996,1997,Sunderland,Coventry,Draw,Away,1997-01-01,1,3,3,6,6,6,9,12,12,-3,-6,-6,-6,0,21.0,16.0,5.0,6
15255,15255,1996-97,1996,1997,Sunderland,Arsenal,Win,Home,1997-01-11,3,1,4,4,7,4,5,5,6,-3,-1,-1,1,1,21.0,5.0,16.0,6
15256,15256,1996-97,1996,1997,Sunderland,Blackburn,Draw,Home,1997-01-18,1,4,4,7,7,6,7,10,10,-2,-3,-3,-3,1,21.0,7.0,14.0,6
15257,15257,1996-97,1996,1997,Sunderland,Leicester,Draw,Away,1997-01-29,1,4,5,5,8,3,4,5,5,1,1,0,3,0,21.0,21.0,0.0,6
15258,15258,1996-97,1996,1997,Sunderland,Aston Villa,Loss,Away,1997-02-01,0,2,5,6,6,0,1,2,3,2,4,4,3,0,21.0,4.0,17.0,7
15259,15259,1996-97,1996,1997,Sunderland,Leeds,Loss,Home,1997-02-22,0,1,2,5,6,1,2,5,8,0,0,0,-2,1,21.0,13.0,8.0,7
15260,15260,1996-97,1996,1997,Sunderland,Blackburn,Loss,Away,1997-03-01,0,0,1,2,5,4,4,5,8,-4,-3,-3,-3,0,21.0,7.0,14.0,8
15261,15261,1996-97,1996,1997,Sunderland,Tottenham,Loss,Home,1997-03-04,0,0,0,1,2,0,1,1,4,0,-1,0,-2,1,21.0,8.0,13.0,8
15262,15262,1996-97,1996,1997,Sunderland,Man United,Win,Home,1997-03-08,3,0,0,0,1,4,7,10,13,-4,-7,-10,-12,1,21.0,1.0,20.0,8
15263,15263,1996-97,1996,1997,Sunderland,Sheffield Weds,Loss,Away,1997-03-12,0,3,3,3,3,6,9,10,11,-3,-6,-7,-8,0,21.0,15.0,6.0,8
15264,15264,1996-97,1996,1997,Sunderland,Chelsea,Loss,Away,1997-03-16,0,3,3,3,3,1,1,2,5,2,2,1,-2,0,21.0,11.0,10.0,8
15265,15265,1996-97,1996,1997,Sunderland,Nott'm Forest,Draw,Home,1997-03-22,1,0,3,3,3,2,2,2,5,-2,1,1,-2,1,21.0,9.0,12.0,8
15266,15266,1996-97,1996,1997,Sunderland,Newcastle,Draw,Away,1997-04-05,1,1,1,4,4,4,4,4,7,-3,-3,0,-3,0,21.0,2.0,19.0,9
15267,15267,1996-97,1996,1997,Sunderland,Liverpool,Loss,Home,1997-04-13,0,2,2,2,5,3,4,7,7,-1,-2,-5,-2,1,21.0,3.0,18.0,9
15268,15268,1996-97,1996,1997,Sunderland,Middlesbrough,Win,Away,1997-04-19,3,1,2,2,2,2,5,8,11,-1,-3,-6,-9,0,21.0,12.0,9.0,9
15269,15269,1996-97,1996,1997,Sunderland,Southampton,Loss,Home,1997-04-22,0,3,4,5,5,4,5,8,9,-1,-1,-3,-4,1,21.0,17.0,4.0,9
15270,15270,1996-97,1996,1997,Sunderland,Everton,Win,Home,1997-05-03,3,3,3,4,5,2,5,6,6,1,-2,-2,-1,1,21.0,6.0,15.0,10
15271,15271,1996-97,1996,1997,Sunderland,Wimbledon,Loss,Away,1997-05-11,0,3,6,6,7,4,4,4,7,-1,2,2,0,0,21.0,14.0,7.0,10
15272,15272,1999-00,1999,2000,Sunderland,Chelsea,Loss,Away,1999-08-07,0,3,3,6,6,4,7,10,11,-1,-4,-4,-5,0,21.0,3.0,18.0,1
15273,15273,1999-00,1999,2000,Sunderland,Watford,Win,Home,1999-08-10,3,0,3,3,6,0,0,0,0,0,3,3,6,1,21.0,21.0,0.0,1
15274,15274,1999-00,1999,2000,Sunderland,Arsenal,Draw,Home,1999-08-14,1,3,3,6,6,6,9,9,12,-3,-6,-3,-6,1,21.0,2.0,19.0,1
15275,15275,1999-00,1999,2000,Sunderland,Leeds,Loss,Away,1999-08-21,0,4,4,4,7,3,4,5,8,1,0,-1,-1,0,21.0,4.0,17.0,1
15276,15276,1999-00,1999,2000,Sunderland,Newcastle,Win,Away,1999-08-25,3,1,4,4,4,1,1,1,2,0,3,3,2,0,21.0,13.0,8.0,1
15277,15277,1999-00,1999,2000,Sunderland,Coventry,Draw,Home,1999-08-29,1,3,4,7,7,3,4,4,4,0,0,3,3,1,21.0,15.0,6.0,1
15278,15278,1999-00,1999,2000,Sunderland,Leicester,Win,Home,1999-09-11,3,4,4,5,8,6,6,7,10,-2,-2,-2,-2,1,21.0,10.0,11.0,2
15279,15279,1999-00,1999,2000,Sunderland,Derby,Win,Away,1999-09-18,3,4,7,7,8,4,7,7,7,0,0,0,1,0,21.0,8.0,13.0,2
15280,15280,1999-00,1999,2000,Sunderland,Sheffield Weds,Win,Home,1999-09-25,3,6,7,10,10,0,0,0,0,6,7,10,10,1,21.0,12.0,9.0,2
15281,15281,1999-00,1999,2000,Sunderland,Bradford,Win,Away,1999-10-02,3,6,9,10,13,3,4,4,4,3,5,6,9,0,21.0,21.0,0.0,3
15282,15282,1999-00,1999,2000,Sunderland,Aston Villa,Win,Home,1999-10-18,3,6,9,12,13,1,4,4,7,5,5,8,6,1,21.0,6.0,15.0,3
15283,15283,1999-00,1999,2000,Sunderland,West Ham,Draw,Away,1999-10-24,1,6,9,12,15,3,3,3,6,3,6,9,9,0,21.0,5.0,16.0,3
15284,15284,1999-00,1999,2000,Sunderland,Tottenham,Win,Home,1999-10-31,3,4,7,10,13,6,6,7,10,-2,1,3,3,1,21.0,11.0,10.0,3
15285,15285,1999-00,1999,2000,Sunderland,Middlesbrough,Draw,Away,1999-11-06,1,4,7,10,13,6,9,9,9,-2,-2,1,4,0,21.0,9.0,12.0,4
15286,15286,1999-00,1999,2000,Sunderland,Liverpool,Loss,Home,1999-11-20,0,4,5,8,11,6,9,10,13,-2,-4,-2,-2,1,21.0,7.0,14.0,4
15287,15287,1999-00,1999,2000,Sunderland,Watford,Win,Away,1999-11-27,3,1,4,5,8,2,2,2,2,-1,2,3,6,0,21.0,21.0,0.0,4
15288,15288,1999-00,1999,2000,Sunderland,Chelsea,Win,Home,1999-12-04,3,3,4,7,8,4,5,5,5,-1,-1,2,3,1,21.0,3.0,18.0,5
15289,15289,1999-00,1999,2000,Sunderland,Southampton,Win,Home,1999-12-18,3,6,6,7,10,1,1,4,5,5,5,3,5,1,21.0,17.0,4.0,5
15290,15290,1999-00,1999,2000,Sunderland,Everton,Loss,Away,1999-12-26,0,6,9,9,10,3,4,5,6,3,5,4,4,0,21.0,14.0,7.0,5
15291,15291,1999-00,1999,2000,Sunderland,Man United,Draw,Home,1999-12-28,1,3,6,9,9,6,9,12,15,-3,-3,-3,-6,1,21.0,1.0,20.0,5
15292,15292,1999-00,1999,2000,Sunderland,Wimbledon,Loss,Away,2000-01-03,0,1,4,7,10,1,2,5,6,0,2,2,4,0,21.0,16.0,5.0,6
15293,15293,1999-00,1999,2000,Sunderland,Arsenal,Loss,Away,2000-01-15,0,1,1,4,7,4,4,5,8,-3,-3,-1,-1,0,21.0,2.0,19.0,6
15294,15294,1999-00,1999,2000,Sunderland,Leeds,Loss,Home,2000-01-23,0,0,1,1,4,0,3,6,9,0,-2,-5,-5,1,21.0,4.0,17.0,6
15295,15295,1999-00,1999,2000,Sunderland,Newcastle,Draw,Home,2000-02-05,1,0,0,1,1,3,4,7,8,-3,-4,-6,-7,1,21.0,13.0,8.0,7
15296,15296,1999-00,1999,2000,Sunderland,Coventry,Loss,Away,2000-02-12,0,1,1,1,2,1,4,5,8,0,-3,-4,-6,0,21.0,15.0,6.0,7
15297,15297,1999-00,1999,2000,Sunderland,Derby,Draw,Home,2000-02-26,1,1,1,1,1,1,2,5,8,0,-1,-4,-7,1,21.0,8.0,13.0,7
15298,15298,1999-00,1999,2000,Sunderland,Leicester,Loss,Away,2000-03-05,0,1,2,2,2,4,4,5,6,-3,-2,-3,-4,0,21.0,10.0,11.0,8
15299,15299,1999-00,1999,2000,Sunderland,Liverpool,Draw,Away,2000-03-11,1,1,1,2,2,4,7,8,11,-3,-6,-6,-9,0,21.0,7.0,14.0,8
15300,15300,1999-00,1999,2000,Sunderland,Middlesbrough,Draw,Home,2000-03-18,1,1,2,2,3,4,5,8,8,-3,-3,-6,-5,1,21.0,9.0,12.0,8
15301,15301,1999-00,1999,2000,Sunderland,Everton,Win,Home,2000-03-25,3,2,2,3,3,0,1,2,5,2,1,1,-2,1,21.0,14.0,7.0,8
15302,15302,1999-00,1999,2000,Sunderland,Southampton,Win,Away,2000-04-01,3,4,5,5,6,4,4,4,5,0,1,1,1,0,21.0,17.0,4.0,9
15303,15303,1999-00,1999,2000,Sunderland,Wimbledon,Win,Home,2000-04-08,3,6,7,8,8,0,0,3,3,6,7,5,5,1,21.0,16.0,5.0,9
15304,15304,1999-00,1999,2000,Sunderland,Man United,Loss,Away,2000-04-15,0,6,9,10,11,6,9,12,15,0,0,-2,-4,0,21.0,1.0,20.0,9
15305,15305,1999-00,1999,2000,Sunderland,Sheffield Weds,Win,Away,2000-04-22,3,3,6,9,10,6,6,6,6,-3,0,3,4,0,21.0,12.0,9.0,9
15306,15306,1999-00,1999,2000,Sunderland,Bradford,Loss,Home,2000-04-24,0,3,6,9,12,1,1,1,1,2,5,8,11,1,21.0,21.0,0.0,9
15307,15307,1999-00,1999,2000,Sunderland,Aston Villa,Draw,Away,2000-04-29,1,3,3,6,9,4,7,10,13,-1,-4,-4,-4,0,21.0,6.0,15.0,9
15308,15308,1999-00,1999,2000,Sunderland,West Ham,Win,Home,2000-05-06,3,1,4,4,7,0,3,6,9,1,1,-2,-2,1,21.0,5.0,16.0,10
15309,15309,1999-00,1999,2000,Sunderland,Tottenham,Loss,Away,2000-05-14,0,4,4,7,7,1,4,7,7,3,0,0,0,0,21.0,11.0,10.0,10
15310,15310,2000-01,2000,2001,Sunderland,Arsenal,Win,Home,2000-08-19,3,3,4,4,7,1,4,7,10,2,0,-3,-3,1,7.0,2.0,5.0,1
15311,15311,2000-01,2000,2001,Sunderland,Man City,Loss,Away,2000-08-23,0,3,6,7,7,1,4,7,7,2,2,0,0,0,7.0,21.0,-14.0,1
15312,15312,2000-01,2000,2001,Sunderland,Ipswich,Loss,Away,2000-08-26,0,3,3,6,7,1,1,1,4,2,2,5,3,0,7.0,21.0,-14.0,1
15313,15313,2000-01,2000,2001,Sunderland,West Ham,Draw,Home,2000-09-05,1,0,3,3,6,1,1,2,2,-1,2,1,4,1,7.0,9.0,-2.0,2
15314,15314,2000-01,2000,2001,Sunderland,Man United,Loss,Away,2000-09-09,0,1,1,4,4,4,5,8,11,-3,-4,-4,-7,0,7.0,1.0,6.0,2
15315,15315,2000-01,2000,2001,Sunderland,Derby,Win,Home,2000-09-16,3,1,1,1,4,2,3,3,4,-1,-2,-2,0,1,7.0,16.0,-9.0,2
15316,15316,2000-01,2000,2001,Sunderland,Liverpool,Draw,Away,2000-09-23,1,3,4,4,4,4,7,8,8,-1,-3,-4,-4,0,7.0,4.0,3.0,2
15317,15317,2000-01,2000,2001,Sunderland,Leicester,Draw,Home,2000-10-01,1,4,4,5,5,4,7,10,11,0,-3,-5,-6,1,7.0,8.0,-1.0,3
15318,15318,2000-01,2000,2001,Sunderland,Chelsea,Win,Home,2000-10-14,3,2,5,5,6,4,4,5,6,-2,1,0,0,1,7.0,5.0,2.0,3
15319,15319,2000-01,2000,2001,Sunderland,Aston Villa,Draw,Away,2000-10-22,1,4,5,8,8,3,4,7,10,1,1,1,-2,0,7.0,6.0,1.0,3
15320,15320,2000-01,2000,2001,Sunderland,Coventry,Win,Home,2000-10-28,3,4,5,6,9,3,4,4,4,1,1,2,5,1,7.0,14.0,-7.0,3
15321,15321,2000-01,2000,2001,Sunderland,Tottenham,Loss,Away,2000-11-04,0,4,7,8,9,3,3,3,4,1,4,5,5,0,7.0,10.0,-3.0,4
15322,15322,2000-01,2000,2001,Sunderland,Southampton,Draw,Home,2000-11-11,1,3,4,7,8,3,3,4,4,0,1,3,4,1,7.0,15.0,-8.0,4
15323,15323,2000-01,2000,2001,Sunderland,Newcastle,Win,Away,2000-11-18,3,1,4,5,8,4,4,4,7,-3,0,1,1,0,7.0,11.0,-4.0,4
15324,15324,2000-01,2000,2001,Sunderland,Charlton,Win,Away,2000-11-25,3,4,4,7,8,3,6,6,9,1,-2,1,-1,0,7.0,21.0,-14.0,4
15325,15325,2000-01,2000,2001,Sunderland,Everton,Win,Home,2000-12-04,3,6,7,7,10,6,9,9,9,0,-2,-2,1,1,7.0,13.0,-6.0,5
15326,15326,2000-01,2000,2001,Sunderland,Middlesbrough,Win,Home,2000-12-09,3,6,9,10,10,1,1,1,1,5,8,9,9,1,7.0,12.0,-5.0,5
15327,15327,2000-01,2000,2001,Sunderland,Leeds,Loss,Away,2000-12-16,0,6,9,12,13,0,3,3,4,6,6,9,9,0,7.0,3.0,4.0,5
15328,15328,2000-01,2000,2001,Sunderland,Man City,Win,Home,2000-12-23,3,3,6,9,12,4,4,4,4,-1,2,5,8,1,7.0,21.0,-14.0,5
15329,15329,2000-01,2000,2001,Sunderland,Bradford,Win,Away,2000-12-26,3,3,6,9,12,0,1,4,5,3,5,5,7,0,7.0,17.0,-10.0,5
15330,15330,2000-01,2000,2001,Sunderland,Arsenal,Draw,Away,2000-12-30,1,6,6,9,12,3,4,7,10,3,2,2,2,0,7.0,2.0,5.0,5
15331,15331,2000-01,2000,2001,Sunderland,Ipswich,Win,Home,2001-01-01,3,4,7,7,10,4,4,7,10,0,3,0,0,1,7.0,21.0,-14.0,6
15332,15332,2000-01,2000,2001,Sunderland,West Ham,Win,Away,2001-01-13,3,4,7,10,10,3,3,4,5,1,4,6,5,0,7.0,9.0,-2.0,6
15333,15333,2000-01,2000,2001,Sunderland,Bradford,Draw,Home,2001-01-21,1,6,7,10,13,3,3,3,3,3,4,7,10,1,7.0,17.0,-10.0,6
15334,15334,2000-01,2000,2001,Sunderland,Man United,Loss,Home,2001-01-31,0,4,7,8,11,6,9,10,13,-2,-2,-2,-2,1,7.0,1.0,6.0,6
15335,15335,2000-01,2000,2001,Sunderland,Derby,Loss,Away,2001-02-03,0,1,4,7,8,1,1,4,4,0,3,3,4,0,7.0,16.0,-9.0,7
15336,15336,2000-01,2000,2001,Sunderland,Liverpool,Draw,Home,2001-02-10,1,0,1,4,7,4,5,8,11,-4,-4,-4,-4,1,7.0,4.0,3.0,7
15337,15337,2000-01,2000,2001,Sunderland,Leicester,Loss,Away,2001-02-24,0,1,1,2,5,3,3,4,4,-2,-2,-2,1,0,7.0,8.0,-1.0,7
15338,15338,2000-01,2000,2001,Sunderland,Aston Villa,Draw,Home,2001-03-05,1,1,1,1,2,1,4,4,4,0,-3,-3,-2,1,7.0,6.0,1.0,8
15339,15339,2000-01,2000,2001,Sunderland,Chelsea,Win,Away,2001-03-17,3,1,2,2,2,4,5,5,8,-3,-3,-3,-6,0,7.0,5.0,2.0,8
15340,15340,2000-01,2000,2001,Sunderland,Leeds,Loss,Home,2001-03-31,0,4,4,5,5,4,7,8,9,0,-3,-3,-4,1,7.0,3.0,4.0,8
15341,15341,2000-01,2000,2001,Sunderland,Middlesbrough,Draw,Away,2001-04-09,1,3,4,4,5,3,4,4,5,0,0,0,0,0,7.0,12.0,-5.0,9
15342,15342,2000-01,2000,2001,Sunderland,Tottenham,Loss,Home,2001-04-14,0,1,4,5,5,3,6,6,6,-2,-2,-1,-1,1,7.0,10.0,-3.0,9
15343,15343,2000-01,2000,2001,Sunderland,Coventry,Loss,Away,2001-04-16,0,1,1,4,5,3,6,6,7,-2,-5,-2,-2,0,7.0,14.0,-7.0,9
15344,15344,2000-01,2000,2001,Sunderland,Newcastle,Draw,Home,2001-04-21,1,0,1,1,4,3,4,4,5,-3,-3,-3,-1,1,7.0,11.0,-4.0,9
15345,15345,2000-01,2000,2001,Sunderland,Southampton,Win,Away,2001-04-28,3,1,1,2,2,1,1,1,4,0,0,1,-2,0,7.0,15.0,-8.0,9
15346,15346,2000-01,2000,2001,Sunderland,Charlton,Win,Home,2001-05-05,3,4,4,4,5,6,7,7,7,-2,-3,-3,-2,1,7.0,21.0,-14.0,10
15347,15347,2000-01,2000,2001,Sunderland,Everton,Draw,Away,2001-05-19,1,6,7,7,7,3,3,3,3,3,4,4,4,0,7.0,13.0,-6.0,10
15348,15348,2001-02,2001,2002,Sunderland,Ipswich,Win,Home,2001-08-18,3,4,7,8,8,4,4,7,10,0,3,1,-2,1,7.0,5.0,2.0,1
15349,15349,2001-02,2001,2002,Sunderland,Fulham,Loss,Away,2001-08-22,0,4,7,10,11,0,0,0,0,4,7,10,11,0,7.0,21.0,-14.0,1
15350,15350,2001-02,2001,2002,Sunderland,Newcastle,Draw,Away,2001-08-26,1,3,4,7,10,4,5,5,6,-1,-1,2,4,0,7.0,11.0,-4.0,1
15351,15351,2001-02,2001,2002,Sunderland,Blackburn,Win,Home,2001-09-08,3,1,4,5,8,4,4,5,6,-3,0,0,2,1,7.0,21.0,-14.0,2
15352,15352,2001-02,2001,2002,Sunderland,Aston Villa,Draw,Away,2001-09-16,1,4,4,7,8,4,5,5,8,0,-1,2,0,0,7.0,8.0,-1.0,2
15353,15353,2001-02,2001,2002,Sunderland,Tottenham,Loss,Home,2001-09-19,0,4,5,5,8,3,3,4,5,1,2,1,3,1,7.0,12.0,-5.0,2
15354,15354,2001-02,2001,2002,Sunderland,Charlton,Draw,Home,2001-09-22,1,1,4,5,5,1,4,4,4,0,0,1,1,1,7.0,9.0,-2.0,2
15355,15355,2001-02,2001,2002,Sunderland,Bolton,Win,Away,2001-09-29,3,1,2,5,6,2,2,3,6,-1,0,2,0,0,7.0,21.0,-14.0,2
15356,15356,2001-02,2001,2002,Sunderland,Man United,Loss,Home,2001-10-13,0,4,4,5,8,6,6,9,10,-2,-2,-4,-2,1,7.0,1.0,6.0,3
15357,15357,2001-02,2001,2002,Sunderland,Middlesbrough,Loss,Away,2001-10-22,0,3,4,4,5,1,2,5,8,2,2,-1,-3,0,7.0,14.0,-7.0,3
15358,15358,2001-02,2001,2002,Sunderland,Arsenal,Draw,Home,2001-10-27,1,0,3,4,4,4,7,8,11,-4,-4,-4,-7,1,7.0,2.0,5.0,3
15359,15359,2001-02,2001,2002,Sunderland,Leicester,Loss,Away,2001-11-03,0,1,1,4,5,1,1,1,1,0,0,3,4,0,7.0,13.0,-6.0,4
15360,15360,2001-02,2001,2002,Sunderland,Leeds,Win,Home,2001-11-18,3,1,1,1,4,4,5,6,9,-3,-4,-5,-5,1,7.0,4.0,3.0,4
15361,15361,2001-02,2001,2002,Sunderland,Liverpool,Loss,Away,2001-11-25,0,3,4,4,4,4,7,10,11,-1,-3,-6,-7,0,7.0,3.0,4.0,4
15362,15362,2001-02,2001,2002,Sunderland,West Ham,Win,Home,2001-12-01,3,3,3,4,4,1,1,4,7,2,2,0,-3,1,7.0,15.0,-8.0,5
15363,15363,2001-02,2001,2002,Sunderland,Chelsea,Draw,Home,2001-12-09,1,3,6,6,7,3,4,5,8,0,2,1,-1,1,7.0,6.0,1.0,5
15364,15364,2001-02,2001,2002,Sunderland,Southampton,Loss,Away,2001-12-15,0,4,4,7,7,3,6,6,6,1,-2,1,1,0,7.0,10.0,-3.0,5
15365,15365,2001-02,2001,2002,Sunderland,Everton,Win,Home,2001-12-22,3,1,4,4,7,3,3,6,7,-2,1,-2,0,1,7.0,16.0,-9.0,5
15366,15366,2001-02,2001,2002,Sunderland,Blackburn,Win,Away,2001-12-26,3,3,4,7,7,3,3,3,4,0,1,4,3,0,7.0,21.0,-14.0,5
15367,15367,2001-02,2001,2002,Sunderland,Ipswich,Loss,Away,2001-12-29,0,6,6,7,10,6,6,6,6,0,0,1,4,0,7.0,5.0,2.0,5
15368,15368,2001-02,2001,2002,Sunderland,Aston Villa,Draw,Home,2002-01-01,1,3,6,6,7,1,1,4,4,2,5,2,3,1,7.0,8.0,-1.0,6
15369,15369,2001-02,2001,2002,Sunderland,Everton,Loss,Away,2002-01-12,0,1,4,7,7,0,0,0,0,1,4,7,7,0,7.0,16.0,-9.0,6
15370,15370,2001-02,2001,2002,Sunderland,Fulham,Draw,Home,2002-01-19,1,1,1,4,7,6,6,7,7,-5,-5,-3,0,1,7.0,21.0,-14.0,6
15371,15371,2001-02,2001,2002,Sunderland,Middlesbrough,Loss,Home,2002-01-29,0,1,2,2,5,1,4,4,4,0,-2,-2,1,1,7.0,14.0,-7.0,6
15372,15372,2001-02,2001,2002,Sunderland,Man United,Loss,Away,2002-02-02,0,1,1,2,2,3,6,9,12,-2,-5,-7,-10,0,7.0,1.0,6.0,7
15373,15373,2001-02,2001,2002,Sunderland,Derby,Win,Away,2002-02-09,3,0,1,1,2,3,3,3,3,-3,-2,-2,-1,0,7.0,17.0,-10.0,7
15374,15374,2001-02,2001,2002,Sunderland,Newcastle,Loss,Home,2002-02-24,0,3,3,4,4,6,9,10,13,-3,-6,-6,-9,1,7.0,11.0,-4.0,7
15375,15375,2001-02,2001,2002,Sunderland,Tottenham,Loss,Away,2002-03-02,0,3,3,3,4,3,3,4,4,0,0,-1,0,0,7.0,12.0,-5.0,8
15376,15376,2001-02,2001,2002,Sunderland,Bolton,Win,Home,2002-03-05,3,0,3,3,3,2,5,5,5,-2,-2,-2,-2,1,7.0,21.0,-14.0,8
15377,15377,2001-02,2001,2002,Sunderland,Chelsea,Loss,Away,2002-03-16,0,3,3,6,6,6,6,7,10,-3,-3,-1,-4,0,7.0,6.0,1.0,8
15378,15378,2001-02,2001,2002,Sunderland,Southampton,Draw,Home,2002-03-23,1,3,3,3,6,2,5,6,6,1,-2,-3,0,1,7.0,10.0,-3.0,8
15379,15379,2001-02,2001,2002,Sunderland,Arsenal,Loss,Away,2002-03-30,0,1,4,4,4,6,9,12,15,-5,-5,-8,-11,0,7.0,2.0,5.0,8
15380,15380,2001-02,2001,2002,Sunderland,Leicester,Win,Home,2002-04-01,3,1,1,4,4,3,4,5,5,-2,-3,-1,-1,1,7.0,13.0,-6.0,9
15381,15381,2001-02,2001,2002,Sunderland,Leeds,Loss,Away,2002-04-07,0,3,4,4,7,0,3,6,9,3,1,-2,-2,0,7.0,4.0,3.0,9
15382,15382,2001-02,2001,2002,Sunderland,Liverpool,Loss,Home,2002-04-13,0,3,3,4,4,6,9,12,15,-3,-6,-8,-11,1,7.0,3.0,4.0,9
15383,15383,2001-02,2001,2002,Sunderland,West Ham,Loss,Away,2002-04-20,0,0,3,3,4,4,7,10,10,-4,-4,-7,-6,0,7.0,15.0,-8.0,9
15384,15384,2001-02,2001,2002,Sunderland,Charlton,Draw,Away,2002-04-27,1,0,0,3,3,1,1,1,1,-1,-1,2,2,0,7.0,9.0,-2.0,9
15385,15385,2001-02,2001,2002,Sunderland,Derby,Draw,Home,2002-05-11,1,1,1,1,4,0,0,0,0,1,1,1,4,1,7.0,17.0,-10.0,10
15386,15386,2002-03,2002,2003,Sunderland,Blackburn,Draw,Away,2002-08-17,1,2,2,2,2,3,6,7,10,-1,-4,-5,-8,0,17.0,10.0,7.0,1
15387,15387,2002-03,2002,2003,Sunderland,Everton,Loss,Home,2002-08-24,0,2,3,3,3,1,1,4,5,1,2,-1,-2,1,17.0,15.0,2.0,1
15388,15388,2002-03,2002,2003,Sunderland,Leeds,Win,Away,2002-08-28,3,1,2,3,3,6,9,12,12,-5,-7,-9,-9,0,17.0,5.0,12.0,1
15389,15389,2002-03,2002,2003,Sunderland,Man United,Draw,Home,2002-08-31,1,3,4,5,6,4,5,5,8,-1,-1,0,-2,1,17.0,3.0,14.0,1
15390,15390,2002-03,2002,2003,Sunderland,Middlesbrough,Loss,Away,2002-09-10,0,4,4,5,6,3,4,5,5,1,0,0,1,0,17.0,12.0,5.0,2
15391,15391,2002-03,2002,2003,Sunderland,Fulham,Loss,Home,2002-09-14,0,1,4,4,5,3,4,7,7,-2,0,-3,-2,1,17.0,13.0,4.0,2
15392,15392,2002-03,2002,2003,Sunderland,Newcastle,Loss,Away,2002-09-21,0,0,1,4,4,0,1,1,4,0,0,3,0,0,17.0,4.0,13.0,2
15393,15393,2002-03,2002,2003,Sunderland,Aston Villa,Win,Home,2002-09-28,3,0,0,1,4,3,6,6,9,-3,-6,-5,-5,1,17.0,8.0,9.0,2
15394,15394,2002-03,2002,2003,Sunderland,Arsenal,Loss,Away,2002-10-06,0,3,3,3,4,6,9,12,13,-3,-6,-9,-9,0,17.0,1.0,16.0,3
15395,15395,2002-03,2002,2003,Sunderland,West Ham,Loss,Home,2002-10-19,0,3,3,3,3,3,4,4,4,0,-1,-1,-1,1,17.0,7.0,10.0,3
15396,15396,2002-03,2002,2003,Sunderland,Bolton,Draw,Away,2002-10-28,1,0,3,3,3,0,1,1,1,0,2,2,2,0,17.0,16.0,1.0,3
15397,15397,2002-03,2002,2003,Sunderland,Charlton,Draw,Away,2002-11-03,1,1,1,4,4,3,3,3,4,-2,-2,1,0,0,17.0,14.0,3.0,4
15398,15398,2002-03,2002,2003,Sunderland,Tottenham,Win,Home,2002-11-10,3,2,2,2,5,1,4,7,7,1,-2,-5,-2,1,17.0,9.0,8.0,4
15399,15399,2002-03,2002,2003,Sunderland,Liverpool,Draw,Away,2002-11-17,1,4,5,5,5,3,6,9,12,1,-1,-4,-7,0,17.0,2.0,15.0,4
15400,15400,2002-03,2002,2003,Sunderland,Birmingham,Loss,Home,2002-11-23,0,4,5,6,6,1,4,4,5,3,1,2,1,1,17.0,21.0,-4.0,4
15401,15401,2002-03,2002,2003,Sunderland,Chelsea,Loss,Away,2002-11-30,0,1,4,5,6,4,7,8,11,-3,-3,-3,-5,0,17.0,6.0,11.0,4
15402,15402,2002-03,2002,2003,Sunderland,Man City,Loss,Home,2002-12-09,0,0,1,4,5,3,3,6,9,-3,-2,-2,-4,1,17.0,21.0,-4.0,5
15403,15403,2002-03,2002,2003,Sunderland,Liverpool,Win,Home,2002-12-15,3,0,0,1,4,0,0,1,1,0,0,0,3,1,17.0,2.0,15.0,5
15404,15404,2002-03,2002,2003,Sunderland,West Brom,Draw,Away,2002-12-21,1,3,3,3,4,0,3,3,4,3,0,0,0,0,17.0,21.0,-4.0,5
15405,15405,2002-03,2002,2003,Sunderland,Leeds,Loss,Home,2002-12-26,0,4,4,4,4,4,4,4,4,0,0,0,0,1,17.0,5.0,12.0,5
15406,15406,2002-03,2002,2003,Sunderland,Southampton,Loss,Away,2002-12-28,0,1,4,4,4,2,3,6,9,-1,1,-2,-5,0,17.0,11.0,6.0,5
15407,15407,2002-03,2002,2003,Sunderland,Man United,Loss,Away,2003-01-01,0,0,1,4,4,3,3,6,9,-3,-2,-2,-5,0,17.0,3.0,14.0,6
15408,15408,2002-03,2002,2003,Sunderland,Blackburn,Draw,Home,2003-01-11,1,0,0,1,4,4,5,8,8,-4,-5,-7,-4,1,17.0,10.0,7.0,6
15409,15409,2002-03,2002,2003,Sunderland,Everton,Loss,Away,2003-01-18,0,1,1,1,2,1,2,3,4,0,-1,-2,-2,0,17.0,15.0,2.0,6
15410,15410,2002-03,2002,2003,Sunderland,Southampton,Loss,Home,2003-01-28,0,1,1,1,1,1,4,7,8,0,-3,-6,-7,1,17.0,11.0,6.0,6
15411,15411,2002-03,2002,2003,Sunderland,Charlton,Loss,Home,2003-02-01,0,0,1,1,1,6,7,7,10,-6,-6,-6,-9,1,17.0,14.0,3.0,7
15412,15412,2002-03,2002,2003,Sunderland,Tottenham,Loss,Away,2003-02-08,0,0,0,1,1,1,4,7,7,-1,-4,-6,-6,0,17.0,9.0,8.0,7
15413,15413,2002-03,2002,2003,Sunderland,Middlesbrough,Loss,Home,2003-02-22,0,0,0,0,1,1,1,2,2,-1,-1,-2,-1,1,17.0,12.0,5.0,7
15414,15414,2002-03,2002,2003,Sunderland,Fulham,Loss,Away,2003-03-01,0,0,0,0,0,4,7,7,7,-4,-7,-7,-7,0,17.0,13.0,4.0,8
15415,15415,2002-03,2002,2003,Sunderland,Bolton,Loss,Home,2003-03-15,0,0,0,0,0,1,2,5,5,-1,-2,-5,-5,1,17.0,16.0,1.0,8
15416,15416,2002-03,2002,2003,Sunderland,West Ham,Loss,Away,2003-03-22,0,0,0,0,0,4,7,7,7,-4,-7,-7,-7,0,17.0,7.0,10.0,8
15417,15417,2002-03,2002,2003,Sunderland,Chelsea,Loss,Home,2003-04-05,0,0,0,0,0,6,6,6,9,-6,-6,-6,-9,1,17.0,6.0,11.0,9
15418,15418,2002-03,2002,2003,Sunderland,Birmingham,Loss,Away,2003-04-12,0,0,0,0,0,3,3,6,9,-3,-3,-6,-9,0,17.0,21.0,-4.0,9
15419,15419,2002-03,2002,2003,Sunderland,West Brom,Loss,Home,2003-04-19,0,0,0,0,0,0,0,0,0,0,0,0,0,1,17.0,21.0,-4.0,9
15420,15420,2002-03,2002,2003,Sunderland,Man City,Loss,Away,2003-04-21,0,0,0,0,0,4,4,4,7,-4,-4,-4,-7,0,17.0,21.0,-4.0,9
15421,15421,2002-03,2002,2003,Sunderland,Newcastle,Loss,Home,2003-04-26,0,0,0,0,0,1,1,1,4,-1,-1,-1,-4,1,17.0,4.0,13.0,9
15422,15422,2002-03,2002,2003,Sunderland,Aston Villa,Loss,Away,2003-05-03,0,0,0,0,0,1,4,5,6,-1,-4,-5,-6,0,17.0,8.0,9.0,10
15423,15423,2002-03,2002,2003,Sunderland,Arsenal,Loss,Home,2003-05-11,0,0,0,0,0,3,4,7,8,-3,-4,-7,-8,1,17.0,1.0,16.0,10
15424,15424,2005-06,2005,2006,Sunderland,Charlton,Loss,Home,2005-08-13,0,0,0,0,0,1,1,1,2,-1,-1,-1,-2,1,21.0,11.0,10.0,1
15425,15425,2005-06,2005,2006,Sunderland,Liverpool,Loss,Away,2005-08-20,0,0,0,0,0,4,4,5,5,-4,-4,-5,-5,0,21.0,5.0,16.0,1
15426,15426,2005-06,2005,2006,Sunderland,Man City,Loss,Home,2005-08-23,0,0,0,0,0,4,5,8,11,-4,-5,-8,-11,1,21.0,8.0,13.0,1
15427,15427,2005-06,2005,2006,Sunderland,Wigan,Loss,Away,2005-08-27,0,0,0,0,0,0,0,0,0,0,0,0,0,0,21.0,21.0,0.0,1
15428,15428,2005-06,2005,2006,Sunderland,Chelsea,Loss,Away,2005-09-10,0,0,0,0,0,6,9,12,13,-6,-9,-12,-13,0,21.0,1.0,20.0,2
15429,15429,2005-06,2005,2006,Sunderland,West Brom,Draw,Home,2005-09-17,1,0,0,0,0,0,0,3,4,0,0,-3,-4,1,21.0,17.0,4.0,2
15430,15430,2005-06,2005,2006,Sunderland,Middlesbrough,Win,Away,2005-09-25,3,1,1,1,1,4,4,7,7,-3,-3,-6,-6,0,21.0,7.0,14.0,2
15431,15431,2005-06,2005,2006,Sunderland,West Ham,Draw,Home,2005-10-01,1,4,4,4,4,4,7,7,8,0,-3,-3,-4,1,21.0,21.0,0.0,3
15432,15432,2005-06,2005,2006,Sunderland,Man United,Loss,Home,2005-10-15,0,4,5,5,5,3,4,5,8,1,1,0,-3,1,21.0,3.0,18.0,3
15433,15433,2005-06,2005,2006,Sunderland,Newcastle,Loss,Away,2005-10-23,0,1,4,5,5,1,4,7,8,0,0,-2,-3,0,21.0,14.0,7.0,3
15434,15434,2005-06,2005,2006,Sunderland,Portsmouth,Loss,Home,2005-10-29,0,0,1,4,5,1,2,2,3,-1,-1,2,2,1,21.0,16.0,5.0,3
15435,15435,2005-06,2005,2006,Sunderland,Arsenal,Loss,Away,2005-11-05,0,0,0,1,4,4,4,7,8,-4,-4,-6,-4,0,21.0,2.0,19.0,4
15436,15436,2005-06,2005,2006,Sunderland,Aston Villa,Loss,Home,2005-11-19,0,0,0,0,1,0,0,3,3,0,0,-3,-2,1,21.0,10.0,11.0,4
15437,15437,2005-06,2005,2006,Sunderland,Birmingham,Loss,Home,2005-11-26,0,0,0,0,0,0,0,0,0,0,0,0,0,1,21.0,12.0,9.0,4
15438,15438,2005-06,2005,2006,Sunderland,Liverpool,Loss,Home,2005-11-30,0,0,0,0,0,6,9,12,12,-6,-9,-12,-12,1,21.0,5.0,16.0,4
15439,15439,2005-06,2005,2006,Sunderland,Tottenham,Loss,Away,2005-12-03,0,0,0,0,0,4,4,5,6,-4,-4,-5,-6,0,21.0,9.0,12.0,5
15440,15440,2005-06,2005,2006,Sunderland,Charlton,Loss,Away,2005-12-10,0,0,0,0,0,0,0,0,0,0,0,0,0,0,21.0,11.0,10.0,5
15441,15441,2005-06,2005,2006,Sunderland,Bolton,Draw,Home,2005-12-26,1,0,0,0,0,4,7,7,10,-4,-7,-7,-10,1,21.0,6.0,15.0,5
15442,15442,2005-06,2005,2006,Sunderland,Everton,Loss,Home,2005-12-31,0,1,1,1,1,0,0,0,1,1,1,1,0,1,21.0,4.0,17.0,5
15443,15443,2005-06,2005,2006,Sunderland,Fulham,Loss,Away,2006-01-02,0,1,1,1,1,1,1,4,4,0,0,-3,-3,0,21.0,13.0,8.0,6
15444,15444,2005-06,2005,2006,Sunderland,Chelsea,Loss,Home,2006-01-15,0,0,1,1,1,6,9,12,15,-6,-8,-11,-14,1,21.0,1.0,20.0,6
15445,15445,2005-06,2005,2006,Sunderland,West Brom,Win,Away,2006-01-21,3,0,0,1,1,3,3,6,6,-3,-3,-5,-5,0,21.0,17.0,4.0,6
15446,15446,2005-06,2005,2006,Sunderland,Middlesbrough,Loss,Home,2006-01-31,0,3,3,3,4,0,1,2,2,3,2,1,2,1,21.0,7.0,14.0,6
15447,15447,2005-06,2005,2006,Sunderland,West Ham,Loss,Away,2006-02-04,0,3,3,3,3,6,9,9,9,-3,-6,-6,-6,0,21.0,21.0,0.0,7
15448,15448,2005-06,2005,2006,Sunderland,Tottenham,Draw,Home,2006-02-12,1,0,3,3,3,3,4,4,7,-3,-1,-1,-4,1,21.0,9.0,12.0,7
15449,15449,2005-06,2005,2006,Sunderland,Blackburn,Loss,Away,2006-02-15,0,1,1,4,4,0,3,6,7,1,-2,-2,-3,0,21.0,15.0,6.0,7
15450,15450,2005-06,2005,2006,Sunderland,Birmingham,Loss,Away,2006-02-25,0,1,1,1,4,0,1,4,4,1,0,-3,0,0,21.0,12.0,9.0,7
15451,15451,2005-06,2005,2006,Sunderland,Man City,Loss,Away,2006-03-05,0,0,1,1,1,3,3,6,6,-3,-2,-5,-5,0,21.0,8.0,13.0,8
15452,15452,2005-06,2005,2006,Sunderland,Wigan,Loss,Home,2006-03-11,0,0,0,1,1,1,1,2,3,-1,-1,-1,-2,1,21.0,21.0,0.0,8
15453,15453,2005-06,2005,2006,Sunderland,Bolton,Loss,Away,2006-03-18,0,0,0,0,1,3,6,7,8,-3,-6,-7,-7,0,21.0,6.0,15.0,8
15454,15454,2005-06,2005,2006,Sunderland,Blackburn,Loss,Home,2006-03-25,0,0,0,0,0,6,6,9,12,-6,-6,-9,-12,1,21.0,15.0,6.0,8
15455,15455,2005-06,2005,2006,Sunderland,Everton,Draw,Away,2006-04-01,1,0,0,0,0,3,6,7,7,-3,-6,-7,-7,0,21.0,4.0,17.0,9
15456,15456,2005-06,2005,2006,Sunderland,Man United,Draw,Away,2006-04-14,1,1,1,1,1,6,9,12,15,-5,-8,-11,-14,0,21.0,3.0,18.0,9
15457,15457,2005-06,2005,2006,Sunderland,Newcastle,Loss,Home,2006-04-17,0,2,2,2,2,6,9,9,9,-4,-7,-7,-7,1,21.0,14.0,7.0,9
15458,15458,2005-06,2005,2006,Sunderland,Portsmouth,Loss,Away,2006-04-22,0,1,2,2,2,3,4,5,8,-2,-2,-3,-6,0,21.0,16.0,5.0,9
15459,15459,2005-06,2005,2006,Sunderland,Arsenal,Loss,Home,2006-05-01,0,0,1,2,2,4,5,5,8,-4,-4,-3,-6,1,21.0,2.0,19.0,10
15460,15460,2005-06,2005,2006,Sunderland,Fulham,Win,Home,2006-05-04,3,0,0,1,2,6,9,9,10,-6,-9,-8,-8,1,21.0,13.0,8.0,10
15461,15461,2005-06,2005,2006,Sunderland,Aston Villa,Loss,Away,2006-05-07,0,3,3,3,4,0,0,3,4,3,3,0,0,0,21.0,10.0,11.0,10
15462,15462,2007-08,2007,2008,Sunderland,Tottenham,Win,Home,2007-08-11,3,3,3,3,3,4,7,10,11,-1,-4,-7,-8,1,21.0,5.0,16.0,1
15463,15463,2007-08,2007,2008,Sunderland,Birmingham,Draw,Away,2007-08-15,1,3,6,6,6,0,1,2,5,3,5,4,1,0,21.0,21.0,0.0,1
15464,15464,2007-08,2007,2008,Sunderland,Wigan,Loss,Away,2007-08-18,0,4,4,7,7,3,6,6,6,1,-2,1,1,0,21.0,17.0,4.0,1
15465,15465,2007-08,2007,2008,Sunderland,Liverpool,Loss,Home,2007-08-25,0,1,4,4,7,4,5,5,5,-3,-1,-1,2,1,21.0,3.0,18.0,1
15466,15466,2007-08,2007,2008,Sunderland,Man United,Loss,Away,2007-09-01,0,0,1,4,4,3,4,5,5,-3,-3,-1,-1,0,21.0,1.0,20.0,2
15467,15467,2007-08,2007,2008,Sunderland,Reading,Win,Home,2007-09-15,3,0,0,1,4,0,3,3,4,0,-3,-2,0,1,21.0,8.0,13.0,2
15468,15468,2007-08,2007,2008,Sunderland,Middlesbrough,Draw,Away,2007-09-22,1,3,3,3,4,3,4,7,7,0,-1,-4,-3,0,21.0,12.0,9.0,2
15469,15469,2007-08,2007,2008,Sunderland,Blackburn,Loss,Home,2007-09-29,0,4,4,4,4,1,4,5,6,3,0,-1,-2,1,21.0,10.0,11.0,2
15470,15470,2007-08,2007,2008,Sunderland,Arsenal,Loss,Away,2007-10-07,0,1,4,4,4,6,9,12,15,-5,-5,-8,-11,0,21.0,4.0,17.0,3
15471,15471,2007-08,2007,2008,Sunderland,West Ham,Loss,Away,2007-10-21,0,0,1,4,4,0,0,3,6,0,1,1,-2,0,21.0,15.0,6.0,3
15472,15472,2007-08,2007,2008,Sunderland,Fulham,Draw,Home,2007-10-27,1,0,0,1,4,1,2,3,4,-1,-2,-2,0,1,21.0,16.0,5.0,3
15473,15473,2007-08,2007,2008,Sunderland,Man City,Loss,Away,2007-11-05,0,1,1,1,2,3,6,9,10,-2,-5,-8,-8,0,21.0,14.0,7.0,4
15474,15474,2007-08,2007,2008,Sunderland,Newcastle,Draw,Home,2007-11-10,1,1,1,1,1,0,3,6,6,1,-2,-5,-5,1,21.0,13.0,8.0,4
15475,15475,2007-08,2007,2008,Sunderland,Everton,Loss,Away,2007-11-24,0,1,2,2,2,4,7,7,7,-3,-5,-5,-5,0,21.0,6.0,15.0,4
15476,15476,2007-08,2007,2008,Sunderland,Derby,Win,Home,2007-12-01,3,1,1,2,2,0,0,0,1,1,1,2,1,1,21.0,21.0,0.0,5
15477,15477,2007-08,2007,2008,Sunderland,Chelsea,Loss,Away,2007-12-08,0,3,4,4,5,6,7,10,13,-3,-3,-6,-8,0,21.0,2.0,19.0,5
15478,15478,2007-08,2007,2008,Sunderland,Aston Villa,Draw,Home,2007-12-15,1,3,3,4,4,0,3,6,9,3,0,-2,-5,1,21.0,11.0,10.0,5
15479,15479,2007-08,2007,2008,Sunderland,Reading,Loss,Away,2007-12-22,0,1,4,4,5,4,5,5,5,-3,-1,-1,0,0,21.0,8.0,13.0,5
15480,15480,2007-08,2007,2008,Sunderland,Man United,Loss,Home,2007-12-26,0,1,1,4,4,6,9,12,12,-5,-8,-8,-8,1,21.0,1.0,20.0,5
15481,15481,2007-08,2007,2008,Sunderland,Bolton,Win,Home,2007-12-29,3,0,1,1,4,3,3,6,6,-3,-2,-5,-2,1,21.0,7.0,14.0,5
15482,15482,2007-08,2007,2008,Sunderland,Blackburn,Loss,Away,2008-01-02,0,3,3,4,4,4,4,4,4,-1,-1,0,0,0,21.0,10.0,11.0,6
15483,15483,2007-08,2007,2008,Sunderland,Portsmouth,Win,Home,2008-01-13,3,3,3,3,4,3,4,4,4,0,-1,-1,0,1,21.0,9.0,12.0,6
15484,15484,2007-08,2007,2008,Sunderland,Tottenham,Loss,Away,2008-01-19,0,3,6,6,6,0,3,6,6,3,3,0,0,0,21.0,5.0,16.0,6
15485,15485,2007-08,2007,2008,Sunderland,Birmingham,Win,Home,2008-01-29,3,3,3,6,6,1,1,2,5,2,2,4,1,1,21.0,21.0,0.0,6
15486,15486,2007-08,2007,2008,Sunderland,Liverpool,Loss,Away,2008-02-02,0,3,6,6,9,1,2,3,4,2,4,3,5,0,21.0,3.0,18.0,7
15487,15487,2007-08,2007,2008,Sunderland,Wigan,Win,Home,2008-02-09,3,3,3,6,6,3,3,6,7,0,0,0,-1,1,21.0,17.0,4.0,7
15488,15488,2007-08,2007,2008,Sunderland,Portsmouth,Loss,Away,2008-02-23,0,3,6,6,9,4,4,7,7,-1,2,-1,2,0,21.0,9.0,12.0,7
15489,15489,2007-08,2007,2008,Sunderland,Derby,Draw,Away,2008-03-01,1,3,3,6,6,0,1,2,2,3,2,4,4,0,21.0,21.0,0.0,8
15490,15490,2007-08,2007,2008,Sunderland,Everton,Loss,Home,2008-03-09,0,1,4,4,7,6,9,10,11,-5,-5,-6,-4,1,21.0,6.0,15.0,8
15491,15491,2007-08,2007,2008,Sunderland,Chelsea,Loss,Home,2008-03-15,0,1,1,4,4,6,7,8,11,-5,-6,-4,-7,1,21.0,2.0,19.0,8
15492,15492,2007-08,2007,2008,Sunderland,Aston Villa,Win,Away,2008-03-22,3,0,1,1,4,1,2,5,8,-1,-1,-4,-4,0,21.0,11.0,10.0,8
15493,15493,2007-08,2007,2008,Sunderland,West Ham,Win,Home,2008-03-29,3,3,3,4,4,4,4,4,4,-1,-1,0,0,1,21.0,15.0,6.0,8
15494,15494,2007-08,2007,2008,Sunderland,Fulham,Win,Away,2008-04-05,3,6,6,6,7,1,4,5,5,5,2,1,2,0,21.0,16.0,5.0,9
15495,15495,2007-08,2007,2008,Sunderland,Man City,Loss,Home,2008-04-12,0,6,9,9,9,0,1,4,4,6,8,5,5,1,21.0,14.0,7.0,9
15496,15496,2007-08,2007,2008,Sunderland,Newcastle,Loss,Away,2008-04-20,0,3,6,9,9,4,7,10,11,-1,-1,-1,-2,0,21.0,13.0,8.0,9
15497,15497,2007-08,2007,2008,Sunderland,Middlesbrough,Win,Home,2008-04-26,3,0,3,6,9,1,2,2,5,-1,1,4,4,1,21.0,12.0,9.0,9
15498,15498,2007-08,2007,2008,Sunderland,Bolton,Loss,Away,2008-05-03,0,3,3,6,9,4,7,7,7,-1,-4,-1,2,0,21.0,7.0,14.0,10
15499,15499,2007-08,2007,2008,Sunderland,Arsenal,Loss,Home,2008-05-11,0,3,3,3,6,6,9,9,10,-3,-6,-6,-4,1,21.0,4.0,17.0,10
15500,15500,2008-09,2008,2009,Sunderland,Liverpool,Loss,Home,2008-08-16,0,0,3,3,3,6,7,10,13,-6,-4,-7,-10,1,15.0,4.0,11.0,1
15501,15501,2008-09,2008,2009,Sunderland,Tottenham,Win,Away,2008-08-23,3,0,0,3,3,0,3,4,5,0,-3,-1,-2,0,15.0,11.0,4.0,1
15502,15502,2008-09,2008,2009,Sunderland,Man City,Loss,Home,2008-08-31,0,3,3,3,6,3,3,3,3,0,0,0,3,1,15.0,9.0,6.0,1
15503,15503,2008-09,2008,2009,Sunderland,Wigan,Draw,Away,2008-09-13,1,3,3,3,3,3,3,3,6,0,0,0,-3,0,15.0,14.0,1.0,2
15504,15504,2008-09,2008,2009,Sunderland,Middlesbrough,Win,Home,2008-09-20,3,1,4,4,4,3,3,6,9,-2,1,-2,-5,1,15.0,13.0,2.0,2
15505,15505,2008-09,2008,2009,Sunderland,Aston Villa,Loss,Away,2008-09-27,0,4,4,7,7,6,7,7,10,-2,-3,0,-3,0,15.0,6.0,9.0,2
15506,15506,2008-09,2008,2009,Sunderland,Arsenal,Draw,Home,2008-10-04,1,3,4,4,7,3,6,9,9,0,-2,-5,-2,1,15.0,3.0,12.0,3
15507,15507,2008-09,2008,2009,Sunderland,Fulham,Draw,Away,2008-10-18,1,1,4,5,5,0,0,3,6,1,4,2,-1,0,15.0,17.0,-2.0,3
15508,15508,2008-09,2008,2009,Sunderland,Newcastle,Win,Home,2008-10-25,3,2,2,5,6,2,2,2,2,0,0,3,4,1,15.0,12.0,3.0,3
15509,15509,2008-09,2008,2009,Sunderland,Stoke,Loss,Away,2008-10-29,0,4,5,5,8,3,3,3,4,1,2,2,4,0,15.0,21.0,-6.0,3
15510,15510,2008-09,2008,2009,Sunderland,Chelsea,Loss,Away,2008-11-01,0,3,4,5,5,3,6,9,12,0,-2,-4,-7,0,15.0,2.0,13.0,4
15511,15511,2008-09,2008,2009,Sunderland,Portsmouth,Loss,Home,2008-11-08,0,0,3,4,5,0,1,2,5,0,2,2,0,1,15.0,8.0,7.0,4
15512,15512,2008-09,2008,2009,Sunderland,Blackburn,Win,Away,2008-11-15,3,0,0,3,4,1,1,2,3,-1,-1,1,1,0,15.0,7.0,8.0,4
15513,15513,2008-09,2008,2009,Sunderland,West Ham,Loss,Home,2008-11-23,0,3,3,3,6,1,2,2,2,2,1,1,4,1,15.0,10.0,5.0,4
15514,15514,2008-09,2008,2009,Sunderland,Bolton,Loss,Home,2008-11-29,0,3,3,3,3,3,6,9,9,0,-3,-6,-6,1,15.0,16.0,-1.0,4
15515,15515,2008-09,2008,2009,Sunderland,Man United,Loss,Away,2008-12-06,0,0,3,3,3,4,7,7,10,-4,-4,-4,-7,0,15.0,1.0,14.0,5
15516,15516,2008-09,2008,2009,Sunderland,West Brom,Win,Home,2008-12-13,3,0,0,3,3,1,1,1,1,-1,-1,2,2,1,15.0,21.0,-6.0,5
15517,15517,2008-09,2008,2009,Sunderland,Hull,Win,Away,2008-12-20,3,3,3,3,6,4,5,6,7,-1,-2,-3,-1,0,15.0,21.0,-6.0,5
15518,15518,2008-09,2008,2009,Sunderland,Blackburn,Draw,Home,2008-12-26,1,6,6,6,6,3,3,3,3,3,3,3,3,1,15.0,7.0,8.0,5
15519,15519,2008-09,2008,2009,Sunderland,Everton,Loss,Away,2008-12-28,0,4,7,7,7,4,7,7,10,0,0,0,-3,0,15.0,5.0,10.0,5
15520,15520,2008-09,2008,2009,Sunderland,Middlesbrough,Draw,Away,2009-01-10,1,1,4,7,7,0,0,1,1,1,4,6,6,0,15.0,13.0,2.0,6
15521,15521,2008-09,2008,2009,Sunderland,Aston Villa,Loss,Home,2009-01-17,0,1,2,5,8,6,7,10,13,-5,-5,-5,-5,1,15.0,6.0,9.0,6
15522,15522,2008-09,2008,2009,Sunderland,Fulham,Win,Home,2009-01-27,3,1,1,2,5,1,2,5,6,0,-1,-3,-1,1,15.0,17.0,-2.0,6
15523,15523,2008-09,2008,2009,Sunderland,Newcastle,Draw,Away,2009-02-01,1,3,4,4,5,0,1,1,1,3,3,3,4,0,15.0,12.0,3.0,7
15524,15524,2008-09,2008,2009,Sunderland,Stoke,Win,Home,2009-02-07,3,4,4,5,5,3,3,4,4,1,1,1,1,1,15.0,21.0,-6.0,7
15525,15525,2008-09,2008,2009,Sunderland,Arsenal,Draw,Away,2009-02-21,1,4,7,7,8,2,3,6,9,2,4,1,-1,0,15.0,3.0,12.0,7
15526,15526,2008-09,2008,2009,Sunderland,Liverpool,Loss,Away,2009-03-03,0,4,5,8,8,1,4,7,8,3,1,1,0,0,15.0,4.0,11.0,8
15527,15527,2008-09,2008,2009,Sunderland,Tottenham,Draw,Home,2009-03-07,1,1,4,5,8,6,7,7,10,-5,-3,-2,-2,1,15.0,11.0,4.0,8
15528,15528,2008-09,2008,2009,Sunderland,Wigan,Loss,Home,2009-03-14,0,1,2,5,6,0,1,2,3,1,1,3,3,1,15.0,14.0,1.0,8
15529,15529,2008-09,2008,2009,Sunderland,Man City,Loss,Away,2009-03-22,0,1,1,2,5,3,3,4,4,-2,-2,-2,1,0,15.0,9.0,6.0,8
15530,15530,2008-09,2008,2009,Sunderland,West Ham,Loss,Away,2009-04-04,0,0,1,1,2,2,5,8,8,-2,-4,-7,-6,0,15.0,10.0,5.0,9
15531,15531,2008-09,2008,2009,Sunderland,Man United,Loss,Home,2009-04-11,0,0,0,1,1,3,3,6,9,-3,-3,-5,-8,1,15.0,1.0,14.0,9
15532,15532,2008-09,2008,2009,Sunderland,Hull,Win,Home,2009-04-18,3,0,0,0,1,1,1,2,5,-1,-1,-2,-4,1,15.0,21.0,-6.0,9
15533,15533,2008-09,2008,2009,Sunderland,West Brom,Loss,Away,2009-04-25,0,3,3,3,3,1,1,2,3,2,2,1,0,0,15.0,21.0,-6.0,9
15534,15534,2008-09,2008,2009,Sunderland,Everton,Loss,Home,2009-05-03,0,3,3,3,3,1,2,5,5,2,1,-2,-2,1,15.0,5.0,10.0,10
15535,15535,2008-09,2008,2009,Sunderland,Bolton,Draw,Away,2009-05-09,1,0,3,3,3,2,2,2,5,-2,1,1,-2,0,15.0,16.0,-1.0,10
15536,15536,2008-09,2008,2009,Sunderland,Portsmouth,Loss,Away,2009-05-18,0,1,1,4,4,0,1,1,4,1,0,3,0,0,15.0,8.0,7.0,10
15537,15537,2008-09,2008,2009,Sunderland,Chelsea,Loss,Home,2009-05-24,0,1,1,1,4,6,9,12,13,-5,-8,-11,-9,1,15.0,2.0,13.0,10
15538,15538,2009-10,2009,2010,Sunderland,Bolton,Win,Away,2009-08-15,3,0,1,1,1,1,2,3,4,-1,-1,-2,-3,0,16.0,13.0,3.0,1
15539,15539,2009-10,2009,2010,Sunderland,Chelsea,Loss,Home,2009-08-18,0,3,3,4,4,6,9,12,15,-3,-6,-8,-11,1,16.0,3.0,13.0,1
15540,15540,2009-10,2009,2010,Sunderland,Blackburn,Win,Home,2009-08-22,3,3,3,3,4,1,1,4,4,2,2,-1,0,1,16.0,15.0,1.0,1
15541,15541,2009-10,2009,2010,Sunderland,Stoke,Loss,Away,2009-08-29,0,3,6,6,6,1,4,4,7,2,2,2,-1,0,16.0,12.0,4.0,1
15542,15542,2009-10,2009,2010,Sunderland,Hull,Win,Home,2009-09-12,3,3,3,6,6,4,4,4,4,-1,-1,2,2,1,16.0,17.0,-1.0,2
15543,15543,2009-10,2009,2010,Sunderland,Burnley,Loss,Away,2009-09-19,0,3,6,6,9,0,3,6,6,3,3,0,3,0,16.0,21.0,-5.0,2
15544,15544,2009-10,2009,2010,Sunderland,Wolves,Win,Home,2009-09-27,3,3,3,6,6,3,4,4,7,0,-1,2,-1,1,16.0,21.0,-5.0,2
15545,15545,2009-10,2009,2010,Sunderland,Man United,Draw,Away,2009-10-03,1,3,6,6,9,6,9,12,15,-3,-3,-6,-6,0,16.0,1.0,15.0,3
15546,15546,2009-10,2009,2010,Sunderland,Liverpool,Win,Home,2009-10-17,3,4,4,7,7,3,6,9,12,1,-2,-2,-5,1,16.0,2.0,14.0,3
15547,15547,2009-10,2009,2010,Sunderland,Birmingham,Loss,Away,2009-10-24,0,4,7,7,10,0,0,3,3,4,7,4,7,0,16.0,21.0,-5.0,3
15548,15548,2009-10,2009,2010,Sunderland,West Ham,Draw,Home,2009-10-31,1,3,4,7,7,1,2,2,2,2,2,5,5,1,16.0,9.0,7.0,3
15549,15549,2009-10,2009,2010,Sunderland,Tottenham,Loss,Away,2009-11-07,0,1,4,5,8,0,3,4,7,1,1,1,1,0,16.0,8.0,8.0,4
15550,15550,2009-10,2009,2010,Sunderland,Arsenal,Win,Home,2009-11-21,3,1,1,4,5,6,7,10,13,-5,-6,-6,-8,1,16.0,4.0,12.0,4
15551,15551,2009-10,2009,2010,Sunderland,Wigan,Loss,Away,2009-11-28,0,3,4,4,7,1,1,4,5,2,3,0,2,0,16.0,11.0,5.0,4
15552,15552,2009-10,2009,2010,Sunderland,Fulham,Loss,Away,2009-12-06,0,3,3,4,4,4,4,5,8,-1,-1,-1,-4,0,16.0,7.0,9.0,5
15553,15553,2009-10,2009,2010,Sunderland,Portsmouth,Draw,Home,2009-12-12,1,0,3,3,4,3,3,3,6,-3,0,0,-2,1,16.0,14.0,2.0,5
15554,15554,2009-10,2009,2010,Sunderland,Aston Villa,Loss,Home,2009-12-15,0,1,1,4,4,6,7,8,11,-5,-6,-4,-7,1,16.0,6.0,10.0,5
15555,15555,2009-10,2009,2010,Sunderland,Man City,Loss,Away,2009-12-19,0,1,1,1,4,1,4,5,6,0,-3,-4,-2,0,16.0,10.0,6.0,5
15556,15556,2009-10,2009,2010,Sunderland,Everton,Draw,Home,2009-12-26,1,0,1,1,1,2,3,3,3,-2,-2,-2,-2,1,16.0,5.0,11.0,5
15557,15557,2009-10,2009,2010,Sunderland,Blackburn,Draw,Away,2009-12-28,1,1,1,2,2,1,1,2,3,0,0,0,-1,0,16.0,15.0,1.0,5
15558,15558,2009-10,2009,2010,Sunderland,Chelsea,Loss,Away,2010-01-16,0,2,2,2,3,4,5,8,9,-2,-3,-6,-6,0,16.0,3.0,13.0,6
15559,15559,2009-10,2009,2010,Sunderland,Everton,Loss,Away,2010-01-27,0,1,2,2,2,4,7,8,9,-3,-5,-6,-7,0,16.0,5.0,11.0,6
15560,15560,2009-10,2009,2010,Sunderland,Stoke,Draw,Home,2010-02-01,1,0,1,2,2,4,4,4,4,-4,-3,-2,-2,1,16.0,12.0,4.0,7
15561,15561,2009-10,2009,2010,Sunderland,Wigan,Draw,Home,2010-02-06,1,1,1,2,3,0,3,3,4,1,-2,-1,-1,1,16.0,11.0,5.0,7
15562,15562,2009-10,2009,2010,Sunderland,Portsmouth,Draw,Away,2010-02-09,1,2,2,2,3,0,0,1,1,2,2,1,2,0,16.0,14.0,2.0,7
15563,15563,2009-10,2009,2010,Sunderland,Arsenal,Loss,Away,2010-02-20,0,2,3,3,3,3,3,4,7,-1,0,-1,-4,0,16.0,4.0,12.0,7
15564,15564,2009-10,2009,2010,Sunderland,Fulham,Draw,Home,2010-02-28,1,1,2,3,3,6,7,10,10,-5,-5,-7,-7,1,16.0,7.0,9.0,7
15565,15565,2009-10,2009,2010,Sunderland,Bolton,Win,Home,2010-03-09,3,1,2,3,4,6,6,7,7,-5,-4,-4,-3,1,16.0,13.0,3.0,8
15566,15566,2009-10,2009,2010,Sunderland,Man City,Draw,Home,2010-03-14,1,4,4,5,6,4,5,8,8,0,-1,-3,-2,1,16.0,10.0,6.0,8
15567,15567,2009-10,2009,2010,Sunderland,Birmingham,Win,Home,2010-03-20,3,4,5,5,6,4,7,7,7,0,-2,-2,-1,1,16.0,21.0,-5.0,8
15568,15568,2009-10,2009,2010,Sunderland,Aston Villa,Draw,Away,2010-03-24,1,4,7,8,8,4,5,8,9,0,2,0,-1,0,16.0,6.0,10.0,8
15569,15569,2009-10,2009,2010,Sunderland,Liverpool,Loss,Away,2010-03-28,0,4,5,8,9,3,3,6,7,1,2,2,2,0,16.0,2.0,14.0,8
15570,15570,2009-10,2009,2010,Sunderland,Tottenham,Win,Home,2010-04-03,3,1,4,5,8,6,9,12,15,-5,-5,-7,-7,1,16.0,8.0,8.0,9
15571,15571,2009-10,2009,2010,Sunderland,West Ham,Loss,Away,2010-04-10,0,3,4,7,8,1,1,1,1,2,3,6,7,0,16.0,9.0,7.0,9
15572,15572,2009-10,2009,2010,Sunderland,Burnley,Win,Home,2010-04-17,3,3,3,4,7,3,3,3,3,0,0,1,4,1,16.0,21.0,-5.0,9
15573,15573,2009-10,2009,2010,Sunderland,Hull,Win,Away,2010-04-24,3,3,6,6,7,1,1,1,4,2,5,5,3,0,16.0,17.0,-1.0,9
15574,15574,2009-10,2009,2010,Sunderland,Man United,Loss,Home,2010-05-02,0,6,6,9,9,6,7,7,10,0,-1,2,-1,1,16.0,1.0,15.0,10
15575,15575,2009-10,2009,2010,Sunderland,Wolves,Loss,Away,2010-05-09,0,3,6,6,9,1,2,3,3,2,4,3,6,0,16.0,21.0,-5.0,10
15576,15576,2010-11,2010,2011,Sunderland,Birmingham,Draw,Home,2010-08-14,1,0,3,6,6,3,3,4,4,-3,0,2,2,1,13.0,9.0,4.0,1
15577,15577,2010-11,2010,2011,Sunderland,West Brom,Loss,Away,2010-08-21,0,1,1,4,7,1,1,4,4,0,0,0,3,0,13.0,21.0,-8.0,1
15578,15578,2010-11,2010,2011,Sunderland,Man City,Win,Home,2010-08-29,3,1,1,1,4,4,5,5,8,-3,-4,-4,-4,1,13.0,5.0,8.0,1
15579,15579,2010-11,2010,2011,Sunderland,Wigan,Draw,Away,2010-09-11,1,3,4,4,4,3,3,3,4,0,1,1,0,0,13.0,16.0,-3.0,2
15580,15580,2010-11,2010,2011,Sunderland,Arsenal,Draw,Home,2010-09-18,1,4,4,5,5,6,9,10,13,-2,-5,-5,-8,1,13.0,3.0,10.0,2
15581,15581,2010-11,2010,2011,Sunderland,Liverpool,Draw,Away,2010-09-25,1,2,5,5,6,1,4,4,5,1,1,1,1,0,13.0,7.0,6.0,2
15582,15582,2010-11,2010,2011,Sunderland,Man United,Draw,Home,2010-10-02,1,2,3,6,6,4,5,8,9,-2,-2,-2,-3,1,13.0,2.0,11.0,3
15583,15583,2010-11,2010,2011,Sunderland,Blackburn,Draw,Away,2010-10-18,1,2,3,4,7,3,4,5,5,-1,-1,-1,2,0,13.0,10.0,3.0,3
15584,15584,2010-11,2010,2011,Sunderland,Aston Villa,Win,Home,2010-10-23,3,2,3,4,5,1,4,5,5,1,-1,-1,0,1,13.0,6.0,7.0,3
15585,15585,2010-11,2010,2011,Sunderland,Newcastle,Loss,Away,2010-10-31,0,4,5,6,7,4,4,4,7,0,1,2,0,0,13.0,21.0,-8.0,3
15586,15586,2010-11,2010,2011,Sunderland,Stoke,Win,Home,2010-11-06,3,3,4,5,6,0,0,3,6,3,4,2,0,1,13.0,11.0,2.0,4
15587,15587,2010-11,2010,2011,Sunderland,Tottenham,Draw,Away,2010-11-09,1,3,6,7,8,0,1,4,7,3,5,3,1,0,13.0,4.0,9.0,4
15588,15588,2010-11,2010,2011,Sunderland,Chelsea,Win,Away,2010-11-14,3,4,4,7,8,3,6,9,10,1,-2,-2,-2,0,13.0,1.0,12.0,4
15589,15589,2010-11,2010,2011,Sunderland,Everton,Draw,Home,2010-11-22,1,4,7,7,10,1,2,5,6,3,5,2,4,1,13.0,8.0,5.0,4
15590,15590,2010-11,2010,2011,Sunderland,Wolves,Loss,Away,2010-11-27,0,4,5,8,8,0,0,0,3,4,5,8,5,0,13.0,15.0,-2.0,4
15591,15591,2010-11,2010,2011,Sunderland,West Ham,Win,Home,2010-12-05,3,1,4,5,8,3,4,5,6,-2,0,0,2,1,13.0,17.0,-4.0,5
15592,15592,2010-11,2010,2011,Sunderland,Fulham,Draw,Away,2010-12-11,1,3,4,7,8,1,1,2,2,2,3,5,6,0,13.0,12.0,1.0,5
15593,15593,2010-11,2010,2011,Sunderland,Bolton,Win,Home,2010-12-18,3,4,4,5,8,3,4,7,10,1,0,-2,-2,1,13.0,14.0,-1.0,5
15594,15594,2010-11,2010,2011,Sunderland,Man United,Loss,Away,2010-12-26,0,4,7,7,8,6,9,10,11,-2,-2,-3,-3,0,13.0,2.0,11.0,5
15595,15595,2010-11,2010,2011,Sunderland,Blackpool,Loss,Home,2010-12-28,0,3,4,7,7,4,7,8,8,-1,-3,-1,-1,1,13.0,21.0,-8.0,5
15596,15596,2010-11,2010,2011,Sunderland,Blackburn,Win,Home,2011-01-01,3,0,3,4,7,3,4,4,7,-3,-1,0,0,1,13.0,10.0,3.0,6
15597,15597,2010-11,2010,2011,Sunderland,Aston Villa,Win,Away,2011-01-05,3,3,3,6,7,1,1,4,4,2,2,2,3,0,13.0,6.0,7.0,6
15598,15598,2010-11,2010,2011,Sunderland,Newcastle,Draw,Home,2011-01-16,1,6,6,6,9,6,6,6,9,0,0,0,0,1,13.0,21.0,-8.0,6
15599,15599,2010-11,2010,2011,Sunderland,Blackpool,Win,Away,2011-01-22,3,4,7,7,7,3,3,3,6,1,4,4,1,0,13.0,21.0,-8.0,6
15600,15600,2010-11,2010,2011,Sunderland,Chelsea,Loss,Home,2011-02-01,0,4,7,10,10,6,6,7,10,-2,1,3,0,1,13.0,1.0,12.0,7
15601,15601,2010-11,2010,2011,Sunderland,Stoke,Loss,Away,2011-02-05,0,3,4,7,10,0,3,3,6,3,1,4,4,0,13.0,11.0,2.0,7
15602,15602,2010-11,2010,2011,Sunderland,Tottenham,Loss,Home,2011-02-12,0,0,3,4,7,6,7,8,8,-6,-4,-4,-1,1,13.0,4.0,9.0,7
15603,15603,2010-11,2010,2011,Sunderland,Everton,Loss,Away,2011-02-26,0,0,0,3,4,3,3,4,5,-3,-3,-1,-1,0,13.0,8.0,5.0,7
15604,15604,2010-11,2010,2011,Sunderland,Arsenal,Draw,Away,2011-03-05,1,0,0,0,3,6,7,10,13,-6,-7,-10,-10,0,13.0,3.0,10.0,8
15605,15605,2010-11,2010,2011,Sunderland,Liverpool,Loss,Home,2011-03-20,0,1,1,1,1,3,4,7,10,-2,-3,-6,-9,1,13.0,7.0,6.0,8
15606,15606,2010-11,2010,2011,Sunderland,Man City,Loss,Away,2011-04-03,0,1,1,1,1,3,4,4,7,-2,-3,-3,-6,0,13.0,5.0,8.0,9
15607,15607,2010-11,2010,2011,Sunderland,West Brom,Loss,Home,2011-04-09,0,0,1,1,1,4,7,8,9,-4,-6,-7,-8,1,13.0,21.0,-8.0,9
15608,15608,2010-11,2010,2011,Sunderland,Birmingham,Loss,Away,2011-04-16,0,0,0,1,1,4,4,5,5,-4,-4,-4,-4,0,13.0,9.0,4.0,9
15609,15609,2010-11,2010,2011,Sunderland,Wigan,Win,Home,2011-04-23,3,0,0,0,1,3,4,7,7,-3,-4,-7,-6,1,13.0,16.0,-3.0,9
15610,15610,2010-11,2010,2011,Sunderland,Fulham,Loss,Home,2011-04-30,0,3,3,3,3,4,4,7,7,-1,-1,-4,-4,1,13.0,12.0,1.0,9
15611,15611,2010-11,2010,2011,Sunderland,Bolton,Win,Away,2011-05-07,3,3,3,3,3,0,3,6,6,3,0,-3,-3,0,13.0,14.0,-1.0,10
15612,15612,2010-11,2010,2011,Sunderland,Wolves,Loss,Home,2011-05-14,0,3,6,6,6,4,4,5,5,-1,2,1,1,1,13.0,15.0,-2.0,10
15613,15613,2010-11,2010,2011,Sunderland,West Ham,Win,Away,2011-05-22,3,3,3,6,6,1,1,1,1,2,2,5,5,0,13.0,17.0,-4.0,10
15614,15614,2011-12,2011,2012,Sunderland,Liverpool,Draw,Away,2011-08-13,1,3,6,6,9,0,3,6,9,3,3,0,0,0,10.0,6.0,4.0,1
15615,15615,2011-12,2011,2012,Sunderland,Newcastle,Loss,Home,2011-08-20,0,4,4,7,7,2,3,6,6,2,1,1,1,1,10.0,12.0,-2.0,1
15616,15616,2011-12,2011,2012,Sunderland,Swansea,Draw,Away,2011-08-27,1,1,4,4,7,1,1,1,1,0,3,3,6,0,10.0,21.0,-11.0,1
15617,15617,2011-12,2011,2012,Sunderland,Chelsea,Loss,Home,2011-09-10,0,1,2,5,5,6,7,7,8,-5,-5,-2,-3,1,10.0,2.0,8.0,2
15618,15618,2011-12,2011,2012,Sunderland,Stoke,Win,Home,2011-09-18,3,1,1,2,5,6,7,8,8,-5,-6,-6,-3,1,10.0,13.0,-3.0,2
15619,15619,2011-12,2011,2012,Sunderland,Norwich,Loss,Away,2011-09-26,0,3,4,4,5,3,3,4,5,0,1,0,0,0,10.0,21.0,-11.0,2
15620,15620,2011-12,2011,2012,Sunderland,West Brom,Draw,Home,2011-10-01,1,3,3,4,4,1,4,4,4,2,-1,0,0,1,10.0,11.0,-1.0,3
15621,15621,2011-12,2011,2012,Sunderland,Arsenal,Loss,Away,2011-10-16,0,1,4,4,5,3,3,6,6,-2,1,-2,-1,0,10.0,4.0,6.0,3
15622,15622,2011-12,2011,2012,Sunderland,Bolton,Win,Away,2011-10-22,3,1,1,4,4,3,3,3,3,-2,-2,1,1,0,10.0,14.0,-4.0,3
15623,15623,2011-12,2011,2012,Sunderland,Aston Villa,Draw,Home,2011-10-29,1,3,4,4,7,0,3,4,5,3,1,0,2,1,10.0,9.0,1.0,3
15624,15624,2011-12,2011,2012,Sunderland,Man United,Loss,Away,2011-11-05,0,4,4,5,5,3,4,7,8,1,0,-2,-3,0,10.0,1.0,9.0,4
15625,15625,2011-12,2011,2012,Sunderland,Fulham,Draw,Home,2011-11-19,1,1,4,4,5,3,3,3,6,-2,1,1,-1,1,10.0,8.0,2.0,4
15626,15626,2011-12,2011,2012,Sunderland,Wigan,Loss,Home,2011-11-26,0,1,2,5,5,1,1,1,1,0,1,4,4,1,10.0,16.0,-6.0,4
15627,15627,2011-12,2011,2012,Sunderland,Wolves,Loss,Away,2011-12-04,0,1,1,2,5,0,3,3,4,1,-2,-1,1,0,10.0,17.0,-7.0,5
15628,15628,2011-12,2011,2012,Sunderland,Blackburn,Win,Home,2011-12-11,3,0,1,1,2,3,4,4,5,-3,-3,-3,-3,1,10.0,15.0,-5.0,5
15629,15629,2011-12,2011,2012,Sunderland,Tottenham,Loss,Away,2011-12-18,0,3,3,4,4,3,6,9,12,0,-3,-5,-8,0,10.0,5.0,5.0,5
15630,15630,2011-12,2011,2012,Sunderland,QPR,Win,Away,2011-12-21,3,3,3,3,4,0,1,1,4,3,2,2,0,0,10.0,21.0,-11.0,5
15631,15631,2011-12,2011,2012,Sunderland,Everton,Draw,Home,2011-12-26,1,3,6,6,6,4,4,4,7,-1,2,2,-1,1,10.0,7.0,3.0,5
15632,15632,2011-12,2011,2012,Sunderland,Man City,Win,Home,2012-01-01,3,4,4,7,7,4,7,7,10,0,-3,0,-3,1,10.0,3.0,7.0,6
15633,15633,2011-12,2011,2012,Sunderland,Wigan,Win,Away,2012-01-03,3,4,7,7,10,1,2,3,6,3,5,4,4,0,10.0,16.0,-6.0,6
15634,15634,2011-12,2011,2012,Sunderland,Chelsea,Loss,Away,2012-01-14,0,6,7,10,10,3,4,5,6,3,3,5,4,0,10.0,2.0,8.0,6
15635,15635,2011-12,2011,2012,Sunderland,Swansea,Win,Home,2012-01-21,3,3,6,7,10,6,7,8,8,-3,-1,-1,2,1,10.0,21.0,-11.0,6
15636,15636,2011-12,2011,2012,Sunderland,Norwich,Win,Home,2012-02-01,3,3,6,9,10,4,7,8,8,-1,-1,1,2,1,10.0,21.0,-11.0,7
15637,15637,2011-12,2011,2012,Sunderland,Stoke,Win,Away,2012-02-04,3,6,6,9,12,0,1,4,5,6,5,5,7,0,10.0,13.0,-3.0,7
15638,15638,2011-12,2011,2012,Sunderland,Arsenal,Loss,Home,2012-02-11,0,6,9,9,12,4,4,4,4,2,5,5,8,1,10.0,4.0,6.0,7
15639,15639,2011-12,2011,2012,Sunderland,West Brom,Loss,Away,2012-02-25,0,3,6,9,9,3,4,7,7,0,2,2,2,0,10.0,11.0,-1.0,7
15640,15640,2011-12,2011,2012,Sunderland,Newcastle,Draw,Away,2012-03-04,1,0,3,6,9,1,4,7,7,-1,-1,-1,2,0,10.0,12.0,-2.0,8
15641,15641,2011-12,2011,2012,Sunderland,Liverpool,Win,Home,2012-03-10,3,1,1,4,7,0,1,4,4,1,0,0,3,1,10.0,6.0,4.0,8
15642,15642,2011-12,2011,2012,Sunderland,Blackburn,Loss,Away,2012-03-20,0,4,4,4,7,4,4,7,7,0,0,-3,0,0,10.0,15.0,-5.0,8
15643,15643,2011-12,2011,2012,Sunderland,QPR,Win,Home,2012-03-24,3,3,4,4,4,3,4,4,4,0,0,0,0,1,10.0,21.0,-11.0,8
15644,15644,2011-12,2011,2012,Sunderland,Man City,Draw,Away,2012-03-31,1,3,6,7,7,4,4,7,10,-1,2,0,-3,0,10.0,3.0,7.0,8
15645,15645,2011-12,2011,2012,Sunderland,Tottenham,Draw,Home,2012-04-07,1,4,4,7,8,4,5,5,5,0,-1,2,3,1,10.0,5.0,5.0,9
15646,15646,2011-12,2011,2012,Sunderland,Everton,Loss,Away,2012-04-09,0,2,5,5,8,4,7,7,7,-2,-2,-2,1,0,10.0,7.0,3.0,9
15647,15647,2011-12,2011,2012,Sunderland,Wolves,Draw,Home,2012-04-14,1,1,2,5,5,0,0,0,0,1,2,5,5,1,10.0,17.0,-7.0,9
15648,15648,2011-12,2011,2012,Sunderland,Aston Villa,Draw,Away,2012-04-21,1,1,2,3,6,1,2,2,2,0,0,1,4,0,10.0,9.0,1.0,9
15649,15649,2011-12,2011,2012,Sunderland,Bolton,Draw,Home,2012-04-28,1,2,2,3,4,4,4,4,7,-2,-2,-1,-3,1,10.0,14.0,-4.0,9
15650,15650,2011-12,2011,2012,Sunderland,Fulham,Loss,Away,2012-05-06,0,2,3,3,4,3,6,7,10,-1,-3,-4,-6,0,10.0,8.0,2.0,10
15651,15651,2011-12,2011,2012,Sunderland,Man United,Loss,Home,2012-05-13,0,1,2,3,3,3,4,7,7,-2,-2,-4,-4,1,10.0,1.0,9.0,10
15652,15652,2012-13,2012,2013,Sunderland,Arsenal,Draw,Away,2012-08-18,1,0,1,2,3,4,5,6,6,-4,-4,-4,-3,0,13.0,3.0,10.0,1
15653,15653,2012-13,2012,2013,Sunderland,Swansea,Draw,Away,2012-09-01,1,1,1,2,3,6,9,9,10,-5,-8,-7,-7,0,13.0,11.0,2.0,2
15654,15654,2012-13,2012,2013,Sunderland,Liverpool,Draw,Home,2012-09-15,1,2,2,2,3,1,1,1,4,1,1,1,-1,1,13.0,8.0,5.0,2
15655,15655,2012-13,2012,2013,Sunderland,West Ham,Draw,Away,2012-09-22,1,2,3,3,3,4,4,7,7,-2,-1,-4,-4,0,13.0,21.0,-8.0,2
15656,15656,2012-13,2012,2013,Sunderland,Wigan,Win,Home,2012-09-29,3,2,3,4,4,0,1,4,4,2,2,0,0,1,13.0,15.0,-2.0,2
15657,15657,2012-13,2012,2013,Sunderland,Man City,Loss,Away,2012-10-06,0,4,5,6,7,4,5,8,9,0,0,-2,-2,0,13.0,1.0,12.0,3
15658,15658,2012-13,2012,2013,Sunderland,Newcastle,Draw,Home,2012-10-21,1,3,4,5,6,1,4,5,6,2,0,0,0,1,13.0,5.0,8.0,3
15659,15659,2012-13,2012,2013,Sunderland,Stoke,Draw,Away,2012-10-27,1,1,4,5,6,1,4,4,5,0,0,1,1,0,13.0,14.0,-1.0,3
15660,15660,2012-13,2012,2013,Sunderland,Aston Villa,Loss,Home,2012-11-03,0,2,2,5,6,1,1,2,2,1,1,3,4,1,13.0,16.0,-3.0,4
15661,15661,2012-13,2012,2013,Sunderland,Everton,Loss,Away,2012-11-10,0,1,2,2,5,2,3,4,7,-1,-1,-2,-2,0,13.0,7.0,6.0,4
15662,15662,2012-13,2012,2013,Sunderland,Fulham,Win,Away,2012-11-18,3,0,1,2,2,2,3,6,7,-2,-2,-4,-5,0,13.0,9.0,4.0,4
15663,15663,2012-13,2012,2013,Sunderland,West Brom,Loss,Home,2012-11-24,0,3,3,4,5,6,9,9,9,-3,-6,-5,-4,1,13.0,10.0,3.0,4
15664,15664,2012-13,2012,2013,Sunderland,QPR,Draw,Home,2012-11-27,1,3,3,3,4,0,0,1,1,3,3,2,3,1,13.0,17.0,-4.0,4
15665,15665,2012-13,2012,2013,Sunderland,Norwich,Loss,Away,2012-12-02,0,1,4,4,4,2,5,6,9,-1,-1,-2,-5,0,13.0,12.0,1.0,5
15666,15666,2012-13,2012,2013,Sunderland,Chelsea,Loss,Home,2012-12-08,0,1,1,4,4,1,2,2,3,0,-1,2,1,1,13.0,6.0,7.0,5
15667,15667,2012-13,2012,2013,Sunderland,Reading,Win,Home,2012-12-11,3,0,1,1,4,0,0,0,3,0,1,1,1,1,13.0,21.0,-8.0,5
15668,15668,2012-13,2012,2013,Sunderland,Man United,Loss,Away,2012-12-15,0,3,3,4,4,6,9,12,12,-3,-6,-8,-8,0,13.0,2.0,11.0,5
15669,15669,2012-13,2012,2013,Sunderland,Southampton,Win,Away,2012-12-22,3,3,3,3,4,3,4,7,10,0,-1,-4,-6,0,13.0,21.0,-8.0,5
15670,15670,2012-13,2012,2013,Sunderland,Man City,Win,Home,2012-12-26,3,3,6,6,6,6,6,7,10,-3,0,-1,-4,1,13.0,1.0,12.0,5
15671,15671,2012-13,2012,2013,Sunderland,Tottenham,Loss,Home,2012-12-29,0,6,6,9,9,4,7,7,10,2,-1,2,-1,1,13.0,4.0,9.0,5
15672,15672,2012-13,2012,2013,Sunderland,Liverpool,Loss,Away,2013-01-02,0,3,6,6,9,3,6,6,9,0,0,0,0,0,13.0,8.0,5.0,6
15673,15673,2012-13,2012,2013,Sunderland,West Ham,Win,Home,2013-01-12,3,0,3,6,6,3,3,4,4,-3,0,2,2,1,13.0,21.0,-8.0,6
15674,15674,2012-13,2012,2013,Sunderland,Wigan,Win,Away,2013-01-19,3,3,3,6,9,1,4,4,4,2,-1,2,5,0,13.0,15.0,-2.0,6
15675,15675,2012-13,2012,2013,Sunderland,Swansea,Draw,Home,2013-01-29,1,6,6,6,9,4,5,8,9,2,1,-2,0,1,13.0,11.0,2.0,6
15676,15676,2012-13,2012,2013,Sunderland,Reading,Loss,Away,2013-02-02,0,4,7,7,7,4,7,7,10,0,0,0,-3,0,13.0,21.0,-8.0,7
15677,15677,2012-13,2012,2013,Sunderland,Arsenal,Loss,Home,2013-02-09,0,1,4,7,7,4,7,7,7,-3,-3,0,0,1,13.0,3.0,10.0,7
15678,15678,2012-13,2012,2013,Sunderland,West Brom,Loss,Away,2013-02-23,0,0,1,4,7,3,3,4,4,-3,-2,0,3,0,13.0,10.0,3.0,7
15679,15679,2012-13,2012,2013,Sunderland,Fulham,Draw,Home,2013-03-02,1,0,0,1,4,4,4,7,7,-4,-4,-6,-3,1,13.0,9.0,4.0,8
15680,15680,2012-13,2012,2013,Sunderland,QPR,Loss,Away,2013-03-09,0,1,1,1,2,3,3,4,5,-2,-2,-3,-3,0,13.0,17.0,-4.0,8
15681,15681,2012-13,2012,2013,Sunderland,Norwich,Draw,Home,2013-03-17,1,1,1,1,1,1,4,5,6,0,-3,-4,-5,1,13.0,12.0,1.0,8
15682,15682,2012-13,2012,2013,Sunderland,Man United,Loss,Home,2013-03-30,0,1,2,2,2,6,9,12,15,-5,-7,-10,-13,1,13.0,2.0,11.0,8
15683,15683,2012-13,2012,2013,Sunderland,Chelsea,Loss,Away,2013-04-07,0,1,1,2,2,3,6,6,9,-2,-5,-4,-7,0,13.0,6.0,7.0,9
15684,15684,2012-13,2012,2013,Sunderland,Newcastle,Win,Away,2013-04-14,3,0,1,1,2,3,3,6,6,-3,-2,-5,-4,0,13.0,5.0,8.0,9
15685,15685,2012-13,2012,2013,Sunderland,Everton,Win,Home,2013-04-20,3,3,3,4,4,4,5,8,11,-1,-2,-4,-7,1,13.0,7.0,6.0,9
15686,15686,2012-13,2012,2013,Sunderland,Aston Villa,Loss,Away,2013-04-29,0,6,6,6,7,1,4,4,7,5,2,2,0,0,13.0,16.0,-3.0,9
15687,15687,2012-13,2012,2013,Sunderland,Stoke,Draw,Home,2013-05-06,1,3,6,6,6,6,6,6,6,-3,0,0,0,1,13.0,14.0,-1.0,10
15688,15688,2012-13,2012,2013,Sunderland,Southampton,Draw,Home,2013-05-12,1,1,4,7,7,0,1,2,5,1,3,5,2,1,13.0,21.0,-8.0,10
15689,15689,2012-13,2012,2013,Sunderland,Tottenham,Loss,Away,2013-05-19,0,2,2,5,8,4,7,8,11,-2,-5,-3,-3,0,13.0,4.0,9.0,10
15690,15690,2013-14,2013,2014,Sunderland,Fulham,Loss,Home,2013-08-17,0,1,2,2,5,3,3,3,3,-2,-1,-1,2,1,17.0,12.0,5.0,1
15691,15691,2013-14,2013,2014,Sunderland,Southampton,Draw,Away,2013-08-24,1,0,1,2,2,4,5,5,5,-4,-4,-3,-3,0,17.0,14.0,3.0,1
15692,15692,2013-14,2013,2014,Sunderland,Crystal Palace,Loss,Away,2013-08-31,0,1,1,2,3,0,1,2,3,1,0,0,0,0,17.0,21.0,-4.0,1
15693,15693,2013-14,2013,2014,Sunderland,Arsenal,Loss,Home,2013-09-14,0,1,1,1,2,6,6,9,12,-5,-5,-8,-10,1,17.0,4.0,13.0,2
15694,15694,2013-14,2013,2014,Sunderland,West Brom,Loss,Away,2013-09-21,0,0,1,1,1,1,2,2,3,-1,-1,-1,-2,0,17.0,8.0,9.0,2
15695,15695,2013-14,2013,2014,Sunderland,Liverpool,Loss,Home,2013-09-29,0,0,0,1,1,1,4,7,10,-1,-4,-6,-9,1,17.0,7.0,10.0,2
15696,15696,2013-14,2013,2014,Sunderland,Man United,Loss,Home,2013-10-05,0,0,0,0,1,0,3,3,4,0,-3,-3,-3,1,17.0,1.0,16.0,3
15697,15697,2013-14,2013,2014,Sunderland,Swansea,Loss,Away,2013-10-19,0,0,0,0,0,0,3,4,7,0,-3,-4,-7,0,17.0,9.0,8.0,3
15698,15698,2013-14,2013,2014,Sunderland,Newcastle,Win,Home,2013-10-27,3,0,0,0,0,4,4,4,7,-4,-4,-4,-7,1,17.0,16.0,1.0,3
15699,15699,2013-14,2013,2014,Sunderland,Hull,Loss,Away,2013-11-02,0,3,3,3,3,0,1,4,7,3,2,-1,-4,0,17.0,21.0,-4.0,4
15700,15700,2013-14,2013,2014,Sunderland,Man City,Win,Home,2013-11-10,3,3,3,3,3,3,6,9,9,0,-3,-6,-6,1,17.0,2.0,15.0,4
15701,15701,2013-14,2013,2014,Sunderland,Stoke,Loss,Away,2013-11-23,0,3,6,6,6,2,2,3,3,1,4,3,3,0,17.0,13.0,4.0,4
15702,15702,2013-14,2013,2014,Sunderland,Aston Villa,Draw,Away,2013-11-30,1,3,3,6,6,4,5,5,5,-1,-2,1,1,0,17.0,15.0,2.0,4
15703,15703,2013-14,2013,2014,Sunderland,Chelsea,Loss,Home,2013-12-04,0,1,4,4,7,6,7,7,10,-5,-3,-3,-3,1,17.0,3.0,14.0,5
15704,15704,2013-14,2013,2014,Sunderland,Tottenham,Loss,Home,2013-12-07,0,1,1,4,4,4,4,4,5,-3,-3,0,-1,1,17.0,5.0,12.0,5
15705,15705,2013-14,2013,2014,Sunderland,West Ham,Draw,Away,2013-12-14,1,0,1,1,4,0,3,3,3,0,-2,-2,1,0,17.0,10.0,7.0,5
15706,15706,2013-14,2013,2014,Sunderland,Norwich,Draw,Home,2013-12-21,1,1,1,2,2,4,4,7,7,-3,-3,-5,-5,1,17.0,11.0,6.0,5
15707,15707,2013-14,2013,2014,Sunderland,Everton,Win,Away,2013-12-26,3,2,2,2,3,6,7,10,13,-4,-5,-8,-10,0,17.0,6.0,11.0,5
15708,15708,2013-14,2013,2014,Sunderland,Cardiff,Draw,Away,2013-12-28,1,4,5,5,5,0,3,3,4,4,2,2,1,0,17.0,21.0,-4.0,5
15709,15709,2013-14,2013,2014,Sunderland,Aston Villa,Loss,Home,2014-01-01,0,4,5,6,6,1,1,1,1,3,4,5,5,1,17.0,15.0,2.0,6
15710,15710,2013-14,2013,2014,Sunderland,Fulham,Win,Away,2014-01-11,3,1,4,5,6,3,6,6,6,-2,-2,-1,0,0,17.0,12.0,5.0,6
15711,15711,2013-14,2013,2014,Sunderland,Southampton,Draw,Home,2014-01-18,1,3,4,7,8,3,3,6,6,0,1,1,2,1,17.0,14.0,3.0,6
15712,15712,2013-14,2013,2014,Sunderland,Stoke,Win,Home,2014-01-29,3,4,4,5,8,0,1,1,1,4,3,4,7,1,17.0,13.0,4.0,6
15713,15713,2013-14,2013,2014,Sunderland,Newcastle,Win,Away,2014-02-01,3,4,7,7,8,4,4,4,4,0,3,3,4,0,17.0,16.0,1.0,7
15714,15714,2013-14,2013,2014,Sunderland,Hull,Loss,Home,2014-02-08,0,6,7,10,10,1,1,1,1,5,6,9,9,1,17.0,21.0,-4.0,7
15715,15715,2013-14,2013,2014,Sunderland,Arsenal,Loss,Away,2014-02-22,0,3,6,7,10,1,4,5,8,2,2,2,2,0,17.0,4.0,13.0,7
15716,15716,2013-14,2013,2014,Sunderland,Crystal Palace,Draw,Home,2014-03-15,1,0,3,6,7,1,1,4,4,-1,2,2,3,1,17.0,21.0,-4.0,8
15717,15717,2013-14,2013,2014,Sunderland,Norwich,Loss,Away,2014-03-22,0,1,1,4,7,1,1,4,4,0,0,0,3,0,17.0,11.0,6.0,8
15718,15718,2013-14,2013,2014,Sunderland,Liverpool,Loss,Away,2014-03-26,0,1,1,1,4,6,9,12,15,-5,-8,-11,-11,0,17.0,7.0,10.0,8
15719,15719,2013-14,2013,2014,Sunderland,West Ham,Loss,Home,2014-03-31,0,0,1,1,1,3,3,3,6,-3,-2,-2,-5,1,17.0,10.0,7.0,8
15720,15720,2013-14,2013,2014,Sunderland,Tottenham,Loss,Away,2014-04-07,0,0,0,1,1,3,3,3,6,-3,-3,-2,-5,0,17.0,5.0,12.0,9
15721,15721,2013-14,2013,2014,Sunderland,Everton,Loss,Home,2014-04-12,0,0,0,0,1,6,9,12,15,-6,-9,-12,-14,1,17.0,6.0,11.0,9
15722,15722,2013-14,2013,2014,Sunderland,Man City,Draw,Away,2014-04-16,1,0,0,0,0,3,4,7,10,-3,-4,-7,-10,0,17.0,2.0,15.0,9
15723,15723,2013-14,2013,2014,Sunderland,Chelsea,Win,Away,2014-04-19,3,1,1,1,1,6,6,9,9,-5,-5,-8,-8,0,17.0,3.0,14.0,9
15724,15724,2013-14,2013,2014,Sunderland,Cardiff,Win,Home,2014-04-27,3,4,4,4,4,4,4,5,5,0,0,-1,-1,1,17.0,21.0,-4.0,9
15725,15725,2013-14,2013,2014,Sunderland,Man United,Win,Away,2014-05-03,3,6,7,7,7,3,6,9,9,3,1,-2,-2,0,17.0,1.0,16.0,10
15726,15726,2013-14,2013,2014,Sunderland,West Brom,Win,Home,2014-05-07,3,6,9,10,10,3,3,4,7,3,6,6,3,1,17.0,8.0,9.0,10
15727,15727,2013-14,2013,2014,Sunderland,Swansea,Loss,Home,2014-05-11,0,6,9,12,13,3,6,6,6,3,3,6,7,1,17.0,9.0,8.0,10
15728,15728,2014-15,2014,2015,Sunderland,West Brom,Draw,Away,2014-08-16,1,3,6,9,12,0,0,3,3,3,6,6,9,0,14.0,17.0,-3.0,1
15729,15729,2014-15,2014,2015,Sunderland,Man United,Draw,Home,2014-08-24,1,1,4,7,10,1,4,4,7,0,0,3,3,1,14.0,7.0,7.0,1
15730,15730,2014-15,2014,2015,Sunderland,QPR,Loss,Away,2014-08-30,0,2,2,5,8,0,0,0,0,2,2,5,8,0,14.0,21.0,-7.0,1
15731,15731,2014-15,2014,2015,Sunderland,Tottenham,Draw,Home,2014-09-13,1,1,2,2,5,3,6,9,9,-2,-4,-7,-4,1,14.0,6.0,8.0,2
15732,15732,2014-15,2014,2015,Sunderland,Burnley,Draw,Away,2014-09-20,1,1,2,3,3,2,2,2,5,-1,0,1,-2,0,14.0,21.0,-7.0,2
15733,15733,2014-15,2014,2015,Sunderland,Swansea,Draw,Home,2014-09-27,1,2,2,3,4,0,3,6,9,2,-1,-3,-5,1,14.0,12.0,2.0,2
15734,15734,2014-15,2014,2015,Sunderland,Stoke,Win,Home,2014-10-04,3,2,3,3,4,4,4,7,8,-2,-1,-4,-4,1,14.0,9.0,5.0,3
15735,15735,2014-15,2014,2015,Sunderland,Southampton,Loss,Away,2014-10-18,0,4,5,6,6,3,6,9,12,1,-1,-3,-6,0,14.0,8.0,6.0,3
15736,15736,2014-15,2014,2015,Sunderland,Arsenal,Loss,Home,2014-10-25,0,3,4,5,6,1,2,5,6,2,2,0,0,1,14.0,4.0,10.0,3
15737,15737,2014-15,2014,2015,Sunderland,Crystal Palace,Win,Away,2014-11-03,3,0,3,4,5,1,1,4,7,-1,2,0,-2,0,14.0,11.0,3.0,4
15738,15738,2014-15,2014,2015,Sunderland,Everton,Draw,Home,2014-11-09,1,3,3,6,7,4,7,7,8,-1,-4,-1,-1,1,14.0,5.0,9.0,4
15739,15739,2014-15,2014,2015,Sunderland,Leicester,Draw,Away,2014-11-22,1,4,4,4,7,0,0,0,1,4,4,4,6,0,14.0,21.0,-7.0,4
15740,15740,2014-15,2014,2015,Sunderland,Chelsea,Draw,Home,2014-11-29,1,2,5,5,5,6,9,10,13,-4,-4,-5,-8,1,14.0,3.0,11.0,4
15741,15741,2014-15,2014,2015,Sunderland,Man City,Loss,Home,2014-12-03,0,2,3,6,6,6,7,10,10,-4,-4,-4,-4,1,14.0,1.0,13.0,5
15742,15742,2014-15,2014,2015,Sunderland,Liverpool,Draw,Away,2014-12-06,1,1,2,3,6,6,6,6,6,-5,-4,-3,0,0,14.0,2.0,12.0,5
15743,15743,2014-15,2014,2015,Sunderland,West Ham,Draw,Home,2014-12-13,1,1,2,3,4,6,9,9,10,-5,-7,-6,-6,1,14.0,13.0,1.0,5
15744,15744,2014-15,2014,2015,Sunderland,Newcastle,Win,Away,2014-12-21,3,2,2,3,4,3,4,4,7,-1,-2,-1,-3,0,14.0,10.0,4.0,5
15745,15745,2014-15,2014,2015,Sunderland,Hull,Loss,Home,2014-12-26,0,4,5,5,6,0,1,2,2,4,4,3,4,1,14.0,16.0,-2.0,5
15746,15746,2014-15,2014,2015,Sunderland,Aston Villa,Draw,Away,2014-12-28,1,3,4,5,5,1,1,4,7,2,3,1,-2,0,14.0,15.0,-1.0,5
15747,15747,2014-15,2014,2015,Sunderland,Man City,Loss,Away,2015-01-01,0,1,4,5,6,4,7,10,13,-3,-3,-5,-7,0,14.0,1.0,13.0,6
15748,15748,2014-15,2014,2015,Sunderland,Liverpool,Loss,Home,2015-01-10,0,1,1,4,5,4,7,8,8,-3,-6,-4,-3,1,14.0,2.0,12.0,6
15749,15749,2014-15,2014,2015,Sunderland,Tottenham,Loss,Away,2015-01-17,0,0,1,1,4,3,4,7,10,-3,-3,-6,-6,0,14.0,6.0,8.0,6
15750,15750,2014-15,2014,2015,Sunderland,Burnley,Win,Home,2015-01-31,3,0,0,1,1,3,4,5,5,-3,-4,-4,-4,1,14.0,21.0,-7.0,6
15751,15751,2014-15,2014,2015,Sunderland,Swansea,Draw,Away,2015-02-07,1,3,3,3,4,3,4,5,5,0,-1,-2,-1,0,14.0,12.0,2.0,7
15752,15752,2014-15,2014,2015,Sunderland,QPR,Loss,Home,2015-02-10,0,4,4,4,4,0,0,0,1,4,4,4,3,1,14.0,21.0,-7.0,7
15753,15753,2014-15,2014,2015,Sunderland,West Brom,Draw,Home,2015-02-21,1,1,4,4,4,4,4,5,8,-3,0,-1,-4,1,14.0,17.0,-3.0,7
15754,15754,2014-15,2014,2015,Sunderland,Man United,Loss,Away,2015-02-28,0,1,2,5,5,3,4,7,10,-2,-2,-2,-5,0,14.0,7.0,7.0,7
15755,15755,2014-15,2014,2015,Sunderland,Hull,Draw,Away,2015-03-03,1,1,1,2,5,3,6,7,7,-2,-5,-5,-2,0,14.0,16.0,-2.0,8
15756,15756,2014-15,2014,2015,Sunderland,Aston Villa,Loss,Home,2015-03-14,0,1,2,2,3,3,3,3,3,-2,-1,-1,0,1,14.0,15.0,-1.0,8
15757,15757,2014-15,2014,2015,Sunderland,West Ham,Loss,Away,2015-03-21,0,1,1,2,2,0,0,1,2,1,1,1,0,0,14.0,13.0,1.0,8
15758,15758,2014-15,2014,2015,Sunderland,Newcastle,Win,Home,2015-04-05,3,0,1,1,2,0,0,3,3,0,1,-2,-1,1,14.0,10.0,4.0,9
15759,15759,2014-15,2014,2015,Sunderland,Crystal Palace,Loss,Home,2015-04-11,0,3,3,4,4,6,9,9,12,-3,-6,-5,-8,1,14.0,11.0,3.0,9
15760,15760,2014-15,2014,2015,Sunderland,Stoke,Draw,Away,2015-04-25,1,3,3,3,4,4,4,4,4,-1,-1,-1,0,0,14.0,9.0,5.0,9
15761,15761,2014-15,2014,2015,Sunderland,Southampton,Win,Home,2015-05-02,3,1,4,4,4,1,4,4,7,0,0,0,-3,1,14.0,8.0,6.0,10
15762,15762,2014-15,2014,2015,Sunderland,Everton,Win,Away,2015-05-09,3,4,4,7,7,3,6,7,10,1,-2,0,-3,0,14.0,5.0,9.0,10
15763,15763,2014-15,2014,2015,Sunderland,Leicester,Draw,Home,2015-05-16,1,6,7,7,10,6,6,9,12,0,1,-2,-2,1,14.0,21.0,-7.0,10
15764,15764,2014-15,2014,2015,Sunderland,Arsenal,Draw,Away,2015-05-20,1,4,7,8,8,1,4,5,8,3,3,3,0,0,14.0,4.0,10.0,10
15765,15765,2014-15,2014,2015,Sunderland,Chelsea,Loss,Away,2015-05-24,0,2,5,8,9,1,4,7,8,1,1,1,1,0,14.0,3.0,11.0,10
15766,15766,2015-16,2015,2016,Sunderland,Leicester,Loss,Away,2015-08-08,0,1,2,5,8,4,7,10,10,-3,-5,-5,-2,0,16.0,14.0,2.0,1
15767,15767,2015-16,2015,2016,Sunderland,Norwich,Loss,Home,2015-08-15,0,0,1,2,5,0,1,1,1,0,0,1,4,1,16.0,21.0,-5.0,1
15768,15768,2015-16,2015,2016,Sunderland,Swansea,Draw,Home,2015-08-22,1,0,0,1,2,4,4,4,7,-4,-4,-3,-5,1,16.0,8.0,8.0,1
15769,15769,2015-16,2015,2016,Sunderland,Aston Villa,Draw,Away,2015-08-29,1,1,1,1,2,0,3,3,3,1,-2,-2,-1,0,16.0,17.0,-1.0,1
15770,15770,2015-16,2015,2016,Sunderland,Tottenham,Loss,Home,2015-09-13,0,2,2,2,2,2,3,3,6,0,-1,-1,-4,1,16.0,5.0,11.0,2
15771,15771,2015-16,2015,2016,Sunderland,Bournemouth,Loss,Away,2015-09-19,0,1,2,2,2,1,4,4,4,0,-2,-2,-2,0,16.0,21.0,-5.0,2
15772,15772,2015-16,2015,2016,Sunderland,Man United,Loss,Away,2015-09-26,0,0,1,2,2,6,6,7,10,-6,-5,-5,-8,0,16.0,4.0,12.0,2
15773,15773,2015-16,2015,2016,Sunderland,West Ham,Draw,Home,2015-10-03,1,0,0,1,2,4,7,10,10,-4,-7,-9,-8,1,16.0,12.0,4.0,3
15774,15774,2015-16,2015,2016,Sunderland,West Brom,Loss,Away,2015-10-17,0,1,1,1,2,0,3,4,7,1,-2,-3,-5,0,16.0,13.0,3.0,3
15775,15775,2015-16,2015,2016,Sunderland,Newcastle,Win,Home,2015-10-25,3,1,1,1,1,3,4,4,4,-2,-3,-3,-3,1,16.0,15.0,1.0,3
15776,15776,2015-16,2015,2016,Sunderland,Everton,Loss,Away,2015-11-01,0,3,4,4,4,0,1,4,5,3,3,0,-1,0,16.0,11.0,5.0,4
15777,15777,2015-16,2015,2016,Sunderland,Southampton,Loss,Home,2015-11-07,0,3,3,4,4,4,5,8,11,-1,-2,-4,-7,1,16.0,7.0,9.0,4
15778,15778,2015-16,2015,2016,Sunderland,Crystal Palace,Win,Away,2015-11-23,3,0,3,3,4,4,4,4,7,-4,-1,-1,-3,0,16.0,10.0,6.0,4
15779,15779,2015-16,2015,2016,Sunderland,Stoke,Win,Home,2015-11-28,3,3,3,6,6,6,7,7,10,-3,-4,-1,-4,1,16.0,9.0,7.0,4
15780,15780,2015-16,2015,2016,Sunderland,Arsenal,Loss,Away,2015-12-05,0,6,6,6,9,1,2,5,8,5,4,1,1,0,16.0,3.0,13.0,5
15781,15781,2015-16,2015,2016,Sunderland,Watford,Loss,Home,2015-12-12,0,3,6,6,6,6,6,6,9,-3,0,0,-3,1,16.0,21.0,-5.0,5
15782,15782,2015-16,2015,2016,Sunderland,Chelsea,Loss,Away,2015-12-19,0,0,3,6,6,0,1,4,4,0,2,2,2,0,16.0,1.0,15.0,5
15783,15783,2015-16,2015,2016,Sunderland,Man City,Loss,Away,2015-12-26,0,0,0,3,6,3,3,6,6,-3,-3,-3,0,0,16.0,2.0,14.0,5
15784,15784,2015-16,2015,2016,Sunderland,Liverpool,Loss,Home,2015-12-30,0,0,0,0,3,3,4,4,7,-3,-4,-4,-4,1,16.0,6.0,10.0,5
15785,15785,2015-16,2015,2016,Sunderland,Aston Villa,Win,Home,2016-01-02,3,0,0,0,0,1,2,2,3,-1,-2,-2,-3,1,16.0,17.0,-1.0,6
15786,15786,2015-16,2015,2016,Sunderland,Swansea,Win,Away,2016-01-13,3,3,3,3,3,1,4,5,5,2,-1,-2,-2,0,16.0,8.0,8.0,6
15787,15787,2015-16,2015,2016,Sunderland,Tottenham,Loss,Away,2016-01-16,0,6,6,6,6,1,4,7,10,5,2,-1,-4,0,16.0,5.0,11.0,6
15788,15788,2015-16,2015,2016,Sunderland,Bournemouth,Draw,Home,2016-01-23,1,3,6,6,6,3,4,4,5,0,2,2,1,1,16.0,21.0,-5.0,6
15789,15789,2015-16,2015,2016,Sunderland,Man City,Loss,Home,2016-02-02,0,1,4,7,7,4,5,8,9,-3,-1,-1,-2,1,16.0,2.0,14.0,7
15790,15790,2015-16,2015,2016,Sunderland,Liverpool,Draw,Away,2016-02-06,1,1,1,4,7,3,3,4,4,-2,-2,0,3,0,16.0,6.0,10.0,7
15791,15791,2015-16,2015,2016,Sunderland,Man United,Win,Home,2016-02-13,3,1,2,2,5,4,4,7,8,-3,-2,-5,-3,1,16.0,4.0,12.0,7
15792,15792,2015-16,2015,2016,Sunderland,West Ham,Loss,Away,2016-02-27,0,4,4,5,5,1,4,5,5,3,0,0,0,0,16.0,12.0,4.0,7
15793,15793,2015-16,2015,2016,Sunderland,Crystal Palace,Draw,Home,2016-03-01,1,3,4,4,5,0,1,1,1,3,3,3,4,1,16.0,10.0,6.0,8
15794,15794,2015-16,2015,2016,Sunderland,Southampton,Draw,Away,2016-03-05,1,1,4,5,5,0,3,6,7,1,1,-1,-2,0,16.0,7.0,9.0,8
15795,15795,2015-16,2015,2016,Sunderland,Newcastle,Draw,Away,2016-03-20,1,2,2,5,6,0,0,0,3,2,2,5,3,0,16.0,15.0,1.0,8
15796,15796,2015-16,2015,2016,Sunderland,West Brom,Draw,Home,2016-04-02,1,2,3,3,6,3,4,7,10,-1,-1,-4,-4,1,16.0,13.0,3.0,9
15797,15797,2015-16,2015,2016,Sunderland,Leicester,Loss,Home,2016-04-10,0,2,3,4,4,6,9,12,13,-4,-6,-8,-9,1,16.0,14.0,2.0,9
15798,15798,2015-16,2015,2016,Sunderland,Norwich,Win,Away,2016-04-16,3,1,2,3,4,3,6,7,7,-2,-4,-4,-3,0,16.0,21.0,-5.0,9
15799,15799,2015-16,2015,2016,Sunderland,Arsenal,Draw,Home,2016-04-24,1,3,4,5,6,4,5,8,11,-1,-1,-3,-5,1,16.0,3.0,13.0,9
15800,15800,2015-16,2015,2016,Sunderland,Stoke,Draw,Away,2016-04-30,1,4,4,5,6,0,0,1,4,4,4,4,2,0,16.0,9.0,7.0,9
15801,15801,2015-16,2015,2016,Sunderland,Chelsea,Win,Home,2016-05-07,3,2,5,5,6,4,4,4,7,-2,1,1,-1,1,16.0,1.0,15.0,10
15802,15802,2015-16,2015,2016,Sunderland,Everton,Win,Home,2016-05-11,3,4,5,8,8,3,3,4,5,1,2,4,3,1,16.0,11.0,5.0,10
15803,15803,2015-16,2015,2016,Sunderland,Watford,Draw,Away,2016-05-15,1,6,7,8,11,0,3,3,6,6,4,5,5,0,16.0,21.0,-5.0,10
15804,15804,2016-17,2016,2017,Sunderland,Man City,Loss,Away,2016-08-13,0,4,7,8,9,2,2,5,6,2,5,3,3,0,17.0,4.0,13.0,1
15805,15805,2016-17,2016,2017,Sunderland,Middlesbrough,Loss,Home,2016-08-21,0,1,4,7,8,1,2,2,2,0,2,5,6,1,17.0,21.0,-4.0,1
15806,15806,2016-17,2016,2017,Sunderland,Southampton,Draw,Away,2016-08-27,1,0,1,4,7,1,4,7,10,-1,-3,-3,-3,0,17.0,6.0,11.0,1
15807,15807,2016-17,2016,2017,Sunderland,Everton,Loss,Home,2016-09-12,0,1,1,2,5,6,7,10,10,-5,-6,-8,-5,1,17.0,11.0,6.0,2
15808,15808,2016-17,2016,2017,Sunderland,Tottenham,Loss,Away,2016-09-18,0,1,1,1,2,4,7,8,8,-3,-6,-7,-6,0,17.0,3.0,14.0,2
15809,15809,2016-17,2016,2017,Sunderland,Crystal Palace,Loss,Home,2016-09-24,0,0,1,1,1,6,7,7,7,-6,-6,-6,-6,1,17.0,15.0,2.0,2
15810,15810,2016-17,2016,2017,Sunderland,West Brom,Draw,Home,2016-10-01,1,0,0,1,1,4,4,5,5,-4,-4,-4,-4,1,17.0,14.0,3.0,3
15811,15811,2016-17,2016,2017,Sunderland,Stoke,Loss,Away,2016-10-15,0,1,1,1,2,2,2,2,2,-1,-1,-1,0,0,17.0,9.0,8.0,3
15812,15812,2016-17,2016,2017,Sunderland,West Ham,Loss,Away,2016-10-22,0,1,1,1,1,4,4,4,4,-3,-3,-3,-3,0,17.0,7.0,10.0,3
15813,15813,2016-17,2016,2017,Sunderland,Arsenal,Loss,Home,2016-10-29,0,0,1,1,1,4,7,10,13,-4,-6,-9,-12,1,17.0,2.0,15.0,3
15814,15814,2016-17,2016,2017,Sunderland,Bournemouth,Win,Away,2016-11-05,3,0,0,1,1,1,4,5,8,-1,-4,-4,-7,0,17.0,16.0,1.0,4
15815,15815,2016-17,2016,2017,Sunderland,Hull,Win,Home,2016-11-19,3,3,3,3,4,3,3,3,3,0,0,0,1,1,17.0,21.0,-4.0,4
15816,15816,2016-17,2016,2017,Sunderland,Liverpool,Loss,Away,2016-11-26,0,6,6,6,6,4,7,10,11,2,-1,-4,-5,0,17.0,8.0,9.0,4
15817,15817,2016-17,2016,2017,Sunderland,Leicester,Win,Home,2016-12-03,3,3,6,6,6,1,1,2,5,2,5,4,1,1,17.0,1.0,16.0,5
15818,15818,2016-17,2016,2017,Sunderland,Swansea,Loss,Away,2016-12-10,0,3,6,9,9,3,4,4,4,0,2,5,5,0,17.0,12.0,5.0,5
15819,15819,2016-17,2016,2017,Sunderland,Chelsea,Loss,Home,2016-12-14,0,3,3,6,9,6,9,12,15,-3,-6,-6,-6,1,17.0,10.0,7.0,5
15820,15820,2016-17,2016,2017,Sunderland,Watford,Win,Home,2016-12-17,3,0,3,3,6,3,3,3,6,-3,0,0,0,1,17.0,13.0,4.0,5
15821,15821,2016-17,2016,2017,Sunderland,Man United,Loss,Away,2016-12-26,0,3,3,6,6,6,9,10,11,-3,-6,-4,-5,0,17.0,5.0,12.0,5
15822,15822,2016-17,2016,2017,Sunderland,Burnley,Loss,Away,2016-12-31,0,3,3,3,6,3,3,6,6,0,0,-3,0,0,17.0,21.0,-4.0,5
15823,15823,2016-17,2016,2017,Sunderland,Liverpool,Draw,Home,2017-01-02,1,0,3,3,3,6,9,12,13,-6,-6,-9,-10,1,17.0,8.0,9.0,6
15824,15824,2016-17,2016,2017,Sunderland,Stoke,Loss,Home,2017-01-14,0,1,1,4,4,3,3,4,5,-2,-2,0,-1,1,17.0,9.0,8.0,6
15825,15825,2016-17,2016,2017,Sunderland,West Brom,Loss,Away,2017-01-21,0,1,1,1,4,3,6,6,6,-2,-5,-5,-2,0,17.0,14.0,3.0,6
15826,15826,2016-17,2016,2017,Sunderland,Tottenham,Draw,Home,2017-01-31,1,0,1,1,1,4,7,10,13,-4,-6,-9,-12,1,17.0,3.0,14.0,6
15827,15827,2016-17,2016,2017,Sunderland,Crystal Palace,Win,Away,2017-02-04,3,1,1,2,2,3,3,3,3,-2,-2,-1,-1,0,17.0,15.0,2.0,7
15828,15828,2016-17,2016,2017,Sunderland,Southampton,Loss,Home,2017-02-11,0,4,4,4,5,0,3,3,3,4,1,1,2,1,17.0,6.0,11.0,7
15829,15829,2016-17,2016,2017,Sunderland,Everton,Loss,Away,2017-02-25,0,3,4,4,4,4,5,8,11,-1,-1,-4,-7,0,17.0,11.0,6.0,7
15830,15830,2016-17,2016,2017,Sunderland,Man City,Loss,Home,2017-03-05,0,0,3,4,4,6,9,10,10,-6,-6,-6,-6,1,17.0,4.0,13.0,8
15831,15831,2016-17,2016,2017,Sunderland,Burnley,Draw,Home,2017-03-18,1,0,0,3,4,0,1,2,2,0,-1,1,2,1,17.0,21.0,-4.0,8
15832,15832,2016-17,2016,2017,Sunderland,Watford,Loss,Away,2017-04-01,0,1,1,1,4,0,1,1,4,1,0,0,0,0,17.0,13.0,4.0,9
15833,15833,2016-17,2016,2017,Sunderland,Leicester,Loss,Away,2017-04-04,0,1,1,1,1,6,9,12,12,-5,-8,-11,-11,0,17.0,1.0,16.0,9
15834,15834,2016-17,2016,2017,Sunderland,Man United,Loss,Home,2017-04-09,0,0,1,1,1,2,5,6,9,-2,-4,-5,-8,1,17.0,5.0,12.0,9
15835,15835,2016-17,2016,2017,Sunderland,West Ham,Draw,Home,2017-04-15,1,0,0,1,1,3,3,3,3,-3,-3,-2,-2,1,17.0,7.0,10.0,9
15836,15836,2016-17,2016,2017,Sunderland,Middlesbrough,Loss,Away,2017-04-26,0,1,1,1,2,0,1,1,2,1,0,0,0,0,17.0,21.0,-4.0,9
15837,15837,2016-17,2016,2017,Sunderland,Bournemouth,Loss,Home,2017-04-29,0,1,1,1,1,3,3,4,5,-2,-2,-3,-4,1,17.0,16.0,1.0,9
15838,15838,2016-17,2016,2017,Sunderland,Hull,Win,Away,2017-05-06,3,0,1,1,1,4,4,4,7,-4,-3,-3,-6,0,17.0,21.0,-4.0,10
15839,15839,2016-17,2016,2017,Sunderland,Swansea,Loss,Home,2017-05-13,0,3,3,4,4,4,7,7,7,-1,-4,-3,-3,1,17.0,12.0,5.0,10
15840,15840,2016-17,2016,2017,Sunderland,Arsenal,Loss,Away,2017-05-16,0,3,3,3,4,6,9,9,12,-3,-6,-6,-8,0,17.0,2.0,15.0,10
15841,15841,2016-17,2016,2017,Sunderland,Chelsea,Loss,Away,2017-05-21,0,0,3,3,3,6,9,12,15,-6,-6,-9,-12,0,17.0,10.0,7.0,10
15842,15842,2011-12,2011,2012,Swansea,Man City,Loss,Away,2011-08-15,0,0,0,0,0,6,9,9,12,-6,-9,-9,-12,0,21.0,3.0,18.0,1
15843,15843,2011-12,2011,2012,Swansea,Wigan,Draw,Home,2011-08-20,1,0,0,0,0,4,7,8,9,-4,-7,-8,-9,1,21.0,16.0,5.0,1
15844,15844,2011-12,2011,2012,Swansea,Sunderland,Draw,Home,2011-08-27,1,1,1,1,1,1,4,4,7,0,-3,-3,-6,1,21.0,10.0,11.0,1
15845,15845,2011-12,2011,2012,Swansea,Arsenal,Loss,Away,2011-09-10,0,2,2,2,2,0,1,2,2,2,1,0,0,0,21.0,4.0,17.0,2
15846,15846,2011-12,2011,2012,Swansea,West Brom,Win,Home,2011-09-17,3,1,2,2,2,3,3,3,4,-2,-1,-1,-2,1,21.0,11.0,10.0,2
15847,15847,2011-12,2011,2012,Swansea,Chelsea,Loss,Away,2011-09-24,0,3,4,5,5,3,6,9,10,0,-2,-4,-5,0,21.0,2.0,19.0,2
15848,15848,2011-12,2011,2012,Swansea,Stoke,Win,Home,2011-10-02,3,3,3,4,5,1,4,7,8,2,-1,-3,-3,1,21.0,13.0,8.0,3
15849,15849,2011-12,2011,2012,Swansea,Norwich,Loss,Away,2011-10-15,0,3,6,6,7,3,6,6,6,0,0,0,1,0,21.0,21.0,0.0,3
15850,15850,2011-12,2011,2012,Swansea,Wolves,Draw,Away,2011-10-22,1,3,3,6,6,0,0,0,0,3,3,6,6,0,21.0,17.0,4.0,3
15851,15851,2011-12,2011,2012,Swansea,Bolton,Win,Home,2011-10-29,3,1,4,4,7,3,3,3,3,-2,1,1,4,1,21.0,14.0,7.0,3
15852,15852,2011-12,2011,2012,Swansea,Liverpool,Draw,Away,2011-11-05,1,4,4,7,7,4,5,8,11,0,-1,-1,-4,0,21.0,6.0,15.0,4
15853,15853,2011-12,2011,2012,Swansea,Man United,Loss,Home,2011-11-19,0,4,5,5,8,6,6,7,10,-2,-1,-2,-2,1,21.0,1.0,20.0,4
15854,15854,2011-12,2011,2012,Swansea,Aston Villa,Draw,Home,2011-11-27,1,1,4,5,5,3,4,4,4,-2,0,1,1,1,21.0,9.0,12.0,4
15855,15855,2011-12,2011,2012,Swansea,Blackburn,Loss,Away,2011-12-03,0,1,2,5,6,1,1,2,2,0,1,3,4,0,21.0,15.0,6.0,5
15856,15856,2011-12,2011,2012,Swansea,Fulham,Win,Home,2011-12-10,3,1,1,2,5,4,5,5,8,-3,-4,-3,-3,1,21.0,8.0,13.0,5
15857,15857,2011-12,2011,2012,Swansea,Newcastle,Draw,Away,2011-12-17,1,3,4,4,5,0,1,1,4,3,3,3,1,0,21.0,12.0,9.0,5
15858,15858,2011-12,2011,2012,Swansea,Everton,Loss,Away,2011-12-21,0,4,4,5,5,1,1,4,7,3,3,1,-2,0,21.0,7.0,14.0,5
15859,15859,2011-12,2011,2012,Swansea,QPR,Draw,Home,2011-12-27,1,1,4,4,5,0,0,1,1,1,4,3,4,1,21.0,21.0,0.0,5
15860,15860,2011-12,2011,2012,Swansea,Tottenham,Draw,Home,2011-12-31,1,1,2,5,5,4,7,7,10,-3,-5,-2,-5,1,21.0,5.0,16.0,5
15861,15861,2011-12,2011,2012,Swansea,Aston Villa,Win,Away,2012-01-02,3,2,2,3,6,4,4,4,7,-2,-2,-1,-1,0,21.0,9.0,12.0,6
15862,15862,2011-12,2011,2012,Swansea,Arsenal,Win,Home,2012-01-15,3,4,5,5,6,3,4,7,7,1,1,-2,-1,1,21.0,4.0,17.0,6
15863,15863,2011-12,2011,2012,Swansea,Sunderland,Loss,Away,2012-01-21,0,6,7,8,8,3,6,7,10,3,1,1,-2,0,21.0,10.0,11.0,6
15864,15864,2011-12,2011,2012,Swansea,Chelsea,Draw,Home,2012-01-31,1,3,6,7,8,4,7,7,8,-1,-1,0,0,1,21.0,2.0,19.0,6
15865,15865,2011-12,2011,2012,Swansea,West Brom,Win,Away,2012-02-04,3,1,4,7,8,4,4,4,4,-3,0,3,4,0,21.0,11.0,10.0,7
15866,15866,2011-12,2011,2012,Swansea,Norwich,Loss,Home,2012-02-11,0,4,4,7,10,3,4,7,10,1,0,0,0,1,21.0,21.0,0.0,7
15867,15867,2011-12,2011,2012,Swansea,Stoke,Loss,Away,2012-02-26,0,3,4,4,7,0,0,0,1,3,4,4,6,0,21.0,13.0,8.0,7
15868,15868,2011-12,2011,2012,Swansea,Wigan,Win,Away,2012-03-03,3,0,3,4,4,4,5,5,5,-4,-2,-1,-1,0,21.0,16.0,5.0,8
15869,15869,2011-12,2011,2012,Swansea,Man City,Win,Home,2012-03-11,3,3,3,6,7,6,9,12,12,-3,-6,-6,-5,1,21.0,3.0,18.0,8
15870,15870,2011-12,2011,2012,Swansea,Fulham,Win,Away,2012-03-17,3,6,6,6,9,3,6,9,9,3,0,-3,0,0,21.0,8.0,13.0,8
15871,15871,2011-12,2011,2012,Swansea,Everton,Loss,Home,2012-03-24,0,6,9,9,9,0,3,4,7,6,6,5,2,1,21.0,7.0,14.0,8
15872,15872,2011-12,2011,2012,Swansea,Tottenham,Loss,Away,2012-04-01,0,3,6,9,9,2,2,2,2,1,4,7,7,0,21.0,5.0,16.0,9
15873,15873,2011-12,2011,2012,Swansea,Newcastle,Loss,Home,2012-04-06,0,0,3,6,9,6,9,9,10,-6,-6,-3,-1,1,21.0,12.0,9.0,9
15874,15874,2011-12,2011,2012,Swansea,QPR,Loss,Away,2012-04-11,0,0,0,3,6,3,3,6,6,-3,-3,-3,0,0,21.0,21.0,0.0,9
15875,15875,2011-12,2011,2012,Swansea,Blackburn,Win,Home,2012-04-14,3,0,0,0,3,0,0,0,3,0,0,0,0,1,21.0,15.0,6.0,9
15876,15876,2011-12,2011,2012,Swansea,Bolton,Draw,Away,2012-04-21,1,3,3,3,3,0,3,6,9,3,0,-3,-6,0,21.0,14.0,7.0,9
15877,15877,2011-12,2011,2012,Swansea,Wolves,Draw,Home,2012-04-28,1,4,4,4,4,1,1,1,1,3,3,3,3,1,21.0,17.0,4.0,9
15878,15878,2011-12,2011,2012,Swansea,Man United,Loss,Away,2012-05-06,0,2,5,5,5,1,4,4,7,1,1,1,-2,0,21.0,1.0,20.0,10
15879,15879,2011-12,2011,2012,Swansea,Liverpool,Win,Home,2012-05-13,3,1,2,5,5,3,6,6,9,-2,-4,-1,-4,1,21.0,6.0,15.0,10
15880,15880,2012-13,2012,2013,Swansea,QPR,Win,Away,2012-08-18,3,3,4,5,8,3,3,6,6,0,1,-1,2,0,11.0,17.0,-6.0,1
15881,15881,2012-13,2012,2013,Swansea,West Ham,Win,Home,2012-08-25,3,6,6,7,8,3,3,4,4,3,3,3,4,1,11.0,21.0,-10.0,1
15882,15882,2012-13,2012,2013,Swansea,Sunderland,Draw,Home,2012-09-01,1,6,9,9,10,1,1,2,3,5,8,7,7,1,11.0,13.0,-2.0,2
15883,15883,2012-13,2012,2013,Swansea,Aston Villa,Loss,Away,2012-09-15,0,4,7,10,10,1,1,1,2,3,6,9,8,0,11.0,16.0,-5.0,2
15884,15884,2012-13,2012,2013,Swansea,Everton,Loss,Home,2012-09-22,0,1,4,7,10,1,4,7,10,0,0,0,0,1,11.0,7.0,4.0,2
15885,15885,2012-13,2012,2013,Swansea,Stoke,Loss,Away,2012-09-29,0,0,1,4,7,1,2,3,4,-1,-1,1,3,0,11.0,14.0,-3.0,2
15886,15886,2012-13,2012,2013,Swansea,Reading,Draw,Home,2012-10-06,1,0,0,1,4,1,1,1,2,-1,-1,0,2,1,11.0,21.0,-10.0,3
15887,15887,2012-13,2012,2013,Swansea,Wigan,Win,Home,2012-10-20,3,1,1,1,2,1,1,1,2,0,0,0,0,1,11.0,15.0,-4.0,3
15888,15888,2012-13,2012,2013,Swansea,Man City,Loss,Away,2012-10-27,0,4,4,4,4,6,9,10,11,-2,-5,-6,-7,0,11.0,1.0,10.0,3
15889,15889,2012-13,2012,2013,Swansea,Chelsea,Draw,Home,2012-11-03,1,3,4,4,4,3,6,9,12,0,-2,-5,-8,1,11.0,6.0,5.0,4
15890,15890,2012-13,2012,2013,Swansea,Southampton,Draw,Away,2012-11-10,1,1,4,5,5,0,0,1,1,1,4,4,4,0,11.0,21.0,-10.0,4
15891,15891,2012-13,2012,2013,Swansea,Newcastle,Win,Away,2012-11-17,3,2,2,5,6,1,4,5,5,1,-2,0,1,0,11.0,5.0,6.0,4
15892,15892,2012-13,2012,2013,Swansea,Liverpool,Draw,Home,2012-11-25,1,4,5,5,8,4,5,6,9,0,0,-1,-1,1,11.0,8.0,3.0,4
15893,15893,2012-13,2012,2013,Swansea,West Brom,Win,Home,2012-11-28,3,4,5,6,6,6,9,12,12,-2,-4,-6,-6,1,11.0,10.0,1.0,4
15894,15894,2012-13,2012,2013,Swansea,Arsenal,Win,Away,2012-12-01,3,4,7,8,9,2,5,6,6,2,2,2,3,0,11.0,3.0,8.0,5
15895,15895,2012-13,2012,2013,Swansea,Norwich,Loss,Home,2012-12-08,0,6,7,10,11,4,5,8,9,2,2,2,2,1,11.0,12.0,-1.0,5
15896,15896,2012-13,2012,2013,Swansea,Tottenham,Loss,Away,2012-12-16,0,3,6,7,10,3,6,9,9,0,0,-2,1,0,11.0,4.0,7.0,5
15897,15897,2012-13,2012,2013,Swansea,Man United,Draw,Home,2012-12-23,1,0,3,6,7,6,9,12,15,-6,-6,-6,-8,1,11.0,2.0,9.0,5
15898,15898,2012-13,2012,2013,Swansea,Reading,Draw,Away,2012-12-26,1,1,1,4,7,0,0,0,0,1,1,4,7,0,11.0,21.0,-10.0,5
15899,15899,2012-13,2012,2013,Swansea,Fulham,Win,Away,2012-12-29,3,2,2,2,5,1,1,4,4,1,1,-2,1,0,11.0,9.0,2.0,5
15900,15900,2012-13,2012,2013,Swansea,Aston Villa,Draw,Home,2013-01-01,1,4,5,5,5,0,0,3,4,4,5,2,1,1,11.0,16.0,-5.0,6
15901,15901,2012-13,2012,2013,Swansea,Everton,Draw,Away,2013-01-12,1,4,5,6,6,3,6,9,10,1,-1,-3,-4,0,11.0,7.0,4.0,6
15902,15902,2012-13,2012,2013,Swansea,Stoke,Win,Home,2013-01-19,3,2,5,6,7,0,1,4,5,2,4,2,2,1,11.0,14.0,-3.0,6
15903,15903,2012-13,2012,2013,Swansea,Sunderland,Draw,Away,2013-01-29,1,4,5,8,9,6,6,6,9,-2,-1,2,0,0,11.0,13.0,-2.0,6
15904,15904,2012-13,2012,2013,Swansea,West Ham,Loss,Away,2013-02-02,0,4,5,6,9,0,1,1,4,4,4,5,5,0,11.0,21.0,-10.0,7
15905,15905,2012-13,2012,2013,Swansea,QPR,Win,Home,2013-02-09,3,1,4,5,6,2,3,4,7,-1,1,1,-1,1,11.0,17.0,-6.0,7
15906,15906,2012-13,2012,2013,Swansea,Liverpool,Loss,Away,2013-02-17,0,3,4,7,8,1,2,5,5,2,2,2,3,0,11.0,8.0,3.0,7
15907,15907,2012-13,2012,2013,Swansea,Newcastle,Win,Home,2013-03-02,3,3,3,4,7,3,6,9,9,0,-3,-5,-2,1,11.0,5.0,6.0,8
15908,15908,2012-13,2012,2013,Swansea,West Brom,Loss,Away,2013-03-09,0,3,6,6,7,3,6,6,6,0,0,0,1,0,11.0,10.0,1.0,8
15909,15909,2012-13,2012,2013,Swansea,Arsenal,Loss,Home,2013-03-16,0,3,3,6,6,3,6,9,10,0,-3,-3,-4,1,11.0,3.0,8.0,8
15910,15910,2012-13,2012,2013,Swansea,Tottenham,Loss,Home,2013-03-30,0,0,3,3,6,0,3,6,9,0,0,-3,-3,1,11.0,4.0,7.0,8
15911,15911,2012-13,2012,2013,Swansea,Norwich,Draw,Away,2013-04-06,1,0,0,3,3,1,2,2,5,-1,-2,1,-2,0,11.0,12.0,-1.0,9
15912,15912,2012-13,2012,2013,Swansea,Southampton,Draw,Home,2013-04-20,1,1,1,1,4,4,7,10,11,-3,-6,-9,-7,1,11.0,21.0,-10.0,9
15913,15913,2012-13,2012,2013,Swansea,Chelsea,Loss,Away,2013-04-28,0,2,2,2,2,4,7,7,10,-2,-5,-5,-8,0,11.0,6.0,5.0,9
15914,15914,2012-13,2012,2013,Swansea,Man City,Draw,Home,2013-05-04,1,1,2,2,2,3,6,9,12,-2,-4,-7,-10,1,11.0,1.0,10.0,10
15915,15915,2012-13,2012,2013,Swansea,Wigan,Win,Away,2013-05-07,3,1,2,3,3,4,4,4,5,-3,-2,-1,-2,0,11.0,15.0,-4.0,10
15916,15916,2012-13,2012,2013,Swansea,Man United,Loss,Away,2013-05-12,0,4,4,5,6,1,4,5,8,3,0,0,-2,0,11.0,2.0,9.0,10
15917,15917,2012-13,2012,2013,Swansea,Fulham,Loss,Home,2013-05-19,0,3,4,4,5,0,0,0,0,3,4,4,5,1,11.0,9.0,2.0,10
15918,15918,2013-14,2013,2014,Swansea,Man United,Loss,Home,2013-08-17,0,0,3,4,4,4,4,5,8,-4,-1,-1,-4,1,9.0,1.0,8.0,1
15919,15919,2013-14,2013,2014,Swansea,Tottenham,Loss,Away,2013-08-25,0,0,0,3,4,6,9,10,13,-6,-9,-7,-9,0,9.0,5.0,4.0,1
15920,15920,2013-14,2013,2014,Swansea,West Brom,Win,Away,2013-09-01,3,0,0,0,3,1,2,2,2,-1,-2,-2,1,0,9.0,8.0,1.0,2
15921,15921,2013-14,2013,2014,Swansea,Liverpool,Draw,Home,2013-09-16,1,3,3,3,3,6,9,12,15,-3,-6,-9,-12,1,9.0,7.0,2.0,2
15922,15922,2013-14,2013,2014,Swansea,Crystal Palace,Win,Away,2013-09-22,3,4,4,4,4,3,3,3,4,1,1,1,0,0,9.0,21.0,-12.0,2
15923,15923,2013-14,2013,2014,Swansea,Arsenal,Loss,Home,2013-09-28,0,4,7,7,7,6,9,12,12,-2,-2,-5,-5,1,9.0,4.0,5.0,2
15924,15924,2013-14,2013,2014,Swansea,Southampton,Loss,Away,2013-10-06,0,3,4,7,7,6,7,7,8,-3,-3,0,-1,0,9.0,14.0,-5.0,3
15925,15925,2013-14,2013,2014,Swansea,Sunderland,Win,Home,2013-10-19,3,0,3,4,7,0,0,0,0,0,3,4,7,1,9.0,17.0,-8.0,3
15926,15926,2013-14,2013,2014,Swansea,West Ham,Draw,Home,2013-10-27,1,3,3,6,7,3,3,3,4,0,0,3,3,1,9.0,10.0,-1.0,3
15927,15927,2013-14,2013,2014,Swansea,Cardiff,Loss,Away,2013-11-03,0,4,4,4,7,1,1,4,4,3,3,0,3,0,9.0,21.0,-12.0,4
15928,15928,2013-14,2013,2014,Swansea,Stoke,Draw,Home,2013-11-10,1,1,4,4,4,1,2,2,2,0,2,2,2,1,9.0,13.0,-4.0,4
15929,15929,2013-14,2013,2014,Swansea,Fulham,Win,Away,2013-11-23,3,1,2,5,5,0,0,3,6,1,2,2,-1,0,9.0,12.0,-3.0,4
15930,15930,2013-14,2013,2014,Swansea,Man City,Loss,Away,2013-12-01,0,4,4,5,8,3,6,6,9,1,-2,-1,-1,0,9.0,2.0,7.0,5
15931,15931,2013-14,2013,2014,Swansea,Newcastle,Win,Home,2013-12-04,3,3,4,4,5,6,9,12,12,-3,-5,-8,-7,1,9.0,16.0,-7.0,5
15932,15932,2013-14,2013,2014,Swansea,Hull,Draw,Home,2013-12-09,1,3,6,7,7,3,3,3,6,0,3,4,1,1,9.0,21.0,-12.0,5
15933,15933,2013-14,2013,2014,Swansea,Norwich,Draw,Away,2013-12-15,1,4,4,7,8,3,6,6,9,1,-2,1,-1,0,9.0,11.0,-2.0,5
15934,15934,2013-14,2013,2014,Swansea,Everton,Loss,Home,2013-12-22,0,2,5,5,8,4,7,10,11,-2,-2,-5,-3,1,9.0,6.0,3.0,5
15935,15935,2013-14,2013,2014,Swansea,Chelsea,Loss,Away,2013-12-26,0,1,2,5,5,4,4,7,10,-3,-2,-2,-5,0,9.0,3.0,6.0,5
15936,15936,2013-14,2013,2014,Swansea,Aston Villa,Draw,Away,2013-12-28,1,0,1,2,5,0,0,0,3,0,1,2,2,0,9.0,15.0,-6.0,5
15937,15937,2013-14,2013,2014,Swansea,Man City,Loss,Home,2014-01-01,0,1,1,2,3,6,9,12,13,-5,-8,-10,-10,1,9.0,2.0,7.0,6
15938,15938,2013-14,2013,2014,Swansea,Man United,Loss,Away,2014-01-11,0,1,1,1,2,3,6,9,12,-2,-5,-8,-10,0,9.0,1.0,8.0,6
15939,15939,2013-14,2013,2014,Swansea,Tottenham,Loss,Home,2014-01-19,0,0,1,1,1,6,9,10,13,-6,-8,-9,-12,1,9.0,5.0,4.0,6
15940,15940,2013-14,2013,2014,Swansea,Fulham,Win,Home,2014-01-28,3,0,0,1,1,0,3,3,6,0,-3,-2,-5,1,9.0,12.0,-3.0,6
15941,15941,2013-14,2013,2014,Swansea,West Ham,Loss,Away,2014-02-01,0,3,3,3,4,1,4,4,5,2,-1,-1,-1,0,9.0,10.0,-1.0,7
15942,15942,2013-14,2013,2014,Swansea,Cardiff,Win,Home,2014-02-08,3,3,3,3,3,3,3,3,3,0,0,0,0,1,9.0,21.0,-12.0,7
15943,15943,2013-14,2013,2014,Swansea,Stoke,Draw,Away,2014-02-12,1,3,6,6,6,4,4,4,4,-1,2,2,2,0,9.0,13.0,-4.0,7
15944,15944,2013-14,2013,2014,Swansea,Liverpool,Loss,Away,2014-02-23,0,4,4,7,7,6,7,10,11,-2,-3,-3,-4,0,9.0,7.0,2.0,7
15945,15945,2013-14,2013,2014,Swansea,Crystal Palace,Draw,Home,2014-03-02,1,1,4,4,7,3,3,6,9,-2,1,-2,-2,1,9.0,21.0,-12.0,8
15946,15946,2013-14,2013,2014,Swansea,West Brom,Loss,Home,2014-03-15,0,1,2,5,5,1,2,2,3,0,0,3,2,1,9.0,8.0,1.0,8
15947,15947,2013-14,2013,2014,Swansea,Everton,Loss,Away,2014-03-22,0,1,1,2,5,6,6,6,9,-5,-5,-4,-4,0,9.0,6.0,3.0,8
15948,15948,2013-14,2013,2014,Swansea,Arsenal,Draw,Away,2014-03-25,1,0,1,1,2,3,3,6,7,-3,-2,-5,-5,0,9.0,4.0,5.0,8
15949,15949,2013-14,2013,2014,Swansea,Norwich,Win,Home,2014-03-29,3,1,1,2,2,3,4,4,7,-2,-3,-2,-5,1,9.0,11.0,-2.0,8
15950,15950,2013-14,2013,2014,Swansea,Hull,Loss,Away,2014-04-05,0,4,4,4,5,0,3,3,3,4,1,1,2,0,9.0,21.0,-12.0,9
15951,15951,2013-14,2013,2014,Swansea,Chelsea,Loss,Home,2014-04-13,0,3,4,4,4,3,6,6,9,0,-2,-2,-5,1,9.0,3.0,6.0,9
15952,15952,2013-14,2013,2014,Swansea,Newcastle,Win,Away,2014-04-19,3,0,3,4,4,0,0,0,3,0,3,4,1,0,9.0,16.0,-7.0,9
15953,15953,2013-14,2013,2014,Swansea,Aston Villa,Win,Home,2014-04-26,3,3,3,6,7,1,1,1,1,2,2,5,6,1,9.0,15.0,-6.0,9
15954,15954,2013-14,2013,2014,Swansea,Southampton,Loss,Home,2014-05-03,0,6,6,6,9,4,4,4,7,2,2,2,2,1,9.0,14.0,-5.0,10
15955,15955,2013-14,2013,2014,Swansea,Sunderland,Win,Away,2014-05-11,3,3,6,6,6,6,9,12,13,-3,-3,-6,-7,0,9.0,17.0,-8.0,10
15956,15956,2014-15,2014,2015,Swansea,Man United,Win,Away,2014-08-16,3,3,6,9,9,4,4,7,7,-1,2,2,2,0,12.0,7.0,5.0,1
15957,15957,2014-15,2014,2015,Swansea,Burnley,Win,Home,2014-08-23,3,6,6,9,12,3,3,3,3,3,3,6,9,1,12.0,21.0,-9.0,1
15958,15958,2014-15,2014,2015,Swansea,West Brom,Win,Home,2014-08-30,3,6,9,9,12,2,2,2,2,4,7,7,10,1,12.0,17.0,-5.0,1
15959,15959,2014-15,2014,2015,Swansea,Chelsea,Loss,Away,2014-09-13,0,6,9,12,12,6,9,12,13,0,0,0,-1,0,12.0,3.0,9.0,2
15960,15960,2014-15,2014,2015,Swansea,Southampton,Loss,Home,2014-09-20,0,3,6,9,12,6,7,7,8,-3,-1,2,4,1,12.0,8.0,4.0,2
15961,15961,2014-15,2014,2015,Swansea,Sunderland,Draw,Away,2014-09-27,1,0,3,6,9,2,2,3,4,-2,1,3,5,0,12.0,14.0,-2.0,2
15962,15962,2014-15,2014,2015,Swansea,Newcastle,Draw,Home,2014-10-04,1,1,1,4,7,1,1,2,3,0,0,2,4,1,12.0,10.0,2.0,3
15963,15963,2014-15,2014,2015,Swansea,Stoke,Loss,Away,2014-10-19,0,2,2,2,5,3,4,4,7,-1,-2,-2,-2,0,12.0,9.0,3.0,3
15964,15964,2014-15,2014,2015,Swansea,Leicester,Win,Home,2014-10-25,3,1,2,2,2,1,1,4,7,0,1,-2,-5,1,12.0,21.0,-9.0,3
15965,15965,2014-15,2014,2015,Swansea,Everton,Draw,Away,2014-11-01,1,3,4,5,5,6,6,7,7,-3,-2,-2,-2,0,12.0,5.0,7.0,4
15966,15966,2014-15,2014,2015,Swansea,Arsenal,Win,Home,2014-11-09,3,4,4,5,6,6,7,7,8,-2,-3,-2,-2,1,12.0,4.0,8.0,4
15967,15967,2014-15,2014,2015,Swansea,Man City,Loss,Away,2014-11-22,0,4,7,7,8,4,4,7,10,0,3,0,-2,0,12.0,1.0,11.0,4
15968,15968,2014-15,2014,2015,Swansea,Crystal Palace,Draw,Home,2014-11-29,1,3,4,7,7,3,3,4,4,0,1,3,3,1,12.0,11.0,1.0,4
15969,15969,2014-15,2014,2015,Swansea,QPR,Win,Home,2014-12-02,3,1,4,5,8,3,4,4,7,-2,0,1,1,1,12.0,21.0,-9.0,5
15970,15970,2014-15,2014,2015,Swansea,West Ham,Loss,Away,2014-12-07,0,4,4,7,8,6,6,7,8,-2,-2,0,0,0,12.0,13.0,-1.0,5
15971,15971,2014-15,2014,2015,Swansea,Tottenham,Loss,Home,2014-12-14,0,3,4,4,7,1,4,7,7,2,0,-3,0,1,12.0,6.0,6.0,5
15972,15972,2014-15,2014,2015,Swansea,Hull,Win,Away,2014-12-20,3,0,3,4,4,1,2,2,2,-1,1,2,2,0,12.0,16.0,-4.0,5
15973,15973,2014-15,2014,2015,Swansea,Aston Villa,Win,Home,2014-12-26,3,3,3,6,7,1,4,7,8,2,-1,-1,-1,1,12.0,15.0,-3.0,5
15974,15974,2014-15,2014,2015,Swansea,Liverpool,Loss,Away,2014-12-29,0,6,6,6,9,4,4,5,8,2,2,1,1,0,12.0,2.0,10.0,5
15975,15975,2014-15,2014,2015,Swansea,QPR,Draw,Away,2015-01-01,1,3,6,6,6,1,4,4,7,2,2,2,-1,0,12.0,21.0,-9.0,6
15976,15976,2014-15,2014,2015,Swansea,West Ham,Draw,Home,2015-01-10,1,1,4,7,7,1,1,4,5,0,3,3,2,1,12.0,13.0,-1.0,6
15977,15977,2014-15,2014,2015,Swansea,Chelsea,Loss,Home,2015-01-17,0,2,2,5,8,3,4,7,10,-1,-2,-2,-2,1,12.0,3.0,9.0,6
15978,15978,2014-15,2014,2015,Swansea,Southampton,Win,Away,2015-02-01,3,1,2,2,5,6,9,10,13,-5,-7,-8,-8,0,12.0,8.0,4.0,7
15979,15979,2014-15,2014,2015,Swansea,Sunderland,Draw,Home,2015-02-07,1,3,4,5,5,3,3,3,4,0,1,2,1,1,12.0,14.0,-2.0,7
15980,15980,2014-15,2014,2015,Swansea,West Brom,Loss,Away,2015-02-11,0,4,4,5,6,1,2,5,6,3,2,0,0,0,12.0,17.0,-5.0,7
15981,15981,2014-15,2014,2015,Swansea,Man United,Win,Home,2015-02-21,3,1,4,4,5,4,7,10,10,-3,-3,-6,-5,1,12.0,7.0,5.0,7
15982,15982,2014-15,2014,2015,Swansea,Burnley,Win,Away,2015-02-28,3,3,4,7,7,1,2,2,2,2,2,5,5,0,12.0,21.0,-9.0,7
15983,15983,2014-15,2014,2015,Swansea,Tottenham,Loss,Away,2015-03-04,0,6,6,7,10,1,4,7,10,5,2,0,0,0,12.0,6.0,6.0,8
15984,15984,2014-15,2014,2015,Swansea,Liverpool,Loss,Home,2015-03-16,0,3,6,6,7,6,9,12,13,-3,-3,-6,-6,1,12.0,2.0,10.0,8
15985,15985,2014-15,2014,2015,Swansea,Aston Villa,Win,Away,2015-03-21,3,0,3,6,6,6,6,6,6,-6,-3,0,0,0,12.0,15.0,-3.0,8
15986,15986,2014-15,2014,2015,Swansea,Hull,Win,Home,2015-04-04,3,3,3,6,9,1,2,2,5,2,1,4,4,1,12.0,16.0,-4.0,9
15987,15987,2014-15,2014,2015,Swansea,Everton,Draw,Home,2015-04-11,1,6,6,6,9,6,9,9,9,0,-3,-3,0,1,12.0,5.0,7.0,9
15988,15988,2014-15,2014,2015,Swansea,Leicester,Loss,Away,2015-04-18,0,4,7,7,7,6,6,7,7,-2,1,0,0,0,12.0,21.0,-9.0,9
15989,15989,2014-15,2014,2015,Swansea,Newcastle,Win,Away,2015-04-25,3,1,4,7,7,0,0,0,0,1,4,7,7,0,12.0,10.0,2.0,9
15990,15990,2014-15,2014,2015,Swansea,Stoke,Win,Home,2015-05-02,3,3,4,7,10,4,5,5,5,-1,-1,2,5,1,12.0,9.0,3.0,10
15991,15991,2014-15,2014,2015,Swansea,Arsenal,Win,Away,2015-05-11,3,6,6,7,10,4,7,10,13,2,-1,-3,-3,0,12.0,4.0,8.0,10
15992,15992,2014-15,2014,2015,Swansea,Man City,Loss,Home,2015-05-17,0,6,9,9,10,6,9,12,12,0,0,-3,-2,1,12.0,1.0,11.0,10
15993,15993,2014-15,2014,2015,Swansea,Crystal Palace,Loss,Away,2015-05-24,0,3,6,9,9,3,3,3,3,0,3,6,6,0,12.0,11.0,1.0,10
15994,15994,2015-16,2015,2016,Swansea,Chelsea,Draw,Away,2015-08-08,1,0,3,6,9,3,4,7,10,-3,-1,-1,-1,0,8.0,1.0,7.0,1
15995,15995,2015-16,2015,2016,Swansea,Newcastle,Win,Home,2015-08-15,3,1,1,4,7,4,4,5,5,-3,-3,-1,2,1,8.0,15.0,-7.0,1
15996,15996,2015-16,2015,2016,Swansea,Sunderland,Draw,Away,2015-08-22,1,4,4,4,7,0,0,1,2,4,4,3,5,0,8.0,16.0,-8.0,1
15997,15997,2015-16,2015,2016,Swansea,Man United,Win,Home,2015-08-30,3,4,5,5,5,4,7,8,9,0,-2,-3,-4,1,8.0,4.0,4.0,1
15998,15998,2015-16,2015,2016,Swansea,Watford,Loss,Away,2015-09-12,0,4,7,8,8,1,2,3,4,3,5,5,4,0,8.0,21.0,-13.0,2
15999,15999,2015-16,2015,2016,Swansea,Everton,Draw,Home,2015-09-19,1,3,4,7,8,4,4,7,8,-1,0,0,0,1,8.0,11.0,-3.0,2
16000,16000,2015-16,2015,2016,Swansea,Southampton,Loss,Away,2015-09-26,0,1,4,5,8,1,4,5,5,0,0,0,3,0,8.0,7.0,1.0,2
16001,16001,2015-16,2015,2016,Swansea,Tottenham,Draw,Home,2015-10-04,1,1,1,4,5,6,9,10,11,-5,-8,-6,-6,1,8.0,5.0,3.0,3
16002,16002,2015-16,2015,2016,Swansea,Stoke,Loss,Home,2015-10-19,0,1,2,2,5,6,7,7,7,-5,-5,-5,-2,1,8.0,9.0,-1.0,3
16003,16003,2015-16,2015,2016,Swansea,Aston Villa,Win,Away,2015-10-24,3,1,1,2,2,0,0,0,0,1,1,2,2,0,8.0,17.0,-9.0,3
16004,16004,2015-16,2015,2016,Swansea,Arsenal,Loss,Home,2015-10-31,0,3,4,4,5,6,9,12,12,-3,-5,-8,-7,1,8.0,3.0,5.0,3
16005,16005,2015-16,2015,2016,Swansea,Norwich,Loss,Away,2015-11-07,0,3,3,4,4,0,0,0,1,3,3,4,3,0,8.0,21.0,-13.0,4
16006,16006,2015-16,2015,2016,Swansea,Bournemouth,Draw,Home,2015-11-21,1,0,3,3,4,0,0,0,1,0,3,3,3,1,8.0,21.0,-13.0,4
16007,16007,2015-16,2015,2016,Swansea,Liverpool,Loss,Away,2015-11-29,0,1,1,4,4,3,6,7,8,-2,-5,-3,-4,0,8.0,6.0,2.0,4
16008,16008,2015-16,2015,2016,Swansea,Leicester,Loss,Home,2015-12-05,0,1,1,1,4,4,7,10,13,-3,-6,-9,-9,1,8.0,14.0,-6.0,5
16009,16009,2015-16,2015,2016,Swansea,Man City,Loss,Away,2015-12-12,0,0,1,1,1,3,3,4,7,-3,-2,-3,-6,0,8.0,2.0,6.0,5
16010,16010,2015-16,2015,2016,Swansea,West Ham,Draw,Home,2015-12-20,1,0,0,1,1,2,3,3,4,-2,-3,-2,-3,1,8.0,12.0,-4.0,5
16011,16011,2015-16,2015,2016,Swansea,West Brom,Win,Home,2015-12-26,3,1,1,1,2,1,2,3,6,0,-1,-2,-4,1,8.0,13.0,-5.0,5
16012,16012,2015-16,2015,2016,Swansea,Crystal Palace,Draw,Away,2015-12-28,1,4,4,4,4,4,7,8,11,0,-3,-4,-7,0,8.0,10.0,-2.0,5
16013,16013,2015-16,2015,2016,Swansea,Man United,Loss,Away,2016-01-02,0,4,5,5,5,1,1,1,2,3,4,4,3,0,8.0,4.0,4.0,6
16014,16014,2015-16,2015,2016,Swansea,Sunderland,Loss,Home,2016-01-13,0,1,4,5,5,3,3,3,3,-2,1,2,2,1,8.0,16.0,-8.0,6
16015,16015,2015-16,2015,2016,Swansea,Watford,Win,Home,2016-01-18,3,0,1,4,5,0,0,1,4,0,1,3,1,1,8.0,21.0,-13.0,6
16016,16016,2015-16,2015,2016,Swansea,Everton,Win,Away,2016-01-24,3,3,3,4,7,2,3,3,6,1,0,1,1,0,8.0,11.0,-3.0,6
16017,16017,2015-16,2015,2016,Swansea,West Brom,Draw,Away,2016-02-02,1,6,6,6,7,1,2,5,8,5,4,1,-1,0,8.0,13.0,-5.0,7
16018,16018,2015-16,2015,2016,Swansea,Crystal Palace,Draw,Home,2016-02-06,1,4,7,7,7,0,0,0,0,4,7,7,7,1,8.0,10.0,-2.0,7
16019,16019,2015-16,2015,2016,Swansea,Southampton,Loss,Home,2016-02-13,0,2,5,8,8,4,7,10,13,-2,-2,-2,-5,1,8.0,7.0,1.0,7
16020,16020,2015-16,2015,2016,Swansea,Tottenham,Loss,Away,2016-02-28,0,1,2,5,8,6,9,12,15,-5,-7,-7,-7,0,8.0,5.0,3.0,7
16021,16021,2015-16,2015,2016,Swansea,Arsenal,Win,Away,2016-03-02,3,0,1,2,5,3,6,7,7,-3,-5,-5,-2,0,8.0,3.0,5.0,8
16022,16022,2015-16,2015,2016,Swansea,Norwich,Win,Home,2016-03-05,3,3,3,4,5,0,1,1,1,3,2,3,4,1,8.0,21.0,-13.0,8
16023,16023,2015-16,2015,2016,Swansea,Bournemouth,Loss,Away,2016-03-12,0,6,6,6,7,6,7,7,7,0,-1,-1,0,0,8.0,21.0,-13.0,8
16024,16024,2015-16,2015,2016,Swansea,Aston Villa,Win,Home,2016-03-19,3,3,6,6,6,0,0,0,0,3,6,6,6,1,8.0,17.0,-9.0,8
16025,16025,2015-16,2015,2016,Swansea,Stoke,Draw,Away,2016-04-02,1,3,6,9,9,3,4,7,10,0,2,2,-1,0,8.0,9.0,-1.0,9
16026,16026,2015-16,2015,2016,Swansea,Chelsea,Win,Home,2016-04-09,3,4,4,7,10,4,5,8,11,0,-1,-1,-1,1,8.0,1.0,7.0,9
16027,16027,2015-16,2015,2016,Swansea,Newcastle,Loss,Away,2016-04-16,0,4,7,7,10,0,1,1,1,4,6,6,9,0,8.0,15.0,-7.0,9
16028,16028,2015-16,2015,2016,Swansea,Leicester,Loss,Away,2016-04-24,0,3,4,7,7,4,7,10,13,-1,-3,-3,-6,0,8.0,14.0,-6.0,9
16029,16029,2015-16,2015,2016,Swansea,Liverpool,Win,Home,2016-05-01,3,0,3,4,7,4,7,10,11,-4,-4,-6,-4,1,8.0,6.0,2.0,10
16030,16030,2015-16,2015,2016,Swansea,West Ham,Win,Away,2016-05-07,3,3,3,6,7,6,7,8,9,-3,-4,-2,-2,0,8.0,12.0,-4.0,10
16031,16031,2015-16,2015,2016,Swansea,Man City,Draw,Home,2016-05-15,1,6,6,6,9,1,4,5,8,5,2,1,1,1,8.0,2.0,6.0,10
16032,16032,2016-17,2016,2017,Swansea,Burnley,Win,Away,2016-08-13,3,4,7,7,7,4,7,7,7,0,0,0,0,0,12.0,21.0,-9.0,1
16033,16033,2016-17,2016,2017,Swansea,Hull,Loss,Home,2016-08-20,0,4,7,10,10,4,4,4,4,0,3,6,6,1,12.0,21.0,-9.0,1
16034,16034,2016-17,2016,2017,Swansea,Leicester,Loss,Away,2016-08-27,0,3,4,7,10,1,2,5,6,2,2,2,4,0,12.0,1.0,11.0,1
16035,16035,2016-17,2016,2017,Swansea,Chelsea,Draw,Home,2016-09-11,1,0,3,4,7,6,9,10,11,-6,-6,-6,-4,1,12.0,10.0,2.0,2
16036,16036,2016-17,2016,2017,Swansea,Southampton,Loss,Away,2016-09-18,0,1,1,4,5,1,1,2,5,0,0,2,0,0,12.0,6.0,6.0,2
16037,16037,2016-17,2016,2017,Swansea,Man City,Loss,Home,2016-09-24,0,1,1,1,4,6,9,12,15,-5,-8,-11,-11,1,12.0,4.0,8.0,2
16038,16038,2016-17,2016,2017,Swansea,Liverpool,Loss,Home,2016-10-01,0,0,1,1,1,6,9,10,10,-6,-8,-9,-9,1,12.0,8.0,4.0,3
16039,16039,2016-17,2016,2017,Swansea,Arsenal,Loss,Away,2016-10-15,0,0,0,1,1,6,9,12,15,-6,-9,-11,-14,0,12.0,2.0,10.0,3
16040,16040,2016-17,2016,2017,Swansea,Watford,Draw,Home,2016-10-22,1,0,0,0,1,4,4,7,10,-4,-4,-7,-9,1,12.0,13.0,-1.0,3
16041,16041,2016-17,2016,2017,Swansea,Stoke,Loss,Away,2016-10-31,0,1,1,1,1,6,7,8,8,-5,-6,-7,-7,0,12.0,9.0,3.0,3
16042,16042,2016-17,2016,2017,Swansea,Man United,Loss,Home,2016-11-06,0,1,1,1,1,1,2,3,6,0,-1,-2,-5,1,12.0,5.0,7.0,4
16043,16043,2016-17,2016,2017,Swansea,Everton,Draw,Away,2016-11-19,1,0,1,1,1,3,3,4,5,-3,-2,-3,-4,0,12.0,11.0,1.0,4
16044,16044,2016-17,2016,2017,Swansea,Crystal Palace,Win,Home,2016-11-26,3,1,1,2,2,0,0,0,0,1,1,2,2,1,12.0,15.0,-3.0,4
16045,16045,2016-17,2016,2017,Swansea,Tottenham,Loss,Away,2016-12-03,0,4,4,4,5,3,4,5,6,1,0,-1,-1,0,12.0,3.0,9.0,5
16046,16046,2016-17,2016,2017,Swansea,Sunderland,Win,Home,2016-12-10,3,3,4,4,4,3,6,9,9,0,-2,-5,-5,1,12.0,17.0,-5.0,5
16047,16047,2016-17,2016,2017,Swansea,West Brom,Loss,Away,2016-12-14,0,3,6,7,7,3,4,7,10,0,2,0,-3,0,12.0,14.0,-2.0,5
16048,16048,2016-17,2016,2017,Swansea,Middlesbrough,Loss,Away,2016-12-17,0,3,3,6,7,0,3,4,4,3,0,2,3,0,12.0,21.0,-9.0,5
16049,16049,2016-17,2016,2017,Swansea,West Ham,Loss,Home,2016-12-26,0,0,3,3,6,6,7,7,8,-6,-4,-4,-2,1,12.0,7.0,5.0,5
16050,16050,2016-17,2016,2017,Swansea,Bournemouth,Loss,Home,2016-12-31,0,0,0,3,3,0,3,3,6,0,-3,0,-3,1,12.0,16.0,-4.0,5
16051,16051,2016-17,2016,2017,Swansea,Crystal Palace,Win,Away,2017-01-03,3,0,0,0,3,1,1,1,2,-1,-1,-1,1,0,12.0,15.0,-3.0,6
16052,16052,2016-17,2016,2017,Swansea,Arsenal,Loss,Home,2017-01-14,0,3,3,3,3,4,7,7,7,-1,-4,-4,-4,1,12.0,2.0,10.0,6
16053,16053,2016-17,2016,2017,Swansea,Liverpool,Win,Away,2017-01-21,3,3,3,3,3,2,5,8,11,1,-2,-5,-8,0,12.0,8.0,4.0,6
16054,16054,2016-17,2016,2017,Swansea,Southampton,Win,Home,2017-01-31,3,3,6,6,6,3,3,3,3,0,3,3,3,1,12.0,6.0,6.0,6
16055,16055,2016-17,2016,2017,Swansea,Man City,Loss,Away,2017-02-05,0,6,6,9,9,4,4,7,7,2,2,2,2,0,12.0,4.0,8.0,7
16056,16056,2016-17,2016,2017,Swansea,Leicester,Win,Home,2017-02-12,3,3,6,6,9,0,0,0,1,3,6,6,8,1,12.0,1.0,11.0,7
16057,16057,2016-17,2016,2017,Swansea,Chelsea,Loss,Away,2017-02-25,0,3,6,9,9,4,5,8,11,-1,1,1,-2,0,12.0,10.0,2.0,7
16058,16058,2016-17,2016,2017,Swansea,Burnley,Win,Home,2017-03-04,3,3,3,6,9,2,2,5,5,1,1,1,4,1,12.0,21.0,-9.0,8
16059,16059,2016-17,2016,2017,Swansea,Hull,Loss,Away,2017-03-11,0,3,6,6,9,1,1,4,5,2,5,2,4,0,12.0,21.0,-9.0,8
16060,16060,2016-17,2016,2017,Swansea,Bournemouth,Loss,Away,2017-03-18,0,3,3,6,6,4,4,4,4,-1,-1,2,2,0,12.0,16.0,-4.0,8
16061,16061,2016-17,2016,2017,Swansea,Middlesbrough,Draw,Home,2017-04-02,1,0,3,3,6,0,0,1,1,0,3,2,5,1,12.0,21.0,-9.0,9
16062,16062,2016-17,2016,2017,Swansea,Tottenham,Loss,Home,2017-04-05,0,1,1,4,4,6,9,12,12,-5,-8,-8,-8,1,12.0,3.0,9.0,9
16063,16063,2016-17,2016,2017,Swansea,West Ham,Loss,Away,2017-04-08,0,1,1,1,4,0,0,0,0,1,1,1,4,0,12.0,7.0,5.0,9
16064,16064,2016-17,2016,2017,Swansea,Watford,Loss,Away,2017-04-15,0,0,1,1,1,3,6,6,6,-3,-5,-5,-5,0,12.0,13.0,-1.0,9
16065,16065,2016-17,2016,2017,Swansea,Stoke,Win,Home,2017-04-22,3,0,0,1,1,3,3,3,3,-3,-3,-2,-2,1,12.0,9.0,3.0,9
16066,16066,2016-17,2016,2017,Swansea,Man United,Draw,Away,2017-04-30,1,3,3,3,4,4,7,10,11,-1,-4,-7,-7,0,12.0,5.0,7.0,9
16067,16067,2016-17,2016,2017,Swansea,Everton,Win,Home,2017-05-06,3,4,4,4,4,1,4,7,8,3,0,-3,-4,1,12.0,11.0,1.0,10
16068,16068,2016-17,2016,2017,Swansea,Sunderland,Win,Away,2017-05-13,3,4,7,7,7,3,3,4,4,1,4,3,3,0,12.0,17.0,-5.0,10
16069,16069,2016-17,2016,2017,Swansea,West Brom,Win,Home,2017-05-21,3,6,7,10,10,0,1,1,1,6,6,9,9,1,12.0,14.0,-2.0,10
16070,16070,2017-18,2017,2018,Swansea,Southampton,Draw,Away,2017-08-12,1,6,9,10,13,1,4,4,5,5,5,6,8,0,15.0,8.0,7.0,1
16071,16071,2017-18,2017,2018,Swansea,Man United,Loss,Home,2017-08-19,0,4,7,10,11,6,7,7,7,-2,0,3,4,1,15.0,6.0,9.0,1
16072,16072,2017-18,2017,2018,Swansea,Crystal Palace,Win,Away,2017-08-26,3,1,4,7,10,0,0,3,3,1,4,4,7,0,15.0,14.0,1.0,1
16073,16073,2017-18,2017,2018,Swansea,Newcastle,Loss,Home,2017-09-10,0,3,4,7,10,3,3,6,7,0,1,1,3,1,15.0,21.0,-6.0,2
16074,16074,2017-18,2017,2018,Swansea,Tottenham,Draw,Away,2017-09-16,1,3,3,4,7,4,4,7,10,-1,-1,-3,-3,0,15.0,2.0,13.0,2
16075,16075,2017-18,2017,2018,Swansea,Watford,Loss,Home,2017-09-23,0,1,4,4,5,3,4,7,8,-2,0,-3,-3,1,15.0,17.0,-2.0,2
16076,16076,2017-18,2017,2018,Swansea,West Ham,Loss,Away,2017-09-30,0,1,1,4,4,1,4,4,4,0,-3,0,0,0,15.0,11.0,4.0,2
16077,16077,2017-18,2017,2018,Swansea,Huddersfield,Win,Home,2017-10-14,3,0,1,1,4,1,2,2,3,-1,-1,-1,1,1,15.0,21.0,-6.0,3
16078,16078,2017-18,2017,2018,Swansea,Leicester,Loss,Home,2017-10-21,0,3,3,4,4,2,2,3,3,1,1,1,1,1,15.0,12.0,3.0,3
16079,16079,2017-18,2017,2018,Swansea,Arsenal,Loss,Away,2017-10-28,0,3,3,3,4,3,6,9,10,0,-3,-6,-6,0,15.0,5.0,10.0,3
16080,16080,2017-18,2017,2018,Swansea,Brighton,Loss,Home,2017-11-04,0,0,3,3,3,4,5,5,8,-4,-2,-2,-5,1,15.0,21.0,-6.0,4
16081,16081,2017-18,2017,2018,Swansea,Burnley,Loss,Away,2017-11-18,0,0,0,3,3,6,6,7,10,-6,-6,-4,-7,0,15.0,16.0,-1.0,4
16082,16082,2017-18,2017,2018,Swansea,Bournemouth,Draw,Home,2017-11-25,1,0,0,0,3,6,6,9,9,-6,-6,-9,-6,1,15.0,9.0,6.0,4
16083,16083,2017-18,2017,2018,Swansea,Chelsea,Loss,Away,2017-11-29,0,1,1,1,1,4,7,10,13,-3,-6,-9,-12,0,15.0,1.0,14.0,4
16084,16084,2017-18,2017,2018,Swansea,Stoke,Loss,Away,2017-12-02,0,1,1,1,1,0,1,2,5,1,0,-1,-4,0,15.0,13.0,2.0,5
16085,16085,2017-18,2017,2018,Swansea,West Brom,Win,Home,2017-12-09,3,0,1,1,1,2,3,3,3,-2,-2,-2,-2,1,15.0,10.0,5.0,5
16086,16086,2017-18,2017,2018,Swansea,Man City,Loss,Home,2017-12-13,0,3,3,4,4,6,9,12,15,-3,-6,-8,-11,1,15.0,3.0,12.0,5
16087,16087,2017-18,2017,2018,Swansea,Everton,Loss,Away,2017-12-18,0,3,3,3,4,4,7,10,10,-1,-4,-7,-6,0,15.0,7.0,8.0,5
16088,16088,2017-18,2017,2018,Swansea,Crystal Palace,Draw,Home,2017-12-23,1,0,3,3,3,6,7,8,9,-6,-4,-5,-6,1,15.0,14.0,1.0,5
16089,16089,2017-18,2017,2018,Swansea,Liverpool,Loss,Away,2017-12-26,0,1,1,4,4,4,5,6,9,-3,-4,-2,-5,0,15.0,4.0,11.0,5
16090,16090,2017-18,2017,2018,Swansea,Watford,Win,Away,2017-12-30,3,1,1,1,4,3,3,3,3,-2,-2,-2,1,0,15.0,17.0,-2.0,5
16091,16091,2017-18,2017,2018,Swansea,Tottenham,Loss,Home,2018-01-02,0,3,4,4,4,6,6,9,12,-3,-2,-5,-8,1,15.0,2.0,13.0,6
16092,16092,2017-18,2017,2018,Swansea,Newcastle,Draw,Away,2018-01-13,1,3,3,4,4,4,4,7,7,-1,-1,-3,-3,0,15.0,21.0,-6.0,6
16093,16093,2017-18,2017,2018,Swansea,Liverpool,Win,Home,2018-01-22,3,1,4,4,5,6,9,12,13,-5,-5,-8,-8,1,15.0,4.0,11.0,6
16094,16094,2017-18,2017,2018,Swansea,Arsenal,Win,Home,2018-01-30,3,4,4,7,7,3,4,5,8,1,0,2,-1,1,15.0,5.0,10.0,6
16095,16095,2017-18,2017,2018,Swansea,Leicester,Draw,Away,2018-02-03,1,6,7,7,10,3,4,7,7,3,3,0,3,0,15.0,12.0,3.0,7
16096,16096,2017-18,2017,2018,Swansea,Burnley,Win,Home,2018-02-10,3,4,7,8,8,2,2,2,2,2,5,6,6,1,15.0,16.0,-1.0,7
16097,16097,2017-18,2017,2018,Swansea,Brighton,Loss,Away,2018-02-24,0,4,7,10,11,4,5,5,5,0,2,5,6,0,15.0,21.0,-6.0,7
16098,16098,2017-18,2017,2018,Swansea,West Ham,Win,Home,2018-03-03,3,3,4,7,10,3,3,4,5,0,1,3,5,1,15.0,11.0,4.0,8
16099,16099,2017-18,2017,2018,Swansea,Huddersfield,Draw,Away,2018-03-10,1,3,6,7,10,3,6,6,6,0,0,1,4,0,15.0,21.0,-6.0,8
16100,16100,2017-18,2017,2018,Swansea,Man United,Loss,Away,2018-03-31,0,4,4,7,8,6,9,9,12,-2,-5,-2,-4,0,15.0,6.0,9.0,8
16101,16101,2017-18,2017,2018,Swansea,West Brom,Draw,Away,2018-04-07,1,1,4,4,7,0,0,0,0,1,4,4,7,0,15.0,10.0,5.0,9
16102,16102,2017-18,2017,2018,Swansea,Everton,Draw,Home,2018-04-14,1,1,2,5,5,1,4,7,7,0,-2,-2,-2,1,15.0,7.0,8.0,9
16103,16103,2017-18,2017,2018,Swansea,Man City,Loss,Away,2018-04-22,0,2,2,3,6,3,6,9,12,-1,-4,-6,-6,0,15.0,3.0,12.0,9
16104,16104,2017-18,2017,2018,Swansea,Chelsea,Loss,Home,2018-04-28,0,1,2,2,3,6,7,7,10,-5,-5,-5,-7,1,15.0,1.0,14.0,9
16105,16105,2017-18,2017,2018,Swansea,Bournemouth,Loss,Away,2018-05-05,0,0,1,2,2,0,0,1,2,0,1,1,0,0,15.0,9.0,6.0,10
16106,16106,2017-18,2017,2018,Swansea,Southampton,Loss,Home,2018-05-08,0,0,0,1,2,4,5,5,5,-4,-5,-4,-3,1,15.0,8.0,7.0,10
16107,16107,2017-18,2017,2018,Swansea,Stoke,Loss,Home,2018-05-13,0,0,0,0,1,1,2,3,3,-1,-2,-3,-2,1,15.0,13.0,2.0,10
16108,16108,1993-94,1993,1994,Swindon,Sheffield United,Loss,Away,1993-08-14,0,0,0,0,0,0,0,0,0,0,0,0,0,0,21.0,14.0,7.0,1
16109,16109,1993-94,1993,1994,Swindon,Oldham,Loss,Home,1993-08-18,0,0,0,0,0,0,0,0,0,0,0,0,0,1,21.0,19.0,2.0,1
16110,16110,1993-94,1993,1994,Swindon,Liverpool,Loss,Home,1993-08-22,0,0,0,0,0,6,6,6,6,-6,-6,-6,-6,1,21.0,6.0,15.0,1
16111,16111,1993-94,1993,1994,Swindon,Southampton,Loss,Away,1993-08-25,0,0,0,0,0,0,0,0,0,0,0,0,0,0,21.0,18.0,3.0,1
16112,16112,1993-94,1993,1994,Swindon,Norwich,Draw,Away,1993-08-28,1,0,0,0,0,6,9,9,9,-6,-9,-9,-9,0,21.0,3.0,18.0,1
16113,16113,1993-94,1993,1994,Swindon,Man City,Loss,Home,1993-09-01,0,1,1,1,1,1,1,1,2,0,0,0,-1,1,21.0,9.0,12.0,2
16114,16114,1993-94,1993,1994,Swindon,West Ham,Draw,Away,1993-09-11,1,1,1,1,1,0,3,4,4,1,-2,-3,-3,0,21.0,21.0,0.0,2
16115,16115,1993-94,1993,1994,Swindon,Newcastle,Draw,Home,1993-09-18,1,1,2,2,2,4,5,8,9,-3,-3,-6,-7,1,21.0,21.0,0.0,2
16116,16116,1993-94,1993,1994,Swindon,Man United,Loss,Away,1993-09-25,0,2,2,3,3,3,6,9,12,-1,-4,-6,-9,0,21.0,1.0,20.0,2
16117,16117,1993-94,1993,1994,Swindon,Blackburn,Loss,Home,1993-10-02,0,1,2,2,3,1,4,5,6,0,-2,-3,-3,1,21.0,4.0,17.0,3
16118,16118,1993-94,1993,1994,Swindon,Everton,Draw,Home,1993-10-16,1,0,1,2,2,0,3,6,6,0,-2,-4,-4,1,21.0,13.0,8.0,3
16119,16119,1993-94,1993,1994,Swindon,Tottenham,Draw,Away,1993-10-23,1,1,1,2,3,3,4,7,8,-2,-3,-5,-5,0,21.0,8.0,13.0,3
16120,16120,1993-94,1993,1994,Swindon,Aston Villa,Loss,Home,1993-10-30,0,2,2,2,3,4,4,5,8,-2,-2,-3,-5,1,21.0,2.0,19.0,3
16121,16121,1993-94,1993,1994,Swindon,Wimbledon,Loss,Away,1993-11-06,0,1,2,2,2,0,1,1,2,1,1,1,0,0,21.0,12.0,9.0,4
16122,16122,1993-94,1993,1994,Swindon,Ipswich,Draw,Home,1993-11-20,1,0,1,2,2,0,3,4,4,0,-2,-2,-2,1,21.0,16.0,5.0,4
16123,16123,1993-94,1993,1994,Swindon,QPR,Win,Home,1993-11-24,3,1,1,2,3,6,6,9,12,-5,-5,-7,-9,1,21.0,5.0,16.0,4
16124,16124,1993-94,1993,1994,Swindon,Leeds,Loss,Away,1993-11-27,0,4,4,4,5,2,5,6,7,2,-1,-2,-2,0,21.0,17.0,4.0,4
16125,16125,1993-94,1993,1994,Swindon,Sheffield United,Draw,Home,1993-12-04,1,3,4,4,4,3,3,3,4,0,1,1,0,1,21.0,14.0,7.0,5
16126,16126,1993-94,1993,1994,Swindon,Oldham,Loss,Away,1993-12-07,0,1,4,5,5,4,4,4,4,-3,0,1,1,0,21.0,19.0,2.0,5
16127,16127,1993-94,1993,1994,Swindon,Liverpool,Draw,Away,1993-12-11,1,1,1,4,5,3,6,6,9,-2,-5,-2,-4,0,21.0,6.0,15.0,5
16128,16128,1993-94,1993,1994,Swindon,Southampton,Win,Home,1993-12-18,3,1,2,2,5,0,0,0,3,1,2,2,2,1,21.0,18.0,3.0,5
16129,16129,1993-94,1993,1994,Swindon,Arsenal,Loss,Home,1993-12-27,0,4,4,5,5,3,4,4,7,1,0,1,-2,1,21.0,10.0,11.0,5
16130,16130,1993-94,1993,1994,Swindon,Sheffield Weds,Draw,Away,1993-12-29,1,3,4,4,5,6,6,7,10,-3,-2,-3,-5,0,21.0,7.0,14.0,5
16131,16131,1993-94,1993,1994,Swindon,Chelsea,Loss,Home,1994-01-01,0,1,4,5,5,3,4,4,4,-2,0,1,1,1,21.0,11.0,10.0,6
16132,16132,1993-94,1993,1994,Swindon,Coventry,Draw,Away,1994-01-03,1,1,1,4,5,6,7,7,10,-5,-6,-3,-5,0,21.0,15.0,6.0,6
16133,16133,1993-94,1993,1994,Swindon,Everton,Loss,Away,1994-01-15,0,1,2,2,5,0,0,0,0,1,2,2,5,0,21.0,13.0,8.0,6
16134,16134,1993-94,1993,1994,Swindon,Tottenham,Win,Home,1994-01-22,3,1,1,2,2,0,0,3,3,1,1,-1,-1,1,21.0,8.0,13.0,6
16135,16135,1993-94,1993,1994,Swindon,Coventry,Win,Home,1994-02-05,3,3,4,4,5,3,3,4,7,0,1,0,-2,1,21.0,15.0,6.0,7
16136,16136,1993-94,1993,1994,Swindon,Aston Villa,Loss,Away,1994-02-12,0,6,6,7,7,4,7,7,10,2,-1,0,-3,0,21.0,2.0,19.0,7
16137,16137,1993-94,1993,1994,Swindon,Norwich,Draw,Home,1994-02-19,1,3,6,6,7,2,3,4,4,1,3,2,3,1,21.0,3.0,18.0,7
16138,16138,1993-94,1993,1994,Swindon,Man City,Loss,Away,1994-02-26,0,1,4,7,7,1,2,5,5,0,2,2,2,0,21.0,9.0,12.0,7
16139,16139,1993-94,1993,1994,Swindon,West Ham,Draw,Home,1994-03-05,1,1,1,4,7,2,3,3,4,-1,-2,1,3,1,21.0,21.0,0.0,8
16140,16140,1993-94,1993,1994,Swindon,Newcastle,Loss,Away,1994-03-12,0,1,2,2,5,6,6,6,6,-5,-4,-4,-1,0,21.0,21.0,0.0,8
16141,16141,1993-94,1993,1994,Swindon,Man United,Draw,Home,1994-03-19,1,1,1,2,2,3,4,7,10,-2,-3,-5,-8,1,21.0,1.0,20.0,8
16142,16142,1993-94,1993,1994,Swindon,Blackburn,Loss,Away,1994-03-26,0,1,2,2,3,6,6,7,10,-5,-4,-5,-7,0,21.0,4.0,17.0,8
16143,16143,1993-94,1993,1994,Swindon,Arsenal,Draw,Away,1994-04-02,1,1,1,2,2,4,7,10,13,-3,-6,-8,-11,0,21.0,10.0,11.0,9
16144,16144,1993-94,1993,1994,Swindon,Sheffield Weds,Loss,Home,1994-04-04,0,1,2,2,3,6,6,6,7,-5,-4,-4,-4,1,21.0,7.0,14.0,9
16145,16145,1993-94,1993,1994,Swindon,Ipswich,Draw,Away,1994-04-16,1,1,1,2,2,0,0,1,1,1,1,1,1,0,21.0,16.0,5.0,9
16146,16146,1993-94,1993,1994,Swindon,Wimbledon,Loss,Home,1994-04-23,0,1,2,2,3,4,5,8,11,-3,-3,-6,-8,1,21.0,12.0,9.0,9
16147,16147,1993-94,1993,1994,Swindon,Chelsea,Loss,Away,1994-04-27,0,1,1,2,2,1,2,3,6,0,-1,-1,-4,0,21.0,11.0,10.0,9
16148,16148,1993-94,1993,1994,Swindon,QPR,Win,Away,1994-04-30,3,0,1,1,2,2,5,6,6,-2,-4,-5,-4,0,21.0,5.0,16.0,9
16149,16149,1993-94,1993,1994,Swindon,Leeds,Loss,Home,1994-05-07,0,3,3,4,4,4,4,5,8,-1,-1,-1,-4,1,21.0,17.0,4.0,10
16150,16150,1993-94,1993,1994,Tottenham,Newcastle,Win,Away,1993-08-14,3,0,0,0,0,0,0,0,0,0,0,0,0,0,8.0,21.0,-13.0,1
16151,16151,1993-94,1993,1994,Tottenham,Arsenal,Loss,Home,1993-08-16,0,3,3,3,3,0,0,0,0,3,3,3,3,1,8.0,10.0,-2.0,1
16152,16152,1993-94,1993,1994,Tottenham,Man City,Win,Home,1993-08-21,3,3,3,3,3,1,1,1,1,2,2,2,2,1,8.0,9.0,-1.0,1
16153,16153,1993-94,1993,1994,Tottenham,Liverpool,Win,Away,1993-08-25,3,3,6,6,6,6,9,9,9,-3,-3,-3,-3,0,8.0,6.0,2.0,1
16154,16154,1993-94,1993,1994,Tottenham,Aston Villa,Loss,Away,1993-08-28,0,6,6,9,9,1,2,5,5,5,4,4,4,0,8.0,2.0,6.0,1
16155,16155,1993-94,1993,1994,Tottenham,Chelsea,Draw,Home,1993-09-01,1,3,6,6,9,4,4,5,5,-1,2,1,4,1,8.0,11.0,-3.0,2
16156,16156,1993-94,1993,1994,Tottenham,Sheffield United,Draw,Away,1993-09-11,1,1,4,7,7,1,4,4,4,0,0,3,3,0,8.0,14.0,-6.0,2
16157,16157,1993-94,1993,1994,Tottenham,Oldham,Win,Home,1993-09-18,3,2,2,5,8,0,1,2,2,2,1,3,6,1,8.0,19.0,-11.0,2
16158,16158,1993-94,1993,1994,Tottenham,Ipswich,Draw,Away,1993-09-26,1,4,5,5,8,0,1,2,2,4,4,3,6,0,8.0,16.0,-8.0,2
16159,16159,1993-94,1993,1994,Tottenham,Everton,Win,Home,1993-10-03,3,4,5,6,6,3,6,6,6,1,-1,0,0,1,8.0,13.0,-5.0,3
16160,16160,1993-94,1993,1994,Tottenham,Man United,Loss,Away,1993-10-16,0,4,7,8,9,6,9,9,12,-2,-2,-1,-3,0,8.0,1.0,7.0,3
16161,16161,1993-94,1993,1994,Tottenham,Swindon,Draw,Home,1993-10-23,1,3,4,7,8,1,1,2,3,2,3,5,5,1,8.0,21.0,-13.0,3
16162,16162,1993-94,1993,1994,Tottenham,Blackburn,Loss,Away,1993-10-30,0,1,4,5,8,2,5,6,6,-1,-1,-1,2,0,8.0,4.0,4.0,3
16163,16163,1993-94,1993,1994,Tottenham,Southampton,Loss,Away,1993-11-06,0,1,1,4,5,3,4,5,5,-2,-3,-1,0,0,8.0,18.0,-10.0,4
16164,16164,1993-94,1993,1994,Tottenham,Leeds,Draw,Home,1993-11-20,1,0,1,1,4,4,5,6,9,-4,-4,-5,-5,1,8.0,17.0,-9.0,4
16165,16165,1993-94,1993,1994,Tottenham,Wimbledon,Draw,Home,1993-11-24,1,1,1,2,2,3,3,3,4,-2,-2,-1,-2,1,8.0,12.0,-4.0,4
16166,16166,1993-94,1993,1994,Tottenham,QPR,Draw,Away,1993-11-27,1,2,2,2,3,3,6,6,9,-1,-4,-4,-6,0,8.0,5.0,3.0,4
16167,16167,1993-94,1993,1994,Tottenham,Newcastle,Loss,Home,1993-12-04,0,2,3,3,3,3,6,9,12,-1,-3,-6,-9,1,8.0,21.0,-13.0,5
16168,16168,1993-94,1993,1994,Tottenham,Arsenal,Draw,Away,1993-12-06,1,1,2,3,3,3,4,7,7,-2,-2,-4,-4,0,8.0,10.0,-2.0,5
16169,16169,1993-94,1993,1994,Tottenham,Man City,Win,Away,1993-12-11,3,1,2,3,4,3,3,4,5,-2,-1,-1,-1,0,8.0,9.0,-1.0,5
16170,16170,1993-94,1993,1994,Tottenham,Liverpool,Draw,Home,1993-12-18,1,4,4,5,6,4,4,7,7,0,0,-2,-1,1,8.0,6.0,2.0,5
16171,16171,1993-94,1993,1994,Tottenham,Norwich,Loss,Home,1993-12-27,0,4,5,5,6,3,4,4,5,1,1,1,1,1,8.0,3.0,5.0,5
16172,16172,1993-94,1993,1994,Tottenham,West Ham,Win,Away,1993-12-28,3,1,4,5,5,1,4,4,7,0,0,1,-2,0,8.0,21.0,-13.0,5
16173,16173,1993-94,1993,1994,Tottenham,Coventry,Loss,Home,1994-01-01,0,3,4,7,8,4,4,7,7,-1,0,0,1,1,8.0,15.0,-7.0,6
16174,16174,1993-94,1993,1994,Tottenham,Sheffield Weds,Loss,Away,1994-01-03,0,3,3,4,7,4,7,10,10,-1,-4,-6,-3,0,8.0,7.0,1.0,6
16175,16175,1993-94,1993,1994,Tottenham,Man United,Loss,Home,1994-01-15,0,0,3,3,4,2,5,6,9,-2,-2,-3,-5,1,8.0,1.0,7.0,6
16176,16176,1993-94,1993,1994,Tottenham,Swindon,Loss,Away,1994-01-22,0,0,0,3,3,1,1,2,2,-1,-1,1,1,0,8.0,21.0,-13.0,6
16177,16177,1993-94,1993,1994,Tottenham,Sheffield Weds,Loss,Home,1994-02-05,0,0,0,0,3,3,6,9,10,-3,-6,-9,-7,1,8.0,7.0,1.0,7
16178,16178,1993-94,1993,1994,Tottenham,Blackburn,Loss,Home,1994-02-12,0,0,0,0,0,6,9,12,15,-6,-9,-12,-15,1,8.0,4.0,4.0,7
16179,16179,1993-94,1993,1994,Tottenham,Chelsea,Loss,Away,1994-02-27,0,0,0,0,0,0,1,2,5,0,-1,-2,-5,0,8.0,11.0,-3.0,7
16180,16180,1993-94,1993,1994,Tottenham,Aston Villa,Draw,Home,1994-03-02,1,0,0,0,0,4,7,8,11,-4,-7,-8,-11,1,8.0,2.0,6.0,8
16181,16181,1993-94,1993,1994,Tottenham,Sheffield United,Draw,Home,1994-03-05,1,1,1,1,1,1,1,1,2,0,0,0,-1,1,8.0,14.0,-6.0,8
16182,16182,1993-94,1993,1994,Tottenham,Ipswich,Draw,Home,1994-03-19,1,2,2,2,2,3,6,7,7,-1,-4,-5,-5,1,8.0,16.0,-8.0,8
16183,16183,1993-94,1993,1994,Tottenham,Everton,Win,Away,1994-03-26,3,2,3,3,3,0,3,4,5,2,0,-1,-2,0,8.0,13.0,-5.0,8
16184,16184,1993-94,1993,1994,Tottenham,Norwich,Win,Away,1994-04-02,3,4,5,6,6,0,3,3,3,4,2,3,3,0,8.0,3.0,5.0,9
16185,16185,1993-94,1993,1994,Tottenham,West Ham,Loss,Home,1994-04-04,0,6,7,8,9,3,3,3,4,3,4,5,5,1,8.0,21.0,-13.0,9
16186,16186,1993-94,1993,1994,Tottenham,Coventry,Loss,Away,1994-04-09,0,3,6,7,8,3,6,6,6,0,0,1,2,0,8.0,15.0,-7.0,9
16187,16187,1993-94,1993,1994,Tottenham,Leeds,Loss,Away,1994-04-17,0,0,3,6,7,4,4,7,10,-4,-1,-1,-3,0,8.0,17.0,-9.0,9
16188,16188,1993-94,1993,1994,Tottenham,Southampton,Win,Home,1994-04-23,3,0,0,3,6,6,6,6,6,-6,-6,-3,0,1,8.0,18.0,-10.0,9
16189,16189,1993-94,1993,1994,Tottenham,Wimbledon,Loss,Away,1994-04-30,0,3,3,3,6,6,7,10,11,-3,-4,-7,-5,0,8.0,12.0,-4.0,9
16190,16190,1993-94,1993,1994,Tottenham,Oldham,Win,Away,1994-05-05,3,3,3,3,3,2,2,2,2,1,1,1,1,0,8.0,19.0,-11.0,10
16191,16191,1993-94,1993,1994,Tottenham,QPR,Loss,Home,1994-05-07,0,3,6,6,6,1,2,3,6,2,4,3,0,1,8.0,5.0,3.0,10
16192,16192,1994-95,1994,1995,Tottenham,Sheffield Weds,Win,Away,1994-08-20,3,3,3,6,6,2,3,6,7,1,0,0,-1,0,15.0,7.0,8.0,1
16193,16193,1994-95,1994,1995,Tottenham,Everton,Win,Home,1994-08-24,3,3,6,6,9,4,4,5,5,-1,2,1,4,1,15.0,17.0,-2.0,1
16194,16194,1994-95,1994,1995,Tottenham,Man United,Loss,Home,1994-08-27,0,6,6,9,9,4,5,8,11,2,1,1,-2,1,15.0,1.0,14.0,1
16195,16195,1994-95,1994,1995,Tottenham,Ipswich,Win,Away,1994-08-30,3,3,6,6,9,4,4,5,5,-1,2,1,4,0,15.0,19.0,-4.0,1
16196,16196,1994-95,1994,1995,Tottenham,Southampton,Loss,Home,1994-09-12,0,3,6,9,9,0,1,2,3,3,5,7,6,1,15.0,18.0,-3.0,2
16197,16197,1994-95,1994,1995,Tottenham,Leicester,Loss,Away,1994-09-17,0,3,3,6,9,1,1,1,1,2,2,5,8,0,15.0,21.0,-6.0,2
16198,16198,1994-95,1994,1995,Tottenham,Nott'm Forest,Loss,Home,1994-09-24,0,0,3,3,6,4,7,10,11,-4,-4,-7,-5,1,15.0,21.0,-6.0,2
16199,16199,1994-95,1994,1995,Tottenham,Wimbledon,Win,Away,1994-10-01,3,0,0,3,3,4,7,7,7,-4,-7,-4,-4,0,15.0,6.0,9.0,3
16200,16200,1994-95,1994,1995,Tottenham,QPR,Draw,Home,1994-10-08,1,3,3,3,6,0,1,2,3,3,2,1,3,1,15.0,9.0,6.0,3
16201,16201,1994-95,1994,1995,Tottenham,Leeds,Draw,Away,1994-10-15,1,4,4,4,4,3,4,4,7,1,0,0,-3,0,15.0,5.0,10.0,3
16202,16202,1994-95,1994,1995,Tottenham,Man City,Loss,Away,1994-10-22,0,2,5,5,5,4,4,7,8,-2,1,-2,-3,0,15.0,16.0,-1.0,3
16203,16203,1994-95,1994,1995,Tottenham,West Ham,Win,Home,1994-10-29,3,1,2,5,5,3,6,9,9,-2,-4,-4,-4,1,15.0,13.0,2.0,3
16204,16204,1994-95,1994,1995,Tottenham,Blackburn,Loss,Away,1994-11-05,0,3,4,5,8,6,6,9,10,-3,-2,-4,-2,0,15.0,2.0,13.0,4
16205,16205,1994-95,1994,1995,Tottenham,Aston Villa,Loss,Home,1994-11-19,0,3,3,4,5,0,0,0,1,3,3,4,4,1,15.0,10.0,5.0,4
16206,16206,1994-95,1994,1995,Tottenham,Chelsea,Draw,Home,1994-11-23,1,0,3,3,4,3,4,5,8,-3,-1,-2,-4,1,15.0,14.0,1.0,4
16207,16207,1994-95,1994,1995,Tottenham,Liverpool,Draw,Away,1994-11-26,1,1,1,4,4,3,6,6,9,-2,-5,-2,-5,0,15.0,8.0,7.0,4
16208,16208,1994-95,1994,1995,Tottenham,Newcastle,Win,Home,1994-12-03,3,2,2,2,5,1,2,5,5,1,0,-3,0,1,15.0,3.0,12.0,5
16209,16209,1994-95,1994,1995,Tottenham,Sheffield Weds,Win,Home,1994-12-10,3,4,5,5,5,4,7,8,8,0,-2,-3,-3,1,15.0,7.0,8.0,5
16210,16210,1994-95,1994,1995,Tottenham,Everton,Draw,Away,1994-12-17,1,6,7,8,8,4,7,10,11,2,0,-2,-3,0,15.0,17.0,-2.0,5
16211,16211,1994-95,1994,1995,Tottenham,Norwich,Win,Away,1994-12-26,3,4,7,8,9,6,6,9,9,-2,1,-1,0,0,15.0,12.0,3.0,5
16212,16212,1994-95,1994,1995,Tottenham,Crystal Palace,Draw,Home,1994-12-27,1,4,7,10,11,1,2,2,3,3,5,8,8,1,15.0,21.0,-6.0,5
16213,16213,1994-95,1994,1995,Tottenham,Coventry,Win,Away,1994-12-31,3,4,5,8,11,1,2,2,3,3,3,6,8,0,15.0,11.0,4.0,5
16214,16214,1994-95,1994,1995,Tottenham,Arsenal,Win,Home,1995-01-02,3,4,7,8,11,3,4,4,7,1,3,4,4,1,15.0,4.0,11.0,6
16215,16215,1994-95,1994,1995,Tottenham,West Ham,Win,Away,1995-01-14,3,6,7,10,11,3,3,4,7,3,4,6,4,0,15.0,13.0,2.0,6
16216,16216,1994-95,1994,1995,Tottenham,Aston Villa,Loss,Away,1995-01-25,0,6,9,10,13,6,7,8,11,0,2,2,2,0,15.0,10.0,5.0,6
16217,16217,1994-95,1994,1995,Tottenham,Blackburn,Win,Home,1995-02-05,3,3,6,9,10,4,4,7,10,-1,2,2,0,1,15.0,2.0,13.0,7
16218,16218,1994-95,1994,1995,Tottenham,Chelsea,Draw,Away,1995-02-11,1,3,6,9,12,1,2,3,4,2,4,6,8,0,15.0,14.0,1.0,7
16219,16219,1994-95,1994,1995,Tottenham,Wimbledon,Loss,Home,1995-02-25,0,4,4,7,10,0,1,1,4,4,3,6,6,1,15.0,6.0,9.0,7
16220,16220,1994-95,1994,1995,Tottenham,Nott'm Forest,Draw,Away,1995-03-04,1,1,4,4,7,1,1,2,5,0,3,2,2,0,15.0,21.0,-6.0,8
16221,16221,1994-95,1994,1995,Tottenham,Ipswich,Win,Home,1995-03-08,3,1,2,5,5,0,3,3,3,1,-1,2,2,1,15.0,19.0,-4.0,8
16222,16222,1994-95,1994,1995,Tottenham,Man United,Draw,Away,1995-03-15,1,4,4,5,8,6,6,9,12,-2,-2,-4,-4,0,15.0,1.0,14.0,8
16223,16223,1994-95,1994,1995,Tottenham,Leicester,Win,Home,1995-03-18,3,4,5,5,6,0,0,1,1,4,5,4,5,1,15.0,21.0,-6.0,8
16224,16224,1994-95,1994,1995,Tottenham,Liverpool,Draw,Home,1995-03-22,1,4,7,8,8,3,6,9,10,1,1,-1,-2,1,15.0,8.0,7.0,8
16225,16225,1994-95,1994,1995,Tottenham,Southampton,Loss,Away,1995-04-02,0,4,5,8,9,3,4,5,5,1,1,3,4,0,15.0,18.0,-3.0,9
16226,16226,1994-95,1994,1995,Tottenham,Man City,Win,Home,1995-04-11,3,1,4,5,8,0,3,4,4,1,1,1,4,1,15.0,16.0,-1.0,9
16227,16227,1994-95,1994,1995,Tottenham,Crystal Palace,Draw,Away,1995-04-14,1,3,4,7,8,4,4,7,8,-1,0,0,0,0,15.0,21.0,-6.0,9
16228,16228,1994-95,1994,1995,Tottenham,Norwich,Win,Home,1995-04-17,3,4,4,5,8,0,0,0,3,4,4,5,5,1,15.0,12.0,3.0,9
16229,16229,1994-95,1994,1995,Tottenham,Arsenal,Draw,Away,1995-04-29,1,4,7,7,8,6,6,6,9,-2,1,1,-1,0,15.0,4.0,11.0,9
16230,16230,1994-95,1994,1995,Tottenham,Newcastle,Draw,Away,1995-05-03,1,4,5,8,8,1,1,4,5,3,4,4,3,0,15.0,3.0,12.0,10
16231,16231,1994-95,1994,1995,Tottenham,QPR,Loss,Away,1995-05-06,0,2,5,6,9,1,1,1,4,1,4,5,5,0,15.0,9.0,6.0,10
16232,16232,1994-95,1994,1995,Tottenham,Coventry,Loss,Home,1995-05-09,0,1,2,5,6,0,0,3,3,1,2,2,3,1,15.0,11.0,4.0,10
16233,16233,1994-95,1994,1995,Tottenham,Leeds,Draw,Home,1995-05-14,1,0,1,2,5,6,9,12,13,-6,-8,-10,-8,1,15.0,5.0,10.0,10
16234,16234,1995-96,1995,1996,Tottenham,Man City,Draw,Away,1995-08-19,1,1,1,2,3,0,1,2,5,1,0,0,-2,0,7.0,17.0,-10.0,1
16235,16235,1995-96,1995,1996,Tottenham,Aston Villa,Loss,Home,1995-08-23,0,2,2,2,3,4,7,8,8,-2,-5,-6,-5,1,7.0,18.0,-11.0,1
16236,16236,1995-96,1995,1996,Tottenham,Liverpool,Loss,Home,1995-08-26,0,1,2,2,2,3,6,6,6,-2,-4,-4,-4,1,7.0,4.0,3.0,1
16237,16237,1995-96,1995,1996,Tottenham,West Ham,Draw,Away,1995-08-30,1,0,1,2,2,1,1,2,5,-1,0,0,-3,0,7.0,14.0,-7.0,1
16238,16238,1995-96,1995,1996,Tottenham,Leeds,Win,Home,1995-09-09,3,1,1,2,3,4,7,10,11,-3,-6,-8,-8,1,7.0,5.0,2.0,2
16239,16239,1995-96,1995,1996,Tottenham,Sheffield Weds,Win,Away,1995-09-16,3,4,4,4,5,4,4,7,7,0,0,-3,-2,0,7.0,13.0,-6.0,2
16240,16240,1995-96,1995,1996,Tottenham,QPR,Win,Away,1995-09-25,3,6,7,7,7,3,3,6,6,3,4,1,1,0,7.0,8.0,-1.0,2
16241,16241,1995-96,1995,1996,Tottenham,Wimbledon,Win,Home,1995-09-30,3,6,9,10,10,0,3,4,4,6,6,6,6,1,7.0,9.0,-2.0,2
16242,16242,1995-96,1995,1996,Tottenham,Nott'm Forest,Loss,Home,1995-10-14,0,6,9,12,13,4,7,8,9,2,2,4,4,1,7.0,3.0,4.0,3
16243,16243,1995-96,1995,1996,Tottenham,Everton,Draw,Away,1995-10-22,1,3,6,9,12,1,1,1,1,2,5,8,11,0,7.0,15.0,-8.0,3
16244,16244,1995-96,1995,1996,Tottenham,Newcastle,Draw,Home,1995-10-29,1,1,4,7,10,6,9,12,15,-5,-5,-5,-5,1,7.0,6.0,1.0,3
16245,16245,1995-96,1995,1996,Tottenham,Coventry,Win,Away,1995-11-04,3,2,2,5,8,0,1,1,1,2,1,4,7,0,7.0,16.0,-9.0,4
16246,16246,1995-96,1995,1996,Tottenham,Arsenal,Win,Home,1995-11-18,3,4,5,5,8,3,6,9,9,1,-1,-4,-1,1,7.0,12.0,-5.0,4
16247,16247,1995-96,1995,1996,Tottenham,Middlesbrough,Win,Away,1995-11-21,3,6,7,8,8,2,2,5,8,4,5,3,0,0,7.0,21.0,-14.0,4
16248,16248,1995-96,1995,1996,Tottenham,Chelsea,Draw,Away,1995-11-25,1,6,9,10,11,3,4,4,4,3,5,6,7,0,7.0,11.0,-4.0,4
16249,16249,1995-96,1995,1996,Tottenham,Everton,Draw,Home,1995-12-02,1,4,7,10,11,4,7,10,10,0,0,0,1,1,7.0,15.0,-8.0,5
16250,16250,1995-96,1995,1996,Tottenham,QPR,Win,Home,1995-12-09,3,2,5,8,11,1,1,2,2,1,4,6,9,1,7.0,8.0,-1.0,5
16251,16251,1995-96,1995,1996,Tottenham,Wimbledon,Win,Away,1995-12-16,3,4,5,8,11,2,3,3,4,2,2,5,7,0,7.0,9.0,-2.0,5
16252,16252,1995-96,1995,1996,Tottenham,Bolton,Draw,Home,1995-12-23,1,6,7,8,11,0,1,1,1,6,6,7,10,1,7.0,21.0,-14.0,5
16253,16253,1995-96,1995,1996,Tottenham,Southampton,Draw,Away,1995-12-26,1,4,7,8,9,1,2,3,6,3,5,5,3,0,7.0,10.0,-3.0,5
16254,16254,1995-96,1995,1996,Tottenham,Blackburn,Loss,Away,1995-12-30,0,2,5,8,9,4,7,7,10,-2,-2,1,-1,0,7.0,1.0,6.0,5
16255,16255,1995-96,1995,1996,Tottenham,Man United,Win,Home,1996-01-01,3,1,2,5,8,6,6,6,7,-5,-4,-1,1,1,7.0,2.0,5.0,6
16256,16256,1995-96,1995,1996,Tottenham,Man City,Win,Home,1996-01-13,3,3,4,5,8,3,3,4,4,0,1,1,4,1,7.0,17.0,-10.0,6
16257,16257,1995-96,1995,1996,Tottenham,Aston Villa,Loss,Away,1996-01-21,0,6,6,7,8,4,4,7,8,2,2,0,0,0,7.0,18.0,-11.0,6
16258,16258,1995-96,1995,1996,Tottenham,Liverpool,Draw,Away,1996-02-03,1,3,6,6,7,6,7,10,11,-3,-1,-4,-4,0,7.0,4.0,3.0,7
16259,16259,1995-96,1995,1996,Tottenham,West Ham,Loss,Home,1996-02-12,0,1,4,7,7,6,6,6,6,-5,-2,1,1,1,7.0,14.0,-7.0,7
16260,16260,1995-96,1995,1996,Tottenham,Sheffield Weds,Win,Home,1996-02-24,3,1,1,4,7,3,3,3,4,-2,-2,1,3,1,7.0,13.0,-6.0,7
16261,16261,1995-96,1995,1996,Tottenham,Southampton,Win,Home,1996-03-02,3,3,4,4,7,1,2,5,5,2,2,-1,2,1,7.0,10.0,-3.0,8
16262,16262,1995-96,1995,1996,Tottenham,Blackburn,Loss,Home,1996-03-16,0,6,6,7,7,4,4,4,4,2,2,3,3,1,7.0,1.0,6.0,8
16263,16263,1995-96,1995,1996,Tottenham,Bolton,Win,Away,1996-03-20,3,3,6,6,7,6,6,9,9,-3,0,-3,-2,0,7.0,21.0,-14.0,8
16264,16264,1995-96,1995,1996,Tottenham,Man United,Loss,Away,1996-03-24,0,3,6,9,9,4,7,10,13,-1,-1,-1,-4,0,7.0,2.0,5.0,8
16265,16265,1995-96,1995,1996,Tottenham,Coventry,Win,Home,1996-03-30,3,3,3,6,9,0,1,2,3,3,2,4,6,1,7.0,16.0,-9.0,8
16266,16266,1995-96,1995,1996,Tottenham,Nott'm Forest,Loss,Away,1996-04-06,0,3,6,6,9,3,4,7,7,0,2,-1,2,0,7.0,3.0,4.0,9
16267,16267,1995-96,1995,1996,Tottenham,Middlesbrough,Draw,Home,1996-04-08,1,3,3,6,6,6,7,8,8,-3,-4,-2,-2,1,7.0,21.0,-14.0,9
16268,16268,1995-96,1995,1996,Tottenham,Arsenal,Draw,Away,1996-04-15,1,1,4,4,7,3,6,6,9,-2,-2,-2,-2,0,7.0,12.0,-5.0,9
16269,16269,1995-96,1995,1996,Tottenham,Chelsea,Draw,Home,1996-04-27,1,2,2,5,5,4,4,4,5,-2,-2,1,0,1,7.0,11.0,-4.0,9
16270,16270,1995-96,1995,1996,Tottenham,Leeds,Win,Away,1996-05-02,3,2,3,3,6,0,0,0,0,2,3,3,6,0,7.0,5.0,2.0,10
16271,16271,1995-96,1995,1996,Tottenham,Newcastle,Draw,Away,1996-05-04,1,4,5,6,6,4,7,10,10,0,-2,-4,-4,0,7.0,6.0,1.0,10
16272,16272,1996-97,1996,1997,Tottenham,Blackburn,Win,Away,1996-08-17,3,4,5,6,7,4,7,10,13,0,-2,-4,-6,0,8.0,7.0,1.0,1
16273,16273,1996-97,1996,1997,Tottenham,Derby,Draw,Home,1996-08-21,1,4,7,8,9,1,1,1,1,3,6,7,8,1,8.0,21.0,-13.0,1
16274,16274,1996-97,1996,1997,Tottenham,Everton,Draw,Home,1996-08-24,1,4,5,8,9,4,7,10,11,0,-2,-2,-2,1,8.0,6.0,2.0,1
16275,16275,1996-97,1996,1997,Tottenham,Wimbledon,Loss,Away,1996-09-04,0,2,5,6,9,0,0,1,1,2,5,5,8,0,8.0,14.0,-6.0,2
16276,16276,1996-97,1996,1997,Tottenham,Newcastle,Loss,Home,1996-09-07,0,1,2,5,6,3,6,6,7,-2,-4,-1,-1,1,8.0,2.0,6.0,2
16277,16277,1996-97,1996,1997,Tottenham,Southampton,Win,Away,1996-09-14,3,0,1,2,5,1,1,1,2,-1,0,1,3,0,8.0,17.0,-9.0,2
16278,16278,1996-97,1996,1997,Tottenham,Leicester,Loss,Home,1996-09-22,0,3,3,4,5,1,1,1,4,2,2,3,1,1,8.0,21.0,-13.0,2
16279,16279,1996-97,1996,1997,Tottenham,Man United,Loss,Away,1996-09-29,0,3,3,3,4,4,7,8,9,-1,-4,-5,-5,0,8.0,1.0,7.0,2
16280,16280,1996-97,1996,1997,Tottenham,Aston Villa,Win,Home,1996-10-12,3,0,3,3,3,1,2,3,6,-1,1,0,-3,1,8.0,4.0,4.0,3
16281,16281,1996-97,1996,1997,Tottenham,Middlesbrough,Win,Away,1996-10-19,3,3,3,6,6,1,1,4,7,2,2,2,-1,0,8.0,12.0,-4.0,3
16282,16282,1996-97,1996,1997,Tottenham,Chelsea,Loss,Away,1996-10-26,0,6,6,6,9,3,4,4,5,3,2,2,4,0,8.0,11.0,-3.0,3
16283,16283,1996-97,1996,1997,Tottenham,West Ham,Win,Home,1996-11-02,3,3,6,6,6,6,6,6,9,-3,0,0,-3,1,8.0,10.0,-2.0,4
16284,16284,1996-97,1996,1997,Tottenham,Sunderland,Win,Home,1996-11-16,3,3,6,9,9,3,3,4,4,0,3,5,5,1,8.0,21.0,-13.0,4
16285,16285,1996-97,1996,1997,Tottenham,Arsenal,Loss,Away,1996-11-24,0,6,6,9,12,1,4,5,8,5,2,4,4,0,8.0,5.0,3.0,4
16286,16286,1996-97,1996,1997,Tottenham,Liverpool,Loss,Home,1996-12-02,0,3,6,6,9,2,5,5,8,1,1,1,1,1,8.0,3.0,5.0,5
16287,16287,1996-97,1996,1997,Tottenham,Coventry,Win,Away,1996-12-07,3,0,3,6,6,0,1,2,3,0,2,4,3,0,8.0,16.0,-8.0,5
16288,16288,1996-97,1996,1997,Tottenham,Leeds,Draw,Away,1996-12-14,1,3,3,6,9,4,7,7,10,-1,-4,-1,-1,0,8.0,13.0,-5.0,5
16289,16289,1996-97,1996,1997,Tottenham,Sheffield Weds,Draw,Home,1996-12-21,1,4,4,4,7,4,5,6,9,0,-1,-2,-2,1,8.0,15.0,-7.0,5
16290,16290,1996-97,1996,1997,Tottenham,Southampton,Win,Home,1996-12-26,3,2,5,5,5,3,3,3,3,-1,2,2,2,1,8.0,17.0,-9.0,5
16291,16291,1996-97,1996,1997,Tottenham,Newcastle,Loss,Away,1996-12-28,0,4,5,8,8,1,1,2,2,3,4,6,6,0,8.0,2.0,6.0,5
16292,16292,1996-97,1996,1997,Tottenham,Man United,Loss,Home,1997-01-12,0,3,4,5,8,4,7,10,11,-1,-3,-5,-3,1,8.0,1.0,7.0,6
16293,16293,1996-97,1996,1997,Tottenham,Nott'm Forest,Loss,Away,1997-01-19,0,0,3,4,5,6,7,7,10,-6,-4,-3,-5,0,8.0,9.0,-1.0,6
16294,16294,1996-97,1996,1997,Tottenham,Blackburn,Win,Home,1997-01-29,3,0,0,3,4,4,7,8,11,-4,-7,-5,-7,1,8.0,7.0,1.0,6
16295,16295,1996-97,1996,1997,Tottenham,Chelsea,Loss,Home,1997-02-01,0,3,3,3,6,3,6,7,10,0,-3,-4,-4,1,8.0,11.0,-3.0,7
16296,16296,1996-97,1996,1997,Tottenham,Arsenal,Draw,Home,1997-02-15,1,3,3,3,3,4,7,7,10,-1,-4,-4,-7,1,8.0,5.0,3.0,7
16297,16297,1996-97,1996,1997,Tottenham,West Ham,Loss,Away,1997-02-24,0,1,4,4,4,0,0,0,1,1,4,4,3,0,8.0,10.0,-2.0,7
16298,16298,1996-97,1996,1997,Tottenham,Nott'm Forest,Loss,Home,1997-03-01,0,1,1,4,4,1,1,4,7,0,0,0,-3,1,8.0,9.0,-1.0,8
16299,16299,1996-97,1996,1997,Tottenham,Sunderland,Win,Away,1997-03-04,3,0,1,1,4,0,0,1,2,0,1,0,2,0,8.0,21.0,-13.0,8
16300,16300,1996-97,1996,1997,Tottenham,Leeds,Win,Home,1997-03-15,3,3,3,4,4,4,7,10,10,-1,-4,-6,-6,1,8.0,13.0,-5.0,8
16301,16301,1996-97,1996,1997,Tottenham,Leicester,Draw,Away,1997-03-19,1,6,6,6,7,1,4,7,10,5,2,-1,-3,0,8.0,21.0,-13.0,8
16302,16302,1996-97,1996,1997,Tottenham,Derby,Loss,Away,1997-03-22,0,4,7,7,7,0,3,3,4,4,4,4,3,0,8.0,21.0,-13.0,8
16303,16303,1996-97,1996,1997,Tottenham,Wimbledon,Win,Home,1997-04-05,3,1,4,7,7,2,2,3,3,-1,2,4,4,1,8.0,14.0,-6.0,9
16304,16304,1996-97,1996,1997,Tottenham,Sheffield Weds,Loss,Away,1997-04-09,0,3,4,7,10,1,4,7,10,2,0,0,0,0,8.0,15.0,-7.0,9
16305,16305,1996-97,1996,1997,Tottenham,Everton,Loss,Away,1997-04-12,0,3,3,4,7,1,1,4,4,2,2,0,3,0,8.0,6.0,2.0,9
16306,16306,1996-97,1996,1997,Tottenham,Aston Villa,Draw,Away,1997-04-19,1,0,3,3,4,3,6,9,10,-3,-3,-6,-6,0,8.0,4.0,4.0,9
16307,16307,1996-97,1996,1997,Tottenham,Middlesbrough,Win,Home,1997-04-24,3,1,1,4,4,1,2,5,8,0,-1,-1,-4,1,8.0,12.0,-4.0,9
16308,16308,1996-97,1996,1997,Tottenham,Liverpool,Loss,Away,1997-05-03,0,4,4,4,7,1,4,4,7,3,0,0,0,0,8.0,3.0,5.0,10
16309,16309,1996-97,1996,1997,Tottenham,Coventry,Loss,Home,1997-05-11,0,3,4,4,4,1,2,5,8,2,2,-1,-4,1,8.0,16.0,-8.0,10
16310,16310,1997-98,1997,1998,Tottenham,Man United,Loss,Home,1997-08-10,0,0,3,4,4,4,5,6,9,-4,-2,-2,-5,1,10.0,1.0,9.0,1
16311,16311,1997-98,1997,1998,Tottenham,West Ham,Loss,Away,1997-08-13,0,0,0,3,4,3,4,7,10,-3,-4,-4,-6,0,10.0,14.0,-4.0,1
16312,16312,1997-98,1997,1998,Tottenham,Derby,Win,Home,1997-08-23,3,0,0,0,3,0,3,4,4,0,-3,-4,-1,1,10.0,12.0,-2.0,1
16313,16313,1997-98,1997,1998,Tottenham,Aston Villa,Win,Home,1997-08-27,3,3,3,3,3,0,0,3,3,3,3,0,0,1,10.0,5.0,5.0,1
16314,16314,1997-98,1997,1998,Tottenham,Arsenal,Draw,Away,1997-08-30,1,6,6,6,6,4,7,8,11,2,-1,-2,-5,0,10.0,3.0,7.0,1
16315,16315,1997-98,1997,1998,Tottenham,Leicester,Loss,Away,1997-09-13,0,4,7,7,7,1,2,5,8,3,5,2,-1,0,10.0,9.0,1.0,2
16316,16316,1997-98,1997,1998,Tottenham,Blackburn,Draw,Home,1997-09-20,1,1,4,7,7,3,6,7,10,-2,-2,0,-3,1,10.0,13.0,-3.0,2
16317,16317,1997-98,1997,1998,Tottenham,Bolton,Draw,Away,1997-09-23,1,1,2,5,8,1,2,2,3,0,0,3,5,0,10.0,21.0,-11.0,2
16318,16318,1997-98,1997,1998,Tottenham,Wimbledon,Draw,Home,1997-09-27,1,2,2,3,6,3,6,6,6,-1,-4,-3,0,1,10.0,8.0,2.0,2
16319,16319,1997-98,1997,1998,Tottenham,Newcastle,Loss,Away,1997-10-04,0,2,3,3,4,3,6,6,9,-1,-3,-3,-5,0,10.0,2.0,8.0,3
16320,16320,1997-98,1997,1998,Tottenham,Sheffield Weds,Win,Home,1997-10-19,3,1,2,3,3,4,4,5,5,-3,-2,-2,-2,1,10.0,7.0,3.0,3
16321,16321,1997-98,1997,1998,Tottenham,Southampton,Loss,Away,1997-10-25,0,3,4,5,6,3,3,3,4,0,1,2,2,0,10.0,16.0,-6.0,3
16322,16322,1997-98,1997,1998,Tottenham,Leeds,Loss,Home,1997-11-01,0,3,3,4,5,3,4,7,10,0,-1,-3,-5,1,10.0,11.0,-1.0,4
16323,16323,1997-98,1997,1998,Tottenham,Liverpool,Loss,Away,1997-11-08,0,0,3,3,4,4,4,7,7,-4,-1,-4,-3,0,10.0,4.0,6.0,4
16324,16324,1997-98,1997,1998,Tottenham,Crystal Palace,Loss,Home,1997-11-24,0,0,0,3,3,4,5,5,6,-4,-5,-2,-3,1,10.0,21.0,-11.0,4
16325,16325,1997-98,1997,1998,Tottenham,Everton,Win,Away,1997-11-29,3,0,0,0,3,0,0,0,1,0,0,0,2,0,10.0,15.0,-5.0,4
16326,16326,1997-98,1997,1998,Tottenham,Chelsea,Loss,Home,1997-12-06,0,3,3,3,3,6,6,9,12,-3,-3,-6,-9,1,10.0,6.0,4.0,5
16327,16327,1997-98,1997,1998,Tottenham,Coventry,Loss,Away,1997-12-13,0,3,3,3,3,0,0,1,4,3,3,2,-1,0,10.0,17.0,-7.0,5
16328,16328,1997-98,1997,1998,Tottenham,Barnsley,Win,Home,1997-12-20,3,0,3,3,3,1,1,4,4,-1,2,-1,-1,1,10.0,21.0,-11.0,5
16329,16329,1997-98,1997,1998,Tottenham,Aston Villa,Loss,Away,1997-12-26,0,3,3,6,6,1,4,4,7,2,-1,2,-1,0,10.0,5.0,5.0,5
16330,16330,1997-98,1997,1998,Tottenham,Arsenal,Draw,Home,1997-12-28,1,3,3,3,6,3,6,6,6,0,-3,-3,0,1,10.0,3.0,7.0,5
16331,16331,1997-98,1997,1998,Tottenham,Man United,Loss,Away,1998-01-10,0,1,4,4,4,3,6,9,12,-2,-2,-5,-8,0,10.0,1.0,9.0,6
16332,16332,1997-98,1997,1998,Tottenham,West Ham,Win,Home,1998-01-17,3,1,1,4,4,6,9,9,12,-5,-8,-5,-8,1,10.0,14.0,-4.0,6
16333,16333,1997-98,1997,1998,Tottenham,Derby,Loss,Away,1998-01-31,0,3,4,4,7,4,4,7,8,-1,0,-3,-1,0,10.0,12.0,-2.0,6
16334,16334,1997-98,1997,1998,Tottenham,Blackburn,Win,Away,1998-02-07,3,3,3,4,4,4,4,5,6,-1,-1,-1,-2,0,10.0,13.0,-3.0,7
16335,16335,1997-98,1997,1998,Tottenham,Leicester,Draw,Home,1998-02-14,1,3,6,6,7,6,7,8,9,-3,-1,-2,-2,1,10.0,9.0,1.0,7
16336,16336,1997-98,1997,1998,Tottenham,Sheffield Weds,Loss,Away,1998-02-21,0,4,4,7,7,1,2,5,8,3,2,2,-1,0,10.0,7.0,3.0,7
16337,16337,1997-98,1997,1998,Tottenham,Bolton,Win,Home,1998-03-01,3,1,4,4,7,2,2,2,3,-1,2,2,4,1,10.0,21.0,-11.0,8
16338,16338,1997-98,1997,1998,Tottenham,Leeds,Loss,Away,1998-03-04,0,3,4,7,7,1,1,4,4,2,3,3,3,0,10.0,11.0,-1.0,8
16339,16339,1997-98,1997,1998,Tottenham,Liverpool,Draw,Home,1998-03-14,1,3,3,4,7,3,4,5,5,0,-1,-1,2,1,10.0,4.0,6.0,8
16340,16340,1997-98,1997,1998,Tottenham,Crystal Palace,Win,Away,1998-03-28,3,1,4,4,5,3,3,3,3,-2,1,1,2,0,10.0,21.0,-11.0,8
16341,16341,1997-98,1997,1998,Tottenham,Everton,Draw,Home,1998-04-04,1,4,4,7,7,3,3,4,5,1,1,3,2,1,10.0,15.0,-5.0,9
16342,16342,1997-98,1997,1998,Tottenham,Chelsea,Loss,Away,1998-04-11,0,4,5,5,8,3,3,6,6,1,2,-1,2,0,10.0,6.0,4.0,9
16343,16343,1997-98,1997,1998,Tottenham,Coventry,Draw,Home,1998-04-13,1,1,4,5,5,1,4,5,8,0,0,0,-3,1,10.0,17.0,-7.0,9
16344,16344,1997-98,1997,1998,Tottenham,Barnsley,Draw,Away,1998-04-18,1,1,2,5,6,3,3,3,3,-2,-1,2,3,0,10.0,21.0,-11.0,9
16345,16345,1997-98,1997,1998,Tottenham,Newcastle,Win,Home,1998-04-25,3,2,2,3,6,4,4,5,5,-2,-2,-2,1,1,10.0,2.0,8.0,9
16346,16346,1997-98,1997,1998,Tottenham,Wimbledon,Win,Away,1998-05-02,3,4,5,5,6,2,2,3,6,2,3,2,0,0,10.0,8.0,2.0,10
16347,16347,1997-98,1997,1998,Tottenham,Southampton,Draw,Home,1998-05-10,1,6,7,8,8,3,3,4,4,3,4,4,4,1,10.0,16.0,-6.0,10
16348,16348,1998-99,1998,1999,Tottenham,Wimbledon,Loss,Away,1998-08-15,0,4,7,8,9,1,2,3,3,3,5,5,6,0,14.0,15.0,-1.0,1
16349,16349,1998-99,1998,1999,Tottenham,Sheffield Weds,Loss,Home,1998-08-22,0,1,4,7,8,0,0,3,3,1,4,4,5,1,14.0,16.0,-2.0,1
16350,16350,1998-99,1998,1999,Tottenham,Everton,Win,Away,1998-08-29,3,0,1,4,7,1,2,2,2,-1,-1,2,5,0,14.0,17.0,-3.0,1
16351,16351,1998-99,1998,1999,Tottenham,Blackburn,Win,Home,1998-09-09,3,3,3,4,7,3,4,7,7,0,-1,-3,0,1,14.0,6.0,8.0,2
16352,16352,1998-99,1998,1999,Tottenham,Middlesbrough,Loss,Home,1998-09-13,0,6,6,6,7,4,4,5,6,2,2,1,1,1,14.0,21.0,-7.0,2
16353,16353,1998-99,1998,1999,Tottenham,Southampton,Draw,Away,1998-09-19,1,3,6,6,6,0,0,0,0,3,6,6,6,0,14.0,12.0,2.0,2
16354,16354,1998-99,1998,1999,Tottenham,Leeds,Draw,Home,1998-09-26,1,1,4,7,7,2,5,6,9,-1,-1,1,-2,1,14.0,5.0,9.0,2
16355,16355,1998-99,1998,1999,Tottenham,Derby,Win,Away,1998-10-03,3,2,2,5,8,3,6,9,10,-1,-4,-4,-2,0,14.0,9.0,5.0,3
16356,16356,1998-99,1998,1999,Tottenham,Leicester,Loss,Away,1998-10-19,0,4,5,5,8,4,4,5,5,0,1,0,3,0,14.0,10.0,4.0,3
16357,16357,1998-99,1998,1999,Tottenham,Newcastle,Win,Home,1998-10-24,3,3,4,5,5,3,6,9,12,0,-2,-4,-7,1,14.0,13.0,1.0,3
16358,16358,1998-99,1998,1999,Tottenham,Charlton,Draw,Home,1998-11-02,1,3,6,7,8,3,6,7,8,0,0,0,0,1,14.0,21.0,-7.0,4
16359,16359,1998-99,1998,1999,Tottenham,Aston Villa,Loss,Away,1998-11-07,0,4,4,7,8,2,5,8,9,2,-1,-1,-1,0,14.0,7.0,7.0,4
16360,16360,1998-99,1998,1999,Tottenham,Arsenal,Draw,Away,1998-11-14,1,1,4,4,7,6,9,10,13,-5,-5,-6,-6,0,14.0,1.0,13.0,4
16361,16361,1998-99,1998,1999,Tottenham,Nott'm Forest,Win,Home,1998-11-21,3,1,2,5,5,1,2,2,3,0,0,3,2,1,14.0,21.0,-7.0,4
16362,16362,1998-99,1998,1999,Tottenham,West Ham,Loss,Away,1998-11-28,0,4,4,5,8,6,7,10,10,-2,-3,-5,-2,0,14.0,8.0,6.0,4
16363,16363,1998-99,1998,1999,Tottenham,Liverpool,Win,Home,1998-12-05,3,3,4,4,5,6,6,6,6,-3,-2,-2,-1,1,14.0,3.0,11.0,5
16364,16364,1998-99,1998,1999,Tottenham,Man United,Draw,Home,1998-12-12,1,3,6,7,7,4,4,7,8,-1,2,0,-1,1,14.0,2.0,12.0,5
16365,16365,1998-99,1998,1999,Tottenham,Chelsea,Loss,Away,1998-12-19,0,4,4,7,8,2,5,6,7,2,-1,1,1,0,14.0,4.0,10.0,5
16366,16366,1998-99,1998,1999,Tottenham,Coventry,Draw,Away,1998-12-26,1,1,4,4,7,1,1,2,2,0,3,2,5,0,14.0,11.0,3.0,5
16367,16367,1998-99,1998,1999,Tottenham,Everton,Win,Home,1998-12-28,3,1,2,5,5,1,4,5,8,0,-2,0,-3,1,14.0,17.0,-3.0,5
16368,16368,1998-99,1998,1999,Tottenham,Sheffield Weds,Draw,Away,1999-01-09,1,4,4,5,8,0,0,3,6,4,4,2,2,0,14.0,16.0,-2.0,6
16369,16369,1998-99,1998,1999,Tottenham,Wimbledon,Draw,Home,1999-01-16,1,4,5,5,6,4,7,7,10,0,-2,-2,-4,1,14.0,15.0,-1.0,6
16370,16370,1998-99,1998,1999,Tottenham,Blackburn,Draw,Away,1999-01-30,1,2,5,6,6,3,4,7,8,-1,1,-1,-2,0,14.0,6.0,8.0,6
16371,16371,1998-99,1998,1999,Tottenham,Coventry,Draw,Home,1999-02-06,1,2,3,6,7,3,6,6,7,-1,-3,0,0,1,14.0,11.0,3.0,7
16372,16372,1998-99,1998,1999,Tottenham,Middlesbrough,Draw,Away,1999-02-20,1,2,3,4,7,0,1,1,2,2,2,3,5,0,14.0,21.0,-7.0,7
16373,16373,1998-99,1998,1999,Tottenham,Derby,Draw,Home,1999-02-27,1,2,3,4,5,3,3,6,9,-1,0,-2,-4,1,14.0,9.0,5.0,7
16374,16374,1998-99,1998,1999,Tottenham,Southampton,Win,Home,1999-03-02,3,2,3,4,5,3,3,6,6,-1,0,-2,-1,1,14.0,12.0,2.0,8
16375,16375,1998-99,1998,1999,Tottenham,Leeds,Loss,Away,1999-03-10,0,4,5,6,7,6,9,9,9,-2,-4,-3,-2,0,14.0,5.0,9.0,8
16376,16376,1998-99,1998,1999,Tottenham,Aston Villa,Win,Home,1999-03-13,3,3,4,5,6,0,1,1,1,3,3,4,5,1,14.0,7.0,7.0,8
16377,16377,1998-99,1998,1999,Tottenham,Leicester,Loss,Home,1999-04-03,0,3,6,7,8,4,4,4,4,-1,2,3,4,1,14.0,10.0,4.0,9
16378,16378,1998-99,1998,1999,Tottenham,Newcastle,Draw,Away,1999-04-05,1,3,3,6,7,3,3,6,7,0,0,0,0,0,14.0,13.0,1.0,9
16379,16379,1998-99,1998,1999,Tottenham,Nott'm Forest,Win,Away,1999-04-17,3,1,4,4,7,1,1,1,4,0,3,3,3,0,14.0,21.0,-7.0,9
16380,16380,1998-99,1998,1999,Tottenham,Charlton,Win,Away,1999-04-20,3,4,4,7,7,1,4,4,5,3,0,3,2,0,14.0,21.0,-7.0,9
16381,16381,1998-99,1998,1999,Tottenham,West Ham,Loss,Home,1999-04-24,0,6,7,7,10,4,4,5,8,2,3,2,2,1,14.0,8.0,6.0,9
16382,16382,1998-99,1998,1999,Tottenham,Liverpool,Loss,Away,1999-05-01,0,3,6,7,7,3,3,4,5,0,3,3,2,0,14.0,3.0,11.0,10
16383,16383,1998-99,1998,1999,Tottenham,Arsenal,Loss,Home,1999-05-05,0,0,3,6,7,6,9,12,13,-6,-6,-6,-6,1,14.0,1.0,13.0,10
16384,16384,1998-99,1998,1999,Tottenham,Chelsea,Draw,Home,1999-05-10,1,0,0,3,6,6,7,8,9,-6,-7,-5,-3,1,14.0,4.0,10.0,10
16385,16385,1998-99,1998,1999,Tottenham,Man United,Loss,Away,1999-05-16,0,1,1,1,4,4,5,8,9,-3,-4,-7,-5,0,14.0,2.0,12.0,10
16386,16386,1999-00,1999,2000,Tottenham,West Ham,Loss,Away,1999-08-07,0,1,1,1,1,3,3,6,9,-2,-2,-5,-8,0,11.0,5.0,6.0,1
16387,16387,1999-00,1999,2000,Tottenham,Newcastle,Win,Home,1999-08-09,3,0,1,1,1,1,1,2,3,-1,0,-1,-2,1,11.0,13.0,-2.0,1
16388,16388,1999-00,1999,2000,Tottenham,Everton,Win,Home,1999-08-14,3,3,3,4,4,1,1,4,4,2,2,0,0,1,11.0,14.0,-3.0,1
16389,16389,1999-00,1999,2000,Tottenham,Sheffield Weds,Win,Away,1999-08-21,3,6,6,6,7,1,1,4,7,5,5,2,0,0,11.0,12.0,-1.0,1
16390,16390,1999-00,1999,2000,Tottenham,Leeds,Loss,Home,1999-08-28,0,6,9,9,9,3,3,6,7,3,6,3,2,1,11.0,4.0,7.0,1
16391,16391,1999-00,1999,2000,Tottenham,Bradford,Draw,Away,1999-09-12,1,3,6,9,9,0,0,1,4,3,6,8,5,0,11.0,21.0,-10.0,2
16392,16392,1999-00,1999,2000,Tottenham,Coventry,Win,Home,1999-09-19,3,1,4,7,10,1,1,4,5,0,3,3,5,1,11.0,15.0,-4.0,2
16393,16393,1999-00,1999,2000,Tottenham,Wimbledon,Draw,Away,1999-09-26,1,4,4,7,10,2,2,2,3,2,2,5,7,0,11.0,16.0,-5.0,2
16394,16394,1999-00,1999,2000,Tottenham,Leicester,Loss,Home,1999-10-03,0,4,5,5,8,4,4,7,10,0,1,-2,-2,1,11.0,10.0,1.0,3
16395,16395,1999-00,1999,2000,Tottenham,Derby,Win,Away,1999-10-16,3,1,4,5,5,1,1,2,5,0,3,3,0,0,11.0,8.0,3.0,3
16396,16396,1999-00,1999,2000,Tottenham,Man United,Win,Home,1999-10-23,3,3,4,7,8,3,4,5,8,0,0,2,0,1,11.0,1.0,10.0,3
16397,16397,1999-00,1999,2000,Tottenham,Sunderland,Loss,Away,1999-10-31,0,6,6,7,10,4,7,10,13,2,-1,-3,-3,0,11.0,21.0,-10.0,3
16398,16398,1999-00,1999,2000,Tottenham,Arsenal,Win,Home,1999-11-07,3,3,6,6,7,4,7,7,10,-1,-1,-1,-3,1,11.0,2.0,9.0,4
16399,16399,1999-00,1999,2000,Tottenham,Southampton,Win,Away,1999-11-20,3,3,6,9,9,4,5,5,6,-1,1,4,3,0,11.0,17.0,-6.0,4
16400,16400,1999-00,1999,2000,Tottenham,Newcastle,Loss,Away,1999-11-28,0,6,6,9,12,2,3,6,6,4,3,3,6,0,11.0,13.0,-2.0,4
16401,16401,1999-00,1999,2000,Tottenham,West Ham,Draw,Home,1999-12-06,1,3,6,6,9,6,7,7,7,-3,-1,-1,2,1,11.0,5.0,6.0,5
16402,16402,1999-00,1999,2000,Tottenham,Middlesbrough,Loss,Away,1999-12-18,0,1,4,7,7,2,2,3,6,-1,2,4,1,0,11.0,9.0,2.0,5
16403,16403,1999-00,1999,2000,Tottenham,Watford,Win,Home,1999-12-26,3,1,1,4,7,0,0,1,2,1,1,3,5,1,11.0,21.0,-10.0,5
16404,16404,1999-00,1999,2000,Tottenham,Aston Villa,Draw,Away,1999-12-29,1,3,4,4,7,6,6,7,7,-3,-2,-3,0,0,11.0,6.0,5.0,5
16405,16405,1999-00,1999,2000,Tottenham,Liverpool,Win,Home,2000-01-03,3,4,4,5,5,4,7,10,10,0,-3,-5,-5,1,11.0,7.0,4.0,6
16406,16406,1999-00,1999,2000,Tottenham,Chelsea,Loss,Away,2000-01-12,0,4,7,7,8,2,5,8,8,2,2,-1,0,0,11.0,3.0,8.0,6
16407,16407,1999-00,1999,2000,Tottenham,Everton,Draw,Away,2000-01-15,1,3,4,7,7,2,5,8,8,1,-1,-1,-1,0,11.0,14.0,-3.0,6
16408,16408,1999-00,1999,2000,Tottenham,Sheffield Weds,Loss,Home,2000-01-22,0,1,4,5,8,4,4,7,7,-3,0,-2,1,1,11.0,12.0,-1.0,6
16409,16409,1999-00,1999,2000,Tottenham,Chelsea,Loss,Home,2000-02-05,0,1,1,4,5,2,5,6,7,-1,-4,-2,-2,1,11.0,3.0,8.0,7
16410,16410,1999-00,1999,2000,Tottenham,Leeds,Loss,Away,2000-02-12,0,0,1,1,4,3,3,3,6,-3,-2,-2,-2,0,11.0,4.0,7.0,7
16411,16411,1999-00,1999,2000,Tottenham,Coventry,Win,Away,2000-02-26,3,0,0,1,1,3,3,4,7,-3,-3,-3,-6,0,11.0,15.0,-4.0,7
16412,16412,1999-00,1999,2000,Tottenham,Bradford,Draw,Home,2000-03-04,1,3,3,3,4,1,4,7,7,2,-1,-4,-3,1,11.0,21.0,-10.0,8
16413,16413,1999-00,1999,2000,Tottenham,Southampton,Win,Home,2000-03-11,3,4,4,4,4,1,1,4,7,3,3,0,-3,1,11.0,17.0,-6.0,8
16414,16414,1999-00,1999,2000,Tottenham,Arsenal,Loss,Away,2000-03-19,0,4,7,7,7,1,4,4,4,3,3,3,3,0,11.0,2.0,9.0,8
16415,16415,1999-00,1999,2000,Tottenham,Watford,Draw,Away,2000-03-25,1,3,4,7,7,3,3,3,4,0,1,4,3,0,11.0,21.0,-10.0,8
16416,16416,1999-00,1999,2000,Tottenham,Middlesbrough,Loss,Home,2000-04-03,0,1,4,5,8,4,7,8,9,-3,-3,-3,-1,1,11.0,9.0,2.0,9
16417,16417,1999-00,1999,2000,Tottenham,Liverpool,Loss,Away,2000-04-09,0,1,1,4,5,6,9,10,11,-5,-8,-6,-6,0,11.0,7.0,4.0,9
16418,16418,1999-00,1999,2000,Tottenham,Aston Villa,Loss,Home,2000-04-15,0,0,1,1,4,6,9,9,10,-6,-8,-8,-6,1,11.0,6.0,5.0,9
16419,16419,1999-00,1999,2000,Tottenham,Leicester,Win,Away,2000-04-19,3,0,0,1,1,4,4,7,7,-4,-4,-6,-6,0,11.0,10.0,1.0,9
16420,16420,1999-00,1999,2000,Tottenham,Wimbledon,Win,Home,2000-04-22,3,3,3,3,4,0,0,0,0,3,3,3,4,1,11.0,16.0,-5.0,9
16421,16421,1999-00,1999,2000,Tottenham,Derby,Draw,Home,2000-04-29,1,6,6,6,6,4,4,5,8,2,2,1,-2,1,11.0,8.0,3.0,9
16422,16422,1999-00,1999,2000,Tottenham,Man United,Loss,Away,2000-05-06,0,4,7,7,7,6,9,12,15,-2,-2,-5,-8,0,11.0,1.0,10.0,10
16423,16423,1999-00,1999,2000,Tottenham,Sunderland,Win,Home,2000-05-14,3,1,4,7,7,4,4,7,7,-3,0,0,0,1,11.0,21.0,-10.0,10
16424,16424,2000-01,2000,2001,Tottenham,Ipswich,Win,Home,2000-08-19,3,3,4,7,10,0,3,3,4,3,1,4,6,1,10.0,21.0,-11.0,1
16425,16425,2000-01,2000,2001,Tottenham,Middlesbrough,Draw,Away,2000-08-22,1,6,6,7,10,6,7,8,11,0,-1,-1,-1,0,10.0,12.0,-2.0,1
16426,16426,2000-01,2000,2001,Tottenham,Newcastle,Loss,Away,2000-08-26,0,4,7,7,8,3,6,7,8,1,1,0,0,0,10.0,11.0,-1.0,1
16427,16427,2000-01,2000,2001,Tottenham,Everton,Win,Home,2000-09-05,3,1,4,7,7,4,4,4,5,-3,0,3,2,1,10.0,13.0,-3.0,2
16428,16428,2000-01,2000,2001,Tottenham,West Ham,Win,Home,2000-09-11,3,3,4,7,10,2,2,2,3,1,2,5,7,1,10.0,9.0,1.0,2
16429,16429,2000-01,2000,2001,Tottenham,Charlton,Loss,Away,2000-09-16,0,6,6,7,10,2,2,2,5,4,4,5,5,0,10.0,21.0,-11.0,2
16430,16430,2000-01,2000,2001,Tottenham,Man City,Draw,Home,2000-09-23,1,3,6,6,7,1,4,4,7,2,2,2,0,1,10.0,21.0,-11.0,2
16431,16431,2000-01,2000,2001,Tottenham,Leeds,Loss,Away,2000-09-30,0,1,4,7,7,1,2,2,5,0,2,5,2,0,10.0,3.0,7.0,2
16432,16432,2000-01,2000,2001,Tottenham,Coventry,Loss,Away,2000-10-14,0,1,1,4,7,1,1,2,2,0,0,2,5,0,10.0,14.0,-4.0,3
16433,16433,2000-01,2000,2001,Tottenham,Derby,Win,Home,2000-10-21,3,0,1,1,4,0,1,1,2,0,0,0,2,1,10.0,16.0,-6.0,3
16434,16434,2000-01,2000,2001,Tottenham,Chelsea,Loss,Away,2000-10-28,0,3,3,4,4,3,6,7,7,0,-3,-3,-3,0,10.0,5.0,5.0,3
16435,16435,2000-01,2000,2001,Tottenham,Sunderland,Win,Home,2000-11-04,3,3,3,3,4,4,7,8,9,-1,-4,-5,-5,1,10.0,7.0,3.0,4
16436,16436,2000-01,2000,2001,Tottenham,Aston Villa,Loss,Away,2000-11-11,0,3,6,6,6,6,7,7,10,-3,-1,-1,-4,0,10.0,6.0,4.0,4
16437,16437,2000-01,2000,2001,Tottenham,Liverpool,Win,Home,2000-11-19,3,3,3,6,6,3,6,9,12,0,-3,-3,-6,1,10.0,4.0,6.0,4
16438,16438,2000-01,2000,2001,Tottenham,Leicester,Win,Home,2000-11-25,3,3,6,6,9,4,7,10,10,-1,-1,-4,-1,1,10.0,8.0,2.0,4
16439,16439,2000-01,2000,2001,Tottenham,Man United,Loss,Away,2000-12-02,0,6,6,9,9,6,9,12,15,0,-3,-3,-6,0,10.0,1.0,9.0,5
16440,16440,2000-01,2000,2001,Tottenham,Bradford,Draw,Away,2000-12-09,1,3,6,6,9,4,4,4,4,-1,2,2,5,0,10.0,17.0,-7.0,5
16441,16441,2000-01,2000,2001,Tottenham,Arsenal,Draw,Home,2000-12-18,1,1,4,7,7,6,6,6,7,-5,-2,1,0,1,10.0,2.0,8.0,5
16442,16442,2000-01,2000,2001,Tottenham,Middlesbrough,Draw,Home,2000-12-23,1,2,2,5,8,3,3,4,4,-1,-1,1,4,1,10.0,12.0,-2.0,5
16443,16443,2000-01,2000,2001,Tottenham,Southampton,Loss,Away,2000-12-27,0,2,3,3,6,1,4,4,4,1,-1,-1,2,0,10.0,15.0,-5.0,5
16444,16444,2000-01,2000,2001,Tottenham,Ipswich,Loss,Away,2000-12-30,0,1,2,3,3,1,4,7,7,0,-2,-4,-4,0,10.0,21.0,-11.0,5
16445,16445,2000-01,2000,2001,Tottenham,Newcastle,Win,Home,2001-01-02,3,0,1,2,3,4,4,7,7,-4,-3,-5,-4,1,10.0,11.0,-1.0,6
16446,16446,2000-01,2000,2001,Tottenham,Everton,Draw,Away,2001-01-13,1,3,3,4,5,0,0,1,1,3,3,3,4,0,10.0,13.0,-3.0,6
16447,16447,2000-01,2000,2001,Tottenham,Southampton,Draw,Home,2001-01-20,1,4,4,4,5,1,4,7,8,3,0,-3,-3,1,10.0,15.0,-5.0,6
16448,16448,2000-01,2000,2001,Tottenham,West Ham,Draw,Away,2001-01-31,1,2,5,5,5,1,1,4,4,1,4,1,1,0,10.0,9.0,1.0,6
16449,16449,2000-01,2000,2001,Tottenham,Charlton,Draw,Home,2001-02-03,1,2,3,6,6,4,5,8,11,-2,-2,-2,-5,1,10.0,21.0,-11.0,7
16450,16450,2000-01,2000,2001,Tottenham,Man City,Win,Away,2001-02-10,3,2,3,4,7,2,3,3,4,0,0,1,3,0,10.0,21.0,-11.0,7
16451,16451,2000-01,2000,2001,Tottenham,Leeds,Loss,Home,2001-02-24,0,4,5,6,7,2,5,8,11,2,0,-2,-4,1,10.0,3.0,7.0,7
16452,16452,2000-01,2000,2001,Tottenham,Derby,Loss,Away,2001-03-03,0,3,4,5,6,4,7,7,8,-1,-3,-2,-2,0,10.0,16.0,-6.0,8
16453,16453,2000-01,2000,2001,Tottenham,Coventry,Win,Home,2001-03-17,3,0,3,4,5,2,3,3,3,-2,0,1,2,1,10.0,14.0,-4.0,8
16454,16454,2000-01,2000,2001,Tottenham,Arsenal,Loss,Away,2001-03-31,0,3,3,6,7,4,4,7,10,-1,-1,-1,-3,0,10.0,2.0,8.0,8
16455,16455,2000-01,2000,2001,Tottenham,Bradford,Win,Home,2001-04-10,3,3,3,3,6,2,2,2,2,1,1,1,4,1,10.0,17.0,-7.0,9
16456,16456,2000-01,2000,2001,Tottenham,Sunderland,Win,Away,2001-04-14,3,3,6,6,6,1,4,5,5,2,2,1,1,0,10.0,7.0,3.0,9
16457,16457,2000-01,2000,2001,Tottenham,Chelsea,Loss,Home,2001-04-17,0,6,6,9,9,6,9,9,12,0,-3,0,-3,1,10.0,5.0,5.0,9
16458,16458,2000-01,2000,2001,Tottenham,Liverpool,Loss,Away,2001-04-22,0,3,6,6,9,3,4,7,8,0,2,-1,1,0,10.0,4.0,6.0,9
16459,16459,2000-01,2000,2001,Tottenham,Aston Villa,Draw,Home,2001-04-28,1,0,3,6,6,2,5,6,9,-2,-2,0,-3,1,10.0,6.0,4.0,9
16460,16460,2000-01,2000,2001,Tottenham,Leicester,Loss,Away,2001-05-05,0,1,1,4,7,0,0,0,0,1,1,4,7,0,10.0,8.0,2.0,10
16461,16461,2000-01,2000,2001,Tottenham,Man United,Win,Home,2001-05-19,3,1,1,1,4,0,3,4,7,1,-2,-3,-3,1,10.0,1.0,9.0,10
16462,16462,2001-02,2001,2002,Tottenham,Aston Villa,Draw,Home,2001-08-18,1,3,4,4,4,3,4,5,6,0,0,-1,-2,1,12.0,8.0,4.0,1
16463,16463,2001-02,2001,2002,Tottenham,Everton,Draw,Away,2001-08-20,1,4,4,5,5,4,4,7,7,0,0,-2,-2,0,12.0,16.0,-4.0,1
16464,16464,2001-02,2001,2002,Tottenham,Blackburn,Loss,Away,2001-08-25,0,2,5,5,6,1,2,3,3,1,3,2,3,0,12.0,21.0,-9.0,1
16465,16465,2001-02,2001,2002,Tottenham,Southampton,Win,Home,2001-09-09,3,1,2,5,5,0,3,6,6,1,-1,-1,-1,1,12.0,10.0,2.0,2
16466,16466,2001-02,2001,2002,Tottenham,Chelsea,Loss,Home,2001-09-16,0,3,4,5,8,4,5,8,9,-1,-1,-3,-1,1,12.0,6.0,6.0,2
16467,16467,2001-02,2001,2002,Tottenham,Sunderland,Win,Away,2001-09-19,3,3,3,4,5,4,5,5,8,-1,-2,-1,-3,0,12.0,7.0,5.0,2
16468,16468,2001-02,2001,2002,Tottenham,Liverpool,Loss,Away,2001-09-22,0,3,6,6,7,3,3,6,9,0,3,0,-2,0,12.0,3.0,9.0,2
16469,16469,2001-02,2001,2002,Tottenham,Man United,Loss,Home,2001-09-29,0,3,3,6,6,3,6,7,8,0,-3,-1,-2,1,12.0,1.0,11.0,2
16470,16470,2001-02,2001,2002,Tottenham,Derby,Win,Home,2001-10-15,3,0,3,3,6,0,0,1,2,0,3,2,4,1,12.0,17.0,-5.0,3
16471,16471,2001-02,2001,2002,Tottenham,Newcastle,Win,Away,2001-10-21,3,3,3,6,6,3,6,6,9,0,-3,0,-3,0,12.0,11.0,1.0,3
16472,16472,2001-02,2001,2002,Tottenham,Middlesbrough,Win,Home,2001-10-27,3,6,6,6,9,4,4,5,8,2,2,1,1,1,12.0,14.0,-2.0,3
16473,16473,2001-02,2001,2002,Tottenham,Leeds,Loss,Away,2001-11-04,0,6,9,9,9,2,3,6,9,4,6,3,0,0,12.0,4.0,8.0,4
16474,16474,2001-02,2001,2002,Tottenham,Arsenal,Draw,Home,2001-11-17,1,3,6,9,9,1,2,5,8,2,4,4,1,1,12.0,2.0,10.0,4
16475,16475,2001-02,2001,2002,Tottenham,West Ham,Win,Away,2001-11-24,3,1,4,7,10,1,4,7,10,0,0,0,0,0,12.0,15.0,-3.0,4
16476,16476,2001-02,2001,2002,Tottenham,Bolton,Win,Home,2001-12-03,3,4,4,7,10,4,5,5,8,0,-1,2,2,1,12.0,21.0,-9.0,5
16477,16477,2001-02,2001,2002,Tottenham,Charlton,Loss,Away,2001-12-08,0,6,7,7,10,4,4,5,8,2,3,2,2,0,12.0,9.0,3.0,5
16478,16478,2001-02,2001,2002,Tottenham,Fulham,Win,Home,2001-12-15,3,3,6,7,7,4,5,6,9,-1,1,1,-2,1,12.0,21.0,-9.0,5
16479,16479,2001-02,2001,2002,Tottenham,Ipswich,Loss,Home,2001-12-22,0,3,6,9,10,0,0,1,1,3,6,8,9,1,12.0,5.0,7.0,5
16480,16480,2001-02,2001,2002,Tottenham,Southampton,Loss,Away,2001-12-26,0,3,3,6,9,3,6,6,9,0,-3,0,0,0,12.0,10.0,2.0,5
16481,16481,2001-02,2001,2002,Tottenham,Aston Villa,Draw,Away,2001-12-29,1,0,3,3,6,0,3,3,4,0,0,0,2,0,12.0,8.0,4.0,5
16482,16482,2001-02,2001,2002,Tottenham,Blackburn,Win,Home,2002-01-01,3,1,1,4,4,0,3,3,3,1,-2,1,1,1,12.0,21.0,-9.0,6
16483,16483,2001-02,2001,2002,Tottenham,Ipswich,Loss,Away,2002-01-12,0,4,4,4,7,3,6,9,9,1,-2,-5,-2,0,12.0,5.0,7.0,6
16484,16484,2001-02,2001,2002,Tottenham,Everton,Draw,Home,2002-01-19,1,3,4,4,4,3,3,3,3,0,1,1,1,1,12.0,16.0,-4.0,6
16485,16485,2001-02,2001,2002,Tottenham,Newcastle,Loss,Home,2002-01-30,0,1,4,5,5,4,4,4,7,-3,0,1,-2,1,12.0,11.0,1.0,6
16486,16486,2001-02,2001,2002,Tottenham,Derby,Loss,Away,2002-02-02,0,1,1,4,5,0,0,0,3,1,1,4,2,0,12.0,17.0,-5.0,7
16487,16487,2001-02,2001,2002,Tottenham,Leicester,Win,Home,2002-02-09,3,0,1,1,4,0,0,1,1,0,1,0,3,1,12.0,13.0,-1.0,7
16488,16488,2001-02,2001,2002,Tottenham,Sunderland,Win,Home,2002-03-02,3,3,3,4,4,3,3,3,4,0,0,1,0,1,12.0,7.0,5.0,8
16489,16489,2001-02,2001,2002,Tottenham,Man United,Loss,Away,2002-03-06,0,6,6,6,7,4,7,10,13,2,-1,-4,-6,0,12.0,1.0,11.0,8
16490,16490,2001-02,2001,2002,Tottenham,Chelsea,Loss,Away,2002-03-13,0,3,6,6,6,3,4,7,10,0,2,-1,-4,0,12.0,6.0,6.0,8
16491,16491,2001-02,2001,2002,Tottenham,Charlton,Loss,Home,2002-03-18,0,0,3,6,6,4,5,5,6,-4,-2,1,0,1,12.0,9.0,3.0,8
16492,16492,2001-02,2001,2002,Tottenham,Fulham,Win,Away,2002-03-24,3,0,0,3,6,0,0,0,0,0,0,3,6,0,12.0,21.0,-9.0,8
16493,16493,2001-02,2001,2002,Tottenham,Middlesbrough,Draw,Away,2002-03-30,1,3,3,3,6,3,4,7,7,0,-1,-4,-1,0,12.0,14.0,-2.0,8
16494,16494,2001-02,2001,2002,Tottenham,Leeds,Win,Home,2002-04-01,3,4,4,4,4,3,6,9,10,1,-2,-5,-6,1,12.0,4.0,8.0,9
16495,16495,2001-02,2001,2002,Tottenham,Arsenal,Loss,Away,2002-04-06,0,4,7,7,7,6,9,12,15,-2,-2,-5,-8,0,12.0,2.0,10.0,9
16496,16496,2001-02,2001,2002,Tottenham,West Ham,Draw,Home,2002-04-13,1,3,4,7,7,6,9,9,12,-3,-5,-2,-5,1,12.0,15.0,-3.0,9
16497,16497,2001-02,2001,2002,Tottenham,Bolton,Draw,Away,2002-04-20,1,1,4,5,8,3,6,9,9,-2,-2,-4,-1,0,12.0,21.0,-9.0,9
16498,16498,2001-02,2001,2002,Tottenham,Liverpool,Win,Home,2002-04-27,3,2,2,5,6,6,9,12,15,-4,-7,-7,-9,1,12.0,3.0,9.0,9
16499,16499,2001-02,2001,2002,Tottenham,Leicester,Loss,Away,2002-05-11,0,4,5,5,8,2,3,3,3,2,2,2,5,0,12.0,13.0,-1.0,10
16500,16500,2002-03,2002,2003,Tottenham,Everton,Draw,Away,2002-08-17,1,3,4,5,5,0,3,4,4,3,1,1,1,0,9.0,15.0,-6.0,1
16501,16501,2002-03,2002,2003,Tottenham,Aston Villa,Win,Home,2002-08-24,3,1,4,5,6,3,6,7,7,-2,-2,-2,-1,1,9.0,8.0,1.0,1
16502,16502,2002-03,2002,2003,Tottenham,Charlton,Win,Away,2002-08-27,3,4,4,7,8,3,4,5,5,1,0,2,3,0,9.0,14.0,-5.0,1
16503,16503,2002-03,2002,2003,Tottenham,Southampton,Win,Home,2002-08-31,3,6,7,7,10,1,2,5,5,5,5,2,5,1,9.0,11.0,-2.0,1
16504,16504,2002-03,2002,2003,Tottenham,Fulham,Loss,Away,2002-09-11,0,6,9,10,10,1,4,4,5,5,5,6,5,0,9.0,13.0,-4.0,2
16505,16505,2002-03,2002,2003,Tottenham,West Ham,Win,Home,2002-09-15,3,3,6,9,10,0,1,1,4,3,5,8,6,1,9.0,7.0,2.0,2
16506,16506,2002-03,2002,2003,Tottenham,Man United,Loss,Away,2002-09-21,0,3,6,9,12,0,3,4,5,3,3,5,7,0,9.0,3.0,6.0,2
16507,16507,2002-03,2002,2003,Tottenham,Middlesbrough,Loss,Home,2002-09-28,0,3,3,6,9,3,6,6,9,0,-3,0,0,1,9.0,12.0,-3.0,2
16508,16508,2002-03,2002,2003,Tottenham,Blackburn,Win,Away,2002-10-06,3,0,3,3,6,6,7,7,7,-6,-4,-4,-1,0,9.0,10.0,-1.0,3
16509,16509,2002-03,2002,2003,Tottenham,Bolton,Win,Home,2002-10-20,3,3,3,6,6,1,1,1,4,2,2,5,2,1,9.0,16.0,-7.0,3
16510,16510,2002-03,2002,2003,Tottenham,Liverpool,Loss,Away,2002-10-26,0,6,6,6,9,6,9,12,15,0,-3,-6,-6,0,9.0,2.0,7.0,3
16511,16511,2002-03,2002,2003,Tottenham,Chelsea,Draw,Home,2002-11-03,1,3,6,6,6,6,6,6,7,-3,0,0,-1,1,9.0,6.0,3.0,4
16512,16512,2002-03,2002,2003,Tottenham,Sunderland,Loss,Away,2002-11-10,0,1,4,7,7,2,2,2,5,-1,2,5,2,0,9.0,17.0,-8.0,4
16513,16513,2002-03,2002,2003,Tottenham,Arsenal,Loss,Away,2002-11-16,0,1,1,4,7,6,6,6,9,-5,-5,-2,-2,0,9.0,1.0,8.0,4
16514,16514,2002-03,2002,2003,Tottenham,Leeds,Win,Home,2002-11-24,3,0,1,1,4,3,3,4,4,-3,-2,-3,0,1,9.0,5.0,4.0,4
16515,16515,2002-03,2002,2003,Tottenham,Birmingham,Draw,Away,2002-11-30,1,3,3,4,4,4,4,7,7,-1,-1,-3,-3,0,9.0,21.0,-12.0,4
16516,16516,2002-03,2002,2003,Tottenham,West Brom,Win,Home,2002-12-08,3,4,4,4,5,3,4,5,5,1,0,-1,0,1,9.0,21.0,-12.0,5
16517,16517,2002-03,2002,2003,Tottenham,Arsenal,Draw,Home,2002-12-15,1,4,7,7,7,3,3,6,9,1,4,1,-2,1,9.0,1.0,8.0,5
16518,16518,2002-03,2002,2003,Tottenham,Man City,Win,Away,2002-12-23,3,4,5,8,8,4,7,7,7,0,-2,1,1,0,9.0,21.0,-12.0,5
16519,16519,2002-03,2002,2003,Tottenham,Charlton,Draw,Home,2002-12-26,1,4,7,8,11,2,5,8,11,2,2,0,0,1,9.0,14.0,-5.0,5
16520,16520,2002-03,2002,2003,Tottenham,Newcastle,Loss,Away,2002-12-29,0,4,5,8,9,3,4,7,10,1,1,1,-1,0,9.0,4.0,5.0,5
16521,16521,2002-03,2002,2003,Tottenham,Southampton,Loss,Away,2003-01-01,0,1,4,5,8,4,5,6,9,-3,-1,-1,-1,0,9.0,11.0,-2.0,6
16522,16522,2002-03,2002,2003,Tottenham,Everton,Win,Home,2003-01-12,3,0,1,4,5,2,3,4,7,-2,-2,0,-2,1,9.0,15.0,-6.0,6
16523,16523,2002-03,2002,2003,Tottenham,Aston Villa,Win,Away,2003-01-18,3,3,3,4,7,4,7,7,7,-1,-4,-3,0,0,9.0,8.0,1.0,6
16524,16524,2002-03,2002,2003,Tottenham,Newcastle,Loss,Home,2003-01-29,0,6,6,6,7,6,7,10,13,0,-1,-4,-6,1,9.0,4.0,5.0,6
16525,16525,2002-03,2002,2003,Tottenham,Chelsea,Draw,Away,2003-02-01,1,3,6,6,6,3,6,6,6,0,0,0,0,0,9.0,6.0,3.0,7
16526,16526,2002-03,2002,2003,Tottenham,Sunderland,Win,Home,2003-02-08,3,1,4,7,7,0,0,1,1,1,4,6,6,1,9.0,17.0,-8.0,7
16527,16527,2002-03,2002,2003,Tottenham,Fulham,Draw,Home,2003-02-24,1,4,4,7,10,6,6,6,9,-2,-2,1,1,1,9.0,13.0,-4.0,7
16528,16528,2002-03,2002,2003,Tottenham,West Ham,Loss,Away,2003-03-01,0,4,5,5,8,3,3,6,6,1,2,-1,2,0,9.0,7.0,2.0,8
16529,16529,2002-03,2002,2003,Tottenham,Liverpool,Loss,Home,2003-03-16,0,1,4,5,5,3,4,7,8,-2,0,-2,-3,1,9.0,2.0,7.0,8
16530,16530,2002-03,2002,2003,Tottenham,Bolton,Loss,Away,2003-03-24,0,0,1,4,5,3,4,5,8,-3,-3,-1,-3,0,9.0,16.0,-7.0,8
16531,16531,2002-03,2002,2003,Tottenham,Birmingham,Win,Home,2003-04-05,3,0,0,1,4,3,6,9,9,-3,-6,-8,-5,1,9.0,21.0,-12.0,9
16532,16532,2002-03,2002,2003,Tottenham,Leeds,Draw,Away,2003-04-12,1,3,3,3,4,3,3,3,3,0,0,0,1,0,9.0,5.0,4.0,9
16533,16533,2002-03,2002,2003,Tottenham,Man City,Loss,Home,2003-04-18,0,4,4,4,4,1,1,4,4,3,3,0,0,1,9.0,21.0,-12.0,9
16534,16534,2002-03,2002,2003,Tottenham,West Brom,Win,Away,2003-04-21,3,1,4,4,4,3,3,3,3,-2,1,1,1,0,9.0,21.0,-12.0,9
16535,16535,2002-03,2002,2003,Tottenham,Man United,Loss,Home,2003-04-27,0,3,4,7,7,4,7,10,13,-1,-3,-3,-6,1,9.0,3.0,6.0,9
16536,16536,2002-03,2002,2003,Tottenham,Middlesbrough,Loss,Away,2003-05-03,0,3,3,4,7,0,0,1,4,3,3,3,3,0,9.0,12.0,-3.0,10
16537,16537,2002-03,2002,2003,Tottenham,Blackburn,Loss,Home,2003-05-11,0,0,3,3,4,4,5,5,8,-4,-2,-2,-4,1,9.0,10.0,-1.0,10
16538,16538,2003-04,2003,2004,Tottenham,Birmingham,Loss,Away,2003-08-16,0,0,0,3,3,1,4,7,10,-1,-4,-4,-7,0,10.0,13.0,-3.0,1
16539,16539,2003-04,2003,2004,Tottenham,Leeds,Win,Home,2003-08-23,3,0,0,0,3,4,7,7,10,-4,-7,-7,-7,1,10.0,15.0,-5.0,1
16540,16540,2003-04,2003,2004,Tottenham,Liverpool,Draw,Away,2003-08-27,1,3,3,3,3,1,1,1,4,2,2,2,-1,0,10.0,5.0,5.0,1
16541,16541,2003-04,2003,2004,Tottenham,Fulham,Loss,Home,2003-08-30,0,4,4,4,4,3,6,9,10,1,-2,-5,-6,1,10.0,14.0,-4.0,1
16542,16542,2003-04,2003,2004,Tottenham,Chelsea,Loss,Away,2003-09-13,0,1,4,4,4,4,7,10,10,-3,-3,-6,-6,0,10.0,4.0,6.0,2
16543,16543,2003-04,2003,2004,Tottenham,Southampton,Loss,Home,2003-09-20,0,0,1,4,4,6,7,8,9,-6,-6,-4,-5,1,10.0,8.0,2.0,2
16544,16544,2003-04,2003,2004,Tottenham,Man City,Draw,Away,2003-09-28,1,0,0,1,4,4,4,7,8,-4,-4,-6,-4,0,10.0,9.0,1.0,2
16545,16545,2003-04,2003,2004,Tottenham,Everton,Win,Home,2003-10-04,3,1,1,1,2,3,4,4,5,-2,-3,-3,-3,1,10.0,7.0,3.0,3
16546,16546,2003-04,2003,2004,Tottenham,Leicester,Win,Away,2003-10-19,3,4,4,4,4,0,0,3,3,4,4,1,1,0,10.0,21.0,-11.0,3
16547,16547,2003-04,2003,2004,Tottenham,Middlesbrough,Draw,Home,2003-10-26,1,6,7,7,7,0,3,6,6,6,4,1,1,1,10.0,11.0,-1.0,3
16548,16548,2003-04,2003,2004,Tottenham,Bolton,Loss,Home,2003-11-01,0,4,7,8,8,0,1,2,3,4,6,6,5,1,10.0,17.0,-7.0,4
16549,16549,2003-04,2003,2004,Tottenham,Arsenal,Loss,Away,2003-11-08,0,1,4,7,8,4,7,10,13,-3,-3,-3,-5,0,10.0,2.0,8.0,4
16550,16550,2003-04,2003,2004,Tottenham,Aston Villa,Win,Home,2003-11-23,3,0,1,4,7,1,2,3,4,-1,-1,1,3,1,10.0,16.0,-6.0,4
16551,16551,2003-04,2003,2004,Tottenham,Blackburn,Loss,Away,2003-11-29,0,3,3,4,7,3,3,3,3,0,0,1,4,0,10.0,6.0,4.0,4
16552,16552,2003-04,2003,2004,Tottenham,Wolves,Win,Home,2003-12-06,3,3,3,3,4,1,2,2,5,2,1,1,-1,1,10.0,21.0,-11.0,5
16553,16553,2003-04,2003,2004,Tottenham,Newcastle,Loss,Away,2003-12-13,0,3,6,6,6,2,5,5,6,1,1,1,0,0,10.0,3.0,7.0,5
16554,16554,2003-04,2003,2004,Tottenham,Man United,Loss,Home,2003-12-21,0,3,3,6,6,6,6,9,12,-3,-3,-3,-6,1,10.0,1.0,9.0,5
16555,16555,2003-04,2003,2004,Tottenham,Portsmouth,Loss,Away,2003-12-26,0,0,3,3,6,0,1,1,1,0,2,2,5,0,10.0,21.0,-11.0,5
16556,16556,2003-04,2003,2004,Tottenham,Charlton,Loss,Home,2003-12-28,0,0,0,3,3,4,5,5,5,-4,-5,-2,-2,1,10.0,12.0,-2.0,5
16557,16557,2003-04,2003,2004,Tottenham,Birmingham,Win,Home,2004-01-07,3,0,0,0,3,3,6,6,6,-3,-6,-6,-3,1,10.0,13.0,-3.0,6
16558,16558,2003-04,2003,2004,Tottenham,Leeds,Win,Away,2004-01-10,3,3,3,3,3,0,1,2,5,3,2,1,-2,0,10.0,15.0,-5.0,6
16559,16559,2003-04,2003,2004,Tottenham,Liverpool,Win,Home,2004-01-17,3,6,6,6,6,6,7,10,10,0,-1,-4,-4,1,10.0,5.0,5.0,6
16560,16560,2003-04,2003,2004,Tottenham,Fulham,Loss,Away,2004-01-31,0,6,9,9,9,3,3,3,6,3,6,6,3,0,10.0,14.0,-4.0,6
16561,16561,2003-04,2003,2004,Tottenham,Portsmouth,Win,Home,2004-02-07,3,3,6,9,9,1,4,4,4,2,2,5,5,1,10.0,21.0,-11.0,7
16562,16562,2003-04,2003,2004,Tottenham,Charlton,Win,Away,2004-02-11,3,3,6,9,12,0,3,6,7,3,3,3,5,0,10.0,12.0,-2.0,7
16563,16563,2003-04,2003,2004,Tottenham,Leicester,Draw,Home,2004-02-22,1,6,6,9,12,1,1,2,2,5,5,7,10,1,10.0,21.0,-11.0,7
16564,16564,2003-04,2003,2004,Tottenham,Middlesbrough,Loss,Away,2004-03-09,0,4,7,7,10,0,3,3,6,4,4,4,4,0,10.0,11.0,-1.0,8
16565,16565,2003-04,2003,2004,Tottenham,Newcastle,Win,Home,2004-03-14,3,1,4,7,7,4,5,8,9,-3,-1,-1,-2,1,10.0,3.0,7.0,8
16566,16566,2003-04,2003,2004,Tottenham,Man United,Loss,Away,2004-03-20,0,3,4,7,10,1,2,2,5,2,2,5,5,0,10.0,1.0,9.0,8
16567,16567,2003-04,2003,2004,Tottenham,Southampton,Loss,Away,2004-03-27,0,3,3,4,7,3,4,5,5,0,-1,-1,2,0,10.0,8.0,2.0,8
16568,16568,2003-04,2003,2004,Tottenham,Chelsea,Loss,Home,2004-04-03,0,0,3,3,4,6,9,12,12,-6,-6,-9,-8,1,10.0,4.0,6.0,9
16569,16569,2003-04,2003,2004,Tottenham,Everton,Loss,Away,2004-04-09,0,0,0,3,3,1,2,5,8,-1,-2,-2,-5,0,10.0,7.0,3.0,9
16570,16570,2003-04,2003,2004,Tottenham,Man City,Draw,Home,2004-04-12,1,0,0,0,3,2,3,3,6,-2,-3,-3,-3,1,10.0,9.0,1.0,9
16571,16571,2003-04,2003,2004,Tottenham,Bolton,Loss,Away,2004-04-17,0,1,1,1,1,4,4,7,7,-3,-3,-6,-6,0,10.0,17.0,-7.0,9
16572,16572,2003-04,2003,2004,Tottenham,Arsenal,Draw,Home,2004-04-25,1,1,1,1,1,4,7,8,11,-3,-6,-7,-10,1,10.0,2.0,8.0,9
16573,16573,2003-04,2003,2004,Tottenham,Aston Villa,Loss,Away,2004-05-02,0,1,2,2,2,4,7,8,9,-3,-5,-6,-7,0,10.0,16.0,-6.0,10
16574,16574,2003-04,2003,2004,Tottenham,Blackburn,Win,Home,2004-05-08,3,1,1,2,2,6,9,12,12,-5,-8,-10,-10,1,10.0,6.0,4.0,10
16575,16575,2003-04,2003,2004,Tottenham,Wolves,Win,Away,2004-05-15,3,3,4,4,5,4,5,8,8,-1,-1,-4,-3,0,10.0,21.0,-11.0,10
16576,16576,2004-05,2004,2005,Tottenham,Liverpool,Draw,Home,2004-08-14,1,6,6,7,7,4,7,10,11,2,-1,-3,-4,1,14.0,4.0,10.0,1
16577,16577,2004-05,2004,2005,Tottenham,Newcastle,Win,Away,2004-08-21,3,4,7,7,8,2,3,4,4,2,4,3,4,0,14.0,5.0,9.0,1
16578,16578,2004-05,2004,2005,Tottenham,West Brom,Draw,Away,2004-08-25,1,4,7,10,10,2,3,4,4,2,4,6,6,0,14.0,21.0,-7.0,1
16579,16579,2004-05,2004,2005,Tottenham,Birmingham,Win,Home,2004-08-28,3,4,5,8,11,3,4,5,5,1,1,3,6,1,14.0,10.0,4.0,1
16580,16580,2004-05,2004,2005,Tottenham,Norwich,Draw,Home,2004-09-12,1,4,7,8,11,1,1,2,3,3,6,6,8,1,14.0,21.0,-7.0,2
16581,16581,2004-05,2004,2005,Tottenham,Chelsea,Draw,Away,2004-09-19,1,4,5,8,9,4,7,10,13,0,-2,-2,-4,0,14.0,2.0,12.0,2
16582,16582,2004-05,2004,2005,Tottenham,Man United,Loss,Home,2004-09-25,0,2,5,6,9,4,5,6,9,-2,0,0,0,1,14.0,3.0,11.0,2
16583,16583,2004-05,2004,2005,Tottenham,Everton,Win,Away,2004-10-02,3,1,2,5,6,6,9,10,13,-5,-7,-5,-7,0,14.0,17.0,-3.0,3
16584,16584,2004-05,2004,2005,Tottenham,Portsmouth,Loss,Away,2004-10-18,0,3,4,5,8,1,1,4,7,2,3,1,1,0,14.0,13.0,1.0,3
16585,16585,2004-05,2004,2005,Tottenham,Bolton,Loss,Home,2004-10-23,0,3,3,4,5,3,4,5,6,0,-1,-1,-1,1,14.0,8.0,6.0,3
16586,16586,2004-05,2004,2005,Tottenham,Fulham,Loss,Away,2004-10-30,0,0,3,3,4,0,0,3,4,0,3,0,0,0,14.0,9.0,5.0,3
16587,16587,2004-05,2004,2005,Tottenham,Charlton,Loss,Home,2004-11-06,0,0,0,3,3,0,1,1,4,0,-1,2,-1,1,14.0,7.0,7.0,4
16588,16588,2004-05,2004,2005,Tottenham,Arsenal,Loss,Home,2004-11-13,0,0,0,0,3,2,2,5,8,-2,-2,-5,-5,1,14.0,1.0,13.0,4
16589,16589,2004-05,2004,2005,Tottenham,Aston Villa,Loss,Away,2004-11-22,0,0,0,0,0,6,7,10,10,-6,-7,-10,-10,0,14.0,6.0,8.0,4
16590,16590,2004-05,2004,2005,Tottenham,Middlesbrough,Win,Home,2004-11-28,3,0,0,0,0,6,7,10,11,-6,-7,-10,-11,1,14.0,11.0,3.0,4
16591,16591,2004-05,2004,2005,Tottenham,Blackburn,Win,Away,2004-12-04,3,3,3,3,3,4,5,6,7,-1,-2,-3,-4,0,14.0,15.0,-1.0,5
16592,16592,2004-05,2004,2005,Tottenham,Man City,Win,Away,2004-12-11,3,6,6,6,6,3,6,7,8,3,0,-1,-2,0,14.0,16.0,-2.0,5
16593,16593,2004-05,2004,2005,Tottenham,Southampton,Win,Home,2004-12-18,3,6,9,9,9,1,2,2,5,5,7,7,4,1,14.0,12.0,2.0,5
16594,16594,2004-05,2004,2005,Tottenham,Norwich,Win,Away,2004-12-26,3,6,9,12,12,3,3,4,7,3,6,8,5,0,14.0,21.0,-7.0,5
16595,16595,2004-05,2004,2005,Tottenham,Crystal Palace,Draw,Home,2004-12-28,1,6,9,12,15,0,1,1,2,6,8,11,13,1,14.0,21.0,-7.0,5
16596,16596,2004-05,2004,2005,Tottenham,Everton,Win,Home,2005-01-01,3,4,7,10,13,3,4,7,10,1,3,3,3,1,14.0,17.0,-3.0,6
16597,16597,2004-05,2004,2005,Tottenham,Man United,Draw,Away,2005-01-04,1,4,7,10,13,6,9,12,13,-2,-2,-2,0,0,14.0,3.0,11.0,6
16598,16598,2004-05,2004,2005,Tottenham,Chelsea,Loss,Home,2005-01-15,0,4,5,8,11,6,9,12,15,-2,-4,-4,-4,1,14.0,2.0,12.0,6
16599,16599,2004-05,2004,2005,Tottenham,Crystal Palace,Loss,Away,2005-01-22,0,1,4,5,8,3,3,4,4,-2,1,1,4,0,14.0,21.0,-7.0,6
16600,16600,2004-05,2004,2005,Tottenham,Bolton,Loss,Away,2005-02-01,0,0,1,4,5,6,9,10,10,-6,-8,-6,-5,0,14.0,8.0,6.0,7
16601,16601,2004-05,2004,2005,Tottenham,Portsmouth,Win,Home,2005-02-05,3,0,0,1,4,3,3,3,4,-3,-3,-2,0,1,14.0,13.0,1.0,7
16602,16602,2004-05,2004,2005,Tottenham,Fulham,Win,Home,2005-02-26,3,3,3,3,4,1,4,7,8,2,-1,-4,-4,1,14.0,9.0,5.0,7
16603,16603,2004-05,2004,2005,Tottenham,Southampton,Loss,Away,2005-03-05,0,6,6,6,6,2,3,3,6,4,3,3,0,0,14.0,12.0,2.0,8
16604,16604,2004-05,2004,2005,Tottenham,Charlton,Loss,Away,2005-03-16,0,3,6,6,6,2,3,3,6,1,3,3,0,0,14.0,7.0,7.0,8
16605,16605,2004-05,2004,2005,Tottenham,Man City,Win,Home,2005-03-19,3,0,3,6,6,3,3,4,5,-3,0,2,1,1,14.0,16.0,-2.0,8
16606,16606,2004-05,2004,2005,Tottenham,Birmingham,Draw,Away,2005-04-02,1,3,3,6,9,3,3,6,6,0,0,0,3,0,14.0,10.0,4.0,9
16607,16607,2004-05,2004,2005,Tottenham,Newcastle,Win,Home,2005-04-10,3,4,4,4,7,1,4,7,8,3,0,-3,-1,1,14.0,5.0,9.0,9
16608,16608,2004-05,2004,2005,Tottenham,Liverpool,Draw,Away,2005-04-16,1,4,7,7,7,3,6,7,7,1,1,0,0,0,14.0,4.0,10.0,9
16609,16609,2004-05,2004,2005,Tottenham,West Brom,Draw,Home,2005-04-20,1,4,5,8,8,4,7,7,10,0,-2,1,-2,1,14.0,21.0,-7.0,9
16610,16610,2004-05,2004,2005,Tottenham,Arsenal,Loss,Away,2005-04-25,0,2,5,6,9,4,7,10,13,-2,-2,-4,-4,0,14.0,1.0,13.0,9
16611,16611,2004-05,2004,2005,Tottenham,Aston Villa,Win,Home,2005-05-01,3,1,2,5,6,2,5,6,9,-1,-3,-1,-3,1,14.0,6.0,8.0,10
16612,16612,2004-05,2004,2005,Tottenham,Middlesbrough,Loss,Away,2005-05-07,0,3,4,5,8,2,5,6,6,1,-1,-1,2,0,14.0,11.0,3.0,10
16613,16613,2004-05,2004,2005,Tottenham,Blackburn,Draw,Home,2005-05-15,1,3,3,4,5,0,1,2,5,3,2,2,0,1,14.0,15.0,-1.0,10
16614,16614,2005-06,2005,2006,Tottenham,Portsmouth,Win,Away,2005-08-13,3,1,4,4,5,1,1,4,4,0,3,0,1,0,9.0,16.0,-7.0,1
16615,16615,2005-06,2005,2006,Tottenham,Middlesbrough,Win,Home,2005-08-20,3,4,4,7,7,2,5,6,7,2,-1,1,0,1,9.0,7.0,2.0,1
16616,16616,2005-06,2005,2006,Tottenham,Blackburn,Draw,Away,2005-08-24,1,6,7,7,10,3,4,4,4,3,3,3,6,0,9.0,15.0,-6.0,1
16617,16617,2005-06,2005,2006,Tottenham,Chelsea,Loss,Home,2005-08-27,0,4,7,8,8,6,9,10,13,-2,-2,-2,-5,1,9.0,1.0,8.0,1
16618,16618,2005-06,2005,2006,Tottenham,Liverpool,Draw,Home,2005-09-10,1,1,4,7,8,4,7,7,8,-3,-3,0,0,1,9.0,5.0,4.0,2
16619,16619,2005-06,2005,2006,Tottenham,Aston Villa,Draw,Away,2005-09-17,1,1,2,5,8,3,4,4,5,-2,-2,1,3,0,9.0,10.0,-1.0,2
16620,16620,2005-06,2005,2006,Tottenham,Fulham,Win,Home,2005-09-26,3,2,2,3,6,1,4,4,4,1,-2,-1,2,1,9.0,13.0,-4.0,2
16621,16621,2005-06,2005,2006,Tottenham,Charlton,Win,Away,2005-10-01,3,4,5,5,6,3,6,9,12,1,-1,-4,-6,0,9.0,11.0,-2.0,3
16622,16622,2005-06,2005,2006,Tottenham,Everton,Win,Home,2005-10-15,3,6,7,8,8,0,0,0,0,6,7,8,8,1,9.0,4.0,5.0,3
16623,16623,2005-06,2005,2006,Tottenham,Man United,Draw,Away,2005-10-22,1,6,9,10,11,6,6,7,8,0,3,3,3,0,9.0,3.0,6.0,3
16624,16624,2005-06,2005,2006,Tottenham,Arsenal,Draw,Home,2005-10-29,1,4,7,10,11,3,6,7,10,1,1,3,1,1,9.0,2.0,7.0,3
16625,16625,2005-06,2005,2006,Tottenham,Bolton,Loss,Away,2005-11-07,0,2,5,8,11,6,6,6,9,-4,-1,2,2,0,9.0,6.0,3.0,4
16626,16626,2005-06,2005,2006,Tottenham,West Ham,Draw,Home,2005-11-20,1,1,2,5,8,3,6,6,7,-2,-4,-1,1,1,9.0,21.0,-12.0,4
16627,16627,2005-06,2005,2006,Tottenham,Wigan,Win,Away,2005-11-26,3,1,2,3,6,3,6,9,12,-2,-4,-6,-6,0,9.0,21.0,-12.0,4
16628,16628,2005-06,2005,2006,Tottenham,Sunderland,Win,Home,2005-12-03,3,4,4,5,6,0,0,0,0,4,4,5,6,1,9.0,21.0,-12.0,5
16629,16629,2005-06,2005,2006,Tottenham,Portsmouth,Win,Home,2005-12-12,3,6,7,7,8,0,0,0,3,6,7,7,5,1,9.0,16.0,-7.0,5
16630,16630,2005-06,2005,2006,Tottenham,Middlesbrough,Draw,Away,2005-12-18,1,6,9,10,10,0,1,4,4,6,8,6,6,0,9.0,7.0,2.0,5
16631,16631,2005-06,2005,2006,Tottenham,Birmingham,Win,Home,2005-12-26,3,4,7,10,11,3,3,6,6,1,4,4,5,1,9.0,12.0,-3.0,5
16632,16632,2005-06,2005,2006,Tottenham,West Brom,Loss,Away,2005-12-28,0,4,7,10,13,0,3,4,5,4,4,6,8,0,9.0,17.0,-8.0,5
16633,16633,2005-06,2005,2006,Tottenham,Newcastle,Win,Home,2005-12-31,3,3,4,7,10,3,6,7,7,0,-2,0,3,1,9.0,14.0,-5.0,5
16634,16634,2005-06,2005,2006,Tottenham,Man City,Win,Away,2006-01-04,3,3,6,7,10,1,1,4,4,2,5,3,6,0,9.0,8.0,1.0,6
16635,16635,2005-06,2005,2006,Tottenham,Liverpool,Loss,Away,2006-01-14,0,6,6,9,10,4,7,10,13,2,-1,-1,-3,0,9.0,5.0,4.0,6
16636,16636,2005-06,2005,2006,Tottenham,Aston Villa,Draw,Home,2006-01-21,1,3,6,6,9,3,4,5,8,0,2,1,1,1,9.0,10.0,-1.0,6
16637,16637,2005-06,2005,2006,Tottenham,Fulham,Loss,Away,2006-01-31,0,1,4,7,7,3,6,6,7,-2,-2,1,0,0,9.0,13.0,-4.0,6
16638,16638,2005-06,2005,2006,Tottenham,Charlton,Win,Home,2006-02-05,3,1,1,4,7,2,5,5,8,-1,-4,-1,-1,1,9.0,11.0,-2.0,7
16639,16639,2005-06,2005,2006,Tottenham,Sunderland,Draw,Away,2006-02-12,1,3,4,4,7,0,3,3,3,3,1,1,4,0,9.0,21.0,-12.0,7
16640,16640,2005-06,2005,2006,Tottenham,Wigan,Draw,Home,2006-02-19,1,4,4,5,5,1,2,5,5,3,2,0,0,1,9.0,21.0,-12.0,7
16641,16641,2005-06,2005,2006,Tottenham,Blackburn,Win,Home,2006-03-05,3,2,5,5,6,6,6,6,9,-4,-1,-1,-3,1,9.0,15.0,-6.0,8
16642,16642,2005-06,2005,2006,Tottenham,Chelsea,Loss,Away,2006-03-11,0,4,5,8,8,6,6,9,10,-2,-1,-1,-2,0,9.0,1.0,8.0,8
16643,16643,2005-06,2005,2006,Tottenham,Birmingham,Win,Away,2006-03-18,3,3,4,5,8,1,4,4,4,2,0,1,4,0,9.0,12.0,-3.0,8
16644,16644,2005-06,2005,2006,Tottenham,West Brom,Win,Home,2006-03-27,3,3,6,7,8,1,1,1,1,2,5,6,7,1,9.0,17.0,-8.0,8
16645,16645,2005-06,2005,2006,Tottenham,Newcastle,Loss,Away,2006-04-01,0,6,6,9,10,0,0,3,6,6,6,6,4,0,9.0,14.0,-5.0,9
16646,16646,2005-06,2005,2006,Tottenham,Man City,Win,Home,2006-04-08,3,3,6,6,9,0,0,0,3,3,6,6,6,1,9.0,8.0,1.0,9
16647,16647,2005-06,2005,2006,Tottenham,Everton,Win,Away,2006-04-15,3,3,6,9,9,2,2,5,8,1,4,4,1,0,9.0,4.0,5.0,9
16648,16648,2005-06,2005,2006,Tottenham,Man United,Loss,Home,2006-04-17,0,6,6,9,12,4,7,10,13,2,-1,-1,-1,1,9.0,3.0,6.0,9
16649,16649,2005-06,2005,2006,Tottenham,Arsenal,Draw,Away,2006-04-22,1,3,6,6,9,4,4,7,10,-1,2,-1,-1,0,9.0,2.0,7.0,9
16650,16650,2005-06,2005,2006,Tottenham,Bolton,Win,Home,2006-04-30,3,1,4,7,7,4,4,4,4,-3,0,3,3,1,9.0,6.0,3.0,9
16651,16651,2005-06,2005,2006,Tottenham,West Ham,Loss,Away,2006-05-07,0,4,4,7,10,3,3,6,6,1,1,1,4,0,9.0,21.0,-12.0,10
16652,16652,2006-07,2006,2007,Tottenham,Bolton,Loss,Away,2006-08-19,0,3,4,4,7,4,4,7,8,-1,0,-3,-1,0,5.0,8.0,-3.0,1
16653,16653,2006-07,2006,2007,Tottenham,Sheffield United,Win,Home,2006-08-22,3,0,3,4,4,1,2,5,8,-1,1,-1,-4,1,5.0,21.0,-16.0,1
16654,16654,2006-07,2006,2007,Tottenham,Everton,Loss,Home,2006-08-26,0,3,3,6,7,4,5,8,9,-1,-2,-2,-2,1,5.0,11.0,-6.0,1
16655,16655,2006-07,2006,2007,Tottenham,Man United,Loss,Away,2006-09-09,0,3,3,3,6,6,9,12,13,-3,-6,-9,-7,0,5.0,2.0,3.0,2
16656,16656,2006-07,2006,2007,Tottenham,Fulham,Draw,Home,2006-09-17,1,0,3,3,3,6,7,7,10,-6,-4,-4,-7,1,5.0,12.0,-7.0,2
16657,16657,2006-07,2006,2007,Tottenham,Liverpool,Loss,Away,2006-09-23,0,1,1,4,4,3,3,6,7,-2,-2,-2,-3,0,5.0,3.0,2.0,2
16658,16658,2006-07,2006,2007,Tottenham,Portsmouth,Win,Home,2006-10-01,3,1,1,1,4,3,6,9,10,-2,-5,-8,-6,1,5.0,17.0,-12.0,3
16659,16659,2006-07,2006,2007,Tottenham,Aston Villa,Draw,Away,2006-10-14,1,3,4,4,4,4,5,6,9,-1,-1,-2,-5,0,5.0,16.0,-11.0,3
16660,16660,2006-07,2006,2007,Tottenham,West Ham,Win,Home,2006-10-22,3,4,4,5,5,0,0,0,1,4,4,5,4,1,5.0,9.0,-4.0,3
16661,16661,2006-07,2006,2007,Tottenham,Watford,Draw,Away,2006-10-28,1,4,7,7,8,1,2,3,4,3,5,4,4,0,5.0,21.0,-16.0,3
16662,16662,2006-07,2006,2007,Tottenham,Chelsea,Win,Home,2006-11-05,3,4,5,8,8,6,9,10,13,-2,-4,-2,-5,1,5.0,1.0,4.0,4
16663,16663,2006-07,2006,2007,Tottenham,Reading,Loss,Away,2006-11-12,0,4,7,8,11,0,0,0,3,4,7,8,8,0,5.0,21.0,-16.0,4
16664,16664,2006-07,2006,2007,Tottenham,Blackburn,Draw,Away,2006-11-19,1,3,4,7,8,0,0,0,1,3,4,7,7,0,5.0,6.0,-1.0,4
16665,16665,2006-07,2006,2007,Tottenham,Wigan,Win,Home,2006-11-26,3,1,4,5,8,4,7,10,13,-3,-3,-5,-5,1,5.0,10.0,-5.0,4
16666,16666,2006-07,2006,2007,Tottenham,Arsenal,Loss,Away,2006-12-02,0,4,4,7,8,0,1,4,4,4,3,3,4,0,5.0,4.0,1.0,5
16667,16667,2006-07,2006,2007,Tottenham,Middlesbrough,Win,Home,2006-12-05,3,3,4,4,7,1,2,5,5,2,2,-1,2,1,5.0,14.0,-9.0,5
16668,16668,2006-07,2006,2007,Tottenham,Charlton,Win,Home,2006-12-09,3,3,6,7,7,3,4,4,4,0,2,3,3,1,5.0,13.0,-8.0,5
16669,16669,2006-07,2006,2007,Tottenham,Man City,Win,Away,2006-12-17,3,6,6,9,10,1,4,4,7,5,2,5,3,0,5.0,15.0,-10.0,5
16670,16670,2006-07,2006,2007,Tottenham,Newcastle,Loss,Away,2006-12-23,0,6,9,9,12,3,6,9,12,3,3,0,0,0,5.0,7.0,-2.0,5
16671,16671,2006-07,2006,2007,Tottenham,Aston Villa,Win,Home,2006-12-26,3,3,6,9,9,0,1,2,2,3,5,7,7,1,5.0,16.0,-11.0,5
16672,16672,2006-07,2006,2007,Tottenham,Liverpool,Loss,Home,2006-12-30,0,3,6,9,12,3,6,9,12,0,0,0,0,1,5.0,3.0,2.0,5
16673,16673,2006-07,2006,2007,Tottenham,Portsmouth,Draw,Away,2007-01-01,1,3,3,6,9,3,6,7,10,0,-3,-1,-1,0,5.0,17.0,-12.0,6
16674,16674,2006-07,2006,2007,Tottenham,Newcastle,Loss,Home,2007-01-14,0,1,4,4,7,1,1,4,7,0,3,0,0,1,5.0,7.0,-2.0,6
16675,16675,2006-07,2006,2007,Tottenham,Fulham,Draw,Away,2007-01-20,1,1,1,4,4,2,3,4,5,-1,-2,0,-1,0,5.0,12.0,-7.0,6
16676,16676,2006-07,2006,2007,Tottenham,Man United,Loss,Home,2007-02-04,0,1,2,2,5,3,6,7,10,-2,-4,-5,-5,1,5.0,2.0,3.0,7
16677,16677,2006-07,2006,2007,Tottenham,Sheffield United,Loss,Away,2007-02-10,0,1,1,2,2,3,3,4,4,-2,-2,-2,-2,0,5.0,21.0,-16.0,7
16678,16678,2006-07,2006,2007,Tottenham,Everton,Win,Away,2007-02-21,3,0,1,1,2,4,7,8,8,-4,-6,-7,-6,0,5.0,11.0,-6.0,7
16679,16679,2006-07,2006,2007,Tottenham,Bolton,Win,Home,2007-02-25,3,3,3,4,4,6,7,7,8,-3,-4,-3,-4,1,5.0,8.0,-3.0,7
16680,16680,2006-07,2006,2007,Tottenham,West Ham,Win,Away,2007-03-04,3,6,6,6,7,0,0,0,1,6,6,6,6,0,5.0,9.0,-4.0,8
16681,16681,2006-07,2006,2007,Tottenham,Watford,Win,Home,2007-03-17,3,6,9,9,9,1,2,5,5,5,7,4,4,1,5.0,21.0,-16.0,8
16682,16682,2006-07,2006,2007,Tottenham,Reading,Win,Home,2007-04-01,3,6,9,12,12,1,1,4,7,5,8,8,5,1,5.0,21.0,-16.0,9
16683,16683,2006-07,2006,2007,Tottenham,Chelsea,Loss,Away,2007-04-07,0,6,9,12,15,6,9,12,15,0,0,0,0,0,5.0,1.0,4.0,9
16684,16684,2006-07,2006,2007,Tottenham,Wigan,Draw,Away,2007-04-15,1,3,6,9,12,1,1,2,5,2,5,7,7,0,5.0,10.0,-5.0,9
16685,16685,2006-07,2006,2007,Tottenham,Arsenal,Draw,Home,2007-04-21,1,1,4,7,10,6,7,7,7,-5,-3,0,3,1,5.0,4.0,1.0,9
16686,16686,2006-07,2006,2007,Tottenham,Middlesbrough,Win,Away,2007-04-28,3,2,2,5,8,1,1,4,4,1,1,1,4,0,5.0,14.0,-9.0,9
16687,16687,2006-07,2006,2007,Tottenham,Charlton,Win,Away,2007-05-07,3,4,5,5,8,1,1,2,3,3,4,3,5,0,5.0,13.0,-8.0,10
16688,16688,2006-07,2006,2007,Tottenham,Blackburn,Draw,Home,2007-05-10,1,6,7,8,8,6,7,10,10,0,0,-2,-2,1,5.0,6.0,-1.0,10
16689,16689,2006-07,2006,2007,Tottenham,Man City,Win,Home,2007-05-13,3,4,7,8,9,0,1,1,2,4,6,7,7,1,5.0,15.0,-10.0,10
16690,16690,2007-08,2007,2008,Tottenham,Sunderland,Loss,Away,2007-08-11,0,4,7,10,11,3,3,3,3,1,4,7,8,0,5.0,21.0,-16.0,1
16691,16691,2007-08,2007,2008,Tottenham,Everton,Loss,Home,2007-08-14,0,3,4,7,10,4,7,7,7,-1,-3,0,3,1,5.0,6.0,-1.0,1
16692,16692,2007-08,2007,2008,Tottenham,Derby,Win,Home,2007-08-18,3,0,3,4,7,1,2,2,2,-1,1,2,5,1,5.0,21.0,-16.0,1
16693,16693,2007-08,2007,2008,Tottenham,Man United,Loss,Away,2007-08-26,0,3,3,6,7,1,2,2,3,2,1,4,4,0,5.0,1.0,4.0,1
16694,16694,2007-08,2007,2008,Tottenham,Fulham,Draw,Away,2007-09-01,1,3,3,3,6,0,3,3,3,3,0,0,3,0,5.0,16.0,-11.0,2
16695,16695,2007-08,2007,2008,Tottenham,Arsenal,Loss,Home,2007-09-15,0,1,4,4,4,6,7,10,11,-5,-3,-6,-7,1,5.0,4.0,1.0,2
16696,16696,2007-08,2007,2008,Tottenham,Bolton,Draw,Away,2007-09-23,1,1,1,4,4,0,3,3,3,1,-2,1,1,0,5.0,7.0,-2.0,2
16697,16697,2007-08,2007,2008,Tottenham,Aston Villa,Draw,Home,2007-10-01,1,1,2,2,5,3,6,9,10,-2,-4,-7,-5,1,5.0,11.0,-6.0,3
16698,16698,2007-08,2007,2008,Tottenham,Liverpool,Draw,Away,2007-10-07,1,2,2,3,3,4,5,8,11,-2,-3,-5,-8,0,5.0,3.0,2.0,3
16699,16699,2007-08,2007,2008,Tottenham,Newcastle,Loss,Away,2007-10-22,0,2,3,3,4,3,6,6,9,-1,-3,-3,-5,0,5.0,13.0,-8.0,3
16700,16700,2007-08,2007,2008,Tottenham,Blackburn,Loss,Home,2007-10-28,0,1,2,3,3,6,9,9,10,-5,-7,-6,-7,1,5.0,10.0,-5.0,3
16701,16701,2007-08,2007,2008,Tottenham,Middlesbrough,Draw,Away,2007-11-03,1,0,1,2,3,0,0,0,1,0,1,2,2,0,5.0,12.0,-7.0,4
16702,16702,2007-08,2007,2008,Tottenham,Wigan,Win,Home,2007-11-11,3,1,1,2,3,0,0,0,0,1,1,2,3,1,5.0,17.0,-12.0,4
16703,16703,2007-08,2007,2008,Tottenham,West Ham,Draw,Away,2007-11-25,1,4,4,4,5,4,5,8,8,0,-1,-4,-3,0,5.0,15.0,-10.0,4
16704,16704,2007-08,2007,2008,Tottenham,Birmingham,Loss,Home,2007-12-02,0,4,5,5,5,0,0,3,3,4,5,2,2,1,5.0,21.0,-16.0,5
16705,16705,2007-08,2007,2008,Tottenham,Man City,Win,Home,2007-12-09,3,1,4,5,5,4,5,8,8,-3,-1,-3,-3,1,5.0,14.0,-9.0,5
16706,16706,2007-08,2007,2008,Tottenham,Portsmouth,Win,Away,2007-12-15,3,3,4,7,8,4,7,8,11,-1,-3,-1,-3,0,5.0,9.0,-4.0,5
16707,16707,2007-08,2007,2008,Tottenham,Arsenal,Loss,Away,2007-12-22,0,6,6,7,10,3,4,7,10,3,2,0,0,0,5.0,4.0,1.0,5
16708,16708,2007-08,2007,2008,Tottenham,Fulham,Win,Home,2007-12-26,3,3,6,6,7,1,1,1,2,2,5,5,5,1,5.0,16.0,-11.0,5
16709,16709,2007-08,2007,2008,Tottenham,Reading,Win,Home,2007-12-29,3,3,6,9,9,4,5,8,9,-1,1,1,0,1,5.0,8.0,-3.0,5
16710,16710,2007-08,2007,2008,Tottenham,Aston Villa,Loss,Away,2008-01-01,0,6,6,9,12,4,5,6,6,2,1,3,6,0,5.0,11.0,-6.0,6
16711,16711,2007-08,2007,2008,Tottenham,Chelsea,Loss,Away,2008-01-12,0,3,6,6,9,6,7,10,10,-3,-1,-4,-1,0,5.0,2.0,3.0,6
16712,16712,2007-08,2007,2008,Tottenham,Sunderland,Win,Home,2008-01-19,3,0,3,6,6,3,6,6,6,-3,-3,0,0,1,5.0,21.0,-16.0,6
16713,16713,2007-08,2007,2008,Tottenham,Everton,Draw,Away,2008-01-30,1,3,3,6,9,6,9,9,12,-3,-6,-3,-3,0,5.0,6.0,-1.0,6
16714,16714,2007-08,2007,2008,Tottenham,Man United,Draw,Home,2008-02-02,1,4,4,4,7,6,9,12,12,-2,-5,-8,-5,1,5.0,1.0,4.0,7
16715,16715,2007-08,2007,2008,Tottenham,Derby,Win,Away,2008-02-09,3,2,5,5,5,2,2,2,2,0,3,3,3,0,5.0,21.0,-16.0,7
16716,16716,2007-08,2007,2008,Tottenham,Birmingham,Loss,Away,2008-03-01,0,4,5,8,8,2,3,3,3,2,2,5,5,0,5.0,21.0,-16.0,8
16717,16717,2007-08,2007,2008,Tottenham,West Ham,Win,Home,2008-03-09,3,3,4,5,8,0,3,4,4,3,1,1,4,1,5.0,15.0,-10.0,8
16718,16718,2007-08,2007,2008,Tottenham,Man City,Loss,Away,2008-03-16,0,3,6,7,8,1,1,4,4,2,5,3,4,0,5.0,14.0,-9.0,8
16719,16719,2007-08,2007,2008,Tottenham,Chelsea,Draw,Home,2008-03-19,1,3,3,6,7,6,9,10,11,-3,-6,-4,-4,1,5.0,2.0,3.0,8
16720,16720,2007-08,2007,2008,Tottenham,Portsmouth,Win,Home,2008-03-22,3,1,4,4,7,6,6,9,12,-5,-2,-5,-5,1,5.0,9.0,-4.0,8
16721,16721,2007-08,2007,2008,Tottenham,Newcastle,Loss,Home,2008-03-30,0,4,4,7,7,4,4,4,4,0,0,3,3,1,5.0,13.0,-8.0,8
16722,16722,2007-08,2007,2008,Tottenham,Blackburn,Draw,Away,2008-04-05,1,3,4,4,7,4,4,5,8,-1,0,-1,-1,0,5.0,10.0,-5.0,9
16723,16723,2007-08,2007,2008,Tottenham,Middlesbrough,Draw,Home,2008-04-12,1,1,4,5,5,1,4,5,6,0,0,0,-1,1,5.0,12.0,-7.0,9
16724,16724,2007-08,2007,2008,Tottenham,Wigan,Draw,Away,2008-04-19,1,2,2,5,6,4,4,4,7,-2,-2,1,-1,0,5.0,17.0,-12.0,9
16725,16725,2007-08,2007,2008,Tottenham,Bolton,Draw,Home,2008-04-26,1,2,3,3,6,6,6,6,7,-4,-3,-3,-1,1,5.0,7.0,-2.0,9
16726,16726,2007-08,2007,2008,Tottenham,Reading,Win,Away,2008-05-03,3,2,3,4,4,1,1,1,2,1,2,3,2,0,5.0,8.0,-3.0,10
16727,16727,2007-08,2007,2008,Tottenham,Liverpool,Loss,Home,2008-05-11,0,4,5,6,7,4,7,10,11,0,-2,-4,-4,1,5.0,3.0,2.0,10
16728,16728,2008-09,2008,2009,Tottenham,Middlesbrough,Loss,Away,2008-08-16,0,3,4,5,6,6,6,6,7,-3,-2,-1,-1,0,11.0,13.0,-2.0,1
16729,16729,2008-09,2008,2009,Tottenham,Sunderland,Loss,Home,2008-08-23,0,0,3,4,5,0,0,3,3,0,3,1,2,1,11.0,15.0,-4.0,1
16730,16730,2008-09,2008,2009,Tottenham,Chelsea,Draw,Away,2008-08-31,1,0,0,3,4,6,7,10,13,-6,-7,-7,-9,0,11.0,2.0,9.0,1
16731,16731,2008-09,2008,2009,Tottenham,Aston Villa,Loss,Home,2008-09-15,0,1,1,1,4,1,4,5,5,0,-3,-4,-1,1,11.0,6.0,5.0,2
16732,16732,2008-09,2008,2009,Tottenham,Wigan,Draw,Home,2008-09-21,1,1,1,1,1,4,4,4,4,-3,-3,-3,-3,1,11.0,14.0,-3.0,2
16733,16733,2008-09,2008,2009,Tottenham,Portsmouth,Loss,Away,2008-09-28,0,1,2,2,2,3,6,6,6,-2,-4,-4,-4,0,11.0,8.0,3.0,2
16734,16734,2008-09,2008,2009,Tottenham,Hull,Loss,Home,2008-10-05,0,1,1,2,2,4,7,7,8,-3,-6,-5,-6,1,11.0,21.0,-10.0,3
16735,16735,2008-09,2008,2009,Tottenham,Stoke,Loss,Away,2008-10-19,0,0,1,1,2,0,1,1,1,0,0,0,1,0,11.0,21.0,-10.0,3
16736,16736,2008-09,2008,2009,Tottenham,Bolton,Win,Home,2008-10-26,3,0,0,1,1,4,4,4,4,-4,-4,-3,-3,1,11.0,16.0,-5.0,3
16737,16737,2008-09,2008,2009,Tottenham,Arsenal,Draw,Away,2008-10-29,1,3,3,3,4,6,7,7,10,-3,-4,-4,-6,0,11.0,3.0,8.0,3
16738,16738,2008-09,2008,2009,Tottenham,Liverpool,Win,Home,2008-11-01,3,4,4,4,4,6,9,12,15,-2,-5,-8,-11,1,11.0,4.0,7.0,4
16739,16739,2008-09,2008,2009,Tottenham,Man City,Win,Away,2008-11-09,3,4,7,7,7,0,3,4,4,4,4,3,3,0,11.0,9.0,2.0,4
16740,16740,2008-09,2008,2009,Tottenham,Fulham,Loss,Away,2008-11-15,0,6,7,10,10,3,6,7,8,3,1,3,2,0,11.0,17.0,-6.0,4
16741,16741,2008-09,2008,2009,Tottenham,Blackburn,Win,Home,2008-11-23,3,3,6,7,10,0,1,1,2,3,5,6,8,1,11.0,7.0,4.0,4
16742,16742,2008-09,2008,2009,Tottenham,Everton,Loss,Home,2008-11-30,0,3,6,9,10,1,4,7,10,2,2,2,0,1,11.0,5.0,6.0,4
16743,16743,2008-09,2008,2009,Tottenham,West Ham,Win,Away,2008-12-08,3,3,3,6,9,4,5,5,6,-1,-2,1,3,0,11.0,10.0,1.0,5
16744,16744,2008-09,2008,2009,Tottenham,Man United,Draw,Home,2008-12-13,1,3,6,6,9,6,7,10,10,-3,-1,-4,-1,1,11.0,1.0,10.0,5
16745,16745,2008-09,2008,2009,Tottenham,Newcastle,Loss,Away,2008-12-21,0,4,4,7,7,4,5,6,7,0,-1,1,0,0,11.0,12.0,-1.0,5
16746,16746,2008-09,2008,2009,Tottenham,Fulham,Draw,Home,2008-12-26,1,1,4,4,7,4,5,6,7,-3,-1,-2,0,1,11.0,17.0,-6.0,5
16747,16747,2008-09,2008,2009,Tottenham,West Brom,Loss,Away,2008-12-28,0,1,2,5,5,3,3,4,4,-2,-1,1,1,0,11.0,21.0,-10.0,5
16748,16748,2008-09,2008,2009,Tottenham,Wigan,Loss,Away,2009-01-11,0,1,1,2,5,6,9,9,12,-5,-8,-7,-7,0,11.0,14.0,-3.0,6
16749,16749,2008-09,2008,2009,Tottenham,Portsmouth,Draw,Home,2009-01-18,1,0,1,1,2,0,0,0,1,0,1,1,1,1,11.0,8.0,3.0,6
16750,16750,2008-09,2008,2009,Tottenham,Stoke,Win,Home,2009-01-27,3,1,1,2,2,1,1,1,1,0,0,1,1,1,11.0,21.0,-10.0,6
16751,16751,2008-09,2008,2009,Tottenham,Bolton,Loss,Away,2009-01-31,0,4,4,4,5,1,1,1,1,3,3,3,4,0,11.0,16.0,-5.0,6
16752,16752,2008-09,2008,2009,Tottenham,Arsenal,Draw,Home,2009-02-08,1,3,4,4,4,2,5,8,11,1,-1,-4,-7,1,11.0,3.0,8.0,7
16753,16753,2008-09,2008,2009,Tottenham,Hull,Win,Away,2009-02-23,3,1,4,5,5,2,2,2,2,-1,2,3,3,0,11.0,21.0,-10.0,7
16754,16754,2008-09,2008,2009,Tottenham,Middlesbrough,Win,Home,2009-03-04,3,4,4,7,8,4,4,5,5,0,0,2,3,1,11.0,13.0,-2.0,8
16755,16755,2008-09,2008,2009,Tottenham,Sunderland,Draw,Away,2009-03-07,1,6,7,7,10,1,4,5,8,5,3,2,2,0,11.0,15.0,-4.0,8
16756,16756,2008-09,2008,2009,Tottenham,Aston Villa,Win,Away,2009-03-15,3,4,7,8,8,1,1,4,5,3,6,4,3,0,11.0,6.0,5.0,8
16757,16757,2008-09,2008,2009,Tottenham,Chelsea,Win,Home,2009-03-21,3,4,7,10,11,6,9,12,13,-2,-2,-2,-2,1,11.0,2.0,9.0,8
16758,16758,2008-09,2008,2009,Tottenham,Blackburn,Loss,Away,2009-04-04,0,6,7,10,13,1,4,5,8,5,3,5,5,0,11.0,7.0,4.0,9
16759,16759,2008-09,2008,2009,Tottenham,West Ham,Win,Home,2009-04-11,3,3,6,7,10,4,5,8,11,-1,1,-1,-1,1,11.0,10.0,1.0,9
16760,16760,2008-09,2008,2009,Tottenham,Newcastle,Win,Home,2009-04-19,3,3,6,9,10,1,1,2,2,2,5,7,8,1,11.0,12.0,-1.0,9
16761,16761,2008-09,2008,2009,Tottenham,Man United,Loss,Away,2009-04-25,0,6,6,9,12,6,9,9,9,0,-3,0,3,0,11.0,1.0,10.0,9
16762,16762,2008-09,2008,2009,Tottenham,West Brom,Win,Home,2009-05-02,3,3,6,6,9,3,4,4,5,0,2,2,4,1,11.0,21.0,-10.0,10
16763,16763,2008-09,2008,2009,Tottenham,Everton,Draw,Away,2009-05-09,1,3,6,9,9,3,4,5,8,0,2,4,1,0,11.0,5.0,6.0,10
16764,16764,2008-09,2008,2009,Tottenham,Man City,Win,Home,2009-05-16,3,4,4,7,10,3,6,9,9,1,-2,-2,1,1,11.0,9.0,2.0,10
16765,16765,2008-09,2008,2009,Tottenham,Liverpool,Loss,Away,2009-05-24,0,4,7,7,10,6,9,12,13,-2,-2,-5,-3,0,11.0,4.0,7.0,10
16766,16766,2009-10,2009,2010,Tottenham,Liverpool,Win,Home,2009-08-16,3,3,4,7,7,6,9,12,15,-3,-5,-5,-8,1,8.0,2.0,6.0,1
16767,16767,2009-10,2009,2010,Tottenham,Hull,Win,Away,2009-08-19,3,3,6,7,10,0,1,1,1,3,5,6,9,0,8.0,17.0,-9.0,1
16768,16768,2009-10,2009,2010,Tottenham,West Ham,Win,Away,2009-08-23,3,6,6,9,10,6,6,6,9,0,0,3,1,0,8.0,9.0,-1.0,1
16769,16769,2009-10,2009,2010,Tottenham,Birmingham,Win,Home,2009-08-29,3,6,9,9,12,4,4,7,7,2,5,2,5,1,8.0,21.0,-13.0,1
16770,16770,2009-10,2009,2010,Tottenham,Man United,Loss,Home,2009-09-12,0,6,9,12,12,6,6,9,12,0,3,3,0,1,8.0,1.0,7.0,2
16771,16771,2009-10,2009,2010,Tottenham,Chelsea,Loss,Away,2009-09-20,0,3,6,9,12,6,9,12,15,-3,-3,-3,-3,0,8.0,3.0,5.0,2
16772,16772,2009-10,2009,2010,Tottenham,Burnley,Win,Home,2009-09-26,3,0,3,6,9,3,3,6,9,-3,0,0,0,1,8.0,21.0,-13.0,2
16773,16773,2009-10,2009,2010,Tottenham,Bolton,Draw,Away,2009-10-03,1,3,3,6,9,4,7,7,7,-1,-4,-1,2,0,8.0,13.0,-5.0,3
16774,16774,2009-10,2009,2010,Tottenham,Portsmouth,Win,Away,2009-10-17,3,4,4,4,7,3,3,3,3,1,1,1,4,0,8.0,14.0,-6.0,3
16775,16775,2009-10,2009,2010,Tottenham,Stoke,Loss,Home,2009-10-24,0,4,7,7,7,4,4,5,5,0,3,2,2,1,8.0,12.0,-4.0,3
16776,16776,2009-10,2009,2010,Tottenham,Arsenal,Loss,Away,2009-10-31,0,3,4,7,7,4,7,10,13,-1,-3,-3,-6,0,8.0,4.0,4.0,3
16777,16777,2009-10,2009,2010,Tottenham,Sunderland,Win,Home,2009-11-07,3,0,3,4,7,1,4,5,8,-1,-1,-1,-1,1,8.0,16.0,-8.0,4
16778,16778,2009-10,2009,2010,Tottenham,Wigan,Win,Home,2009-11-22,3,3,3,6,7,1,4,5,5,2,-1,1,2,1,8.0,11.0,-3.0,4
16779,16779,2009-10,2009,2010,Tottenham,Aston Villa,Draw,Away,2009-11-28,1,6,6,6,9,4,4,5,6,2,2,1,3,0,8.0,6.0,2.0,4
16780,16780,2009-10,2009,2010,Tottenham,Everton,Draw,Away,2009-12-06,1,4,7,7,7,0,0,3,4,4,7,4,3,0,8.0,5.0,3.0,5
16781,16781,2009-10,2009,2010,Tottenham,Wolves,Loss,Home,2009-12-12,0,2,5,8,8,3,3,3,4,-1,2,5,4,1,8.0,21.0,-13.0,5
16782,16782,2009-10,2009,2010,Tottenham,Man City,Win,Home,2009-12-16,3,1,2,5,8,4,5,6,7,-3,-3,-1,1,1,8.0,10.0,-2.0,5
16783,16783,2009-10,2009,2010,Tottenham,Blackburn,Win,Away,2009-12-19,3,3,4,5,8,1,2,3,3,2,2,2,5,0,8.0,15.0,-7.0,5
16784,16784,2009-10,2009,2010,Tottenham,Fulham,Draw,Away,2009-12-26,1,6,6,7,8,4,7,8,11,2,-1,-1,-3,0,8.0,7.0,1.0,5
16785,16785,2009-10,2009,2010,Tottenham,West Ham,Win,Home,2009-12-28,3,4,7,7,8,4,4,4,4,0,3,3,4,1,8.0,9.0,-1.0,5
16786,16786,2009-10,2009,2010,Tottenham,Hull,Draw,Home,2010-01-16,1,4,7,10,10,1,1,2,2,3,6,8,8,1,8.0,17.0,-9.0,6
16787,16787,2009-10,2009,2010,Tottenham,Liverpool,Loss,Away,2010-01-20,0,4,5,8,11,4,7,7,10,0,-2,1,1,0,8.0,2.0,6.0,6
16788,16788,2009-10,2009,2010,Tottenham,Fulham,Win,Home,2010-01-26,3,1,4,5,8,0,0,1,4,1,4,4,4,1,8.0,7.0,1.0,6
16789,16789,2009-10,2009,2010,Tottenham,Birmingham,Draw,Away,2010-01-30,1,3,4,7,8,1,4,5,6,2,0,2,2,0,8.0,21.0,-13.0,6
16790,16790,2009-10,2009,2010,Tottenham,Aston Villa,Draw,Home,2010-02-06,1,4,4,5,8,4,5,5,5,0,-1,0,3,1,8.0,6.0,2.0,7
16791,16791,2009-10,2009,2010,Tottenham,Wolves,Loss,Away,2010-02-10,0,2,5,5,6,1,2,2,2,1,3,3,4,0,8.0,21.0,-13.0,7
16792,16792,2009-10,2009,2010,Tottenham,Wigan,Win,Away,2010-02-21,3,1,2,5,5,2,3,3,3,-1,-1,2,2,0,8.0,11.0,-3.0,7
16793,16793,2009-10,2009,2010,Tottenham,Everton,Win,Home,2010-02-28,3,3,4,5,8,6,6,9,12,-3,-2,-4,-4,1,8.0,5.0,3.0,7
16794,16794,2009-10,2009,2010,Tottenham,Blackburn,Win,Home,2010-03-13,3,6,6,7,8,3,6,6,7,3,0,1,1,1,8.0,15.0,-7.0,8
16795,16795,2009-10,2009,2010,Tottenham,Stoke,Win,Away,2010-03-20,3,6,9,9,10,2,2,5,6,4,7,4,4,0,8.0,12.0,-4.0,8
16796,16796,2009-10,2009,2010,Tottenham,Portsmouth,Win,Home,2010-03-27,3,6,9,12,12,3,3,3,6,3,6,9,6,1,8.0,14.0,-6.0,8
16797,16797,2009-10,2009,2010,Tottenham,Sunderland,Loss,Away,2010-04-03,0,6,9,12,15,1,4,5,8,5,5,7,7,0,8.0,16.0,-8.0,9
16798,16798,2009-10,2009,2010,Tottenham,Arsenal,Win,Home,2010-04-14,3,3,6,9,12,4,7,10,13,-1,-1,-1,-1,1,8.0,4.0,4.0,9
16799,16799,2009-10,2009,2010,Tottenham,Chelsea,Win,Home,2010-04-17,3,3,6,9,12,6,9,12,13,-3,-3,-3,-1,1,8.0,3.0,5.0,9
16800,16800,2009-10,2009,2010,Tottenham,Man United,Loss,Away,2010-04-24,0,6,6,9,12,4,4,7,10,2,2,2,2,0,8.0,1.0,7.0,9
16801,16801,2009-10,2009,2010,Tottenham,Bolton,Win,Home,2010-05-01,3,3,6,6,9,4,4,4,4,-1,2,2,5,1,8.0,13.0,-5.0,10
16802,16802,2009-10,2009,2010,Tottenham,Man City,Win,Away,2010-05-05,3,3,6,9,9,4,4,7,10,-1,2,2,-1,0,8.0,10.0,-2.0,10
16803,16803,2009-10,2009,2010,Tottenham,Burnley,Loss,Away,2010-05-09,0,6,6,9,12,0,0,3,3,6,6,6,9,0,8.0,21.0,-13.0,10
16804,16804,2010-11,2010,2011,Tottenham,Man City,Draw,Home,2010-08-14,1,3,6,6,9,1,4,5,5,2,2,1,4,1,4.0,5.0,-1.0,1
16805,16805,2010-11,2010,2011,Tottenham,Stoke,Win,Away,2010-08-21,3,1,4,7,7,0,3,4,4,1,1,3,3,0,4.0,11.0,-7.0,1
16806,16806,2010-11,2010,2011,Tottenham,Wigan,Loss,Home,2010-08-28,0,4,4,7,10,0,0,1,1,4,4,6,9,1,4.0,16.0,-12.0,1
16807,16807,2010-11,2010,2011,Tottenham,West Brom,Draw,Away,2010-09-11,1,3,4,4,7,3,3,4,4,0,1,0,3,0,4.0,21.0,-17.0,2
16808,16808,2010-11,2010,2011,Tottenham,Wolves,Win,Home,2010-09-18,3,1,4,5,5,1,2,5,8,0,2,0,-3,1,4.0,15.0,-11.0,2
16809,16809,2010-11,2010,2011,Tottenham,West Ham,Loss,Away,2010-09-25,0,4,4,7,8,1,1,1,1,3,3,6,7,0,4.0,17.0,-13.0,2
16810,16810,2010-11,2010,2011,Tottenham,Aston Villa,Win,Home,2010-10-02,3,3,4,4,7,4,4,7,7,-1,0,-3,0,1,4.0,6.0,-2.0,3
16811,16811,2010-11,2010,2011,Tottenham,Fulham,Win,Away,2010-10-16,3,3,6,7,7,2,3,6,7,1,3,1,0,0,4.0,12.0,-8.0,3
16812,16812,2010-11,2010,2011,Tottenham,Everton,Draw,Home,2010-10-23,1,6,6,9,10,6,7,7,8,0,-1,2,2,1,4.0,8.0,-4.0,3
16813,16813,2010-11,2010,2011,Tottenham,Man United,Loss,Away,2010-10-30,0,4,7,7,10,4,5,6,9,0,2,1,1,0,4.0,2.0,2.0,3
16814,16814,2010-11,2010,2011,Tottenham,Bolton,Loss,Away,2010-11-06,0,1,4,7,7,1,4,5,6,0,0,2,1,0,4.0,14.0,-10.0,4
16815,16815,2010-11,2010,2011,Tottenham,Sunderland,Draw,Home,2010-11-09,1,0,1,4,7,3,6,7,8,-3,-5,-3,-1,1,4.0,13.0,-9.0,4
16816,16816,2010-11,2010,2011,Tottenham,Blackburn,Win,Home,2010-11-13,3,1,1,2,5,6,6,6,7,-5,-5,-4,-2,1,4.0,10.0,-6.0,4
16817,16817,2010-11,2010,2011,Tottenham,Arsenal,Win,Away,2010-11-20,3,4,4,4,5,6,6,9,12,-2,-2,-5,-7,0,4.0,3.0,1.0,4
16818,16818,2010-11,2010,2011,Tottenham,Liverpool,Win,Home,2010-11-28,3,6,7,7,7,3,4,7,10,3,3,0,-3,1,4.0,7.0,-3.0,4
16819,16819,2010-11,2010,2011,Tottenham,Birmingham,Draw,Away,2010-12-04,1,6,9,10,10,4,5,5,6,2,4,5,4,0,4.0,9.0,-5.0,5
16820,16820,2010-11,2010,2011,Tottenham,Chelsea,Draw,Home,2010-12-12,1,4,7,10,11,2,2,2,5,2,5,8,6,1,4.0,1.0,3.0,5
16821,16821,2010-11,2010,2011,Tottenham,Aston Villa,Win,Away,2010-12-26,3,2,5,8,11,3,3,3,4,-1,2,5,7,0,4.0,6.0,-2.0,5
16822,16822,2010-11,2010,2011,Tottenham,Newcastle,Win,Home,2010-12-28,3,4,5,8,11,3,3,4,4,1,2,4,7,1,4.0,21.0,-17.0,5
16823,16823,2010-11,2010,2011,Tottenham,Fulham,Win,Home,2011-01-01,3,6,7,8,11,3,4,4,5,3,3,4,6,1,4.0,12.0,-8.0,6
16824,16824,2010-11,2010,2011,Tottenham,Everton,Loss,Away,2011-01-05,0,6,9,10,11,1,4,5,6,5,5,5,5,0,4.0,8.0,-4.0,6
16825,16825,2010-11,2010,2011,Tottenham,Man United,Draw,Home,2011-01-16,1,3,6,9,10,6,7,10,13,-3,-1,-1,-3,1,4.0,2.0,2.0,6
16826,16826,2010-11,2010,2011,Tottenham,Newcastle,Draw,Away,2011-01-22,1,1,4,7,10,4,7,7,7,-3,-3,0,3,0,4.0,21.0,-17.0,6
16827,16827,2010-11,2010,2011,Tottenham,Blackburn,Win,Away,2011-02-02,3,2,2,5,8,3,6,6,9,-1,-4,-1,-1,0,4.0,10.0,-6.0,7
16828,16828,2010-11,2010,2011,Tottenham,Bolton,Win,Home,2011-02-05,3,4,5,5,8,3,3,4,4,1,2,1,4,1,4.0,14.0,-10.0,7
16829,16829,2010-11,2010,2011,Tottenham,Sunderland,Win,Away,2011-02-12,3,6,7,8,8,0,3,4,7,6,4,4,1,0,4.0,13.0,-9.0,7
16830,16830,2010-11,2010,2011,Tottenham,Blackpool,Loss,Away,2011-02-22,0,6,9,10,11,1,1,1,1,5,8,9,10,0,4.0,21.0,-17.0,7
16831,16831,2010-11,2010,2011,Tottenham,Wolves,Draw,Away,2011-03-06,1,3,6,9,10,4,4,7,7,-1,2,2,3,0,4.0,15.0,-11.0,8
16832,16832,2010-11,2010,2011,Tottenham,West Ham,Draw,Home,2011-03-19,1,1,4,7,10,6,7,7,10,-5,-3,0,0,1,4.0,17.0,-13.0,8
16833,16833,2010-11,2010,2011,Tottenham,Wigan,Draw,Away,2011-04-02,1,2,2,5,8,3,3,4,7,-1,-1,1,1,0,4.0,16.0,-12.0,9
16834,16834,2010-11,2010,2011,Tottenham,Stoke,Win,Home,2011-04-09,3,2,3,3,6,4,4,5,5,-2,-1,-2,1,1,4.0,11.0,-7.0,9
16835,16835,2010-11,2010,2011,Tottenham,Arsenal,Draw,Home,2011-04-20,1,4,5,6,6,4,5,6,7,0,0,0,-1,1,4.0,3.0,1.0,9
16836,16836,2010-11,2010,2011,Tottenham,West Brom,Draw,Home,2011-04-23,1,4,5,6,7,3,6,7,10,1,-1,-1,-3,1,4.0,21.0,-17.0,9
16837,16837,2010-11,2010,2011,Tottenham,Chelsea,Loss,Away,2011-04-30,0,2,5,6,7,6,9,12,13,-4,-4,-6,-6,0,4.0,1.0,3.0,9
16838,16838,2010-11,2010,2011,Tottenham,Blackpool,Draw,Home,2011-05-07,1,1,2,5,6,2,2,2,2,-1,0,3,4,1,4.0,21.0,-17.0,10
16839,16839,2010-11,2010,2011,Tottenham,Man City,Loss,Away,2011-05-10,0,1,2,3,6,3,6,6,9,-2,-4,-3,-3,0,4.0,5.0,-1.0,10
16840,16840,2010-11,2010,2011,Tottenham,Liverpool,Win,Away,2011-05-15,3,1,1,2,3,6,9,10,13,-5,-8,-8,-10,0,4.0,7.0,-3.0,10
16841,16841,2010-11,2010,2011,Tottenham,Birmingham,Win,Home,2011-05-22,3,3,4,4,5,0,1,1,1,3,3,3,4,1,4.0,9.0,-5.0,10
16842,16842,2011-12,2011,2012,Tottenham,Man United,Loss,Away,2011-08-22,0,6,6,7,7,6,7,10,10,0,-1,-3,-3,0,5.0,1.0,4.0,1
16843,16843,2011-12,2011,2012,Tottenham,Man City,Loss,Home,2011-08-28,0,3,6,6,7,6,9,12,15,-3,-3,-6,-8,1,5.0,3.0,2.0,1
16844,16844,2011-12,2011,2012,Tottenham,Wolves,Win,Away,2011-09-10,3,0,3,6,6,4,7,7,10,-4,-4,-1,-4,0,5.0,17.0,-12.0,2
16845,16845,2011-12,2011,2012,Tottenham,Liverpool,Win,Home,2011-09-18,3,3,3,6,9,3,6,7,7,0,-3,-1,2,1,5.0,6.0,-1.0,2
16846,16846,2011-12,2011,2012,Tottenham,Wigan,Win,Away,2011-09-24,3,6,6,6,9,0,3,4,5,6,3,2,4,0,5.0,16.0,-11.0,2
16847,16847,2011-12,2011,2012,Tottenham,Arsenal,Win,Home,2011-10-02,3,6,9,9,9,3,6,6,6,3,3,3,3,1,5.0,4.0,1.0,3
16848,16848,2011-12,2011,2012,Tottenham,Newcastle,Draw,Away,2011-10-16,1,6,9,12,12,6,7,8,11,0,2,4,1,0,5.0,12.0,-7.0,3
16849,16849,2011-12,2011,2012,Tottenham,Blackburn,Win,Away,2011-10-23,3,4,7,10,13,1,1,4,5,3,6,6,8,0,5.0,15.0,-10.0,3
16850,16850,2011-12,2011,2012,Tottenham,QPR,Win,Home,2011-10-30,3,4,7,10,13,4,4,5,8,0,3,5,5,1,5.0,21.0,-16.0,3
16851,16851,2011-12,2011,2012,Tottenham,Fulham,Win,Away,2011-11-06,3,6,7,10,13,3,3,6,7,3,4,4,6,0,5.0,8.0,-3.0,4
16852,16852,2011-12,2011,2012,Tottenham,Aston Villa,Win,Home,2011-11-21,3,6,9,10,13,4,4,4,7,2,5,6,6,1,5.0,9.0,-4.0,4
16853,16853,2011-12,2011,2012,Tottenham,West Brom,Win,Away,2011-11-26,3,6,9,12,13,3,3,6,9,3,6,6,4,0,5.0,11.0,-6.0,4
16854,16854,2011-12,2011,2012,Tottenham,Bolton,Win,Home,2011-12-03,3,6,9,12,15,0,3,3,3,6,6,9,12,1,5.0,14.0,-9.0,5
16855,16855,2011-12,2011,2012,Tottenham,Stoke,Loss,Away,2011-12-11,0,6,9,12,15,6,6,6,6,0,3,6,9,0,5.0,13.0,-8.0,5
16856,16856,2011-12,2011,2012,Tottenham,Sunderland,Win,Home,2011-12-18,3,3,6,9,12,3,3,4,4,0,3,5,8,1,5.0,10.0,-5.0,5
16857,16857,2011-12,2011,2012,Tottenham,Chelsea,Draw,Home,2011-12-22,1,3,6,9,12,4,7,10,10,-1,-1,-1,2,1,5.0,2.0,3.0,5
16858,16858,2011-12,2011,2012,Tottenham,Norwich,Win,Away,2011-12-27,3,4,4,7,10,2,5,5,8,2,-1,2,2,0,5.0,21.0,-16.0,5
16859,16859,2011-12,2011,2012,Tottenham,Swansea,Draw,Away,2011-12-31,1,4,7,7,10,1,2,5,5,3,5,2,5,0,5.0,21.0,-16.0,5
16860,16860,2011-12,2011,2012,Tottenham,West Brom,Win,Home,2012-01-03,3,4,5,8,8,1,4,7,7,3,1,1,1,1,5.0,11.0,-6.0,6
16861,16861,2011-12,2011,2012,Tottenham,Everton,Win,Home,2012-01-11,3,4,7,8,11,3,4,7,8,1,3,1,3,1,5.0,7.0,-2.0,6
16862,16862,2011-12,2011,2012,Tottenham,Wolves,Draw,Home,2012-01-14,1,6,7,10,11,1,2,3,3,5,5,7,8,1,5.0,17.0,-12.0,6
16863,16863,2011-12,2011,2012,Tottenham,Man City,Loss,Away,2012-01-22,0,4,7,8,11,6,6,7,10,-2,1,1,1,0,5.0,3.0,2.0,6
16864,16864,2011-12,2011,2012,Tottenham,Wigan,Win,Home,2012-01-31,3,1,4,7,8,0,0,1,1,1,4,6,7,1,5.0,16.0,-11.0,6
16865,16865,2011-12,2011,2012,Tottenham,Liverpool,Draw,Away,2012-02-06,1,3,4,7,10,3,4,4,7,0,0,3,3,0,5.0,6.0,-1.0,7
16866,16866,2011-12,2011,2012,Tottenham,Newcastle,Win,Home,2012-02-11,3,4,4,5,8,6,6,9,12,-2,-2,-4,-4,1,5.0,12.0,-7.0,7
16867,16867,2011-12,2011,2012,Tottenham,Arsenal,Loss,Away,2012-02-26,0,4,7,7,8,6,7,7,7,-2,0,0,1,0,5.0,4.0,1.0,7
16868,16868,2011-12,2011,2012,Tottenham,Man United,Loss,Home,2012-03-04,0,3,4,7,7,6,7,10,13,-3,-3,-3,-6,1,5.0,1.0,4.0,8
16869,16869,2011-12,2011,2012,Tottenham,Everton,Loss,Away,2012-03-10,0,0,3,4,7,4,5,8,9,-4,-2,-4,-2,0,5.0,7.0,-2.0,8
16870,16870,2011-12,2011,2012,Tottenham,Stoke,Draw,Home,2012-03-21,1,0,0,3,4,3,6,6,6,-3,-6,-3,-2,1,5.0,13.0,-8.0,8
16871,16871,2011-12,2011,2012,Tottenham,Chelsea,Draw,Away,2012-03-24,1,1,1,1,4,3,3,6,6,-2,-2,-5,-2,0,5.0,2.0,3.0,8
16872,16872,2011-12,2011,2012,Tottenham,Swansea,Win,Home,2012-04-01,3,2,2,2,2,3,6,9,9,-1,-4,-7,-7,1,5.0,21.0,-16.0,9
16873,16873,2011-12,2011,2012,Tottenham,Sunderland,Draw,Away,2012-04-07,1,4,5,5,5,4,4,7,8,0,1,-2,-3,0,5.0,10.0,-5.0,9
16874,16874,2011-12,2011,2012,Tottenham,Norwich,Loss,Home,2012-04-09,0,4,5,6,6,1,4,4,5,3,1,2,1,1,5.0,21.0,-16.0,9
16875,16875,2011-12,2011,2012,Tottenham,QPR,Loss,Away,2012-04-21,0,1,4,5,6,3,3,6,6,-2,1,-1,0,0,5.0,21.0,-16.0,9
16876,16876,2011-12,2011,2012,Tottenham,Blackburn,Win,Home,2012-04-29,3,0,1,4,5,3,3,3,3,-3,-2,1,2,1,5.0,15.0,-10.0,9
16877,16877,2011-12,2011,2012,Tottenham,Bolton,Win,Away,2012-05-02,3,3,3,4,7,4,5,5,5,-1,-2,-1,2,0,5.0,14.0,-9.0,10
16878,16878,2011-12,2011,2012,Tottenham,Aston Villa,Draw,Away,2012-05-06,1,6,6,6,7,1,2,2,3,5,4,4,4,0,5.0,9.0,-4.0,10
16879,16879,2011-12,2011,2012,Tottenham,Fulham,Win,Home,2012-05-13,3,4,7,7,7,6,6,9,10,-2,1,-2,-3,1,5.0,8.0,-3.0,10
16880,16880,2012-13,2012,2013,Tottenham,Newcastle,Loss,Away,2012-08-18,0,4,7,10,10,0,3,3,6,4,4,7,4,0,4.0,5.0,-1.0,1
16881,16881,2012-13,2012,2013,Tottenham,West Brom,Draw,Home,2012-08-25,1,3,4,7,10,3,4,5,8,0,0,2,2,1,4.0,10.0,-6.0,1
16882,16882,2012-13,2012,2013,Tottenham,Norwich,Draw,Home,2012-09-01,1,1,4,5,8,1,4,5,5,0,0,0,3,1,4.0,12.0,-8.0,2
16883,16883,2012-13,2012,2013,Tottenham,Reading,Win,Away,2012-09-16,3,2,2,5,6,1,4,4,5,1,-2,1,1,0,4.0,21.0,-17.0,2
16884,16884,2012-13,2012,2013,Tottenham,QPR,Win,Home,2012-09-23,3,4,5,5,8,1,2,2,2,3,3,3,6,1,4.0,17.0,-13.0,2
16885,16885,2012-13,2012,2013,Tottenham,Man United,Win,Away,2012-09-29,3,6,7,8,8,6,9,12,12,0,-2,-4,-4,0,4.0,2.0,2.0,2
16886,16886,2012-13,2012,2013,Tottenham,Aston Villa,Win,Home,2012-10-07,3,6,9,10,11,1,4,5,5,5,5,5,6,1,4.0,16.0,-12.0,3
16887,16887,2012-13,2012,2013,Tottenham,Chelsea,Loss,Home,2012-10-20,0,6,9,12,13,6,9,10,13,0,0,2,0,1,4.0,6.0,-2.0,3
16888,16888,2012-13,2012,2013,Tottenham,Southampton,Win,Away,2012-10-28,3,3,6,9,12,1,1,4,4,2,5,5,8,0,4.0,21.0,-17.0,3
16889,16889,2012-13,2012,2013,Tottenham,Wigan,Loss,Home,2012-11-03,0,3,6,9,12,3,4,4,4,0,2,5,8,1,4.0,15.0,-11.0,4
16890,16890,2012-13,2012,2013,Tottenham,Man City,Loss,Away,2012-11-11,0,3,3,6,9,4,7,10,13,-1,-4,-4,-4,0,4.0,1.0,3.0,4
16891,16891,2012-13,2012,2013,Tottenham,Arsenal,Loss,Away,2012-11-17,0,0,3,3,6,1,4,4,7,-1,-1,-1,-1,0,4.0,3.0,1.0,4
16892,16892,2012-13,2012,2013,Tottenham,West Ham,Win,Home,2012-11-25,3,0,0,3,3,4,5,5,8,-4,-5,-2,-5,1,4.0,21.0,-17.0,4
16893,16893,2012-13,2012,2013,Tottenham,Liverpool,Win,Home,2012-11-28,3,3,3,3,6,4,5,6,7,-1,-2,-3,-1,1,4.0,8.0,-4.0,4
16894,16894,2012-13,2012,2013,Tottenham,Fulham,Win,Away,2012-12-01,3,6,6,6,6,1,1,2,3,5,5,4,3,0,4.0,9.0,-5.0,5
16895,16895,2012-13,2012,2013,Tottenham,Everton,Loss,Away,2012-12-09,0,6,9,9,9,2,3,3,6,4,6,6,3,0,4.0,7.0,-3.0,5
16896,16896,2012-13,2012,2013,Tottenham,Swansea,Win,Home,2012-12-16,3,3,6,9,9,3,6,7,10,0,0,2,-1,1,4.0,11.0,-7.0,5
16897,16897,2012-13,2012,2013,Tottenham,Stoke,Draw,Home,2012-12-22,1,3,6,9,12,2,5,8,11,1,1,1,1,1,4.0,14.0,-10.0,5
16898,16898,2012-13,2012,2013,Tottenham,Aston Villa,Win,Away,2012-12-26,3,4,4,7,10,3,4,5,8,1,0,2,2,0,4.0,16.0,-12.0,5
16899,16899,2012-13,2012,2013,Tottenham,Sunderland,Win,Away,2012-12-29,3,4,7,7,10,6,6,9,9,-2,1,-2,1,0,4.0,13.0,-9.0,5
16900,16900,2012-13,2012,2013,Tottenham,Reading,Win,Home,2013-01-01,3,6,7,10,10,4,4,4,4,2,3,6,6,1,4.0,21.0,-17.0,6
16901,16901,2012-13,2012,2013,Tottenham,QPR,Draw,Away,2013-01-12,1,6,9,10,13,3,3,3,6,3,6,7,7,0,4.0,17.0,-13.0,6
16902,16902,2012-13,2012,2013,Tottenham,Man United,Draw,Home,2013-01-20,1,4,7,10,11,6,9,12,13,-2,-2,-2,-2,1,4.0,2.0,2.0,6
16903,16903,2012-13,2012,2013,Tottenham,Norwich,Draw,Away,2013-01-30,1,2,5,8,11,1,1,1,1,1,4,7,10,0,4.0,12.0,-8.0,6
16904,16904,2012-13,2012,2013,Tottenham,West Brom,Win,Away,2013-02-03,3,2,3,6,9,1,1,1,1,1,2,5,8,0,4.0,10.0,-6.0,7
16905,16905,2012-13,2012,2013,Tottenham,Newcastle,Win,Home,2013-02-09,3,4,5,6,9,6,6,7,7,-2,-1,-1,2,1,4.0,5.0,-1.0,7
16906,16906,2012-13,2012,2013,Tottenham,West Ham,Win,Away,2013-02-25,3,6,7,8,9,3,3,3,4,3,4,5,5,0,4.0,21.0,-17.0,7
16907,16907,2012-13,2012,2013,Tottenham,Arsenal,Win,Home,2013-03-03,3,6,9,10,11,6,9,10,13,0,0,0,-2,1,4.0,3.0,1.0,8
16908,16908,2012-13,2012,2013,Tottenham,Liverpool,Loss,Away,2013-03-10,0,6,9,12,13,6,6,7,8,0,3,5,5,0,4.0,8.0,-4.0,8
16909,16909,2012-13,2012,2013,Tottenham,Fulham,Loss,Home,2013-03-17,0,3,6,9,12,4,5,5,8,-1,1,4,4,1,4.0,9.0,-5.0,8
16910,16910,2012-13,2012,2013,Tottenham,Swansea,Win,Away,2013-03-30,3,0,3,6,9,0,3,3,6,0,0,3,3,0,4.0,11.0,-7.0,8
16911,16911,2012-13,2012,2013,Tottenham,Everton,Draw,Home,2013-04-07,1,3,3,6,9,6,9,9,9,-3,-6,-3,0,1,4.0,7.0,-3.0,9
16912,16912,2012-13,2012,2013,Tottenham,Man City,Win,Home,2013-04-21,3,4,4,4,7,6,9,9,12,-2,-5,-5,-5,1,4.0,1.0,3.0,9
16913,16913,2012-13,2012,2013,Tottenham,Wigan,Draw,Away,2013-04-27,1,4,7,7,7,0,1,4,7,4,6,3,0,0,4.0,15.0,-11.0,9
16914,16914,2012-13,2012,2013,Tottenham,Southampton,Win,Home,2013-05-04,3,4,5,8,8,1,2,5,8,3,3,3,0,1,4.0,21.0,-17.0,10
16915,16915,2012-13,2012,2013,Tottenham,Chelsea,Draw,Away,2013-05-08,1,4,7,8,11,6,7,10,13,-2,0,-2,-2,0,4.0,6.0,-2.0,10
16916,16916,2012-13,2012,2013,Tottenham,Stoke,Win,Away,2013-05-12,3,4,5,8,9,4,7,7,7,0,-2,1,2,0,4.0,14.0,-10.0,10
16917,16917,2012-13,2012,2013,Tottenham,Sunderland,Win,Home,2013-05-19,3,4,7,8,11,2,2,5,8,2,5,3,3,1,4.0,13.0,-9.0,10
16918,16918,2013-14,2013,2014,Tottenham,Crystal Palace,Win,Away,2013-08-18,3,6,7,10,11,2,3,6,6,4,4,4,5,0,5.0,21.0,-16.0,1
16919,16919,2013-14,2013,2014,Tottenham,Swansea,Win,Home,2013-08-25,3,6,9,10,13,0,0,3,4,6,9,7,9,1,5.0,9.0,-4.0,1
16920,16920,2013-14,2013,2014,Tottenham,Arsenal,Loss,Away,2013-09-01,0,6,9,12,13,3,6,9,12,3,3,3,1,0,5.0,4.0,1.0,2
16921,16921,2013-14,2013,2014,Tottenham,Norwich,Win,Home,2013-09-14,3,3,6,9,12,3,4,7,10,0,2,2,2,1,5.0,11.0,-6.0,2
16922,16922,2013-14,2013,2014,Tottenham,Cardiff,Win,Away,2013-09-22,3,3,6,9,12,2,5,5,5,1,1,4,7,0,5.0,21.0,-16.0,2
16923,16923,2013-14,2013,2014,Tottenham,Chelsea,Draw,Home,2013-09-28,1,6,6,9,12,3,4,7,10,3,2,2,2,1,5.0,3.0,2.0,2
16924,16924,2013-14,2013,2014,Tottenham,West Ham,Loss,Home,2013-10-06,0,4,7,7,10,0,1,1,2,4,6,6,8,1,5.0,10.0,-5.0,3
16925,16925,2013-14,2013,2014,Tottenham,Aston Villa,Win,Away,2013-10-20,3,1,4,7,7,4,7,7,7,-3,-3,0,0,0,5.0,15.0,-10.0,3
16926,16926,2013-14,2013,2014,Tottenham,Hull,Win,Home,2013-10-27,3,3,4,7,10,1,4,7,8,2,0,0,2,1,5.0,21.0,-16.0,3
16927,16927,2013-14,2013,2014,Tottenham,Everton,Draw,Away,2013-11-03,1,6,6,7,10,6,6,9,12,0,0,-2,-2,0,5.0,6.0,-1.0,4
16928,16928,2013-14,2013,2014,Tottenham,Newcastle,Loss,Home,2013-11-10,0,4,7,7,8,3,4,7,7,1,3,0,1,1,5.0,16.0,-11.0,4
16929,16929,2013-14,2013,2014,Tottenham,Man City,Loss,Away,2013-11-24,0,1,4,7,7,3,3,6,9,-2,1,1,-2,0,5.0,2.0,3.0,4
16930,16930,2013-14,2013,2014,Tottenham,Man United,Draw,Home,2013-12-01,1,0,1,4,7,4,7,10,11,-4,-6,-6,-4,1,5.0,1.0,4.0,5
16931,16931,2013-14,2013,2014,Tottenham,Fulham,Win,Away,2013-12-04,3,1,1,2,5,0,0,0,0,1,1,2,5,0,5.0,12.0,-7.0,5
16932,16932,2013-14,2013,2014,Tottenham,Sunderland,Win,Away,2013-12-07,3,4,4,4,5,1,1,4,4,3,3,0,1,0,5.0,17.0,-12.0,5
16933,16933,2013-14,2013,2014,Tottenham,Liverpool,Loss,Home,2013-12-15,0,6,7,7,7,6,6,7,10,0,1,0,-3,1,5.0,7.0,-2.0,5
16934,16934,2013-14,2013,2014,Tottenham,Southampton,Win,Away,2013-12-22,3,3,6,7,7,2,2,2,2,1,4,5,5,0,5.0,14.0,-9.0,5
16935,16935,2013-14,2013,2014,Tottenham,West Brom,Draw,Home,2013-12-26,1,3,6,9,10,1,1,1,1,2,5,8,9,1,5.0,8.0,-3.0,5
16936,16936,2013-14,2013,2014,Tottenham,Stoke,Win,Home,2013-12-29,3,4,4,7,10,3,4,7,8,1,0,0,2,1,5.0,13.0,-8.0,5
16937,16937,2013-14,2013,2014,Tottenham,Man United,Win,Away,2014-01-01,3,4,7,7,10,6,9,12,12,-2,-2,-5,-2,0,5.0,1.0,4.0,6
16938,16938,2013-14,2013,2014,Tottenham,Crystal Palace,Win,Home,2014-01-11,3,6,7,10,10,1,4,4,4,5,3,6,6,1,5.0,21.0,-16.0,6
16939,16939,2013-14,2013,2014,Tottenham,Swansea,Win,Away,2014-01-19,3,6,9,10,13,0,1,1,1,6,8,9,12,0,5.0,9.0,-4.0,6
16940,16940,2013-14,2013,2014,Tottenham,Man City,Loss,Home,2014-01-29,0,6,9,12,13,6,9,12,15,0,0,0,-2,1,5.0,2.0,3.0,6
16941,16941,2013-14,2013,2014,Tottenham,Hull,Draw,Away,2014-02-01,1,3,6,9,12,0,0,0,3,3,6,9,9,0,5.0,21.0,-16.0,7
16942,16942,2013-14,2013,2014,Tottenham,Everton,Win,Home,2014-02-09,3,1,4,7,10,3,4,7,8,-2,0,0,2,1,5.0,6.0,-1.0,7
16943,16943,2013-14,2013,2014,Tottenham,Newcastle,Win,Away,2014-02-12,3,4,4,7,10,0,1,4,4,4,3,3,6,0,5.0,16.0,-11.0,7
16944,16944,2013-14,2013,2014,Tottenham,Norwich,Loss,Away,2014-02-23,0,6,7,7,10,1,1,2,5,5,6,5,5,0,5.0,11.0,-6.0,7
16945,16945,2013-14,2013,2014,Tottenham,Cardiff,Win,Home,2014-03-02,3,3,6,7,7,1,1,4,4,2,5,3,3,1,5.0,21.0,-16.0,8
16946,16946,2013-14,2013,2014,Tottenham,Chelsea,Loss,Away,2014-03-08,0,3,6,9,10,6,7,10,13,-3,-1,-1,-3,0,5.0,3.0,2.0,8
16947,16947,2013-14,2013,2014,Tottenham,Arsenal,Loss,Home,2014-03-16,0,3,3,6,9,3,4,4,7,0,-1,2,2,1,5.0,4.0,1.0,8
16948,16948,2013-14,2013,2014,Tottenham,Southampton,Win,Home,2014-03-23,3,0,3,3,6,6,6,6,9,-6,-3,-3,-3,1,5.0,14.0,-9.0,8
16949,16949,2013-14,2013,2014,Tottenham,Liverpool,Loss,Away,2014-03-30,0,3,3,6,6,6,9,12,15,-3,-6,-6,-9,0,5.0,7.0,-2.0,8
16950,16950,2013-14,2013,2014,Tottenham,Sunderland,Win,Home,2014-04-07,3,3,3,3,6,0,0,1,1,3,3,2,5,1,5.0,17.0,-12.0,9
16951,16951,2013-14,2013,2014,Tottenham,West Brom,Draw,Away,2014-04-12,1,3,6,6,6,4,4,7,7,-1,2,-1,-1,0,5.0,8.0,-3.0,9
16952,16952,2013-14,2013,2014,Tottenham,Fulham,Win,Home,2014-04-19,3,4,4,7,7,6,6,6,9,-2,-2,1,-2,1,5.0,12.0,-7.0,9
16953,16953,2013-14,2013,2014,Tottenham,Stoke,Win,Away,2014-04-26,3,4,7,7,10,4,4,7,10,0,3,0,0,0,5.0,13.0,-8.0,9
16954,16954,2013-14,2013,2014,Tottenham,West Ham,Loss,Away,2014-05-03,0,6,7,10,10,0,0,0,3,6,7,10,7,0,5.0,10.0,-5.0,10
16955,16955,2013-14,2013,2014,Tottenham,Aston Villa,Win,Home,2014-05-11,3,3,6,7,10,3,3,4,4,0,3,3,6,1,5.0,15.0,-10.0,10
16956,16956,2014-15,2014,2015,Tottenham,West Ham,Win,Away,2014-08-16,3,3,6,9,10,3,3,3,3,0,3,6,7,0,6.0,13.0,-7.0,1
16957,16957,2014-15,2014,2015,Tottenham,QPR,Win,Home,2014-08-24,3,6,6,9,12,0,0,0,1,6,6,9,11,1,6.0,21.0,-15.0,1
16958,16958,2014-15,2014,2015,Tottenham,Liverpool,Loss,Home,2014-08-31,0,6,9,9,12,3,6,7,7,3,3,2,5,1,6.0,2.0,4.0,1
16959,16959,2014-15,2014,2015,Tottenham,Sunderland,Draw,Away,2014-09-13,1,3,6,9,9,1,2,2,5,2,4,7,4,0,6.0,14.0,-8.0,2
16960,16960,2014-15,2014,2015,Tottenham,West Brom,Loss,Home,2014-09-21,0,1,4,7,10,0,1,2,2,1,3,5,8,1,6.0,17.0,-11.0,2
16961,16961,2014-15,2014,2015,Tottenham,Arsenal,Draw,Away,2014-09-27,1,1,1,4,7,4,5,6,9,-3,-4,-2,-2,0,6.0,4.0,2.0,2
16962,16962,2014-15,2014,2015,Tottenham,Southampton,Win,Home,2014-10-05,3,1,2,2,5,6,9,12,13,-5,-7,-10,-8,1,6.0,8.0,-2.0,3
16963,16963,2014-15,2014,2015,Tottenham,Man City,Loss,Away,2014-10-18,0,4,4,5,5,6,7,8,8,-2,-3,-3,-3,0,6.0,1.0,5.0,3
16964,16964,2014-15,2014,2015,Tottenham,Newcastle,Loss,Home,2014-10-26,0,3,4,4,5,4,4,5,5,-1,0,-1,0,1,6.0,10.0,-4.0,3
16965,16965,2014-15,2014,2015,Tottenham,Aston Villa,Win,Away,2014-11-02,3,0,3,4,4,0,0,0,0,0,3,4,4,0,6.0,15.0,-9.0,4
16966,16966,2014-15,2014,2015,Tottenham,Stoke,Loss,Home,2014-11-09,0,3,3,6,7,1,4,4,7,2,-1,2,0,1,6.0,9.0,-3.0,4
16967,16967,2014-15,2014,2015,Tottenham,Hull,Win,Away,2014-11-23,3,3,3,3,6,0,1,2,5,3,2,1,1,0,6.0,16.0,-10.0,4
16968,16968,2014-15,2014,2015,Tottenham,Everton,Win,Home,2014-11-30,3,3,6,6,6,4,5,8,11,-1,1,-2,-5,1,6.0,5.0,1.0,4
16969,16969,2014-15,2014,2015,Tottenham,Chelsea,Loss,Away,2014-12-03,0,6,6,9,9,4,7,10,11,2,-1,-1,-2,0,6.0,3.0,3.0,5
16970,16970,2014-15,2014,2015,Tottenham,Crystal Palace,Draw,Home,2014-12-06,1,3,6,6,9,1,4,4,4,2,2,2,5,1,6.0,11.0,-5.0,5
16971,16971,2014-15,2014,2015,Tottenham,Swansea,Win,Away,2014-12-14,3,1,4,7,7,3,4,4,7,-2,0,3,0,0,6.0,12.0,-6.0,5
16972,16972,2014-15,2014,2015,Tottenham,Burnley,Win,Home,2014-12-20,3,4,4,7,10,3,4,5,8,1,0,2,2,1,6.0,21.0,-15.0,5
16973,16973,2014-15,2014,2015,Tottenham,Leicester,Win,Away,2014-12-26,3,6,7,7,10,0,0,0,0,6,7,7,10,0,6.0,21.0,-15.0,5
16974,16974,2014-15,2014,2015,Tottenham,Man United,Draw,Home,2014-12-28,1,6,9,10,10,4,7,10,13,2,2,0,-3,1,6.0,7.0,-1.0,5
16975,16975,2014-15,2014,2015,Tottenham,Chelsea,Win,Home,2015-01-01,3,4,7,10,11,4,7,10,10,0,0,0,1,1,6.0,3.0,3.0,6
16976,16976,2014-15,2014,2015,Tottenham,Crystal Palace,Loss,Away,2015-01-10,0,4,7,10,13,2,2,2,3,2,5,8,10,0,6.0,11.0,-5.0,6
16977,16977,2014-15,2014,2015,Tottenham,Sunderland,Win,Home,2015-01-17,3,3,4,7,10,0,1,1,4,3,3,6,6,1,6.0,14.0,-8.0,6
16978,16978,2014-15,2014,2015,Tottenham,West Brom,Win,Away,2015-01-31,3,3,6,7,10,4,5,5,5,-1,1,2,5,0,6.0,17.0,-11.0,6
16979,16979,2014-15,2014,2015,Tottenham,Arsenal,Win,Home,2015-02-07,3,6,6,9,10,6,9,9,12,0,-3,0,-2,1,6.0,4.0,2.0,7
16980,16980,2014-15,2014,2015,Tottenham,Liverpool,Loss,Away,2015-02-10,0,6,9,9,12,4,7,10,11,2,2,-1,1,0,6.0,2.0,4.0,7
16981,16981,2014-15,2014,2015,Tottenham,West Ham,Draw,Home,2015-02-22,1,3,6,9,9,2,2,5,6,1,4,4,3,1,6.0,13.0,-7.0,7
16982,16982,2014-15,2014,2015,Tottenham,Swansea,Win,Home,2015-03-04,3,1,4,7,10,6,6,7,10,-5,-2,0,0,1,6.0,12.0,-6.0,8
16983,16983,2014-15,2014,2015,Tottenham,QPR,Win,Away,2015-03-07,3,4,4,7,10,0,3,3,3,4,1,4,7,0,6.0,21.0,-15.0,8
16984,16984,2014-15,2014,2015,Tottenham,Man United,Loss,Away,2015-03-15,0,6,7,7,10,6,6,9,10,0,1,-2,0,0,6.0,7.0,-1.0,8
16985,16985,2014-15,2014,2015,Tottenham,Leicester,Win,Home,2015-03-21,3,3,6,7,7,1,2,2,2,2,4,5,5,1,6.0,21.0,-15.0,8
16986,16986,2014-15,2014,2015,Tottenham,Burnley,Draw,Away,2015-04-05,1,3,6,9,10,3,3,3,4,0,3,6,6,0,6.0,21.0,-15.0,9
16987,16987,2014-15,2014,2015,Tottenham,Aston Villa,Loss,Home,2015-04-11,0,4,4,7,10,1,1,4,7,3,3,3,3,1,6.0,15.0,-9.0,9
16988,16988,2014-15,2014,2015,Tottenham,Newcastle,Win,Away,2015-04-19,3,1,4,4,7,0,0,0,0,1,4,4,7,0,6.0,10.0,-4.0,9
16989,16989,2014-15,2014,2015,Tottenham,Southampton,Draw,Away,2015-04-25,1,3,4,7,7,3,3,6,7,0,1,1,0,0,6.0,8.0,-2.0,9
16990,16990,2014-15,2014,2015,Tottenham,Man City,Loss,Home,2015-05-03,0,4,4,5,8,6,6,6,9,-2,-2,-1,-1,1,6.0,1.0,5.0,10
16991,16991,2014-15,2014,2015,Tottenham,Stoke,Loss,Away,2015-05-09,0,1,4,4,5,1,4,5,5,0,0,-1,0,0,6.0,9.0,-3.0,10
16992,16992,2014-15,2014,2015,Tottenham,Hull,Win,Home,2015-05-16,3,0,1,4,4,0,3,6,6,0,-2,-2,-2,1,6.0,16.0,-10.0,10
16993,16993,2014-15,2014,2015,Tottenham,Everton,Win,Away,2015-05-24,3,3,3,4,7,3,3,6,9,0,0,-2,-2,0,6.0,5.0,1.0,10
16994,16994,2015-16,2015,2016,Tottenham,Man United,Loss,Away,2015-08-08,0,6,6,6,7,2,5,5,5,4,1,1,2,0,5.0,4.0,1.0,1
16995,16995,2015-16,2015,2016,Tottenham,Stoke,Draw,Home,2015-08-15,1,3,6,6,6,3,4,7,7,0,2,-1,-1,1,5.0,9.0,-4.0,1
16996,16996,2015-16,2015,2016,Tottenham,Leicester,Draw,Away,2015-08-22,1,1,4,7,7,6,9,10,13,-5,-5,-3,-6,0,5.0,14.0,-9.0,1
16997,16997,2015-16,2015,2016,Tottenham,Everton,Draw,Home,2015-08-29,1,2,2,5,8,3,4,4,7,-1,-2,1,1,1,5.0,11.0,-6.0,1
16998,16998,2015-16,2015,2016,Tottenham,Sunderland,Win,Away,2015-09-13,3,2,3,3,6,2,2,2,2,0,1,1,4,0,5.0,16.0,-11.0,2
16999,16999,2015-16,2015,2016,Tottenham,Crystal Palace,Win,Home,2015-09-20,3,4,5,6,6,3,6,6,9,1,-1,0,-3,1,5.0,10.0,-5.0,2
17000,17000,2015-16,2015,2016,Tottenham,Man City,Win,Home,2015-09-26,3,6,7,8,9,3,6,9,12,3,1,-1,-3,1,5.0,2.0,3.0,2
17001,17001,2015-16,2015,2016,Tottenham,Swansea,Draw,Away,2015-10-04,1,6,9,10,11,1,1,4,5,5,8,6,6,0,5.0,8.0,-3.0,3
17002,17002,2015-16,2015,2016,Tottenham,Liverpool,Draw,Home,2015-10-17,1,4,7,10,11,4,5,5,5,0,2,5,6,1,5.0,6.0,-1.0,3
17003,17003,2015-16,2015,2016,Tottenham,Bournemouth,Win,Away,2015-10-25,3,2,5,8,11,1,1,4,4,1,4,4,7,0,5.0,21.0,-16.0,3
17004,17004,2015-16,2015,2016,Tottenham,Aston Villa,Win,Home,2015-11-02,3,4,5,8,11,0,0,0,0,4,5,8,11,1,5.0,17.0,-12.0,4
17005,17005,2015-16,2015,2016,Tottenham,Arsenal,Draw,Away,2015-11-08,1,6,7,8,11,6,9,12,15,0,-2,-4,-4,0,5.0,3.0,2.0,4
17006,17006,2015-16,2015,2016,Tottenham,West Ham,Win,Home,2015-11-22,3,4,7,8,9,1,4,7,8,3,3,1,1,1,5.0,12.0,-7.0,4
17007,17007,2015-16,2015,2016,Tottenham,Chelsea,Draw,Home,2015-11-29,1,4,7,10,11,3,3,3,6,1,4,7,5,1,5.0,1.0,4.0,4
17008,17008,2015-16,2015,2016,Tottenham,West Brom,Draw,Away,2015-12-05,1,4,5,8,11,4,4,4,7,0,1,4,4,0,5.0,13.0,-8.0,5
17009,17009,2015-16,2015,2016,Tottenham,Newcastle,Loss,Home,2015-12-13,0,2,5,6,9,3,3,6,7,-1,2,0,2,1,5.0,15.0,-10.0,5
17010,17010,2015-16,2015,2016,Tottenham,Southampton,Win,Away,2015-12-19,3,1,2,5,6,1,1,1,4,0,1,4,2,0,5.0,7.0,-2.0,5
17011,17011,2015-16,2015,2016,Tottenham,Norwich,Win,Home,2015-12-26,3,3,4,5,8,4,4,5,5,-1,0,0,3,1,5.0,21.0,-16.0,5
17012,17012,2015-16,2015,2016,Tottenham,Watford,Win,Away,2015-12-28,3,6,6,7,8,4,7,10,13,2,-1,-3,-5,0,5.0,21.0,-16.0,5
17013,17013,2015-16,2015,2016,Tottenham,Everton,Draw,Away,2016-01-03,1,6,9,9,10,3,3,4,5,3,6,5,5,0,5.0,11.0,-6.0,6
17014,17014,2015-16,2015,2016,Tottenham,Leicester,Loss,Home,2016-01-13,0,4,7,10,10,2,2,5,8,2,5,5,2,1,5.0,14.0,-9.0,6
17015,17015,2015-16,2015,2016,Tottenham,Sunderland,Win,Home,2016-01-16,3,1,4,7,10,6,6,6,6,-5,-2,1,4,1,5.0,16.0,-11.0,6
17016,17016,2015-16,2015,2016,Tottenham,Crystal Palace,Win,Away,2016-01-23,3,3,4,7,10,0,0,1,2,3,4,6,8,0,5.0,10.0,-5.0,6
17017,17017,2015-16,2015,2016,Tottenham,Norwich,Win,Away,2016-02-02,3,6,6,7,10,0,0,3,6,6,6,4,4,0,5.0,21.0,-16.0,7
17018,17018,2015-16,2015,2016,Tottenham,Watford,Win,Home,2016-02-06,3,6,9,9,10,4,4,4,4,2,5,5,6,1,5.0,21.0,-16.0,7
17019,17019,2015-16,2015,2016,Tottenham,Man City,Win,Away,2016-02-14,3,6,9,12,12,3,4,7,8,3,5,5,4,0,5.0,2.0,3.0,7
17020,17020,2015-16,2015,2016,Tottenham,Swansea,Win,Home,2016-02-28,3,6,9,12,15,1,2,5,8,5,7,7,7,1,5.0,8.0,-3.0,7
17021,17021,2015-16,2015,2016,Tottenham,West Ham,Loss,Away,2016-03-02,0,6,9,12,15,4,4,7,8,2,5,5,7,0,5.0,12.0,-7.0,8
17022,17022,2015-16,2015,2016,Tottenham,Arsenal,Draw,Home,2016-03-05,1,3,6,9,12,0,3,6,7,3,3,3,5,1,5.0,3.0,2.0,8
17023,17023,2015-16,2015,2016,Tottenham,Aston Villa,Win,Away,2016-03-13,3,1,4,7,10,0,0,0,3,1,4,7,7,0,5.0,17.0,-12.0,8
17024,17024,2015-16,2015,2016,Tottenham,Bournemouth,Win,Home,2016-03-20,3,4,4,7,10,6,9,10,10,-2,-5,-3,0,1,5.0,21.0,-16.0,8
17025,17025,2015-16,2015,2016,Tottenham,Liverpool,Draw,Away,2016-04-02,1,6,7,7,10,3,6,9,10,3,1,-2,0,0,5.0,6.0,-1.0,9
17026,17026,2015-16,2015,2016,Tottenham,Man United,Win,Home,2016-04-10,3,4,7,8,8,6,6,9,12,-2,1,-1,-4,1,5.0,4.0,1.0,9
17027,17027,2015-16,2015,2016,Tottenham,Stoke,Win,Away,2016-04-18,3,4,7,10,11,1,4,4,5,3,3,6,6,0,5.0,9.0,-4.0,9
17028,17028,2015-16,2015,2016,Tottenham,West Brom,Draw,Home,2016-04-25,1,6,7,10,13,0,0,1,1,6,7,9,12,1,5.0,13.0,-8.0,9
17029,17029,2015-16,2015,2016,Tottenham,Chelsea,Draw,Away,2016-05-02,1,4,7,8,11,3,3,6,7,1,4,2,4,0,5.0,1.0,4.0,10
17030,17030,2015-16,2015,2016,Tottenham,Southampton,Loss,Home,2016-05-08,0,2,5,8,9,6,7,10,10,-4,-2,-2,-1,1,5.0,7.0,-2.0,10
17031,17031,2015-16,2015,2016,Tottenham,Newcastle,Loss,Away,2016-05-15,0,1,2,5,8,4,5,6,9,-3,-3,-1,-1,0,5.0,15.0,-10.0,10
17032,17032,2016-17,2016,2017,Tottenham,Everton,Draw,Away,2016-08-13,1,0,1,2,5,3,3,6,6,-3,-2,-4,-1,0,3.0,11.0,-8.0,1
17033,17033,2016-17,2016,2017,Tottenham,Crystal Palace,Win,Home,2016-08-20,3,1,1,2,3,0,3,3,3,1,-2,-1,0,1,3.0,15.0,-12.0,1
17034,17034,2016-17,2016,2017,Tottenham,Liverpool,Draw,Home,2016-08-27,1,4,4,4,5,3,4,5,8,1,0,-1,-3,1,3.0,8.0,-5.0,1
17035,17035,2016-17,2016,2017,Tottenham,Stoke,Win,Away,2016-09-10,3,4,5,5,5,0,1,4,4,4,4,1,1,0,3.0,9.0,-6.0,2
17036,17036,2016-17,2016,2017,Tottenham,Sunderland,Win,Home,2016-09-18,3,4,7,8,8,1,1,1,2,3,6,7,6,1,3.0,17.0,-14.0,2
17037,17037,2016-17,2016,2017,Tottenham,Middlesbrough,Win,Away,2016-09-24,3,6,7,10,11,0,1,4,5,6,6,6,6,0,3.0,21.0,-18.0,2
17038,17038,2016-17,2016,2017,Tottenham,Man City,Win,Home,2016-10-02,3,6,9,10,13,6,9,12,15,0,0,-2,-2,1,3.0,4.0,-1.0,3
17039,17039,2016-17,2016,2017,Tottenham,West Brom,Draw,Away,2016-10-15,1,6,9,12,13,2,5,5,6,4,4,7,7,0,3.0,14.0,-11.0,3
17040,17040,2016-17,2016,2017,Tottenham,Bournemouth,Draw,Away,2016-10-22,1,4,7,10,13,4,7,7,10,0,0,3,3,0,3.0,16.0,-13.0,3
17041,17041,2016-17,2016,2017,Tottenham,Leicester,Draw,Home,2016-10-29,1,2,5,8,11,3,4,4,7,-1,1,4,4,1,3.0,1.0,2.0,3
17042,17042,2016-17,2016,2017,Tottenham,Arsenal,Draw,Away,2016-11-06,1,2,3,6,9,4,7,10,13,-2,-4,-4,-4,0,3.0,2.0,1.0,4
17043,17043,2016-17,2016,2017,Tottenham,West Ham,Win,Home,2016-11-19,3,2,3,4,7,1,4,7,8,1,-1,-3,-1,1,3.0,7.0,-4.0,4
17044,17044,2016-17,2016,2017,Tottenham,Chelsea,Loss,Away,2016-11-26,0,4,5,6,7,6,9,12,15,-2,-4,-6,-8,0,3.0,10.0,-7.0,4
17045,17045,2016-17,2016,2017,Tottenham,Swansea,Win,Home,2016-12-03,3,3,4,5,6,4,4,4,5,-1,0,1,1,1,3.0,12.0,-9.0,5
17046,17046,2016-17,2016,2017,Tottenham,Man United,Loss,Away,2016-12-11,0,3,6,7,8,2,3,6,7,1,3,1,1,0,3.0,5.0,-2.0,5
17047,17047,2016-17,2016,2017,Tottenham,Hull,Win,Home,2016-12-14,3,3,3,6,7,1,2,2,5,2,1,4,2,1,3.0,21.0,-18.0,5
17048,17048,2016-17,2016,2017,Tottenham,Burnley,Win,Home,2016-12-18,3,3,6,6,9,3,3,3,3,0,3,3,6,1,3.0,21.0,-18.0,5
17049,17049,2016-17,2016,2017,Tottenham,Southampton,Win,Away,2016-12-28,3,6,6,9,9,4,7,7,10,2,-1,2,-1,0,3.0,6.0,-3.0,5
17050,17050,2016-17,2016,2017,Tottenham,Watford,Win,Away,2017-01-01,3,6,9,9,12,1,1,4,4,5,8,5,8,0,3.0,13.0,-10.0,6
17051,17051,2016-17,2016,2017,Tottenham,Chelsea,Win,Home,2017-01-04,3,6,9,12,12,6,9,12,15,0,0,0,-3,1,3.0,10.0,-7.0,6
17052,17052,2016-17,2016,2017,Tottenham,West Brom,Win,Home,2017-01-14,3,6,9,12,15,6,6,6,9,0,3,6,6,1,3.0,14.0,-11.0,6
17053,17053,2016-17,2016,2017,Tottenham,Man City,Draw,Away,2017-01-21,1,6,9,12,15,3,3,6,9,3,6,6,6,0,3.0,4.0,-1.0,6
17054,17054,2016-17,2016,2017,Tottenham,Sunderland,Draw,Away,2017-01-31,1,4,7,10,13,0,1,1,1,4,6,9,12,0,3.0,17.0,-14.0,6
17055,17055,2016-17,2016,2017,Tottenham,Middlesbrough,Win,Home,2017-02-04,3,2,5,8,11,1,2,3,3,1,3,5,8,1,3.0,21.0,-18.0,7
17056,17056,2016-17,2016,2017,Tottenham,Liverpool,Loss,Away,2017-02-11,0,4,5,8,11,1,1,2,3,3,4,6,8,0,3.0,8.0,-5.0,7
17057,17057,2016-17,2016,2017,Tottenham,Stoke,Win,Home,2017-02-26,3,3,4,5,8,3,4,5,8,0,0,0,0,1,3.0,9.0,-6.0,7
17058,17058,2016-17,2016,2017,Tottenham,Everton,Win,Home,2017-03-05,3,3,6,7,8,4,7,8,11,-1,-1,-1,-3,1,3.0,11.0,-8.0,8
17059,17059,2016-17,2016,2017,Tottenham,Southampton,Win,Home,2017-03-19,3,6,6,9,10,6,6,6,9,0,0,3,1,1,3.0,6.0,-3.0,8
17060,17060,2016-17,2016,2017,Tottenham,Burnley,Win,Away,2017-04-01,3,6,9,9,12,1,1,2,3,5,8,7,9,0,3.0,21.0,-18.0,9
17061,17061,2016-17,2016,2017,Tottenham,Swansea,Win,Away,2017-04-05,3,6,9,12,12,1,1,4,4,5,8,8,8,0,3.0,12.0,-9.0,9
17062,17062,2016-17,2016,2017,Tottenham,Watford,Win,Home,2017-04-08,3,6,9,12,15,6,6,6,7,0,3,6,8,1,3.0,13.0,-10.0,9
17063,17063,2016-17,2016,2017,Tottenham,Bournemouth,Win,Home,2017-04-15,3,6,9,12,15,1,2,5,8,5,7,7,7,1,3.0,16.0,-13.0,9
17064,17064,2016-17,2016,2017,Tottenham,Crystal Palace,Win,Away,2017-04-26,3,6,9,12,15,4,7,7,10,2,2,5,5,0,3.0,15.0,-12.0,9
17065,17065,2016-17,2016,2017,Tottenham,Arsenal,Win,Home,2017-04-30,3,6,9,12,15,6,6,9,10,0,3,3,5,1,3.0,2.0,1.0,9
17066,17066,2016-17,2016,2017,Tottenham,West Ham,Loss,Away,2017-05-05,0,6,9,12,15,2,3,6,6,4,6,6,9,0,3.0,7.0,-4.0,10
17067,17067,2016-17,2016,2017,Tottenham,Man United,Win,Home,2017-05-14,3,3,6,9,12,1,2,5,8,2,4,4,4,1,3.0,5.0,-2.0,10
17068,17068,2016-17,2016,2017,Tottenham,Leicester,Win,Away,2017-05-18,3,3,6,9,12,3,6,6,7,0,0,3,5,0,3.0,1.0,2.0,10
17069,17069,2016-17,2016,2017,Tottenham,Hull,Win,Away,2017-05-21,3,6,6,9,12,0,1,4,4,6,5,5,8,0,3.0,21.0,-18.0,10
17070,17070,2017-18,2017,2018,Tottenham,Newcastle,Win,Away,2017-08-13,3,6,9,9,12,4,7,8,9,2,2,1,3,0,2.0,21.0,-19.0,1
17071,17071,2017-18,2017,2018,Tottenham,Chelsea,Loss,Home,2017-08-20,0,6,9,12,12,3,6,9,12,3,3,3,0,1,2.0,1.0,1.0,1
17072,17072,2017-18,2017,2018,Tottenham,Burnley,Draw,Home,2017-08-27,1,3,6,9,12,3,3,3,4,0,3,6,8,1,2.0,16.0,-14.0,1
17073,17073,2017-18,2017,2018,Tottenham,Everton,Win,Away,2017-09-09,3,1,4,7,10,1,4,4,7,0,0,3,3,0,2.0,7.0,-5.0,2
17074,17074,2017-18,2017,2018,Tottenham,Swansea,Draw,Home,2017-09-16,1,4,4,7,10,3,3,4,7,1,1,3,3,1,2.0,15.0,-13.0,2
17075,17075,2017-18,2017,2018,Tottenham,West Ham,Win,Away,2017-09-23,3,4,5,5,8,4,4,4,4,0,1,1,4,0,2.0,11.0,-9.0,2
17076,17076,2017-18,2017,2018,Tottenham,Huddersfield,Win,Away,2017-09-30,3,4,7,8,8,2,2,3,6,2,5,5,2,0,2.0,21.0,-19.0,2
17077,17077,2017-18,2017,2018,Tottenham,Bournemouth,Win,Home,2017-10-14,3,6,7,10,11,1,4,4,4,5,3,6,7,1,2.0,9.0,-7.0,3
17078,17078,2017-18,2017,2018,Tottenham,Liverpool,Win,Home,2017-10-22,3,6,9,10,13,2,5,6,6,4,4,4,7,1,2.0,4.0,-2.0,3
17079,17079,2017-18,2017,2018,Tottenham,Man United,Loss,Away,2017-10-28,0,6,9,12,13,1,4,7,10,5,5,5,3,0,2.0,6.0,-4.0,3
17080,17080,2017-18,2017,2018,Tottenham,Crystal Palace,Win,Home,2017-11-05,3,3,6,9,12,1,4,4,4,2,2,5,8,1,2.0,14.0,-12.0,4
17081,17081,2017-18,2017,2018,Tottenham,Arsenal,Loss,Away,2017-11-18,0,3,6,9,12,3,6,6,9,0,0,3,3,0,2.0,5.0,-3.0,4
17082,17082,2017-18,2017,2018,Tottenham,West Brom,Draw,Home,2017-11-25,1,3,3,6,9,0,0,0,1,3,3,6,8,1,2.0,10.0,-8.0,4
17083,17083,2017-18,2017,2018,Tottenham,Leicester,Loss,Away,2017-11-28,0,1,4,4,7,1,2,5,8,0,2,-1,-1,0,2.0,12.0,-10.0,4
17084,17084,2017-18,2017,2018,Tottenham,Watford,Draw,Away,2017-12-02,1,1,1,4,4,3,6,6,6,-2,-5,-2,-2,0,2.0,17.0,-15.0,5
17085,17085,2017-18,2017,2018,Tottenham,Stoke,Win,Home,2017-12-09,3,1,2,2,5,3,3,4,5,-2,-1,-2,0,1,2.0,13.0,-11.0,5
17086,17086,2017-18,2017,2018,Tottenham,Brighton,Win,Home,2017-12-13,3,4,4,5,5,0,1,1,2,4,3,4,3,1,2.0,21.0,-19.0,5
17087,17087,2017-18,2017,2018,Tottenham,Man City,Loss,Away,2017-12-16,0,6,7,7,8,6,9,12,15,0,-2,-5,-7,0,2.0,3.0,-1.0,5
17088,17088,2017-18,2017,2018,Tottenham,Burnley,Win,Away,2017-12-23,3,3,6,7,7,4,7,7,10,-1,-1,0,-3,0,2.0,16.0,-14.0,5
17089,17089,2017-18,2017,2018,Tottenham,Southampton,Win,Home,2017-12-26,3,3,6,9,10,1,1,2,3,2,5,7,7,1,2.0,8.0,-6.0,5
17090,17090,2017-18,2017,2018,Tottenham,Swansea,Win,Away,2018-01-02,3,6,6,9,12,3,4,4,4,3,2,5,8,0,2.0,15.0,-13.0,6
17091,17091,2017-18,2017,2018,Tottenham,West Ham,Draw,Home,2018-01-04,1,6,9,9,12,4,4,7,8,2,5,2,4,1,2.0,11.0,-9.0,6
17092,17092,2017-18,2017,2018,Tottenham,Everton,Win,Home,2018-01-13,3,4,7,10,10,0,1,2,5,4,6,8,5,1,2.0,7.0,-5.0,6
17093,17093,2017-18,2017,2018,Tottenham,Southampton,Draw,Away,2018-01-21,1,4,7,10,13,1,2,2,3,3,5,8,10,0,2.0,8.0,-6.0,6
17094,17094,2017-18,2017,2018,Tottenham,Man United,Win,Home,2018-01-31,3,4,5,8,11,6,9,10,11,-2,-4,-2,0,1,2.0,6.0,-4.0,6
17095,17095,2017-18,2017,2018,Tottenham,Liverpool,Draw,Away,2018-02-04,1,4,7,8,11,3,6,9,12,1,1,-1,-1,0,2.0,4.0,-2.0,7
17096,17096,2017-18,2017,2018,Tottenham,Arsenal,Win,Home,2018-02-10,3,4,5,8,9,3,6,6,7,1,-1,2,2,1,2.0,5.0,-3.0,7
17097,17097,2017-18,2017,2018,Tottenham,Crystal Palace,Win,Away,2018-02-25,3,4,7,8,11,1,2,2,5,3,5,6,6,0,2.0,14.0,-12.0,7
17098,17098,2017-18,2017,2018,Tottenham,Huddersfield,Win,Home,2018-03-03,3,6,7,10,11,6,6,6,6,0,1,4,5,1,2.0,21.0,-19.0,8
17099,17099,2017-18,2017,2018,Tottenham,Bournemouth,Win,Away,2018-03-11,3,6,9,10,13,2,2,5,8,4,7,5,5,0,2.0,9.0,-7.0,8
17100,17100,2017-18,2017,2018,Tottenham,Chelsea,Win,Away,2018-04-01,3,6,9,12,13,3,3,6,6,3,6,6,7,0,2.0,1.0,1.0,9
17101,17101,2017-18,2017,2018,Tottenham,Stoke,Win,Away,2018-04-07,3,6,9,12,15,0,0,1,2,6,9,11,13,0,2.0,13.0,-11.0,9
17102,17102,2017-18,2017,2018,Tottenham,Man City,Loss,Home,2018-04-14,0,6,9,12,15,3,6,9,12,3,3,3,3,1,2.0,3.0,-1.0,9
17103,17103,2017-18,2017,2018,Tottenham,Brighton,Draw,Away,2018-04-17,1,3,6,9,12,1,1,1,4,2,5,8,8,0,2.0,21.0,-19.0,9
17104,17104,2017-18,2017,2018,Tottenham,Watford,Win,Home,2018-04-30,3,1,4,7,10,1,1,2,2,0,3,5,8,1,2.0,17.0,-15.0,9
17105,17105,2017-18,2017,2018,Tottenham,West Brom,Loss,Away,2018-05-05,0,4,4,7,10,4,7,8,8,0,-3,-1,2,0,2.0,10.0,-8.0,10
17106,17106,2017-18,2017,2018,Tottenham,Newcastle,Win,Home,2018-05-09,3,3,4,4,7,0,0,3,6,3,4,1,1,1,2.0,21.0,-19.0,10
17107,17107,2017-18,2017,2018,Tottenham,Leicester,Win,Home,2018-05-13,3,3,6,7,7,3,3,4,4,0,3,3,3,1,2.0,12.0,-10.0,10
17108,17108,1999-00,1999,2000,Watford,Wimbledon,Loss,Home,1999-08-07,0,0,0,0,0,0,0,1,1,0,0,-1,-1,1,21.0,16.0,5.0,1
17109,17109,1999-00,1999,2000,Watford,Sunderland,Loss,Away,1999-08-10,0,0,0,0,0,0,3,3,6,0,-3,-3,-6,0,21.0,21.0,0.0,1
17110,17110,1999-00,1999,2000,Watford,Liverpool,Win,Away,1999-08-14,3,0,0,0,0,6,6,7,10,-6,-6,-7,-10,0,21.0,7.0,14.0,1
17111,17111,1999-00,1999,2000,Watford,Bradford,Win,Home,1999-08-21,3,3,3,3,3,4,4,4,4,-1,-1,-1,-1,1,21.0,21.0,0.0,1
17112,17112,1999-00,1999,2000,Watford,Aston Villa,Loss,Home,1999-08-24,0,6,6,6,6,1,4,7,7,5,2,-1,-1,1,21.0,6.0,15.0,1
17113,17113,1999-00,1999,2000,Watford,Leicester,Loss,Away,1999-08-30,0,3,6,6,6,3,4,7,7,0,2,-1,-1,0,21.0,10.0,11.0,1
17114,17114,1999-00,1999,2000,Watford,West Ham,Loss,Away,1999-09-11,0,0,3,6,6,6,7,10,13,-6,-4,-4,-7,0,21.0,5.0,16.0,2
17115,17115,1999-00,1999,2000,Watford,Chelsea,Win,Home,1999-09-18,3,0,0,3,6,6,9,10,13,-6,-9,-7,-7,1,21.0,3.0,18.0,2
17116,17116,1999-00,1999,2000,Watford,Arsenal,Loss,Away,1999-09-25,0,3,3,3,6,6,6,9,9,-3,-3,-6,-3,0,21.0,2.0,19.0,2
17117,17117,1999-00,1999,2000,Watford,Leeds,Loss,Home,1999-10-03,0,3,3,3,3,6,9,12,12,-3,-6,-9,-9,1,21.0,4.0,17.0,3
17118,17118,1999-00,1999,2000,Watford,Man United,Loss,Away,1999-10-16,0,0,3,3,3,1,2,5,8,-1,1,-2,-5,0,21.0,1.0,20.0,3
17119,17119,1999-00,1999,2000,Watford,Middlesbrough,Loss,Home,1999-10-24,0,0,0,3,3,3,3,3,6,-3,-3,0,-3,1,21.0,9.0,12.0,3
17120,17120,1999-00,1999,2000,Watford,Coventry,Loss,Away,1999-10-31,0,0,0,0,3,4,5,8,8,-4,-5,-8,-5,0,21.0,15.0,6.0,3
17121,17121,1999-00,1999,2000,Watford,Sheffield Weds,Draw,Away,1999-11-06,1,0,0,0,0,1,1,4,4,-1,-1,-4,-4,0,21.0,12.0,9.0,4
17122,17122,1999-00,1999,2000,Watford,Newcastle,Draw,Home,1999-11-20,1,1,1,1,1,2,5,5,8,-1,-4,-4,-7,1,21.0,13.0,8.0,4
17123,17123,1999-00,1999,2000,Watford,Sunderland,Loss,Home,1999-11-27,0,2,2,2,2,1,4,5,8,1,-2,-3,-6,1,21.0,21.0,0.0,4
17124,17124,1999-00,1999,2000,Watford,Wimbledon,Loss,Away,1999-12-04,0,1,2,2,2,1,4,5,6,0,-2,-3,-4,0,21.0,16.0,5.0,5
17125,17125,1999-00,1999,2000,Watford,Everton,Loss,Home,1999-12-18,0,0,1,2,2,1,2,3,3,-1,-1,-1,-1,1,21.0,14.0,7.0,5
17126,17126,1999-00,1999,2000,Watford,Tottenham,Loss,Away,1999-12-26,0,0,0,1,2,1,1,4,7,-1,-1,-3,-5,0,21.0,11.0,10.0,5
17127,17127,1999-00,1999,2000,Watford,Southampton,Win,Home,1999-12-28,3,0,0,0,1,0,1,1,1,0,-1,-1,0,1,21.0,17.0,4.0,5
17128,17128,1999-00,1999,2000,Watford,Derby,Loss,Away,2000-01-03,0,3,3,3,3,1,4,4,4,2,-1,-1,-1,0,21.0,8.0,13.0,6
17129,17129,1999-00,1999,2000,Watford,Liverpool,Loss,Home,2000-01-15,0,3,3,3,3,3,4,7,10,0,-1,-4,-7,1,21.0,7.0,14.0,6
17130,17130,1999-00,1999,2000,Watford,Bradford,Loss,Away,2000-01-22,0,0,3,3,3,1,1,2,2,-1,2,1,1,0,21.0,21.0,0.0,6
17131,17131,1999-00,1999,2000,Watford,Aston Villa,Loss,Away,2000-02-05,0,0,0,3,3,2,5,6,9,-2,-5,-3,-6,0,21.0,6.0,15.0,7
17132,17132,1999-00,1999,2000,Watford,Leicester,Draw,Home,2000-02-12,1,0,0,0,3,3,4,5,5,-3,-4,-5,-2,1,21.0,10.0,11.0,7
17133,17133,1999-00,1999,2000,Watford,Chelsea,Loss,Away,2000-02-26,0,1,1,1,1,6,7,8,11,-5,-6,-7,-10,0,21.0,3.0,18.0,7
17134,17134,1999-00,1999,2000,Watford,West Ham,Loss,Home,2000-03-04,0,1,1,1,1,3,3,6,7,-2,-2,-5,-6,1,21.0,5.0,16.0,8
17135,17135,1999-00,1999,2000,Watford,Newcastle,Loss,Away,2000-03-11,0,0,1,1,1,3,6,7,7,-3,-5,-6,-6,0,21.0,13.0,8.0,8
17136,17136,1999-00,1999,2000,Watford,Sheffield Weds,Win,Home,2000-03-18,3,0,0,1,1,4,4,4,5,-4,-4,-3,-4,1,21.0,12.0,9.0,8
17137,17137,1999-00,1999,2000,Watford,Tottenham,Draw,Home,2000-03-25,1,3,3,3,4,3,4,7,7,0,-1,-4,-3,1,21.0,11.0,10.0,8
17138,17138,1999-00,1999,2000,Watford,Everton,Loss,Away,2000-04-01,0,4,4,4,4,0,0,1,2,4,4,3,2,0,21.0,14.0,7.0,9
17139,17139,1999-00,1999,2000,Watford,Derby,Draw,Home,2000-04-08,1,1,4,4,4,3,3,3,6,-2,1,1,-2,1,21.0,8.0,13.0,9
17140,17140,1999-00,1999,2000,Watford,Southampton,Loss,Away,2000-04-15,0,1,2,5,5,3,4,7,7,-2,-2,-2,-2,0,21.0,17.0,4.0,9
17141,17141,1999-00,1999,2000,Watford,Arsenal,Loss,Home,2000-04-23,0,1,1,2,5,6,9,12,12,-5,-8,-10,-7,1,21.0,2.0,19.0,9
17142,17142,1999-00,1999,2000,Watford,Man United,Loss,Home,2000-04-29,0,0,1,1,2,6,9,12,15,-6,-8,-11,-13,1,21.0,1.0,20.0,9
17143,17143,1999-00,1999,2000,Watford,Leeds,Loss,Away,2000-05-03,0,0,0,1,1,4,4,4,4,-4,-4,-3,-3,0,21.0,4.0,17.0,10
17144,17144,1999-00,1999,2000,Watford,Middlesbrough,Draw,Away,2000-05-06,1,0,0,0,1,4,5,5,5,-4,-5,-5,-4,0,21.0,9.0,12.0,10
17145,17145,1999-00,1999,2000,Watford,Coventry,Win,Home,2000-05-14,3,1,1,1,1,3,3,6,6,-2,-2,-5,-5,1,21.0,15.0,6.0,10
17146,17146,2006-07,2006,2007,Watford,Everton,Loss,Away,2006-08-19,0,4,4,4,4,4,5,5,5,0,-1,-1,-1,0,21.0,11.0,10.0,1
17147,17147,2006-07,2006,2007,Watford,West Ham,Draw,Home,2006-08-22,1,3,4,4,4,6,9,9,9,-3,-5,-5,-5,1,21.0,9.0,12.0,1
17148,17148,2006-07,2006,2007,Watford,Man United,Loss,Home,2006-08-26,0,1,4,5,5,6,9,10,10,-5,-5,-5,-5,1,21.0,2.0,19.0,1
17149,17149,2006-07,2006,2007,Watford,Bolton,Loss,Away,2006-09-09,0,1,1,4,5,1,4,7,8,0,-3,-3,-3,0,21.0,8.0,13.0,2
17150,17150,2006-07,2006,2007,Watford,Aston Villa,Draw,Home,2006-09-16,1,0,1,1,4,4,7,8,11,-4,-6,-7,-7,1,21.0,16.0,5.0,2
17151,17151,2006-07,2006,2007,Watford,Wigan,Draw,Away,2006-09-23,1,1,1,2,2,1,4,4,4,0,-3,-2,-2,0,21.0,10.0,11.0,2
17152,17152,2006-07,2006,2007,Watford,Fulham,Draw,Home,2006-10-02,1,2,2,2,3,1,4,7,8,1,-2,-5,-5,1,21.0,12.0,9.0,3
17153,17153,2006-07,2006,2007,Watford,Arsenal,Loss,Away,2006-10-14,0,2,3,3,3,6,9,10,10,-4,-6,-7,-7,0,21.0,4.0,17.0,3
17154,17154,2006-07,2006,2007,Watford,Charlton,Draw,Away,2006-10-21,1,1,2,3,3,0,0,0,0,1,2,3,3,0,21.0,13.0,8.0,3
17155,17155,2006-07,2006,2007,Watford,Tottenham,Draw,Home,2006-10-28,1,1,2,3,4,4,7,7,8,-3,-5,-4,-4,1,21.0,5.0,16.0,3
17156,17156,2006-07,2006,2007,Watford,Middlesbrough,Win,Home,2006-11-04,3,2,2,3,4,3,6,6,6,-1,-4,-3,-2,1,21.0,14.0,7.0,4
17157,17157,2006-07,2006,2007,Watford,Chelsea,Loss,Away,2006-11-11,0,4,5,5,6,3,6,9,10,1,-1,-4,-4,0,21.0,1.0,20.0,4
17158,17158,2006-07,2006,2007,Watford,Portsmouth,Loss,Away,2006-11-18,0,3,4,5,5,1,4,4,7,2,0,1,-2,0,21.0,17.0,4.0,4
17159,17159,2006-07,2006,2007,Watford,Sheffield United,Loss,Home,2006-11-28,0,0,3,4,5,0,1,4,4,0,2,0,1,1,21.0,21.0,0.0,4
17160,17160,2006-07,2006,2007,Watford,Man City,Draw,Away,2006-12-04,1,0,0,3,4,3,6,7,7,-3,-6,-4,-3,0,21.0,15.0,6.0,5
17161,17161,2006-07,2006,2007,Watford,Reading,Draw,Home,2006-12-09,1,1,1,1,4,3,6,9,12,-2,-5,-8,-8,1,21.0,21.0,0.0,5
17162,17162,2006-07,2006,2007,Watford,Newcastle,Loss,Away,2006-12-16,0,2,2,2,2,3,6,9,10,-1,-4,-7,-8,0,21.0,7.0,14.0,5
17163,17163,2006-07,2006,2007,Watford,Liverpool,Loss,Away,2006-12-23,0,1,2,2,2,6,9,10,13,-5,-7,-8,-11,0,21.0,3.0,18.0,5
17164,17164,2006-07,2006,2007,Watford,Arsenal,Loss,Home,2006-12-26,0,0,1,2,2,4,7,8,11,-4,-6,-6,-9,1,21.0,4.0,17.0,5
17165,17165,2006-07,2006,2007,Watford,Fulham,Draw,Away,2007-01-01,1,0,0,1,2,2,3,6,6,-2,-3,-5,-4,0,21.0,12.0,9.0,6
17166,17166,2006-07,2006,2007,Watford,Liverpool,Loss,Home,2007-01-13,0,1,1,1,2,6,6,9,12,-5,-5,-8,-10,1,21.0,3.0,18.0,6
17167,17167,2006-07,2006,2007,Watford,Aston Villa,Loss,Away,2007-01-20,0,1,1,1,1,1,1,1,1,0,0,0,0,0,21.0,16.0,5.0,6
17168,17168,2006-07,2006,2007,Watford,Blackburn,Win,Home,2007-01-23,3,0,1,1,1,3,6,9,12,-3,-5,-8,-11,1,21.0,6.0,15.0,6
17169,17169,2006-07,2006,2007,Watford,Man United,Loss,Away,2007-01-31,0,3,3,4,4,3,4,7,10,0,-1,-3,-6,0,21.0,2.0,19.0,6
17170,17170,2006-07,2006,2007,Watford,Bolton,Loss,Home,2007-02-03,0,3,3,3,4,1,2,2,5,2,1,1,-1,1,21.0,8.0,13.0,7
17171,17171,2006-07,2006,2007,Watford,West Ham,Win,Away,2007-02-10,3,0,3,3,3,0,1,2,2,0,2,1,1,0,21.0,9.0,12.0,7
17172,17172,2006-07,2006,2007,Watford,Wigan,Draw,Home,2007-02-21,1,3,3,6,6,3,3,3,3,0,0,3,3,1,21.0,10.0,11.0,7
17173,17173,2006-07,2006,2007,Watford,Everton,Loss,Home,2007-02-24,0,4,4,4,7,3,4,7,8,1,0,-3,-1,1,21.0,11.0,10.0,7
17174,17174,2006-07,2006,2007,Watford,Charlton,Draw,Home,2007-03-03,1,1,4,4,4,3,3,4,7,-2,1,0,-3,1,21.0,13.0,8.0,8
17175,17175,2006-07,2006,2007,Watford,Tottenham,Loss,Away,2007-03-17,0,1,2,5,5,6,9,9,9,-5,-7,-4,-4,0,21.0,5.0,16.0,8
17176,17176,2006-07,2006,2007,Watford,Chelsea,Loss,Home,2007-03-31,0,1,1,2,5,6,9,12,15,-5,-8,-10,-10,1,21.0,1.0,20.0,8
17177,17177,2006-07,2006,2007,Watford,Middlesbrough,Loss,Away,2007-04-07,0,0,1,1,2,0,1,4,4,0,0,-3,-2,0,21.0,14.0,7.0,9
17178,17178,2006-07,2006,2007,Watford,Portsmouth,Win,Home,2007-04-09,3,0,0,1,1,4,5,5,5,-4,-5,-4,-4,1,21.0,17.0,4.0,9
17179,17179,2006-07,2006,2007,Watford,Blackburn,Loss,Away,2007-04-18,0,3,3,3,4,0,0,3,6,3,3,0,-2,0,21.0,6.0,15.0,9
17180,17180,2006-07,2006,2007,Watford,Man City,Draw,Home,2007-04-21,1,3,3,3,3,1,4,5,8,2,-1,-2,-5,1,21.0,15.0,6.0,9
17181,17181,2006-07,2006,2007,Watford,Sheffield United,Loss,Away,2007-04-28,0,1,4,4,4,1,4,4,4,0,0,0,0,0,21.0,21.0,0.0,9
17182,17182,2006-07,2006,2007,Watford,Reading,Win,Away,2007-05-05,3,1,1,4,4,6,9,10,10,-5,-8,-6,-6,0,21.0,21.0,0.0,10
17183,17183,2006-07,2006,2007,Watford,Newcastle,Draw,Home,2007-05-13,1,3,4,4,7,0,1,1,2,3,3,3,5,1,21.0,7.0,14.0,10
17184,17184,2015-16,2015,2016,Watford,Everton,Draw,Away,2015-08-08,1,4,4,5,5,3,3,3,6,1,1,2,-1,0,21.0,11.0,10.0,1
17185,17185,2015-16,2015,2016,Watford,West Brom,Draw,Home,2015-08-15,1,2,5,5,6,0,3,4,7,2,2,1,-1,1,21.0,13.0,8.0,1
17186,17186,2015-16,2015,2016,Watford,Southampton,Draw,Home,2015-08-23,1,2,3,6,6,1,1,4,4,1,2,2,2,1,21.0,7.0,14.0,1
17187,17187,2015-16,2015,2016,Watford,Man City,Loss,Away,2015-08-29,0,2,3,4,7,6,9,12,15,-4,-6,-8,-8,0,21.0,2.0,19.0,1
17188,17188,2015-16,2015,2016,Watford,Swansea,Win,Home,2015-09-12,3,1,2,3,4,4,7,8,8,-3,-5,-5,-4,1,21.0,8.0,13.0,2
17189,17189,2015-16,2015,2016,Watford,Newcastle,Win,Away,2015-09-19,3,3,4,5,6,0,1,1,2,3,3,4,4,0,21.0,15.0,6.0,2
17190,17190,2015-16,2015,2016,Watford,Crystal Palace,Loss,Home,2015-09-27,0,6,6,7,8,0,3,6,6,6,3,1,2,1,21.0,10.0,11.0,2
17191,17191,2015-16,2015,2016,Watford,Bournemouth,Draw,Away,2015-10-03,1,3,6,6,7,3,3,4,7,0,3,2,0,0,21.0,21.0,0.0,3
17192,17192,2015-16,2015,2016,Watford,Arsenal,Loss,Home,2015-10-17,0,1,4,7,7,6,6,9,12,-5,-2,-2,-5,1,21.0,3.0,18.0,3
17193,17193,2015-16,2015,2016,Watford,Stoke,Win,Away,2015-10-24,3,1,1,4,7,6,9,10,10,-5,-8,-6,-3,0,21.0,9.0,12.0,3
17194,17194,2015-16,2015,2016,Watford,West Ham,Win,Home,2015-10-31,3,3,4,4,7,6,7,8,11,-3,-3,-4,-4,1,21.0,12.0,9.0,3
17195,17195,2015-16,2015,2016,Watford,Leicester,Loss,Away,2015-11-07,0,6,6,7,7,6,7,10,10,0,-1,-3,-3,0,21.0,14.0,7.0,4
17196,17196,2015-16,2015,2016,Watford,Man United,Loss,Home,2015-11-21,0,3,6,6,7,4,5,8,8,-1,1,-2,-1,1,21.0,4.0,17.0,4
17197,17197,2015-16,2015,2016,Watford,Aston Villa,Win,Away,2015-11-28,3,0,3,6,6,1,1,1,1,-1,2,5,5,0,21.0,17.0,4.0,4
17198,17198,2015-16,2015,2016,Watford,Norwich,Win,Home,2015-12-05,3,3,3,6,9,1,4,4,4,2,-1,2,5,1,21.0,21.0,0.0,5
17199,17199,2015-16,2015,2016,Watford,Sunderland,Win,Away,2015-12-12,3,6,6,6,9,3,6,6,6,3,0,0,3,0,21.0,16.0,5.0,5
17200,17200,2015-16,2015,2016,Watford,Liverpool,Win,Home,2015-12-20,3,6,9,9,9,1,4,7,7,5,5,2,2,1,21.0,6.0,15.0,5
17201,17201,2015-16,2015,2016,Watford,Chelsea,Draw,Away,2015-12-26,1,6,9,12,12,3,3,4,7,3,6,8,5,0,21.0,1.0,20.0,5
17202,17202,2015-16,2015,2016,Watford,Tottenham,Loss,Home,2015-12-28,0,4,7,10,13,6,6,7,8,-2,1,3,5,1,21.0,5.0,16.0,5
17203,17203,2015-16,2015,2016,Watford,Man City,Loss,Home,2016-01-02,0,1,4,7,10,4,4,7,7,-3,0,0,3,1,21.0,2.0,19.0,6
17204,17204,2015-16,2015,2016,Watford,Southampton,Loss,Away,2016-01-13,0,0,1,4,7,0,3,3,3,0,-2,1,4,0,21.0,7.0,14.0,6
17205,17205,2015-16,2015,2016,Watford,Swansea,Loss,Away,2016-01-18,0,0,0,1,4,0,1,4,5,0,-1,-3,-1,0,21.0,8.0,13.0,6
17206,17206,2015-16,2015,2016,Watford,Newcastle,Win,Home,2016-01-23,3,0,0,0,1,4,4,4,4,-4,-4,-4,-3,1,21.0,15.0,6.0,6
17207,17207,2015-16,2015,2016,Watford,Chelsea,Draw,Home,2016-02-03,1,3,3,3,3,4,5,8,9,-1,-2,-5,-6,1,21.0,1.0,20.0,7
17208,17208,2015-16,2015,2016,Watford,Tottenham,Loss,Away,2016-02-06,0,4,4,4,4,6,9,9,10,-2,-5,-5,-6,0,21.0,5.0,16.0,7
17209,17209,2015-16,2015,2016,Watford,Crystal Palace,Win,Away,2016-02-13,3,1,4,4,4,1,1,1,1,0,3,3,3,0,21.0,10.0,11.0,7
17210,17210,2015-16,2015,2016,Watford,Bournemouth,Draw,Home,2016-02-27,1,3,4,7,7,0,3,4,7,3,1,3,0,1,21.0,21.0,0.0,7
17211,17211,2015-16,2015,2016,Watford,Man United,Loss,Away,2016-03-02,0,4,4,5,8,3,4,7,7,1,0,-2,1,0,21.0,4.0,17.0,8
17212,17212,2015-16,2015,2016,Watford,Leicester,Loss,Home,2016-03-05,0,1,4,4,5,4,4,7,10,-3,0,-3,-5,1,21.0,14.0,7.0,8
17213,17213,2015-16,2015,2016,Watford,Stoke,Loss,Home,2016-03-19,0,0,1,4,4,1,4,7,10,-1,-3,-3,-6,1,21.0,9.0,12.0,8
17214,17214,2015-16,2015,2016,Watford,Arsenal,Loss,Away,2016-04-02,0,0,0,1,4,4,4,4,7,-4,-4,-3,-3,0,21.0,3.0,18.0,9
17215,17215,2015-16,2015,2016,Watford,Everton,Draw,Home,2016-04-09,1,0,0,0,1,0,0,3,3,0,0,-3,-2,1,21.0,11.0,10.0,9
17216,17216,2015-16,2015,2016,Watford,West Brom,Win,Away,2016-04-16,3,1,1,1,1,1,1,4,5,0,0,-3,-4,0,21.0,13.0,8.0,9
17217,17217,2015-16,2015,2016,Watford,West Ham,Loss,Away,2016-04-20,0,4,4,4,4,2,3,4,7,2,1,0,-3,0,21.0,12.0,9.0,9
17218,17218,2015-16,2015,2016,Watford,Aston Villa,Win,Home,2016-04-30,3,3,4,4,4,0,0,0,0,3,4,4,4,1,21.0,17.0,4.0,9
17219,17219,2015-16,2015,2016,Watford,Liverpool,Loss,Away,2016-05-08,0,3,6,7,7,1,4,7,10,2,2,0,-3,0,21.0,6.0,15.0,10
17220,17220,2015-16,2015,2016,Watford,Norwich,Loss,Away,2016-05-11,0,3,3,6,7,0,0,0,3,3,3,6,4,0,21.0,21.0,0.0,10
17221,17221,2015-16,2015,2016,Watford,Sunderland,Draw,Home,2016-05-15,1,0,3,3,6,6,7,8,11,-6,-4,-5,-5,1,21.0,16.0,5.0,10
17222,17222,2016-17,2016,2017,Watford,Southampton,Draw,Away,2016-08-13,1,1,1,4,4,6,9,12,13,-5,-8,-8,-9,0,13.0,6.0,7.0,1
17223,17223,2016-17,2016,2017,Watford,Chelsea,Loss,Home,2016-08-20,0,2,2,2,5,4,5,5,6,-2,-3,-3,-1,1,13.0,10.0,3.0,1
17224,17224,2016-17,2016,2017,Watford,Arsenal,Loss,Home,2016-08-27,0,1,2,2,2,1,4,5,8,0,-2,-3,-6,1,13.0,2.0,11.0,1
17225,17225,2016-17,2016,2017,Watford,West Ham,Win,Away,2016-09-10,3,0,1,2,2,3,3,3,6,-3,-2,-1,-4,0,13.0,7.0,6.0,2
17226,17226,2016-17,2016,2017,Watford,Man United,Win,Home,2016-09-18,3,3,3,4,5,3,6,9,12,0,-3,-5,-7,1,13.0,5.0,8.0,2
17227,17227,2016-17,2016,2017,Watford,Burnley,Loss,Away,2016-09-26,0,6,6,6,7,1,1,4,4,5,5,2,3,0,13.0,21.0,-8.0,2
17228,17228,2016-17,2016,2017,Watford,Bournemouth,Draw,Home,2016-10-01,1,3,6,6,6,3,6,7,7,0,0,-1,-1,1,13.0,16.0,-3.0,3
17229,17229,2016-17,2016,2017,Watford,Middlesbrough,Win,Away,2016-10-16,3,1,4,7,7,1,1,1,2,0,3,6,5,0,13.0,21.0,-8.0,3
17230,17230,2016-17,2016,2017,Watford,Swansea,Draw,Away,2016-10-22,1,4,4,7,10,0,0,0,1,4,4,7,9,0,13.0,12.0,1.0,3
17231,17231,2016-17,2016,2017,Watford,Hull,Win,Home,2016-10-29,3,4,5,5,8,0,0,0,0,4,5,5,8,1,13.0,21.0,-8.0,3
17232,17232,2016-17,2016,2017,Watford,Liverpool,Loss,Away,2016-11-06,0,4,7,8,8,6,7,10,13,-2,0,-2,-5,0,13.0,8.0,5.0,4
17233,17233,2016-17,2016,2017,Watford,Leicester,Win,Home,2016-11-19,3,3,4,7,8,1,4,4,5,2,0,3,3,1,13.0,1.0,12.0,4
17234,17234,2016-17,2016,2017,Watford,Stoke,Loss,Home,2016-11-27,0,3,6,7,10,1,4,7,10,2,2,0,0,1,13.0,9.0,4.0,4
17235,17235,2016-17,2016,2017,Watford,West Brom,Loss,Away,2016-12-03,0,3,3,6,7,4,7,7,7,-1,-4,-1,0,0,13.0,14.0,-1.0,5
17236,17236,2016-17,2016,2017,Watford,Everton,Win,Home,2016-12-10,3,0,3,3,6,1,2,2,5,-1,1,1,1,1,13.0,11.0,2.0,5
17237,17237,2016-17,2016,2017,Watford,Man City,Loss,Away,2016-12-14,0,3,3,6,6,0,3,6,7,3,0,0,-1,0,13.0,4.0,9.0,5
17238,17238,2016-17,2016,2017,Watford,Sunderland,Loss,Away,2016-12-17,0,3,3,3,6,0,3,3,6,3,0,0,0,0,13.0,17.0,-4.0,5
17239,17239,2016-17,2016,2017,Watford,Crystal Palace,Draw,Home,2016-12-26,1,0,3,3,3,0,1,4,4,0,2,-1,-1,1,13.0,15.0,-2.0,5
17240,17240,2016-17,2016,2017,Watford,Tottenham,Loss,Home,2017-01-01,0,1,1,4,4,6,9,9,12,-5,-8,-5,-8,1,13.0,3.0,10.0,6
17241,17241,2016-17,2016,2017,Watford,Stoke,Loss,Away,2017-01-03,0,1,1,1,4,0,1,2,2,1,0,-1,2,0,13.0,9.0,4.0,6
17242,17242,2016-17,2016,2017,Watford,Middlesbrough,Draw,Home,2017-01-14,1,0,1,1,1,1,1,4,4,-1,0,-3,-3,1,13.0,21.0,-8.0,6
17243,17243,2016-17,2016,2017,Watford,Bournemouth,Draw,Away,2017-01-21,1,1,1,2,2,1,4,4,4,0,-3,-2,-2,0,13.0,16.0,-3.0,6
17244,17244,2016-17,2016,2017,Watford,Arsenal,Win,Away,2017-01-31,3,2,2,2,3,6,7,10,13,-4,-5,-8,-10,0,13.0,2.0,11.0,6
17245,17245,2016-17,2016,2017,Watford,Burnley,Win,Home,2017-02-04,3,4,5,5,5,3,6,6,9,1,-1,-1,-4,1,13.0,21.0,-8.0,7
17246,17246,2016-17,2016,2017,Watford,Man United,Loss,Away,2017-02-11,0,6,7,8,8,4,5,6,9,2,2,2,-1,0,13.0,5.0,8.0,7
17247,17247,2016-17,2016,2017,Watford,West Ham,Draw,Home,2017-02-25,1,3,6,7,8,4,4,7,10,-1,2,0,-2,1,13.0,7.0,6.0,7
17248,17248,2016-17,2016,2017,Watford,Southampton,Loss,Home,2017-03-04,0,1,4,7,8,3,3,6,6,-2,1,1,2,1,13.0,6.0,7.0,8
17249,17249,2016-17,2016,2017,Watford,Crystal Palace,Loss,Away,2017-03-18,0,1,1,4,7,6,6,6,9,-5,-5,-2,-2,0,13.0,15.0,-2.0,8
17250,17250,2016-17,2016,2017,Watford,Sunderland,Win,Home,2017-04-01,3,0,1,1,4,1,1,1,4,-1,0,0,0,1,13.0,17.0,-4.0,9
17251,17251,2016-17,2016,2017,Watford,West Brom,Win,Home,2017-04-04,3,3,3,4,4,4,4,4,7,-1,-1,0,-3,1,13.0,14.0,-1.0,9
17252,17252,2016-17,2016,2017,Watford,Tottenham,Loss,Away,2017-04-08,0,6,6,6,7,6,9,12,15,0,-3,-6,-8,0,13.0,3.0,10.0,9
17253,17253,2016-17,2016,2017,Watford,Swansea,Win,Home,2017-04-15,3,3,6,6,6,0,1,1,1,3,5,5,5,1,13.0,12.0,1.0,9
17254,17254,2016-17,2016,2017,Watford,Hull,Loss,Away,2017-04-22,0,3,6,9,9,0,3,6,6,3,3,3,3,0,13.0,21.0,-8.0,9
17255,17255,2016-17,2016,2017,Watford,Liverpool,Loss,Home,2017-05-01,0,3,3,6,9,3,6,7,10,0,-3,-1,-1,1,13.0,8.0,5.0,10
17256,17256,2016-17,2016,2017,Watford,Leicester,Loss,Away,2017-05-06,0,0,3,3,6,3,4,4,7,-3,-1,-1,-1,0,13.0,1.0,12.0,10
17257,17257,2016-17,2016,2017,Watford,Everton,Loss,Away,2017-05-12,0,0,0,3,3,0,1,4,7,0,-1,-1,-4,0,13.0,11.0,2.0,10
17258,17258,2016-17,2016,2017,Watford,Chelsea,Loss,Away,2017-05-15,0,0,0,0,3,6,9,12,12,-6,-9,-12,-9,0,13.0,10.0,3.0,10
17259,17259,2016-17,2016,2017,Watford,Man City,Loss,Home,2017-05-21,0,0,0,0,0,6,9,10,11,-6,-9,-10,-11,1,13.0,4.0,9.0,10
17260,17260,2017-18,2017,2018,Watford,Liverpool,Draw,Home,2017-08-12,1,0,0,0,0,6,7,10,10,-6,-7,-10,-10,1,17.0,4.0,13.0,1
17261,17261,2017-18,2017,2018,Watford,Bournemouth,Win,Away,2017-08-19,3,1,1,1,1,1,4,5,8,0,-3,-4,-7,0,17.0,9.0,8.0,1
17262,17262,2017-18,2017,2018,Watford,Brighton,Draw,Home,2017-08-26,1,4,4,4,4,0,0,0,0,4,4,4,4,1,17.0,21.0,-4.0,1
17263,17263,2017-18,2017,2018,Watford,Southampton,Win,Away,2017-09-09,3,4,5,5,5,4,5,5,6,0,0,0,-1,0,17.0,8.0,9.0,2
17264,17264,2017-18,2017,2018,Watford,Man City,Loss,Home,2017-09-16,0,4,7,8,8,6,7,10,13,-2,0,-2,-5,1,17.0,3.0,14.0,2
17265,17265,2017-18,2017,2018,Watford,Swansea,Win,Away,2017-09-23,3,3,4,7,8,1,4,4,5,2,0,3,3,0,17.0,15.0,2.0,2
17266,17266,2017-18,2017,2018,Watford,West Brom,Draw,Away,2017-09-30,1,3,6,7,10,1,1,2,5,2,5,5,5,0,17.0,10.0,7.0,2
17267,17267,2017-18,2017,2018,Watford,Arsenal,Win,Home,2017-10-14,3,4,4,7,8,6,7,10,10,-2,-3,-3,-2,1,17.0,5.0,12.0,3
17268,17268,2017-18,2017,2018,Watford,Chelsea,Loss,Away,2017-10-21,0,4,7,7,10,0,3,4,7,4,4,3,3,0,17.0,1.0,16.0,3
17269,17269,2017-18,2017,2018,Watford,Stoke,Loss,Home,2017-10-28,0,3,4,7,7,0,3,3,3,3,1,4,4,1,17.0,13.0,4.0,3
17270,17270,2017-18,2017,2018,Watford,Everton,Loss,Away,2017-11-05,0,0,3,4,7,0,1,1,4,0,2,3,3,0,17.0,7.0,10.0,4
17271,17271,2017-18,2017,2018,Watford,West Ham,Win,Home,2017-11-19,3,0,0,3,4,1,1,2,5,-1,-1,1,-1,1,17.0,11.0,6.0,4
17272,17272,2017-18,2017,2018,Watford,Newcastle,Win,Away,2017-11-25,3,3,3,3,6,0,0,3,4,3,3,0,2,0,17.0,21.0,-4.0,4
17273,17273,2017-18,2017,2018,Watford,Man United,Loss,Home,2017-11-28,0,6,6,6,6,6,6,9,9,0,0,-3,-3,1,17.0,6.0,11.0,4
17274,17274,2017-18,2017,2018,Watford,Tottenham,Draw,Home,2017-12-02,1,3,6,6,6,1,1,4,4,2,5,2,2,1,17.0,2.0,15.0,5
17275,17275,2017-18,2017,2018,Watford,Burnley,Loss,Away,2017-12-09,0,1,4,7,7,3,3,6,9,-2,1,1,-2,0,17.0,16.0,1.0,5
17276,17276,2017-18,2017,2018,Watford,Crystal Palace,Loss,Away,2017-12-12,0,1,1,4,7,2,3,6,7,-1,-2,-2,0,0,17.0,14.0,3.0,5
17277,17277,2017-18,2017,2018,Watford,Huddersfield,Loss,Home,2017-12-16,0,0,1,1,4,3,3,3,3,-3,-2,-2,1,1,17.0,21.0,-4.0,5
17278,17278,2017-18,2017,2018,Watford,Brighton,Loss,Away,2017-12-23,0,0,0,1,1,1,1,1,2,-1,-1,0,-1,0,17.0,21.0,-4.0,5
17279,17279,2017-18,2017,2018,Watford,Leicester,Win,Home,2017-12-26,3,0,0,0,1,1,4,7,10,-1,-4,-7,-9,1,17.0,12.0,5.0,5
17280,17280,2017-18,2017,2018,Watford,Swansea,Loss,Home,2017-12-30,0,3,3,3,3,1,1,1,4,2,2,2,-1,1,17.0,15.0,2.0,5
17281,17281,2017-18,2017,2018,Watford,Man City,Loss,Away,2018-01-02,0,3,3,3,3,4,7,10,13,-1,-4,-7,-10,0,17.0,3.0,14.0,6
17282,17282,2017-18,2017,2018,Watford,Southampton,Draw,Home,2018-01-13,1,0,3,3,3,1,1,2,2,-1,2,1,1,1,17.0,8.0,9.0,6
17283,17283,2017-18,2017,2018,Watford,Leicester,Loss,Away,2018-01-20,0,1,1,4,4,4,4,4,5,-3,-3,0,-1,0,17.0,12.0,5.0,6
17284,17284,2017-18,2017,2018,Watford,Stoke,Draw,Away,2018-01-31,1,1,1,1,4,3,3,3,4,-2,-2,-2,0,0,17.0,13.0,4.0,6
17285,17285,2017-18,2017,2018,Watford,Chelsea,Win,Home,2018-02-05,3,1,2,2,2,3,4,5,8,-2,-2,-3,-6,1,17.0,1.0,16.0,7
17286,17286,2017-18,2017,2018,Watford,West Ham,Loss,Away,2018-02-10,0,4,4,5,5,1,2,5,6,3,2,0,-1,0,17.0,11.0,6.0,7
17287,17287,2017-18,2017,2018,Watford,Everton,Win,Home,2018-02-24,3,3,4,4,5,3,6,7,7,0,-2,-3,-2,1,17.0,7.0,10.0,7
17288,17288,2017-18,2017,2018,Watford,West Brom,Win,Home,2018-03-03,3,3,6,7,7,0,0,0,1,3,6,7,6,1,17.0,10.0,7.0,8
17289,17289,2017-18,2017,2018,Watford,Arsenal,Loss,Away,2018-03-11,0,6,6,9,10,0,0,3,3,6,6,6,7,0,17.0,5.0,12.0,8
17290,17290,2017-18,2017,2018,Watford,Liverpool,Loss,Away,2018-03-17,0,3,6,6,9,3,6,9,10,0,0,-3,-1,0,17.0,4.0,13.0,8
17291,17291,2017-18,2017,2018,Watford,Bournemouth,Draw,Home,2018-03-31,1,0,3,6,6,3,4,5,5,-3,-1,1,1,1,17.0,9.0,8.0,8
17292,17292,2017-18,2017,2018,Watford,Burnley,Loss,Home,2018-04-07,0,1,1,4,7,6,9,10,10,-5,-8,-6,-3,1,17.0,16.0,1.0,9
17293,17293,2017-18,2017,2018,Watford,Huddersfield,Loss,Away,2018-04-14,0,1,1,1,4,1,1,2,2,0,0,-1,2,0,17.0,21.0,-4.0,9
17294,17294,2017-18,2017,2018,Watford,Crystal Palace,Draw,Home,2018-04-21,1,0,1,1,1,4,4,7,7,-4,-3,-6,-6,1,17.0,14.0,3.0,9
17295,17295,2017-18,2017,2018,Watford,Tottenham,Loss,Away,2018-04-30,0,1,1,2,2,1,4,7,10,0,-3,-5,-8,0,17.0,2.0,15.0,9
17296,17296,2017-18,2017,2018,Watford,Newcastle,Win,Home,2018-05-05,3,1,1,1,2,0,3,6,9,1,-2,-5,-7,1,17.0,21.0,-4.0,10
17297,17297,2017-18,2017,2018,Watford,Man United,Loss,Away,2018-05-13,0,3,4,4,4,1,4,7,7,2,0,-3,-3,0,17.0,6.0,11.0,10
17298,17298,2002-03,2002,2003,West Brom,Man United,Loss,Away,2002-08-17,0,0,0,0,0,1,4,7,10,-1,-4,-7,-10,0,21.0,3.0,18.0,1
17299,17299,2002-03,2002,2003,West Brom,Leeds,Loss,Home,2002-08-24,0,0,0,0,0,6,9,9,12,-6,-9,-9,-12,1,21.0,5.0,16.0,1
17300,17300,2002-03,2002,2003,West Brom,Arsenal,Loss,Away,2002-08-27,0,0,0,0,0,4,7,10,13,-4,-7,-10,-13,0,21.0,1.0,20.0,1
17301,17301,2002-03,2002,2003,West Brom,Fulham,Win,Home,2002-08-31,3,0,0,0,0,4,4,5,8,-4,-4,-5,-8,1,21.0,13.0,8.0,1
17302,17302,2002-03,2002,2003,West Brom,West Ham,Win,Away,2002-09-11,3,3,3,3,3,1,1,4,4,2,2,-1,-1,0,21.0,7.0,14.0,2
17303,17303,2002-03,2002,2003,West Brom,Southampton,Win,Home,2002-09-14,3,6,6,6,6,3,4,4,5,3,2,2,1,1,21.0,11.0,10.0,2
17304,17304,2002-03,2002,2003,West Brom,Liverpool,Loss,Away,2002-09-21,0,6,9,9,9,4,5,6,9,2,4,3,0,0,21.0,2.0,19.0,2
17305,17305,2002-03,2002,2003,West Brom,Blackburn,Loss,Home,2002-09-30,0,3,6,9,9,4,4,4,5,-1,2,5,4,1,21.0,10.0,11.0,2
17306,17306,2002-03,2002,2003,West Brom,Newcastle,Loss,Away,2002-10-05,0,0,3,6,9,6,6,6,7,-6,-3,0,2,0,21.0,4.0,17.0,3
17307,17307,2002-03,2002,2003,West Brom,Birmingham,Draw,Home,2002-10-19,1,0,0,3,6,3,3,6,7,-3,-3,-3,-1,1,21.0,21.0,0.0,3
17308,17308,2002-03,2002,2003,West Brom,Chelsea,Loss,Away,2002-10-26,0,1,1,1,4,3,3,4,7,-2,-2,-3,-3,0,21.0,6.0,15.0,3
17309,17309,2002-03,2002,2003,West Brom,Man City,Loss,Home,2002-11-02,0,1,1,1,1,3,3,3,4,-2,-2,-2,-3,1,21.0,21.0,0.0,4
17310,17310,2002-03,2002,2003,West Brom,Bolton,Draw,Away,2002-11-09,1,0,1,1,1,1,1,1,2,-1,0,0,-1,0,21.0,16.0,5.0,4
17311,17311,2002-03,2002,2003,West Brom,Aston Villa,Draw,Home,2002-11-16,1,1,1,2,2,4,5,5,6,-3,-4,-3,-4,1,21.0,8.0,13.0,4
17312,17312,2002-03,2002,2003,West Brom,Everton,Loss,Away,2002-11-23,0,2,2,2,3,6,9,12,15,-4,-7,-10,-12,0,21.0,15.0,6.0,4
17313,17313,2002-03,2002,2003,West Brom,Middlesbrough,Win,Home,2002-11-30,3,1,2,2,2,3,6,6,7,-2,-4,-4,-5,1,21.0,12.0,9.0,4
17314,17314,2002-03,2002,2003,West Brom,Tottenham,Loss,Away,2002-12-08,0,3,4,5,5,4,4,4,5,-1,0,1,0,0,21.0,9.0,12.0,5
17315,17315,2002-03,2002,2003,West Brom,Aston Villa,Loss,Away,2002-12-14,0,3,3,4,5,0,3,4,7,3,0,0,-2,0,21.0,8.0,13.0,5
17316,17316,2002-03,2002,2003,West Brom,Sunderland,Draw,Home,2002-12-21,1,0,3,3,4,3,3,3,4,-3,0,0,0,1,21.0,17.0,4.0,5
17317,17317,2002-03,2002,2003,West Brom,Arsenal,Loss,Home,2002-12-26,0,1,1,4,4,4,4,7,7,-3,-3,-3,-3,1,21.0,1.0,20.0,5
17318,17318,2002-03,2002,2003,West Brom,Charlton,Loss,Away,2002-12-28,0,1,1,1,4,2,3,6,9,-1,-2,-5,-5,0,21.0,14.0,7.0,5
17319,17319,2002-03,2002,2003,West Brom,Man United,Loss,Home,2003-01-11,0,0,1,1,1,6,6,6,9,-6,-5,-5,-8,1,21.0,3.0,18.0,6
17320,17320,2002-03,2002,2003,West Brom,Leeds,Draw,Away,2003-01-18,1,0,0,1,1,3,6,9,10,-3,-6,-8,-9,0,21.0,5.0,16.0,6
17321,17321,2002-03,2002,2003,West Brom,Charlton,Loss,Home,2003-01-29,0,1,1,1,2,4,4,7,8,-3,-3,-6,-6,1,21.0,14.0,7.0,6
17322,17322,2002-03,2002,2003,West Brom,Man City,Win,Away,2003-02-01,3,1,1,1,1,3,6,7,10,-2,-5,-6,-9,0,21.0,21.0,0.0,7
17323,17323,2002-03,2002,2003,West Brom,Bolton,Draw,Home,2003-02-08,1,3,4,4,4,3,3,4,5,0,1,0,-1,1,21.0,16.0,5.0,7
17324,17324,2002-03,2002,2003,West Brom,Fulham,Loss,Away,2003-02-19,0,4,4,5,5,3,3,6,7,1,1,-1,-2,0,21.0,13.0,8.0,7
17325,17325,2002-03,2002,2003,West Brom,West Ham,Loss,Home,2003-02-23,0,1,4,4,5,0,3,3,3,1,1,1,2,1,21.0,7.0,14.0,7
17326,17326,2002-03,2002,2003,West Brom,Southampton,Loss,Away,2003-03-01,0,0,1,4,4,0,0,3,3,0,1,1,1,0,21.0,11.0,10.0,8
17327,17327,2002-03,2002,2003,West Brom,Chelsea,Loss,Home,2003-03-16,0,0,0,1,4,0,3,4,7,0,-3,-3,-3,1,21.0,6.0,15.0,8
17328,17328,2002-03,2002,2003,West Brom,Birmingham,Loss,Away,2003-03-22,0,0,0,0,1,3,6,6,6,-3,-6,-6,-5,0,21.0,21.0,0.0,8
17329,17329,2002-03,2002,2003,West Brom,Middlesbrough,Loss,Away,2003-04-05,0,0,0,0,0,4,7,8,11,-4,-7,-8,-11,0,21.0,12.0,9.0,9
17330,17330,2002-03,2002,2003,West Brom,Everton,Loss,Home,2003-04-12,0,0,0,0,0,3,4,5,8,-3,-4,-5,-8,1,21.0,15.0,6.0,9
17331,17331,2002-03,2002,2003,West Brom,Sunderland,Win,Away,2003-04-19,3,0,0,0,0,0,0,0,0,0,0,0,0,0,21.0,17.0,4.0,9
17332,17332,2002-03,2002,2003,West Brom,Tottenham,Loss,Home,2003-04-21,0,3,3,3,3,1,4,4,4,2,-1,-1,-1,1,21.0,9.0,12.0,9
17333,17333,2002-03,2002,2003,West Brom,Liverpool,Loss,Home,2003-04-26,0,3,3,3,3,6,9,9,12,-3,-6,-6,-9,1,21.0,2.0,19.0,9
17334,17334,2002-03,2002,2003,West Brom,Blackburn,Draw,Away,2003-05-03,1,0,3,3,3,4,4,7,10,-4,-1,-4,-7,0,21.0,10.0,11.0,10
17335,17335,2002-03,2002,2003,West Brom,Newcastle,Draw,Home,2003-05-11,1,1,1,4,4,6,7,7,7,-5,-6,-3,-3,1,21.0,4.0,17.0,10
17336,17336,2004-05,2004,2005,West Brom,Blackburn,Draw,Away,2004-08-14,1,2,2,2,5,1,4,7,10,1,-2,-5,-5,0,21.0,15.0,6.0,1
17337,17337,2004-05,2004,2005,West Brom,Aston Villa,Draw,Home,2004-08-22,1,2,3,3,3,3,4,7,10,-1,-1,-4,-7,1,21.0,6.0,15.0,1
17338,17338,2004-05,2004,2005,West Brom,Tottenham,Draw,Home,2004-08-25,1,2,3,4,4,4,7,10,10,-2,-4,-6,-6,1,21.0,14.0,7.0,1
17339,17339,2004-05,2004,2005,West Brom,Everton,Loss,Away,2004-08-28,0,2,3,4,5,3,3,3,3,-1,0,1,2,0,21.0,17.0,4.0,1
17340,17340,2004-05,2004,2005,West Brom,Liverpool,Loss,Away,2004-09-11,0,1,2,3,4,3,4,5,8,-2,-2,-2,-4,0,21.0,4.0,17.0,2
17341,17341,2004-05,2004,2005,West Brom,Fulham,Draw,Home,2004-09-18,1,0,1,2,3,0,0,3,4,0,1,-1,-1,1,21.0,9.0,12.0,2
17342,17342,2004-05,2004,2005,West Brom,Newcastle,Loss,Away,2004-09-25,0,1,1,2,3,6,6,7,7,-5,-5,-5,-4,0,21.0,5.0,16.0,2
17343,17343,2004-05,2004,2005,West Brom,Bolton,Win,Home,2004-10-02,3,1,1,1,2,2,3,6,9,-1,-2,-5,-7,1,21.0,8.0,13.0,3
17344,17344,2004-05,2004,2005,West Brom,Norwich,Draw,Home,2004-10-16,1,3,4,4,4,1,2,3,3,2,2,1,1,1,21.0,21.0,0.0,3
17345,17345,2004-05,2004,2005,West Brom,Crystal Palace,Loss,Away,2004-10-23,0,4,4,5,5,3,4,4,4,1,0,1,1,0,21.0,21.0,0.0,3
17346,17346,2004-05,2004,2005,West Brom,Chelsea,Loss,Home,2004-10-30,0,1,4,4,5,3,6,9,10,-2,-2,-5,-5,1,21.0,2.0,19.0,3
17347,17347,2004-05,2004,2005,West Brom,Southampton,Draw,Away,2004-11-06,1,0,1,4,4,2,2,3,3,-2,-1,1,1,0,21.0,12.0,9.0,4
17348,17348,2004-05,2004,2005,West Brom,Middlesbrough,Loss,Home,2004-11-14,0,1,1,2,5,4,5,8,9,-3,-4,-6,-4,1,21.0,11.0,10.0,4
17349,17349,2004-05,2004,2005,West Brom,Arsenal,Draw,Away,2004-11-20,1,1,1,1,2,4,5,5,8,-3,-4,-4,-6,0,21.0,1.0,20.0,4
17350,17350,2004-05,2004,2005,West Brom,Man United,Loss,Home,2004-11-27,0,1,2,2,2,6,7,7,10,-5,-5,-5,-8,1,21.0,3.0,18.0,4
17351,17351,2004-05,2004,2005,West Brom,Portsmouth,Loss,Away,2004-12-04,0,1,1,2,2,3,3,3,6,-2,-2,-1,-4,0,21.0,13.0,8.0,5
17352,17352,2004-05,2004,2005,West Brom,Charlton,Loss,Home,2004-12-11,0,0,1,1,2,3,3,6,9,-3,-2,-5,-7,1,21.0,7.0,14.0,5
17353,17353,2004-05,2004,2005,West Brom,Birmingham,Loss,Away,2004-12-18,0,0,0,1,1,3,4,5,5,-3,-4,-4,-4,0,21.0,10.0,11.0,5
17354,17354,2004-05,2004,2005,West Brom,Liverpool,Loss,Home,2004-12-26,0,0,0,0,1,4,4,5,8,-4,-4,-5,-7,1,21.0,4.0,17.0,5
17355,17355,2004-05,2004,2005,West Brom,Man City,Draw,Away,2004-12-28,1,0,0,0,0,3,3,3,6,-3,-3,-3,-6,0,21.0,16.0,5.0,5
17356,17356,2004-05,2004,2005,West Brom,Bolton,Draw,Away,2005-01-01,1,1,1,1,1,0,0,0,0,1,1,1,1,0,21.0,8.0,13.0,6
17357,17357,2004-05,2004,2005,West Brom,Newcastle,Draw,Home,2005-01-03,1,2,2,2,2,3,4,4,5,-1,-2,-2,-3,1,21.0,5.0,16.0,6
17358,17358,2004-05,2004,2005,West Brom,Fulham,Loss,Away,2005-01-16,0,2,3,3,3,4,4,4,4,-2,-1,-1,-1,0,21.0,9.0,12.0,6
17359,17359,2004-05,2004,2005,West Brom,Man City,Win,Home,2005-01-22,3,1,2,3,3,4,7,8,8,-3,-5,-5,-5,1,21.0,16.0,5.0,6
17360,17360,2004-05,2004,2005,West Brom,Crystal Palace,Draw,Home,2005-02-01,1,3,4,5,6,3,6,6,7,0,-2,-1,-1,1,21.0,21.0,0.0,7
17361,17361,2004-05,2004,2005,West Brom,Norwich,Loss,Away,2005-02-05,0,4,4,5,6,1,1,1,2,3,3,4,4,0,21.0,21.0,0.0,7
17362,17362,2004-05,2004,2005,West Brom,Southampton,Draw,Home,2005-02-22,1,1,4,4,5,1,4,4,5,0,0,0,0,1,21.0,12.0,9.0,7
17363,17363,2004-05,2004,2005,West Brom,Birmingham,Win,Home,2005-03-06,3,1,2,5,5,3,3,6,6,-2,-1,-1,-1,1,21.0,10.0,11.0,8
17364,17364,2004-05,2004,2005,West Brom,Chelsea,Loss,Away,2005-03-15,0,4,4,5,8,6,7,10,13,-2,-3,-5,-5,0,21.0,2.0,19.0,8
17365,17365,2004-05,2004,2005,West Brom,Charlton,Win,Away,2005-03-19,3,3,4,4,5,4,5,6,6,-1,-1,-2,-1,0,21.0,7.0,14.0,8
17366,17366,2004-05,2004,2005,West Brom,Everton,Win,Home,2005-04-03,3,3,6,7,7,0,3,3,4,3,3,4,3,1,21.0,17.0,4.0,9
17367,17367,2004-05,2004,2005,West Brom,Aston Villa,Draw,Away,2005-04-10,1,6,6,9,10,3,6,6,9,3,0,3,1,0,21.0,6.0,15.0,9
17368,17368,2004-05,2004,2005,West Brom,Tottenham,Draw,Away,2005-04-20,1,4,7,7,10,4,5,8,8,0,2,-1,2,0,21.0,14.0,7.0,9
17369,17369,2004-05,2004,2005,West Brom,Middlesbrough,Loss,Away,2005-04-23,0,2,5,8,8,1,4,4,4,1,1,4,4,0,21.0,11.0,10.0,9
17370,17370,2004-05,2004,2005,West Brom,Blackburn,Draw,Home,2005-04-26,1,1,2,5,8,4,7,8,8,-3,-5,-3,0,1,21.0,15.0,6.0,9
17371,17371,2004-05,2004,2005,West Brom,Arsenal,Loss,Home,2005-05-02,0,1,2,3,6,4,7,10,13,-3,-5,-7,-7,1,21.0,1.0,20.0,10
17372,17372,2004-05,2004,2005,West Brom,Man United,Draw,Away,2005-05-07,1,1,1,2,3,6,6,6,7,-5,-5,-4,-4,0,21.0,3.0,18.0,10
17373,17373,2004-05,2004,2005,West Brom,Portsmouth,Win,Home,2005-05-15,3,1,2,2,3,1,4,4,5,0,-2,-2,-2,1,21.0,13.0,8.0,10
17374,17374,2005-06,2005,2006,West Brom,Man City,Draw,Away,2005-08-13,1,4,4,5,5,4,7,8,11,0,-3,-3,-6,0,17.0,8.0,9.0,1
17375,17375,2005-06,2005,2006,West Brom,Portsmouth,Win,Home,2005-08-20,3,4,5,5,6,0,1,1,4,4,4,4,2,1,17.0,16.0,1.0,1
17376,17376,2005-06,2005,2006,West Brom,Chelsea,Loss,Away,2005-08-24,0,4,7,8,8,6,7,10,13,-2,0,-2,-5,0,17.0,1.0,16.0,1
17377,17377,2005-06,2005,2006,West Brom,Birmingham,Loss,Home,2005-08-27,0,3,4,7,8,0,1,4,4,3,3,3,4,1,17.0,12.0,5.0,1
17378,17378,2005-06,2005,2006,West Brom,Wigan,Loss,Home,2005-09-10,0,0,3,4,7,3,3,3,3,-3,0,1,4,1,17.0,21.0,-4.0,2
17379,17379,2005-06,2005,2006,West Brom,Sunderland,Draw,Away,2005-09-17,1,0,0,3,4,0,0,0,0,0,0,3,4,0,17.0,21.0,-4.0,2
17380,17380,2005-06,2005,2006,West Brom,Charlton,Loss,Home,2005-09-24,0,1,1,1,4,3,6,9,12,-2,-5,-8,-8,1,17.0,11.0,6.0,2
17381,17381,2005-06,2005,2006,West Brom,Blackburn,Loss,Away,2005-10-01,0,1,1,1,1,3,4,4,5,-2,-3,-3,-4,0,17.0,15.0,2.0,3
17382,17382,2005-06,2005,2006,West Brom,Arsenal,Win,Home,2005-10-15,3,0,1,1,1,4,7,7,10,-4,-6,-6,-9,1,17.0,2.0,15.0,3
17383,17383,2005-06,2005,2006,West Brom,Bolton,Loss,Away,2005-10-23,0,3,3,4,4,0,3,6,7,3,0,-2,-3,0,17.0,6.0,11.0,3
17384,17384,2005-06,2005,2006,West Brom,Newcastle,Loss,Home,2005-10-30,0,3,3,3,4,3,4,7,10,0,-1,-4,-6,1,17.0,14.0,3.0,3
17385,17385,2005-06,2005,2006,West Brom,West Ham,Loss,Away,2005-11-05,0,0,3,3,3,3,3,4,5,-3,0,-1,-2,0,17.0,21.0,-4.0,4
17386,17386,2005-06,2005,2006,West Brom,Everton,Win,Home,2005-11-19,3,0,0,3,3,6,7,7,7,-6,-7,-4,-4,1,17.0,4.0,13.0,4
17387,17387,2005-06,2005,2006,West Brom,Middlesbrough,Draw,Away,2005-11-27,1,3,3,3,6,3,6,6,7,0,-3,-3,-1,0,17.0,7.0,10.0,4
17388,17388,2005-06,2005,2006,West Brom,Fulham,Draw,Home,2005-12-03,1,4,4,4,4,3,6,6,9,1,-2,-2,-5,1,17.0,13.0,4.0,5
17389,17389,2005-06,2005,2006,West Brom,Man City,Win,Home,2005-12-10,3,2,5,5,5,3,4,4,7,-1,1,1,-2,1,17.0,8.0,9.0,5
17390,17390,2005-06,2005,2006,West Brom,Portsmouth,Loss,Away,2005-12-17,0,4,5,8,8,0,0,0,0,4,5,8,8,0,17.0,16.0,1.0,5
17391,17391,2005-06,2005,2006,West Brom,Man United,Loss,Away,2005-12-26,0,3,4,5,8,6,7,10,13,-3,-3,-5,-5,0,17.0,3.0,14.0,5
17392,17392,2005-06,2005,2006,West Brom,Tottenham,Win,Home,2005-12-28,3,0,3,4,5,4,7,10,13,-4,-4,-6,-8,1,17.0,9.0,8.0,5
17393,17393,2005-06,2005,2006,West Brom,Liverpool,Loss,Away,2005-12-31,0,3,3,6,7,6,9,12,15,-3,-6,-6,-8,0,17.0,5.0,12.0,5
17394,17394,2005-06,2005,2006,West Brom,Aston Villa,Loss,Home,2006-01-02,0,3,3,3,6,2,5,5,6,1,-2,-2,0,1,17.0,10.0,7.0,6
17395,17395,2005-06,2005,2006,West Brom,Wigan,Win,Away,2006-01-15,3,0,3,3,3,0,3,6,9,0,0,-3,-6,0,17.0,21.0,-4.0,6
17396,17396,2005-06,2005,2006,West Brom,Sunderland,Loss,Home,2006-01-21,0,3,3,6,6,0,0,1,1,3,3,5,5,1,17.0,21.0,-4.0,6
17397,17397,2005-06,2005,2006,West Brom,Charlton,Draw,Away,2006-01-31,1,3,3,3,6,4,4,7,7,-1,-1,-4,-1,0,17.0,11.0,6.0,6
17398,17398,2005-06,2005,2006,West Brom,Blackburn,Win,Home,2006-02-04,3,1,4,4,4,6,7,10,13,-5,-3,-6,-9,1,17.0,15.0,2.0,7
17399,17399,2005-06,2005,2006,West Brom,Fulham,Loss,Away,2006-02-11,0,4,4,7,7,3,3,6,9,1,1,1,-2,0,17.0,13.0,4.0,7
17400,17400,2005-06,2005,2006,West Brom,Middlesbrough,Loss,Home,2006-02-26,0,3,4,4,7,3,6,6,6,0,-2,-2,1,1,17.0,7.0,10.0,7
17401,17401,2005-06,2005,2006,West Brom,Chelsea,Loss,Home,2006-03-04,0,0,3,4,4,3,6,7,8,-3,-3,-3,-4,1,17.0,1.0,16.0,8
17402,17402,2005-06,2005,2006,West Brom,Birmingham,Draw,Away,2006-03-11,1,0,0,3,4,3,3,3,4,-3,-3,0,0,0,17.0,12.0,5.0,8
17403,17403,2005-06,2005,2006,West Brom,Man United,Loss,Home,2006-03-18,0,1,1,1,4,6,9,12,12,-5,-8,-11,-8,1,17.0,3.0,14.0,8
17404,17404,2005-06,2005,2006,West Brom,Tottenham,Loss,Away,2006-03-27,0,1,1,1,1,3,6,7,8,-2,-5,-6,-7,0,17.0,9.0,8.0,8
17405,17405,2005-06,2005,2006,West Brom,Liverpool,Loss,Home,2006-04-01,0,0,1,1,1,6,9,9,10,-6,-8,-8,-9,1,17.0,5.0,12.0,9
17406,17406,2005-06,2005,2006,West Brom,Aston Villa,Draw,Away,2006-04-09,1,0,0,1,1,1,1,1,4,-1,-1,0,-3,0,17.0,10.0,7.0,9
17407,17407,2005-06,2005,2006,West Brom,Arsenal,Loss,Away,2006-04-15,0,1,1,1,2,1,4,7,10,0,-3,-6,-8,0,17.0,2.0,15.0,9
17408,17408,2005-06,2005,2006,West Brom,Bolton,Draw,Home,2006-04-17,1,1,1,1,1,0,0,0,0,1,1,1,1,1,17.0,6.0,11.0,9
17409,17409,2005-06,2005,2006,West Brom,Newcastle,Loss,Away,2006-04-22,0,1,2,2,2,6,9,12,12,-5,-7,-10,-10,0,17.0,14.0,3.0,9
17410,17410,2005-06,2005,2006,West Brom,West Ham,Loss,Home,2006-05-01,0,1,1,2,2,0,3,3,4,1,-2,-1,-2,1,17.0,21.0,-4.0,10
17411,17411,2005-06,2005,2006,West Brom,Everton,Draw,Away,2006-05-07,1,0,1,1,2,4,4,4,5,-4,-3,-3,-3,0,17.0,4.0,13.0,10
17412,17412,2008-09,2008,2009,West Brom,Arsenal,Loss,Away,2008-08-16,0,1,1,2,2,6,9,12,12,-5,-8,-10,-10,0,21.0,3.0,18.0,1
17413,17413,2008-09,2008,2009,West Brom,Everton,Loss,Home,2008-08-23,0,1,1,1,2,3,3,4,4,-2,-2,-3,-2,1,21.0,5.0,16.0,1
17414,17414,2008-09,2008,2009,West Brom,Bolton,Draw,Away,2008-08-30,1,0,1,1,1,3,4,7,8,-3,-3,-6,-7,0,21.0,16.0,5.0,1
17415,17415,2008-09,2008,2009,West Brom,West Ham,Win,Home,2008-09-13,3,1,1,2,2,3,6,7,7,-2,-5,-5,-5,1,21.0,10.0,11.0,2
17416,17416,2008-09,2008,2009,West Brom,Aston Villa,Loss,Home,2008-09-21,0,4,4,4,5,4,4,7,8,0,0,-3,-3,1,21.0,6.0,15.0,2
17417,17417,2008-09,2008,2009,West Brom,Middlesbrough,Win,Away,2008-09-27,3,3,4,4,4,0,3,3,6,3,1,1,-2,0,21.0,13.0,8.0,2
17418,17418,2008-09,2008,2009,West Brom,Fulham,Win,Home,2008-10-04,3,3,6,7,7,0,3,6,6,3,3,1,1,1,21.0,17.0,4.0,3
17419,17419,2008-09,2008,2009,West Brom,Man United,Loss,Away,2008-10-18,0,6,6,9,10,6,7,7,10,0,-1,2,0,0,21.0,1.0,20.0,3
17420,17420,2008-09,2008,2009,West Brom,Hull,Loss,Home,2008-10-25,0,3,6,6,9,6,9,10,13,-3,-3,-4,-4,1,21.0,21.0,0.0,3
17421,17421,2008-09,2008,2009,West Brom,Newcastle,Loss,Away,2008-10-28,0,0,3,6,6,1,2,2,2,-1,1,4,4,0,21.0,12.0,9.0,3
17422,17422,2008-09,2008,2009,West Brom,Blackburn,Draw,Home,2008-11-01,1,0,0,3,6,1,2,2,5,-1,-2,1,1,1,21.0,7.0,14.0,4
17423,17423,2008-09,2008,2009,West Brom,Liverpool,Loss,Away,2008-11-08,0,1,1,1,4,3,6,9,12,-2,-5,-8,-8,0,21.0,4.0,17.0,4
17424,17424,2008-09,2008,2009,West Brom,Chelsea,Loss,Home,2008-11-15,0,1,1,1,1,6,9,9,12,-5,-8,-8,-11,1,21.0,2.0,19.0,4
17425,17425,2008-09,2008,2009,West Brom,Stoke,Loss,Away,2008-11-22,0,0,1,1,1,1,4,7,7,-1,-3,-6,-6,0,21.0,21.0,0.0,4
17426,17426,2008-09,2008,2009,West Brom,Wigan,Loss,Away,2008-11-29,0,0,0,1,1,4,5,8,8,-4,-5,-7,-7,0,21.0,14.0,7.0,4
17427,17427,2008-09,2008,2009,West Brom,Portsmouth,Draw,Home,2008-12-07,1,0,0,0,1,4,5,8,8,-4,-5,-8,-7,1,21.0,8.0,13.0,5
17428,17428,2008-09,2008,2009,West Brom,Sunderland,Loss,Away,2008-12-13,0,1,1,1,1,0,0,3,3,1,1,-2,-2,0,21.0,15.0,6.0,5
17429,17429,2008-09,2008,2009,West Brom,Man City,Win,Home,2008-12-21,3,1,1,1,1,1,1,4,5,0,0,-3,-4,1,21.0,9.0,12.0,5
17430,17430,2008-09,2008,2009,West Brom,Chelsea,Loss,Away,2008-12-26,0,3,4,4,4,2,5,5,6,1,-1,-1,-2,0,21.0,2.0,19.0,5
17431,17431,2008-09,2008,2009,West Brom,Tottenham,Win,Home,2008-12-28,3,3,3,4,4,1,2,5,5,2,1,-1,-1,1,21.0,11.0,10.0,5
17432,17432,2008-09,2008,2009,West Brom,Aston Villa,Loss,Away,2009-01-10,0,3,6,6,7,4,7,10,13,-1,-1,-4,-6,0,21.0,6.0,15.0,6
17433,17433,2008-09,2008,2009,West Brom,Middlesbrough,Win,Home,2009-01-17,3,3,3,6,6,1,1,1,2,2,2,5,4,1,21.0,13.0,8.0,6
17434,17434,2008-09,2008,2009,West Brom,Man United,Loss,Home,2009-01-27,0,3,6,6,9,6,9,12,15,-3,-3,-6,-6,1,21.0,1.0,20.0,6
17435,17435,2008-09,2008,2009,West Brom,Hull,Draw,Away,2009-01-31,1,3,3,6,6,0,0,0,0,3,3,6,6,0,21.0,21.0,0.0,6
17436,17436,2008-09,2008,2009,West Brom,Newcastle,Loss,Home,2009-02-07,0,1,4,4,7,1,1,2,2,0,3,2,5,1,21.0,12.0,9.0,7
17437,17437,2008-09,2008,2009,West Brom,Fulham,Loss,Away,2009-02-22,0,1,1,4,4,1,4,4,4,0,-3,0,0,0,21.0,17.0,4.0,7
17438,17438,2008-09,2008,2009,West Brom,Everton,Loss,Away,2009-02-28,0,0,1,1,4,4,4,5,6,-4,-3,-4,-2,0,21.0,5.0,16.0,7
17439,17439,2008-09,2008,2009,West Brom,Arsenal,Loss,Home,2009-03-03,0,0,0,1,1,2,3,4,5,-2,-3,-3,-4,1,21.0,3.0,18.0,8
17440,17440,2008-09,2008,2009,West Brom,West Ham,Draw,Away,2009-03-16,1,0,0,0,1,6,6,6,7,-6,-6,-6,-6,0,21.0,10.0,11.0,8
17441,17441,2008-09,2008,2009,West Brom,Bolton,Draw,Home,2009-03-21,1,1,1,1,1,0,3,6,6,1,-2,-5,-5,1,21.0,16.0,5.0,8
17442,17442,2008-09,2008,2009,West Brom,Stoke,Loss,Home,2009-04-04,0,2,2,2,2,3,6,7,8,-1,-4,-5,-6,1,21.0,21.0,0.0,9
17443,17443,2008-09,2008,2009,West Brom,Portsmouth,Draw,Away,2009-04-11,1,1,2,2,2,4,5,5,6,-3,-3,-3,-4,0,21.0,8.0,13.0,9
17444,17444,2008-09,2008,2009,West Brom,Man City,Loss,Away,2009-04-19,0,1,2,3,3,0,3,3,6,1,-1,0,-3,0,21.0,9.0,12.0,9
17445,17445,2008-09,2008,2009,West Brom,Sunderland,Win,Home,2009-04-25,3,1,1,2,3,3,3,3,3,-2,-2,-1,0,1,21.0,15.0,6.0,9
17446,17446,2008-09,2008,2009,West Brom,Tottenham,Loss,Away,2009-05-02,0,3,4,4,5,3,6,6,9,0,-2,-2,-4,0,21.0,11.0,10.0,10
17447,17447,2008-09,2008,2009,West Brom,Wigan,Win,Home,2009-05-09,3,3,3,4,4,1,1,1,4,2,2,3,0,1,21.0,14.0,7.0,10
17448,17448,2008-09,2008,2009,West Brom,Liverpool,Loss,Home,2009-05-17,0,3,6,6,7,6,9,10,13,-3,-3,-4,-6,1,21.0,4.0,17.0,10
17449,17449,2008-09,2008,2009,West Brom,Blackburn,Draw,Away,2009-05-24,1,3,3,6,6,3,3,6,6,0,0,0,0,0,21.0,7.0,14.0,10
17450,17450,2010-11,2010,2011,West Brom,Chelsea,Loss,Away,2010-08-14,0,1,4,4,7,6,9,9,12,-5,-5,-5,-5,0,21.0,1.0,20.0,1
17451,17451,2010-11,2010,2011,West Brom,Sunderland,Win,Home,2010-08-21,3,1,1,4,4,1,1,4,7,0,0,0,-3,1,21.0,13.0,8.0,1
17452,17452,2010-11,2010,2011,West Brom,Liverpool,Loss,Away,2010-08-29,0,3,4,4,7,1,2,2,5,2,2,2,2,0,21.0,7.0,14.0,1
17453,17453,2010-11,2010,2011,West Brom,Tottenham,Draw,Home,2010-09-11,1,3,3,4,4,3,4,4,7,0,-1,0,-3,1,21.0,4.0,17.0,2
17454,17454,2010-11,2010,2011,West Brom,Birmingham,Win,Home,2010-09-18,3,1,4,4,5,2,5,6,6,-1,-1,-2,-1,1,21.0,9.0,12.0,2
17455,17455,2010-11,2010,2011,West Brom,Arsenal,Win,Away,2010-09-25,3,4,4,7,7,4,7,10,11,0,-3,-3,-4,0,21.0,3.0,18.0,2
17456,17456,2010-11,2010,2011,West Brom,Bolton,Draw,Home,2010-10-02,1,6,7,7,10,2,2,3,6,4,5,4,4,1,21.0,14.0,7.0,3
17457,17457,2010-11,2010,2011,West Brom,Man United,Draw,Away,2010-10-16,1,4,7,8,8,2,5,6,9,2,2,2,-1,0,21.0,2.0,19.0,3
17458,17458,2010-11,2010,2011,West Brom,Fulham,Win,Home,2010-10-23,3,2,5,8,9,1,2,3,6,1,3,5,3,1,21.0,12.0,9.0,3
17459,17459,2010-11,2010,2011,West Brom,Blackpool,Loss,Away,2010-11-01,0,4,5,8,11,0,3,3,3,4,2,5,8,0,21.0,21.0,0.0,4
17460,17460,2010-11,2010,2011,West Brom,Man City,Loss,Home,2010-11-07,0,3,4,5,8,0,3,6,9,3,1,-1,-1,1,21.0,5.0,16.0,4
17461,17461,2010-11,2010,2011,West Brom,West Ham,Draw,Away,2010-11-10,1,0,3,4,5,1,1,2,3,-1,2,2,2,0,21.0,17.0,4.0,4
17462,17462,2010-11,2010,2011,West Brom,Wigan,Loss,Away,2010-11-13,0,1,1,4,5,1,1,2,3,0,0,2,2,0,21.0,16.0,5.0,4
17463,17463,2010-11,2010,2011,West Brom,Stoke,Loss,Home,2010-11-20,0,1,1,1,4,6,6,6,6,-5,-5,-5,-2,1,21.0,11.0,10.0,4
17464,17464,2010-11,2010,2011,West Brom,Everton,Win,Away,2010-11-27,3,0,1,1,1,1,2,3,6,-1,-1,-2,-5,0,21.0,8.0,13.0,4
17465,17465,2010-11,2010,2011,West Brom,Newcastle,Win,Home,2010-12-05,3,3,3,4,4,1,2,2,5,2,1,2,-1,1,21.0,21.0,0.0,5
17466,17466,2010-11,2010,2011,West Brom,Aston Villa,Loss,Away,2010-12-11,0,6,6,6,7,0,0,1,4,6,6,5,3,0,21.0,6.0,15.0,5
17467,17467,2010-11,2010,2011,West Brom,Bolton,Loss,Away,2010-12-26,0,3,6,6,6,3,3,4,7,0,3,2,-1,0,21.0,14.0,7.0,5
17468,17468,2010-11,2010,2011,West Brom,Blackburn,Loss,Home,2010-12-28,0,0,3,6,6,1,1,4,4,-1,2,2,2,1,21.0,10.0,11.0,5
17469,17469,2010-11,2010,2011,West Brom,Man United,Loss,Home,2011-01-01,0,0,0,3,6,4,7,10,13,-4,-7,-7,-7,1,21.0,2.0,19.0,6
17470,17470,2010-11,2010,2011,West Brom,Fulham,Loss,Away,2011-01-04,0,0,0,0,3,3,3,4,4,-3,-3,-4,-1,0,21.0,12.0,9.0,6
17471,17471,2010-11,2010,2011,West Brom,Blackpool,Win,Home,2011-01-15,3,0,0,0,0,3,3,6,9,-3,-3,-6,-9,1,21.0,21.0,0.0,6
17472,17472,2010-11,2010,2011,West Brom,Blackburn,Loss,Away,2011-01-23,0,3,3,3,3,3,3,6,6,0,0,-3,-3,0,21.0,10.0,11.0,6
17473,17473,2010-11,2010,2011,West Brom,Wigan,Draw,Home,2011-02-01,1,3,3,3,3,0,1,2,2,3,2,1,1,1,21.0,16.0,5.0,7
17474,17474,2010-11,2010,2011,West Brom,Man City,Loss,Away,2011-02-05,0,1,4,4,4,1,4,5,8,0,0,-1,-4,0,21.0,5.0,16.0,7
17475,17475,2010-11,2010,2011,West Brom,West Ham,Draw,Home,2011-02-12,1,1,1,4,4,3,4,4,4,-2,-3,0,0,1,21.0,17.0,4.0,7
17476,17476,2010-11,2010,2011,West Brom,Wolves,Draw,Home,2011-02-20,1,1,2,2,5,3,3,3,3,-2,-1,-1,2,1,21.0,15.0,6.0,7
17477,17477,2010-11,2010,2011,West Brom,Stoke,Draw,Away,2011-02-28,1,2,2,3,3,0,3,3,3,2,-1,0,0,0,21.0,11.0,10.0,7
17478,17478,2010-11,2010,2011,West Brom,Birmingham,Win,Away,2011-03-05,3,2,3,3,4,3,6,7,7,-1,-3,-4,-3,0,21.0,9.0,12.0,8
17479,17479,2010-11,2010,2011,West Brom,Arsenal,Draw,Home,2011-03-19,1,4,5,6,6,4,7,8,11,0,-2,-2,-5,1,21.0,3.0,18.0,8
17480,17480,2010-11,2010,2011,West Brom,Liverpool,Win,Home,2011-04-02,3,4,5,6,7,6,6,7,10,-2,-1,-1,-3,1,21.0,7.0,14.0,9
17481,17481,2010-11,2010,2011,West Brom,Sunderland,Win,Away,2011-04-09,3,4,7,8,9,0,1,1,1,4,6,7,8,0,21.0,13.0,8.0,9
17482,17482,2010-11,2010,2011,West Brom,Chelsea,Loss,Home,2011-04-16,0,6,7,10,11,4,7,10,13,2,0,0,-2,1,21.0,1.0,20.0,9
17483,17483,2010-11,2010,2011,West Brom,Tottenham,Draw,Away,2011-04-23,1,3,6,7,10,4,5,6,7,-1,1,1,3,0,21.0,4.0,17.0,9
17484,17484,2010-11,2010,2011,West Brom,Aston Villa,Win,Home,2011-04-30,3,1,4,7,8,4,7,8,8,-3,-3,-1,0,1,21.0,6.0,15.0,9
17485,17485,2010-11,2010,2011,West Brom,Wolves,Loss,Away,2011-05-08,0,4,4,7,10,1,2,2,2,3,2,5,8,0,21.0,15.0,6.0,10
17486,17486,2010-11,2010,2011,West Brom,Everton,Win,Home,2011-05-14,3,3,4,4,7,4,4,7,10,-1,0,-3,-3,1,21.0,8.0,13.0,10
17487,17487,2010-11,2010,2011,West Brom,Newcastle,Draw,Away,2011-05-22,1,3,6,7,7,4,4,5,6,-1,2,2,1,0,21.0,21.0,0.0,10
17488,17488,2011-12,2011,2012,West Brom,Man United,Loss,Home,2011-08-14,0,4,4,7,8,4,7,7,10,0,-3,0,-2,1,11.0,1.0,10.0,1
17489,17489,2011-12,2011,2012,West Brom,Chelsea,Loss,Away,2011-08-20,0,1,4,4,7,1,2,2,5,0,2,2,2,0,11.0,2.0,9.0,1
17490,17490,2011-12,2011,2012,West Brom,Stoke,Loss,Home,2011-08-28,0,0,1,4,4,2,2,2,5,-2,-1,2,-1,1,11.0,13.0,-2.0,1
17491,17491,2011-12,2011,2012,West Brom,Norwich,Win,Away,2011-09-11,3,0,0,1,4,1,2,2,5,-1,-2,-1,-1,0,11.0,21.0,-10.0,2
17492,17492,2011-12,2011,2012,West Brom,Swansea,Loss,Away,2011-09-17,0,3,3,3,4,1,2,2,2,2,1,1,2,0,11.0,21.0,-10.0,2
17493,17493,2011-12,2011,2012,West Brom,Fulham,Draw,Home,2011-09-24,1,3,3,3,3,2,2,2,3,1,1,1,0,1,11.0,8.0,3.0,2
17494,17494,2011-12,2011,2012,West Brom,Sunderland,Draw,Away,2011-10-01,1,1,4,4,4,3,3,4,4,-2,1,0,0,0,11.0,10.0,1.0,3
17495,17495,2011-12,2011,2012,West Brom,Wolves,Win,Home,2011-10-16,3,2,2,5,5,0,0,0,1,2,2,5,4,1,11.0,17.0,-6.0,3
17496,17496,2011-12,2011,2012,West Brom,Aston Villa,Win,Away,2011-10-22,3,4,5,5,8,3,4,5,6,1,1,0,2,0,11.0,9.0,2.0,3
17497,17497,2011-12,2011,2012,West Brom,Liverpool,Loss,Home,2011-10-29,0,6,7,8,8,2,5,8,8,4,2,0,0,1,11.0,6.0,5.0,3
17498,17498,2011-12,2011,2012,West Brom,Arsenal,Loss,Away,2011-11-05,0,3,6,7,8,6,9,9,12,-3,-3,-2,-4,0,11.0,4.0,7.0,4
17499,17499,2011-12,2011,2012,West Brom,Bolton,Win,Home,2011-11-19,3,0,3,6,7,3,3,6,6,-3,0,0,1,1,11.0,14.0,-3.0,4
17500,17500,2011-12,2011,2012,West Brom,Tottenham,Loss,Home,2011-11-26,0,3,3,6,9,6,9,12,13,-3,-6,-6,-4,1,11.0,5.0,6.0,4
17501,17501,2011-12,2011,2012,West Brom,QPR,Draw,Away,2011-12-03,1,3,3,3,6,3,3,3,6,0,0,0,0,0,11.0,21.0,-10.0,5
17502,17502,2011-12,2011,2012,West Brom,Wigan,Loss,Home,2011-12-10,0,1,4,4,4,3,4,4,4,-2,0,0,0,1,11.0,16.0,-5.0,5
17503,17503,2011-12,2011,2012,West Brom,Blackburn,Win,Away,2011-12-17,3,1,1,4,4,3,3,4,4,-2,-2,0,0,0,11.0,15.0,-4.0,5
17504,17504,2011-12,2011,2012,West Brom,Newcastle,Win,Away,2011-12-21,3,3,4,4,7,1,1,2,2,2,3,2,5,0,11.0,12.0,-1.0,5
17505,17505,2011-12,2011,2012,West Brom,Man City,Draw,Home,2011-12-26,1,6,6,7,7,6,6,9,10,0,0,-2,-3,1,11.0,3.0,8.0,5
17506,17506,2011-12,2011,2012,West Brom,Everton,Loss,Home,2012-01-01,0,4,7,7,8,4,5,5,5,0,2,2,3,1,11.0,7.0,4.0,6
17507,17507,2011-12,2011,2012,West Brom,Tottenham,Loss,Away,2012-01-03,0,1,4,7,7,4,5,8,8,-3,-1,-1,-1,0,11.0,5.0,6.0,6
17508,17508,2011-12,2011,2012,West Brom,Norwich,Loss,Home,2012-01-14,0,0,1,4,7,4,4,5,6,-4,-3,-1,1,1,11.0,21.0,-10.0,6
17509,17509,2011-12,2011,2012,West Brom,Stoke,Win,Away,2012-01-21,3,0,0,1,4,4,5,6,6,-4,-5,-5,-2,0,11.0,13.0,-2.0,6
17510,17510,2011-12,2011,2012,West Brom,Fulham,Draw,Away,2012-02-01,1,3,3,3,4,3,6,7,8,0,-3,-4,-4,0,11.0,8.0,3.0,7
17511,17511,2011-12,2011,2012,West Brom,Swansea,Loss,Home,2012-02-04,0,4,4,4,4,1,4,7,8,3,0,-3,-4,1,11.0,21.0,-10.0,7
17512,17512,2011-12,2011,2012,West Brom,Wolves,Win,Away,2012-02-12,3,1,4,4,4,3,3,4,4,-2,1,0,0,0,11.0,17.0,-6.0,7
17513,17513,2011-12,2011,2012,West Brom,Sunderland,Win,Home,2012-02-25,3,3,4,7,7,3,6,9,9,0,-2,-2,-2,1,11.0,10.0,1.0,7
17514,17514,2011-12,2011,2012,West Brom,Chelsea,Win,Home,2012-03-03,3,6,6,7,10,3,4,5,6,3,2,2,4,1,11.0,2.0,9.0,8
17515,17515,2011-12,2011,2012,West Brom,Man United,Loss,Away,2012-03-11,0,6,9,9,10,6,9,10,13,0,0,-1,-3,0,11.0,1.0,10.0,8
17516,17516,2011-12,2011,2012,West Brom,Wigan,Draw,Away,2012-03-17,1,3,6,9,9,1,2,5,6,2,4,4,3,0,11.0,16.0,-5.0,8
17517,17517,2011-12,2011,2012,West Brom,Newcastle,Loss,Home,2012-03-25,0,1,4,7,10,3,4,5,5,-2,0,2,5,1,11.0,12.0,-1.0,8
17518,17518,2011-12,2011,2012,West Brom,Everton,Loss,Away,2012-03-31,0,1,1,4,7,3,3,6,7,-2,-2,-2,0,0,11.0,7.0,4.0,8
17519,17519,2011-12,2011,2012,West Brom,Blackburn,Win,Home,2012-04-07,3,0,1,1,4,0,3,6,7,0,-2,-5,-3,1,11.0,15.0,-4.0,9
17520,17520,2011-12,2011,2012,West Brom,Man City,Loss,Away,2012-04-11,0,3,3,4,4,1,2,5,5,2,1,-1,-1,0,11.0,3.0,8.0,9
17521,17521,2011-12,2011,2012,West Brom,QPR,Win,Home,2012-04-14,3,3,3,3,4,3,6,6,9,0,-3,-3,-5,1,11.0,21.0,-10.0,9
17522,17522,2011-12,2011,2012,West Brom,Liverpool,Win,Away,2012-04-22,3,3,6,6,6,4,4,4,4,-1,2,2,2,0,11.0,6.0,5.0,9
17523,17523,2011-12,2011,2012,West Brom,Aston Villa,Draw,Home,2012-04-28,1,6,6,9,9,1,1,2,3,5,5,7,6,1,11.0,9.0,2.0,9
17524,17524,2011-12,2011,2012,West Brom,Bolton,Draw,Away,2012-05-06,1,4,7,7,10,1,4,5,5,3,3,2,5,0,11.0,14.0,-3.0,10
17525,17525,2011-12,2011,2012,West Brom,Arsenal,Loss,Home,2012-05-13,0,2,5,8,8,2,3,3,6,0,2,5,2,1,11.0,4.0,7.0,10
17526,17526,2012-13,2012,2013,West Brom,Liverpool,Win,Home,2012-08-18,3,1,2,5,8,3,3,6,6,-2,-1,-1,2,1,10.0,8.0,2.0,1
17527,17527,2012-13,2012,2013,West Brom,Tottenham,Draw,Away,2012-08-25,1,3,4,5,8,3,4,7,10,0,0,-2,-2,0,10.0,4.0,6.0,1
17528,17528,2012-13,2012,2013,West Brom,Everton,Win,Home,2012-09-01,3,4,4,5,6,6,9,10,11,-2,-5,-5,-5,1,10.0,7.0,3.0,2
17529,17529,2012-13,2012,2013,West Brom,Fulham,Loss,Away,2012-09-15,0,4,7,7,8,0,3,3,6,4,4,4,2,0,10.0,9.0,1.0,2
17530,17530,2012-13,2012,2013,West Brom,Reading,Win,Home,2012-09-22,3,3,4,7,7,0,1,4,4,3,3,3,3,1,10.0,21.0,-11.0,2
17531,17531,2012-13,2012,2013,West Brom,Aston Villa,Draw,Away,2012-09-30,1,3,6,7,10,3,4,4,4,0,2,3,6,0,10.0,16.0,-6.0,2
17532,17532,2012-13,2012,2013,West Brom,QPR,Win,Home,2012-10-06,3,4,4,7,8,0,1,1,2,4,3,6,6,1,10.0,17.0,-7.0,3
17533,17533,2012-13,2012,2013,West Brom,Man City,Loss,Home,2012-10-20,0,4,7,7,10,6,7,8,11,-2,0,-1,-1,1,10.0,1.0,9.0,3
17534,17534,2012-13,2012,2013,West Brom,Newcastle,Loss,Away,2012-10-28,0,3,4,7,7,1,2,5,6,2,2,2,1,0,10.0,5.0,5.0,3
17535,17535,2012-13,2012,2013,West Brom,Southampton,Win,Home,2012-11-05,3,0,3,4,7,0,1,1,4,0,2,3,3,1,10.0,21.0,-11.0,4
17536,17536,2012-13,2012,2013,West Brom,Wigan,Win,Away,2012-11-10,3,3,3,6,7,6,6,7,7,-3,-3,-1,0,0,10.0,15.0,-5.0,4
17537,17537,2012-13,2012,2013,West Brom,Chelsea,Win,Home,2012-11-17,3,6,6,6,9,2,2,5,8,4,4,1,1,1,10.0,6.0,4.0,4
17538,17538,2012-13,2012,2013,West Brom,Sunderland,Win,Away,2012-11-24,3,6,9,9,9,3,3,4,5,3,6,5,4,0,10.0,13.0,-3.0,4
17539,17539,2012-13,2012,2013,West Brom,Swansea,Loss,Away,2012-11-28,0,6,9,12,12,4,5,6,6,2,4,6,6,0,10.0,11.0,-1.0,4
17540,17540,2012-13,2012,2013,West Brom,Stoke,Loss,Home,2012-12-01,0,3,6,9,12,6,7,10,10,-3,-1,-1,2,1,10.0,14.0,-4.0,5
17541,17541,2012-13,2012,2013,West Brom,Arsenal,Loss,Away,2012-12-08,0,0,3,6,9,1,2,5,6,-1,1,1,3,0,10.0,3.0,7.0,5
17542,17542,2012-13,2012,2013,West Brom,West Ham,Draw,Home,2012-12-16,1,0,0,3,6,3,3,3,4,-3,-3,0,2,1,10.0,21.0,-11.0,5
17543,17543,2012-13,2012,2013,West Brom,Norwich,Win,Home,2012-12-22,3,1,1,1,4,6,9,10,11,-5,-8,-9,-7,1,10.0,12.0,-2.0,5
17544,17544,2012-13,2012,2013,West Brom,QPR,Win,Away,2012-12-26,3,4,4,4,4,3,4,5,6,1,0,-1,-2,0,10.0,17.0,-7.0,5
17545,17545,2012-13,2012,2013,West Brom,Man United,Loss,Away,2012-12-29,0,6,7,7,7,4,7,10,13,2,0,-3,-6,0,10.0,2.0,8.0,5
17546,17546,2012-13,2012,2013,West Brom,Fulham,Loss,Home,2013-01-01,0,3,6,7,7,1,1,1,4,2,5,6,3,1,10.0,9.0,1.0,6
17547,17547,2012-13,2012,2013,West Brom,Reading,Loss,Away,2013-01-12,0,0,3,6,7,3,4,4,4,-3,-1,2,3,0,10.0,21.0,-11.0,6
17548,17548,2012-13,2012,2013,West Brom,Aston Villa,Draw,Home,2013-01-19,1,0,0,3,6,1,1,1,1,-1,-1,2,5,1,10.0,16.0,-6.0,6
17549,17549,2012-13,2012,2013,West Brom,Everton,Loss,Away,2013-01-30,0,1,1,1,4,2,5,5,8,-1,-4,-4,-4,0,10.0,7.0,3.0,6
17550,17550,2012-13,2012,2013,West Brom,Tottenham,Loss,Home,2013-02-03,0,1,1,1,1,2,3,6,9,-1,-2,-5,-8,1,10.0,4.0,6.0,7
17551,17551,2012-13,2012,2013,West Brom,Liverpool,Win,Away,2013-02-11,3,0,1,1,1,2,5,5,8,-2,-4,-4,-7,0,10.0,8.0,2.0,7
17552,17552,2012-13,2012,2013,West Brom,Sunderland,Win,Home,2013-02-23,3,3,3,4,4,0,1,4,7,3,2,0,-3,1,10.0,13.0,-3.0,7
17553,17553,2012-13,2012,2013,West Brom,Chelsea,Loss,Away,2013-03-02,0,6,6,6,7,3,3,4,7,3,3,2,0,0,10.0,6.0,4.0,8
17554,17554,2012-13,2012,2013,West Brom,Swansea,Win,Home,2013-03-09,3,3,6,6,6,3,6,6,7,0,0,0,-1,1,10.0,11.0,-1.0,8
17555,17555,2012-13,2012,2013,West Brom,Stoke,Draw,Away,2013-03-16,1,3,6,9,9,0,0,3,3,3,6,6,6,0,10.0,14.0,-4.0,8
17556,17556,2012-13,2012,2013,West Brom,West Ham,Loss,Away,2013-03-30,0,4,4,7,10,3,3,3,6,1,1,4,4,0,10.0,21.0,-11.0,8
17557,17557,2012-13,2012,2013,West Brom,Arsenal,Loss,Home,2013-04-06,0,1,4,4,7,6,6,9,12,-5,-2,-5,-5,1,10.0,3.0,7.0,9
17558,17558,2012-13,2012,2013,West Brom,Newcastle,Draw,Home,2013-04-20,1,0,1,4,4,3,3,3,6,-3,-2,1,-2,1,10.0,5.0,5.0,9
17559,17559,2012-13,2012,2013,West Brom,Southampton,Win,Away,2013-04-27,3,1,1,2,5,2,5,8,11,-1,-4,-6,-6,0,10.0,21.0,-11.0,9
17560,17560,2012-13,2012,2013,West Brom,Wigan,Loss,Home,2013-05-04,0,4,4,4,5,1,1,2,5,3,3,2,0,1,10.0,15.0,-5.0,10
17561,17561,2012-13,2012,2013,West Brom,Man City,Loss,Away,2013-05-07,0,3,4,4,4,4,4,7,10,-1,0,-3,-6,0,10.0,1.0,9.0,10
17562,17562,2012-13,2012,2013,West Brom,Norwich,Loss,Away,2013-05-12,0,0,3,4,4,0,3,3,4,0,0,1,0,0,10.0,12.0,-2.0,10
17563,17563,2012-13,2012,2013,West Brom,Man United,Draw,Home,2013-05-19,1,0,0,3,4,3,4,7,8,-3,-4,-4,-4,1,10.0,2.0,8.0,10
17564,17564,2013-14,2013,2014,West Brom,Southampton,Loss,Home,2013-08-17,0,1,1,1,4,2,2,2,3,-1,-1,-1,1,1,8.0,14.0,-6.0,1
17565,17565,2013-14,2013,2014,West Brom,Everton,Draw,Away,2013-08-24,1,1,1,1,1,1,4,5,8,0,-3,-4,-7,0,8.0,6.0,2.0,1
17566,17566,2013-14,2013,2014,West Brom,Swansea,Loss,Home,2013-09-01,0,1,2,2,2,0,0,0,3,1,2,2,-1,1,8.0,9.0,-1.0,2
17567,17567,2013-14,2013,2014,West Brom,Fulham,Draw,Away,2013-09-14,1,1,1,2,2,0,3,6,6,1,-2,-4,-4,0,8.0,12.0,-4.0,2
17568,17568,2013-14,2013,2014,West Brom,Sunderland,Win,Home,2013-09-21,3,1,2,2,3,0,1,1,1,1,1,1,2,1,8.0,17.0,-9.0,2
17569,17569,2013-14,2013,2014,West Brom,Man United,Win,Away,2013-09-28,3,4,4,5,5,3,3,4,7,1,1,1,-2,0,8.0,1.0,7.0,2
17570,17570,2013-14,2013,2014,West Brom,Arsenal,Draw,Home,2013-10-06,1,6,7,7,8,6,9,12,15,0,-2,-5,-7,1,8.0,4.0,4.0,3
17571,17571,2013-14,2013,2014,West Brom,Stoke,Draw,Away,2013-10-19,1,4,7,8,8,0,0,1,4,4,7,7,4,0,8.0,13.0,-5.0,3
17572,17572,2013-14,2013,2014,West Brom,Liverpool,Loss,Away,2013-10-26,0,2,5,8,9,4,7,7,8,-2,-2,1,1,0,8.0,7.0,1.0,3
17573,17573,2013-14,2013,2014,West Brom,Crystal Palace,Win,Home,2013-11-02,3,1,2,5,8,0,0,0,0,1,2,5,8,1,8.0,21.0,-13.0,4
17574,17574,2013-14,2013,2014,West Brom,Chelsea,Draw,Away,2013-11-09,1,3,4,5,8,3,6,9,10,0,-2,-4,-2,0,8.0,3.0,5.0,4
17575,17575,2013-14,2013,2014,West Brom,Aston Villa,Draw,Home,2013-11-25,1,4,4,5,6,4,4,4,5,0,0,1,1,1,8.0,15.0,-7.0,4
17576,17576,2013-14,2013,2014,West Brom,Newcastle,Loss,Away,2013-11-30,0,2,5,5,6,6,9,9,10,-4,-4,-4,-4,0,8.0,16.0,-8.0,4
17577,17577,2013-14,2013,2014,West Brom,Man City,Loss,Home,2013-12-04,0,1,2,5,5,6,6,9,9,-5,-4,-4,-4,1,8.0,2.0,6.0,5
17578,17578,2013-14,2013,2014,West Brom,Norwich,Loss,Home,2013-12-07,0,0,1,2,5,3,3,6,6,-3,-2,-4,-1,1,8.0,11.0,-3.0,5
17579,17579,2013-14,2013,2014,West Brom,Cardiff,Loss,Away,2013-12-14,0,0,0,1,2,1,1,2,2,-1,-1,-1,0,0,8.0,21.0,-13.0,5
17580,17580,2013-14,2013,2014,West Brom,Hull,Draw,Home,2013-12-21,1,0,0,0,1,2,2,5,5,-2,-2,-5,-4,1,8.0,21.0,-13.0,5
17581,17581,2013-14,2013,2014,West Brom,Tottenham,Draw,Away,2013-12-26,1,1,1,1,1,3,6,9,10,-2,-5,-8,-9,0,8.0,5.0,3.0,5
17582,17582,2013-14,2013,2014,West Brom,West Ham,Draw,Away,2013-12-28,1,2,2,2,2,0,1,1,1,2,1,1,1,0,8.0,10.0,-2.0,5
17583,17583,2013-14,2013,2014,West Brom,Newcastle,Win,Home,2014-01-01,3,2,3,3,3,3,6,7,10,-1,-3,-4,-7,1,8.0,16.0,-8.0,6
17584,17584,2013-14,2013,2014,West Brom,Southampton,Loss,Away,2014-01-11,0,4,5,6,6,0,3,3,4,4,2,3,2,0,8.0,14.0,-6.0,6
17585,17585,2013-14,2013,2014,West Brom,Everton,Draw,Home,2014-01-20,1,3,4,5,6,4,7,7,10,-1,-3,-2,-4,1,8.0,6.0,2.0,6
17586,17586,2013-14,2013,2014,West Brom,Aston Villa,Loss,Away,2014-01-29,0,1,4,5,6,1,4,5,5,0,0,0,1,0,8.0,15.0,-7.0,6
17587,17587,2013-14,2013,2014,West Brom,Liverpool,Draw,Home,2014-02-02,1,1,1,4,5,4,7,10,10,-3,-6,-6,-5,1,8.0,7.0,1.0,7
17588,17588,2013-14,2013,2014,West Brom,Crystal Palace,Loss,Away,2014-02-08,0,1,2,2,5,3,6,6,7,-2,-4,-4,-2,0,8.0,21.0,-13.0,7
17589,17589,2013-14,2013,2014,West Brom,Chelsea,Draw,Home,2014-02-11,1,1,1,2,2,6,7,10,13,-5,-6,-8,-11,1,8.0,3.0,5.0,7
17590,17590,2013-14,2013,2014,West Brom,Fulham,Draw,Home,2014-02-22,1,1,2,2,3,1,1,1,1,0,1,1,2,1,8.0,12.0,-4.0,7
17591,17591,2013-14,2013,2014,West Brom,Man United,Loss,Home,2014-03-08,0,2,2,3,3,4,5,5,8,-2,-3,-2,-5,1,8.0,1.0,7.0,8
17592,17592,2013-14,2013,2014,West Brom,Swansea,Win,Away,2014-03-15,3,1,2,2,3,1,2,5,5,0,0,-3,-2,0,8.0,9.0,-1.0,8
17593,17593,2013-14,2013,2014,West Brom,Hull,Loss,Away,2014-03-22,0,3,4,5,5,0,3,3,6,3,1,2,-1,0,8.0,21.0,-13.0,8
17594,17594,2013-14,2013,2014,West Brom,Cardiff,Draw,Home,2014-03-29,1,3,3,4,5,0,3,3,3,3,0,1,2,1,8.0,21.0,-13.0,8
17595,17595,2013-14,2013,2014,West Brom,Norwich,Win,Away,2014-04-05,3,1,4,4,5,3,3,4,4,-2,1,0,1,0,8.0,11.0,-3.0,9
17596,17596,2013-14,2013,2014,West Brom,Tottenham,Draw,Home,2014-04-12,1,4,4,7,7,3,6,6,6,1,-2,1,1,1,8.0,5.0,3.0,9
17597,17597,2013-14,2013,2014,West Brom,Man City,Loss,Away,2014-04-21,0,4,5,5,8,1,4,5,8,3,1,0,0,0,8.0,2.0,6.0,9
17598,17598,2013-14,2013,2014,West Brom,West Ham,Win,Home,2014-04-26,3,1,4,5,5,0,0,3,6,1,4,2,-1,1,8.0,10.0,-2.0,9
17599,17599,2013-14,2013,2014,West Brom,Arsenal,Loss,Away,2014-05-04,0,3,4,7,8,6,9,9,10,-3,-5,-2,-2,0,8.0,4.0,4.0,10
17600,17600,2013-14,2013,2014,West Brom,Sunderland,Loss,Away,2014-05-07,0,3,3,4,7,6,9,10,10,-3,-6,-6,-3,0,8.0,17.0,-9.0,10
17601,17601,2013-14,2013,2014,West Brom,Stoke,Loss,Home,2014-05-11,0,0,3,3,4,3,4,7,7,-3,-1,-4,-3,1,8.0,13.0,-5.0,10
17602,17602,2014-15,2014,2015,West Brom,Sunderland,Draw,Home,2014-08-16,1,0,0,3,3,3,6,9,12,-3,-6,-6,-9,1,17.0,14.0,3.0,1
17603,17603,2014-15,2014,2015,West Brom,Southampton,Draw,Away,2014-08-23,1,1,1,1,4,1,4,7,8,0,-3,-6,-4,0,17.0,8.0,9.0,1
17604,17604,2014-15,2014,2015,West Brom,Swansea,Loss,Away,2014-08-30,0,2,2,2,2,6,9,9,12,-4,-7,-7,-10,0,17.0,12.0,5.0,1
17605,17605,2014-15,2014,2015,West Brom,Everton,Loss,Home,2014-09-13,0,1,2,2,2,1,2,5,5,0,0,-3,-3,1,17.0,5.0,12.0,2
17606,17606,2014-15,2014,2015,West Brom,Tottenham,Win,Away,2014-09-21,3,0,1,2,2,1,4,7,10,-1,-3,-5,-8,0,17.0,6.0,11.0,2
17607,17607,2014-15,2014,2015,West Brom,Burnley,Win,Home,2014-09-28,3,3,3,4,5,2,3,3,3,1,0,1,2,1,17.0,21.0,-4.0,2
17608,17608,2014-15,2014,2015,West Brom,Liverpool,Loss,Away,2014-10-04,0,6,6,6,7,1,1,4,4,5,5,2,3,0,17.0,2.0,15.0,3
17609,17609,2014-15,2014,2015,West Brom,Man United,Draw,Home,2014-10-20,1,3,6,6,6,6,6,9,10,-3,0,-3,-4,1,17.0,7.0,10.0,3
17610,17610,2014-15,2014,2015,West Brom,Crystal Palace,Draw,Home,2014-10-25,1,1,4,7,7,0,3,6,7,1,1,1,0,1,17.0,11.0,6.0,3
17611,17611,2014-15,2014,2015,West Brom,Leicester,Win,Away,2014-11-01,3,2,2,5,8,0,1,1,4,2,1,4,4,0,17.0,21.0,-4.0,4
17612,17612,2014-15,2014,2015,West Brom,Newcastle,Loss,Home,2014-11-09,0,4,5,5,8,6,9,10,10,-2,-4,-5,-2,1,17.0,10.0,7.0,4
17613,17613,2014-15,2014,2015,West Brom,Chelsea,Loss,Away,2014-11-22,0,3,4,5,5,6,7,10,13,-3,-3,-5,-8,0,17.0,3.0,14.0,4
17614,17614,2014-15,2014,2015,West Brom,Arsenal,Loss,Home,2014-11-29,0,0,3,4,5,0,3,6,7,0,0,-2,-2,1,17.0,4.0,13.0,4
17615,17615,2014-15,2014,2015,West Brom,West Ham,Loss,Home,2014-12-02,0,0,0,3,4,3,4,5,8,-3,-4,-2,-4,1,17.0,13.0,4.0,5
17616,17616,2014-15,2014,2015,West Brom,Hull,Draw,Away,2014-12-06,1,0,0,0,3,1,1,1,1,-1,-1,-1,2,0,17.0,16.0,1.0,5
17617,17617,2014-15,2014,2015,West Brom,Aston Villa,Win,Home,2014-12-13,3,1,1,1,1,6,7,8,9,-5,-6,-7,-8,1,17.0,15.0,2.0,5
17618,17618,2014-15,2014,2015,West Brom,QPR,Loss,Away,2014-12-20,0,4,4,4,4,3,3,6,6,1,1,-2,-2,0,17.0,21.0,-4.0,5
17619,17619,2014-15,2014,2015,West Brom,Man City,Loss,Home,2014-12-26,0,3,4,4,4,6,9,12,15,-3,-5,-8,-11,1,17.0,1.0,16.0,5
17620,17620,2014-15,2014,2015,West Brom,Stoke,Loss,Away,2014-12-28,0,0,3,4,4,3,4,7,7,-3,-1,-3,-3,0,17.0,9.0,8.0,5
17621,17621,2014-15,2014,2015,West Brom,West Ham,Draw,Away,2015-01-01,1,0,0,3,4,0,3,4,7,0,-3,-1,-3,0,17.0,13.0,4.0,6
17622,17622,2014-15,2014,2015,West Brom,Hull,Win,Home,2015-01-10,3,1,1,1,4,3,6,6,6,-2,-5,-5,-2,1,17.0,16.0,1.0,6
17623,17623,2014-15,2014,2015,West Brom,Everton,Draw,Away,2015-01-19,1,4,4,4,4,1,1,1,1,3,3,3,3,0,17.0,5.0,12.0,6
17624,17624,2014-15,2014,2015,West Brom,Tottenham,Loss,Home,2015-01-31,0,4,5,5,5,3,6,7,10,1,-1,-2,-5,1,17.0,6.0,11.0,6
17625,17625,2014-15,2014,2015,West Brom,Burnley,Draw,Away,2015-02-08,1,1,4,5,5,0,3,4,5,1,1,1,0,0,17.0,21.0,-4.0,7
17626,17626,2014-15,2014,2015,West Brom,Swansea,Win,Home,2015-02-11,3,1,2,5,6,4,4,5,6,-3,-2,0,0,1,17.0,12.0,5.0,7
17627,17627,2014-15,2014,2015,West Brom,Sunderland,Draw,Away,2015-02-21,1,4,4,5,8,1,4,4,4,3,0,1,4,0,17.0,14.0,3.0,7
17628,17628,2014-15,2014,2015,West Brom,Southampton,Win,Home,2015-02-28,3,4,5,5,6,1,4,4,7,3,1,1,-1,1,17.0,8.0,9.0,7
17629,17629,2014-15,2014,2015,West Brom,Aston Villa,Loss,Away,2015-03-03,0,4,7,8,8,0,0,0,0,4,7,8,8,0,17.0,15.0,2.0,8
17630,17630,2014-15,2014,2015,West Brom,Stoke,Win,Home,2015-03-14,3,3,4,7,8,6,9,9,10,-3,-5,-2,-2,1,17.0,9.0,8.0,8
17631,17631,2014-15,2014,2015,West Brom,Man City,Loss,Away,2015-03-21,0,3,6,7,10,3,3,6,9,0,3,1,1,0,17.0,1.0,16.0,8
17632,17632,2014-15,2014,2015,West Brom,QPR,Loss,Home,2015-04-04,0,3,3,6,7,0,0,0,0,3,3,6,7,1,17.0,21.0,-4.0,9
17633,17633,2014-15,2014,2015,West Brom,Leicester,Loss,Home,2015-04-11,0,0,3,3,6,3,4,4,5,-3,-1,-1,1,1,17.0,21.0,-4.0,9
17634,17634,2014-15,2014,2015,West Brom,Crystal Palace,Win,Away,2015-04-18,3,0,0,3,3,6,9,12,12,-6,-9,-9,-9,0,17.0,11.0,6.0,9
17635,17635,2014-15,2014,2015,West Brom,Liverpool,Draw,Home,2015-04-25,1,3,3,3,6,3,3,6,9,0,0,-3,-3,1,17.0,2.0,15.0,9
17636,17636,2014-15,2014,2015,West Brom,Man United,Win,Away,2015-05-02,3,4,4,4,4,0,3,6,9,4,1,-2,-5,0,17.0,7.0,10.0,10
17637,17637,2014-15,2014,2015,West Brom,Newcastle,Draw,Away,2015-05-09,1,4,7,7,7,0,0,0,0,4,7,7,7,0,17.0,10.0,7.0,10
17638,17638,2014-15,2014,2015,West Brom,Chelsea,Win,Home,2015-05-18,3,4,5,8,8,4,7,8,11,0,-2,0,-3,1,17.0,3.0,14.0,10
17639,17639,2014-15,2014,2015,West Brom,Arsenal,Loss,Away,2015-05-24,0,4,7,8,11,2,2,5,6,2,5,3,5,0,17.0,4.0,13.0,10
17640,17640,2015-16,2015,2016,West Brom,Man City,Loss,Home,2015-08-10,0,3,4,7,8,6,9,12,15,-3,-5,-5,-7,1,13.0,2.0,11.0,1
17641,17641,2015-16,2015,2016,West Brom,Watford,Draw,Away,2015-08-15,1,0,3,4,7,2,5,5,6,-2,-2,-1,1,0,13.0,21.0,-8.0,1
17642,17642,2015-16,2015,2016,West Brom,Chelsea,Loss,Home,2015-08-23,0,1,1,4,5,1,4,4,5,0,-3,0,0,1,13.0,1.0,12.0,1
17643,17643,2015-16,2015,2016,West Brom,Stoke,Win,Away,2015-08-29,3,1,1,1,4,2,2,5,6,-1,-1,-4,-2,0,13.0,9.0,4.0,1
17644,17644,2015-16,2015,2016,West Brom,Southampton,Draw,Home,2015-09-12,1,3,4,4,4,4,4,5,5,-1,0,-1,-1,1,13.0,7.0,6.0,2
17645,17645,2015-16,2015,2016,West Brom,Aston Villa,Win,Away,2015-09-19,3,4,4,5,5,1,1,1,4,3,3,4,1,0,13.0,17.0,-4.0,2
17646,17646,2015-16,2015,2016,West Brom,Everton,Loss,Home,2015-09-28,0,4,7,7,8,4,5,5,8,0,2,2,0,1,13.0,11.0,2.0,2
17647,17647,2015-16,2015,2016,West Brom,Crystal Palace,Loss,Away,2015-10-03,0,3,4,7,7,3,3,6,9,0,1,1,-2,0,13.0,10.0,3.0,3
17648,17648,2015-16,2015,2016,West Brom,Sunderland,Win,Home,2015-10-17,3,0,3,4,7,1,1,1,2,-1,2,3,5,1,13.0,16.0,-3.0,3
17649,17649,2015-16,2015,2016,West Brom,Norwich,Win,Away,2015-10-24,3,3,3,6,7,0,1,2,5,3,2,4,2,0,13.0,21.0,-8.0,3
17650,17650,2015-16,2015,2016,West Brom,Leicester,Loss,Home,2015-10-31,0,6,6,6,9,4,7,7,8,2,-1,-1,1,1,13.0,14.0,-1.0,3
17651,17651,2015-16,2015,2016,West Brom,Man United,Loss,Away,2015-11-07,0,3,6,6,6,2,5,5,8,1,1,1,-2,0,13.0,4.0,9.0,4
17652,17652,2015-16,2015,2016,West Brom,Arsenal,Win,Home,2015-11-21,3,0,3,6,6,4,7,10,13,-4,-4,-4,-7,1,13.0,3.0,10.0,4
17653,17653,2015-16,2015,2016,West Brom,West Ham,Draw,Away,2015-11-29,1,3,3,6,9,1,1,4,7,2,2,2,2,0,13.0,12.0,1.0,4
17654,17654,2015-16,2015,2016,West Brom,Tottenham,Draw,Home,2015-12-05,1,4,4,4,7,4,5,8,11,0,-1,-4,-4,1,13.0,5.0,8.0,5
17655,17655,2015-16,2015,2016,West Brom,Liverpool,Draw,Away,2015-12-13,1,2,5,5,5,3,6,6,9,-1,-1,-1,-4,0,13.0,6.0,7.0,5
17656,17656,2015-16,2015,2016,West Brom,Bournemouth,Loss,Home,2015-12-19,0,2,3,6,6,6,7,8,8,-4,-4,-2,-2,1,13.0,21.0,-8.0,5
17657,17657,2015-16,2015,2016,West Brom,Swansea,Loss,Away,2015-12-26,0,1,2,3,6,1,1,1,2,0,1,2,4,0,13.0,8.0,5.0,5
17658,17658,2015-16,2015,2016,West Brom,Newcastle,Win,Home,2015-12-28,3,0,1,2,3,1,4,7,7,-1,-3,-5,-4,1,13.0,15.0,-2.0,5
17659,17659,2015-16,2015,2016,West Brom,Stoke,Win,Home,2016-01-02,3,3,3,4,5,6,6,7,10,-3,-3,-3,-5,1,13.0,9.0,4.0,6
17660,17660,2015-16,2015,2016,West Brom,Chelsea,Draw,Away,2016-01-13,1,6,6,6,7,4,5,8,8,2,1,-2,-1,0,13.0,1.0,12.0,6
17661,17661,2015-16,2015,2016,West Brom,Southampton,Loss,Away,2016-01-16,0,4,7,7,7,3,3,6,6,1,4,1,1,0,13.0,7.0,6.0,6
17662,17662,2015-16,2015,2016,West Brom,Aston Villa,Draw,Home,2016-01-23,1,1,4,7,7,4,4,4,5,-3,0,3,2,1,13.0,17.0,-4.0,6
17663,17663,2015-16,2015,2016,West Brom,Swansea,Draw,Home,2016-02-02,1,1,2,5,8,6,6,6,7,-5,-4,-1,1,1,13.0,8.0,5.0,7
17664,17664,2015-16,2015,2016,West Brom,Newcastle,Loss,Away,2016-02-06,0,2,2,3,6,0,3,4,4,2,-1,-1,2,0,13.0,15.0,-2.0,7
17665,17665,2015-16,2015,2016,West Brom,Everton,Win,Away,2016-02-13,3,1,2,2,3,6,6,7,8,-5,-4,-5,-5,0,13.0,11.0,2.0,7
17666,17666,2015-16,2015,2016,West Brom,Crystal Palace,Win,Home,2016-02-27,3,3,4,5,5,1,1,1,1,2,3,4,4,1,13.0,10.0,3.0,7
17667,17667,2015-16,2015,2016,West Brom,Leicester,Draw,Away,2016-03-01,1,6,6,7,8,3,6,9,12,3,0,-2,-4,0,13.0,14.0,-1.0,8
17668,17668,2015-16,2015,2016,West Brom,Man United,Win,Home,2016-03-06,3,4,7,7,8,6,6,7,10,-2,1,0,-2,1,13.0,4.0,9.0,8
17669,17669,2015-16,2015,2016,West Brom,Norwich,Loss,Home,2016-03-19,0,4,7,10,10,1,1,1,2,3,6,9,8,1,13.0,21.0,-8.0,8
17670,17670,2015-16,2015,2016,West Brom,Sunderland,Draw,Away,2016-04-02,1,3,4,7,10,2,3,3,6,1,1,4,4,0,13.0,16.0,-3.0,9
17671,17671,2015-16,2015,2016,West Brom,Man City,Loss,Away,2016-04-09,0,1,4,5,8,3,4,7,7,-2,0,-2,1,0,13.0,2.0,11.0,9
17672,17672,2015-16,2015,2016,West Brom,Watford,Loss,Home,2016-04-16,0,1,1,4,5,1,1,1,1,0,0,3,4,1,13.0,21.0,-8.0,9
17673,17673,2015-16,2015,2016,West Brom,Arsenal,Loss,Away,2016-04-21,0,0,1,1,4,2,5,8,9,-2,-4,-7,-5,0,13.0,3.0,10.0,9
17674,17674,2015-16,2015,2016,West Brom,Tottenham,Draw,Away,2016-04-25,1,0,0,1,1,6,7,10,13,-6,-7,-9,-12,0,13.0,5.0,8.0,9
17675,17675,2015-16,2015,2016,West Brom,West Ham,Loss,Home,2016-04-30,0,1,1,1,2,4,5,6,7,-3,-4,-5,-5,1,13.0,12.0,1.0,9
17676,17676,2015-16,2015,2016,West Brom,Bournemouth,Draw,Away,2016-05-07,1,1,1,1,1,0,0,3,3,1,1,-2,-2,0,13.0,21.0,-8.0,10
17677,17677,2015-16,2015,2016,West Brom,Liverpool,Draw,Home,2016-05-15,1,1,2,2,2,4,4,5,8,-3,-2,-3,-6,1,13.0,6.0,7.0,10
17678,17678,2016-17,2016,2017,West Brom,Crystal Palace,Win,Away,2016-08-13,3,2,2,3,3,3,3,3,4,-1,-1,0,-1,0,14.0,15.0,-1.0,1
17679,17679,2016-17,2016,2017,West Brom,Everton,Loss,Home,2016-08-20,0,4,5,5,6,4,4,4,7,0,1,1,-1,1,14.0,11.0,3.0,1
17680,17680,2016-17,2016,2017,West Brom,Middlesbrough,Draw,Home,2016-08-28,1,3,4,5,5,4,4,5,5,-1,0,0,0,1,14.0,21.0,-7.0,1
17681,17681,2016-17,2016,2017,West Brom,Bournemouth,Loss,Away,2016-09-10,0,1,4,5,6,1,1,1,2,0,3,4,4,0,14.0,16.0,-2.0,2
17682,17682,2016-17,2016,2017,West Brom,West Ham,Win,Home,2016-09-17,3,1,1,4,5,0,3,3,3,1,-2,1,2,1,14.0,7.0,7.0,2
17683,17683,2016-17,2016,2017,West Brom,Stoke,Draw,Away,2016-09-24,1,3,4,4,7,0,0,0,1,3,4,4,6,0,14.0,9.0,5.0,2
17684,17684,2016-17,2016,2017,West Brom,Sunderland,Draw,Away,2016-10-01,1,4,4,5,5,0,0,1,1,4,4,4,4,0,14.0,17.0,-3.0,3
17685,17685,2016-17,2016,2017,West Brom,Tottenham,Draw,Home,2016-10-15,1,2,5,5,6,6,9,12,13,-4,-4,-7,-7,1,14.0,3.0,11.0,3
17686,17686,2016-17,2016,2017,West Brom,Liverpool,Loss,Away,2016-10-22,0,2,3,6,6,4,7,10,13,-2,-4,-4,-7,0,14.0,8.0,6.0,3
17687,17687,2016-17,2016,2017,West Brom,Man City,Loss,Home,2016-10-29,0,1,2,3,6,2,2,5,8,-1,0,-2,-2,1,14.0,4.0,10.0,3
17688,17688,2016-17,2016,2017,West Brom,Leicester,Win,Away,2016-11-06,3,0,1,2,3,4,4,5,5,-4,-3,-3,-2,0,14.0,1.0,13.0,4
17689,17689,2016-17,2016,2017,West Brom,Burnley,Win,Home,2016-11-21,3,3,3,4,5,4,7,7,7,-1,-4,-3,-2,1,14.0,21.0,-7.0,4
17690,17690,2016-17,2016,2017,West Brom,Hull,Draw,Away,2016-11-26,1,6,6,6,7,3,3,3,3,3,3,3,4,0,14.0,21.0,-7.0,4
17691,17691,2016-17,2016,2017,West Brom,Watford,Win,Home,2016-12-03,3,4,7,7,7,3,3,6,7,1,4,1,0,1,14.0,13.0,1.0,5
17692,17692,2016-17,2016,2017,West Brom,Chelsea,Loss,Away,2016-12-11,0,4,7,10,10,6,9,12,15,-2,-2,-2,-5,0,14.0,10.0,4.0,5
17693,17693,2016-17,2016,2017,West Brom,Swansea,Win,Home,2016-12-14,3,3,4,7,10,3,6,7,7,0,-2,0,3,1,14.0,12.0,2.0,5
17694,17694,2016-17,2016,2017,West Brom,Man United,Loss,Home,2016-12-17,0,3,6,7,10,6,7,8,9,-3,-1,-1,1,1,14.0,5.0,9.0,5
17695,17695,2016-17,2016,2017,West Brom,Arsenal,Loss,Away,2016-12-26,0,3,3,6,7,0,3,6,9,3,0,0,-2,0,14.0,2.0,12.0,5
17696,17696,2016-17,2016,2017,West Brom,Southampton,Win,Away,2016-12-31,3,0,3,3,6,3,4,7,7,-3,-1,-4,-1,0,14.0,6.0,8.0,5
17697,17697,2016-17,2016,2017,West Brom,Hull,Win,Home,2017-01-02,3,3,3,6,6,1,1,1,2,2,2,5,4,1,14.0,21.0,-7.0,6
17698,17698,2016-17,2016,2017,West Brom,Tottenham,Loss,Away,2017-01-14,0,6,6,6,9,6,9,12,15,0,-3,-6,-6,0,14.0,3.0,11.0,6
17699,17699,2016-17,2016,2017,West Brom,Sunderland,Win,Home,2017-01-21,3,3,6,6,6,1,1,1,4,2,5,5,2,1,14.0,17.0,-3.0,6
17700,17700,2016-17,2016,2017,West Brom,Middlesbrough,Draw,Away,2017-01-31,1,3,6,9,9,1,2,2,2,2,4,7,7,0,14.0,21.0,-7.0,6
17701,17701,2016-17,2016,2017,West Brom,Stoke,Win,Home,2017-02-04,3,4,4,7,10,2,5,8,8,2,-1,-1,2,1,14.0,9.0,5.0,7
17702,17702,2016-17,2016,2017,West Brom,West Ham,Draw,Away,2017-02-11,1,4,7,7,10,3,6,9,9,1,1,-2,1,0,14.0,7.0,7.0,7
17703,17703,2016-17,2016,2017,West Brom,Bournemouth,Win,Home,2017-02-25,3,4,5,8,8,0,0,1,1,4,5,7,7,1,14.0,16.0,-2.0,7
17704,17704,2016-17,2016,2017,West Brom,Crystal Palace,Loss,Home,2017-03-04,0,4,7,8,11,3,3,6,6,1,4,2,5,1,14.0,15.0,-1.0,8
17705,17705,2016-17,2016,2017,West Brom,Everton,Loss,Away,2017-03-11,0,3,4,7,8,3,4,7,8,0,0,0,0,0,14.0,11.0,3.0,8
17706,17706,2016-17,2016,2017,West Brom,Arsenal,Win,Home,2017-03-18,3,0,3,4,7,3,3,3,6,-3,0,1,1,1,14.0,2.0,12.0,8
17707,17707,2016-17,2016,2017,West Brom,Man United,Draw,Away,2017-04-01,1,3,3,6,7,4,7,10,11,-1,-4,-4,-4,0,14.0,5.0,9.0,9
17708,17708,2016-17,2016,2017,West Brom,Watford,Loss,Away,2017-04-04,0,4,4,4,7,3,3,4,4,1,1,0,3,0,14.0,13.0,1.0,9
17709,17709,2016-17,2016,2017,West Brom,Southampton,Loss,Home,2017-04-08,0,1,4,4,4,4,4,7,10,-3,0,-3,-6,1,14.0,6.0,8.0,9
17710,17710,2016-17,2016,2017,West Brom,Liverpool,Loss,Home,2017-04-16,0,0,1,4,4,4,7,8,11,-4,-6,-4,-7,1,14.0,8.0,6.0,9
17711,17711,2016-17,2016,2017,West Brom,Leicester,Loss,Home,2017-04-29,0,0,0,1,4,1,1,4,7,-1,-1,-3,-3,1,14.0,1.0,13.0,9
17712,17712,2016-17,2016,2017,West Brom,Burnley,Draw,Away,2017-05-06,1,0,0,0,1,3,3,4,7,-3,-3,-4,-6,0,14.0,21.0,-7.0,10
17713,17713,2016-17,2016,2017,West Brom,Chelsea,Loss,Home,2017-05-12,0,1,1,1,1,6,9,9,12,-5,-8,-8,-11,1,14.0,10.0,4.0,10
17714,17714,2016-17,2016,2017,West Brom,Man City,Loss,Away,2017-05-16,0,1,1,1,1,6,7,8,11,-5,-6,-7,-10,0,14.0,4.0,10.0,10
17715,17715,2016-17,2016,2017,West Brom,Swansea,Loss,Away,2017-05-21,0,0,1,1,1,6,7,10,10,-6,-6,-9,-9,0,14.0,12.0,2.0,10
17716,17716,2017-18,2017,2018,West Brom,Bournemouth,Win,Home,2017-08-12,3,0,0,1,1,4,5,8,11,-4,-5,-7,-10,1,10.0,9.0,1.0,1
17717,17717,2017-18,2017,2018,West Brom,Burnley,Win,Away,2017-08-19,3,3,3,3,4,3,3,4,7,0,0,-1,-3,0,10.0,16.0,-6.0,1
17718,17718,2017-18,2017,2018,West Brom,Stoke,Draw,Home,2017-08-27,1,6,6,6,6,3,6,6,7,3,0,0,-1,1,10.0,13.0,-3.0,1
17719,17719,2017-18,2017,2018,West Brom,Brighton,Loss,Away,2017-09-09,0,4,7,7,7,1,1,1,1,3,6,6,6,0,10.0,21.0,-11.0,2
17720,17720,2017-18,2017,2018,West Brom,West Ham,Draw,Home,2017-09-16,1,1,4,7,7,3,3,3,6,-2,1,4,1,1,10.0,11.0,-1.0,2
17721,17721,2017-18,2017,2018,West Brom,Arsenal,Loss,Away,2017-09-25,0,1,2,5,8,4,4,4,7,-3,-2,1,1,0,10.0,5.0,5.0,2
17722,17722,2017-18,2017,2018,West Brom,Watford,Draw,Home,2017-09-30,1,1,1,2,5,3,6,7,10,-2,-5,-5,-5,1,10.0,17.0,-7.0,2
17723,17723,2017-18,2017,2018,West Brom,Leicester,Draw,Away,2017-10-16,1,1,2,2,3,1,2,2,2,0,0,0,1,0,10.0,12.0,-2.0,3
17724,17724,2017-18,2017,2018,West Brom,Southampton,Loss,Away,2017-10-21,0,2,2,3,3,1,1,4,4,1,1,-1,-1,0,10.0,8.0,2.0,3
17725,17725,2017-18,2017,2018,West Brom,Man City,Loss,Home,2017-10-28,0,1,2,2,3,6,9,12,15,-5,-7,-10,-12,1,10.0,3.0,7.0,3
17726,17726,2017-18,2017,2018,West Brom,Huddersfield,Loss,Away,2017-11-04,0,0,1,2,2,3,3,3,4,-3,-2,-1,-2,0,10.0,21.0,-11.0,4
17727,17727,2017-18,2017,2018,West Brom,Chelsea,Loss,Home,2017-11-18,0,0,0,1,2,6,9,9,9,-6,-9,-8,-7,1,10.0,1.0,9.0,4
17728,17728,2017-18,2017,2018,West Brom,Tottenham,Draw,Away,2017-11-25,1,0,0,0,1,3,3,6,9,-3,-3,-6,-8,0,10.0,2.0,8.0,4
17729,17729,2017-18,2017,2018,West Brom,Newcastle,Draw,Home,2017-11-28,1,1,1,1,1,0,0,0,3,1,1,1,-2,1,10.0,21.0,-11.0,4
17730,17730,2017-18,2017,2018,West Brom,Crystal Palace,Draw,Home,2017-12-02,1,2,2,2,2,4,5,5,6,-2,-3,-3,-4,1,10.0,14.0,-4.0,5
17731,17731,2017-18,2017,2018,West Brom,Swansea,Loss,Away,2017-12-09,0,2,3,3,3,0,1,1,1,2,2,2,2,0,10.0,15.0,-5.0,5
17732,17732,2017-18,2017,2018,West Brom,Liverpool,Draw,Away,2017-12-13,1,1,2,3,3,4,7,8,11,-3,-5,-5,-8,0,10.0,4.0,6.0,5
17733,17733,2017-18,2017,2018,West Brom,Man United,Loss,Home,2017-12-17,0,1,2,3,4,3,6,9,12,-2,-4,-6,-8,1,10.0,6.0,4.0,5
17734,17734,2017-18,2017,2018,West Brom,Stoke,Loss,Away,2017-12-23,0,1,1,2,3,0,0,3,3,1,1,-1,0,0,10.0,13.0,-3.0,5
17735,17735,2017-18,2017,2018,West Brom,Everton,Draw,Home,2017-12-26,1,0,1,1,2,4,7,8,11,-4,-6,-7,-9,1,10.0,7.0,3.0,5
17736,17736,2017-18,2017,2018,West Brom,Arsenal,Draw,Home,2017-12-31,1,1,1,2,2,4,7,8,9,-3,-6,-6,-7,1,10.0,5.0,5.0,5
17737,17737,2017-18,2017,2018,West Brom,West Ham,Loss,Away,2018-01-02,0,2,2,2,3,1,4,5,8,1,-2,-3,-5,0,10.0,11.0,-1.0,6
17738,17738,2017-18,2017,2018,West Brom,Brighton,Win,Home,2018-01-13,3,1,2,2,2,2,2,5,6,-1,0,-3,-4,1,10.0,21.0,-11.0,6
17739,17739,2017-18,2017,2018,West Brom,Everton,Draw,Away,2018-01-20,1,3,4,5,5,0,0,1,2,3,4,4,3,0,10.0,7.0,3.0,6
17740,17740,2017-18,2017,2018,West Brom,Man City,Loss,Away,2018-01-31,0,4,4,5,6,3,6,7,10,1,-2,-2,-4,0,10.0,3.0,7.0,6
17741,17741,2017-18,2017,2018,West Brom,Southampton,Loss,Home,2018-02-03,0,1,4,4,5,2,3,3,4,-1,1,1,1,1,10.0,8.0,2.0,7
17742,17742,2017-18,2017,2018,West Brom,Chelsea,Loss,Away,2018-02-12,0,0,1,4,4,0,3,4,5,0,-2,0,-1,0,10.0,1.0,9.0,7
17743,17743,2017-18,2017,2018,West Brom,Huddersfield,Loss,Home,2018-02-24,0,0,0,1,4,3,3,3,3,-3,-3,-2,1,1,10.0,21.0,-11.0,7
17744,17744,2017-18,2017,2018,West Brom,Watford,Loss,Away,2018-03-03,0,0,0,0,1,3,6,7,7,-3,-6,-7,-6,0,10.0,17.0,-7.0,8
17745,17745,2017-18,2017,2018,West Brom,Leicester,Loss,Home,2018-03-10,0,0,0,0,0,2,2,3,3,-2,-2,-3,-3,1,10.0,12.0,-2.0,8
17746,17746,2017-18,2017,2018,West Brom,Bournemouth,Loss,Away,2018-03-17,0,0,0,0,0,1,2,2,5,-1,-2,-2,-5,0,10.0,9.0,1.0,8
17747,17747,2017-18,2017,2018,West Brom,Burnley,Loss,Home,2018-03-31,0,0,0,0,0,6,7,7,8,-6,-7,-7,-8,1,10.0,16.0,-6.0,8
17748,17748,2017-18,2017,2018,West Brom,Swansea,Draw,Home,2018-04-07,1,0,0,0,0,1,4,4,7,-1,-4,-4,-7,1,10.0,15.0,-5.0,9
17749,17749,2017-18,2017,2018,West Brom,Man United,Win,Away,2018-04-15,3,1,1,1,1,6,9,12,15,-5,-8,-11,-14,0,10.0,6.0,4.0,9
17750,17750,2017-18,2017,2018,West Brom,Liverpool,Draw,Home,2018-04-21,1,4,4,4,4,4,7,10,10,0,-3,-6,-6,1,10.0,4.0,6.0,9
17751,17751,2017-18,2017,2018,West Brom,Newcastle,Win,Away,2018-04-28,3,4,5,5,5,3,6,9,12,1,-1,-4,-7,0,10.0,21.0,-11.0,9
17752,17752,2017-18,2017,2018,West Brom,Tottenham,Win,Home,2018-05-05,3,4,7,8,8,4,4,7,10,0,3,1,-2,1,10.0,2.0,8.0,10
17753,17753,2017-18,2017,2018,West Brom,Crystal Palace,Loss,Away,2018-05-13,0,6,7,10,11,6,7,10,11,0,0,0,0,0,10.0,14.0,-4.0,10
17754,17754,1993-94,1993,1994,West Ham,Wimbledon,Loss,Home,1993-08-14,0,0,0,0,0,0,0,0,0,0,0,0,0,1,21.0,12.0,9.0,1
17755,17755,1993-94,1993,1994,West Ham,Leeds,Loss,Away,1993-08-17,0,0,0,0,0,1,1,1,1,-1,-1,-1,-1,0,21.0,17.0,4.0,1
17756,17756,1993-94,1993,1994,West Ham,Coventry,Draw,Away,1993-08-21,1,0,0,0,0,6,6,6,6,-6,-6,-6,-6,0,21.0,15.0,6.0,1
17757,17757,1993-94,1993,1994,West Ham,Sheffield Weds,Win,Home,1993-08-25,3,1,1,1,1,1,1,1,1,0,0,0,0,1,21.0,7.0,14.0,1
17758,17758,1993-94,1993,1994,West Ham,QPR,Loss,Home,1993-08-28,0,4,4,4,4,3,3,3,3,1,1,1,1,1,21.0,5.0,16.0,1
17759,17759,1993-94,1993,1994,West Ham,Man United,Loss,Away,1993-09-01,0,3,4,4,4,6,7,10,13,-3,-3,-6,-9,0,21.0,1.0,20.0,2
17760,17760,1993-94,1993,1994,West Ham,Swindon,Draw,Home,1993-09-11,1,0,3,4,4,1,1,1,1,-1,2,3,3,1,21.0,21.0,0.0,2
17761,17761,1993-94,1993,1994,West Ham,Blackburn,Win,Away,1993-09-18,3,1,1,4,5,4,5,8,11,-3,-4,-4,-6,0,21.0,4.0,17.0,2
17762,17762,1993-94,1993,1994,West Ham,Newcastle,Loss,Away,1993-09-25,0,4,4,4,7,4,5,6,9,0,-1,-2,-2,0,21.0,21.0,0.0,2
17763,17763,1993-94,1993,1994,West Ham,Chelsea,Win,Home,1993-10-02,3,3,4,4,4,4,7,8,9,-1,-3,-4,-5,1,21.0,11.0,10.0,3
17764,17764,1993-94,1993,1994,West Ham,Aston Villa,Draw,Home,1993-10-16,1,3,6,7,7,1,4,5,8,2,2,2,-1,1,21.0,2.0,19.0,3
17765,17765,1993-94,1993,1994,West Ham,Norwich,Draw,Away,1993-10-23,1,4,4,7,8,6,9,10,10,-2,-5,-3,-2,0,21.0,3.0,18.0,3
17766,17766,1993-94,1993,1994,West Ham,Man City,Win,Home,1993-11-01,3,2,5,5,8,2,3,6,6,0,2,-1,2,1,21.0,9.0,12.0,4
17767,17767,1993-94,1993,1994,West Ham,Liverpool,Loss,Away,1993-11-06,0,4,5,8,8,4,7,8,8,0,-2,0,0,0,21.0,6.0,15.0,4
17768,17768,1993-94,1993,1994,West Ham,Oldham,Win,Home,1993-11-20,3,3,4,5,8,3,4,4,5,0,0,1,3,1,21.0,19.0,2.0,4
17769,17769,1993-94,1993,1994,West Ham,Arsenal,Draw,Home,1993-11-24,1,3,6,7,8,3,4,5,6,0,2,2,2,1,21.0,10.0,11.0,4
17770,17770,1993-94,1993,1994,West Ham,Southampton,Win,Away,1993-11-29,3,4,4,7,8,3,6,6,9,1,-2,1,-1,0,21.0,18.0,3.0,4
17771,17771,1993-94,1993,1994,West Ham,Wimbledon,Win,Away,1993-12-04,3,4,7,7,10,2,2,5,5,2,5,2,5,0,21.0,12.0,9.0,5
17772,17772,1993-94,1993,1994,West Ham,Leeds,Loss,Home,1993-12-08,0,6,7,10,10,6,7,8,11,0,0,2,-1,1,21.0,17.0,4.0,5
17773,17773,1993-94,1993,1994,West Ham,Coventry,Win,Home,1993-12-11,3,3,6,7,10,3,3,4,7,0,3,3,3,1,21.0,15.0,6.0,5
17774,17774,1993-94,1993,1994,West Ham,Sheffield Weds,Loss,Away,1993-12-18,0,3,6,9,10,1,4,7,10,2,2,2,0,0,21.0,7.0,14.0,5
17775,17775,1993-94,1993,1994,West Ham,Ipswich,Draw,Away,1993-12-27,1,3,3,6,9,4,7,8,11,-1,-4,-2,-2,0,21.0,16.0,5.0,5
17776,17776,1993-94,1993,1994,West Ham,Tottenham,Loss,Home,1993-12-28,0,1,4,4,7,1,4,5,5,0,0,-1,2,1,21.0,8.0,13.0,5
17777,17777,1993-94,1993,1994,West Ham,Everton,Win,Away,1994-01-01,3,1,1,4,4,0,0,1,1,1,1,3,3,0,21.0,13.0,8.0,6
17778,17778,1993-94,1993,1994,West Ham,Sheffield United,Draw,Home,1994-01-03,1,3,4,4,7,3,4,4,5,0,0,0,2,1,21.0,14.0,7.0,6
17779,17779,1993-94,1993,1994,West Ham,Aston Villa,Loss,Away,1994-01-15,0,4,4,5,5,3,3,3,4,1,1,2,1,0,21.0,2.0,19.0,6
17780,17780,1993-94,1993,1994,West Ham,Norwich,Draw,Home,1994-01-24,1,1,4,4,5,1,4,4,7,0,0,0,-2,1,21.0,3.0,18.0,6
17781,17781,1993-94,1993,1994,West Ham,Man City,Draw,Away,1994-02-12,1,1,2,5,5,3,4,4,5,-2,-2,1,0,0,21.0,9.0,12.0,7
17782,17782,1993-94,1993,1994,West Ham,Man United,Draw,Home,1994-02-26,1,2,2,3,6,6,9,10,11,-4,-7,-7,-5,1,21.0,1.0,20.0,7
17783,17783,1993-94,1993,1994,West Ham,Swindon,Draw,Away,1994-03-05,1,2,3,3,4,1,1,4,7,1,2,-1,-3,0,21.0,21.0,0.0,8
17784,17784,1993-94,1993,1994,West Ham,Newcastle,Loss,Home,1994-03-19,0,2,3,4,4,6,9,9,9,-4,-6,-5,-5,1,21.0,21.0,0.0,8
17785,17785,1993-94,1993,1994,West Ham,Chelsea,Loss,Away,1994-03-26,0,1,2,3,4,3,6,9,9,-2,-4,-6,-5,0,21.0,11.0,10.0,8
17786,17786,1993-94,1993,1994,West Ham,Sheffield United,Loss,Away,1994-03-28,0,0,1,2,3,2,3,4,5,-2,-2,-2,-2,0,21.0,14.0,7.0,8
17787,17787,1993-94,1993,1994,West Ham,Ipswich,Win,Home,1994-04-02,3,0,0,1,2,1,1,2,5,-1,-1,-1,-3,1,21.0,16.0,5.0,9
17788,17788,1993-94,1993,1994,West Ham,Tottenham,Win,Away,1994-04-04,3,3,3,3,4,6,7,8,9,-3,-4,-5,-5,0,21.0,8.0,13.0,9
17789,17789,1993-94,1993,1994,West Ham,Everton,Loss,Home,1994-04-09,0,6,6,6,6,0,1,1,1,6,5,5,5,1,21.0,13.0,8.0,9
17790,17790,1993-94,1993,1994,West Ham,Oldham,Win,Away,1994-04-16,3,3,6,6,6,3,6,7,10,0,0,-1,-4,0,21.0,19.0,2.0,9
17791,17791,1993-94,1993,1994,West Ham,Liverpool,Loss,Home,1994-04-23,0,3,6,9,9,3,4,4,4,0,2,5,5,1,21.0,6.0,15.0,9
17792,17792,1993-94,1993,1994,West Ham,Blackburn,Loss,Home,1994-04-27,0,3,3,6,9,1,4,7,10,2,-1,-1,-1,1,21.0,4.0,17.0,9
17793,17793,1993-94,1993,1994,West Ham,Arsenal,Win,Away,1994-04-30,3,0,3,3,6,4,5,8,9,-4,-2,-5,-3,0,21.0,10.0,11.0,9
17794,17794,1993-94,1993,1994,West Ham,QPR,Draw,Away,1994-05-03,1,3,3,6,6,1,2,5,6,2,1,1,0,0,21.0,5.0,16.0,10
17795,17795,1993-94,1993,1994,West Ham,Southampton,Draw,Home,1994-05-07,1,4,4,4,7,3,3,6,9,1,1,-2,-2,1,21.0,18.0,3.0,10
17796,17796,1994-95,1994,1995,West Ham,Leeds,Draw,Home,1994-08-20,1,2,5,5,5,4,7,7,8,-2,-2,-2,-3,1,13.0,5.0,8.0,1
17797,17797,1994-95,1994,1995,West Ham,Man City,Loss,Away,1994-08-24,0,2,3,6,6,1,2,2,3,1,1,4,3,0,13.0,16.0,-3.0,1
17798,17798,1994-95,1994,1995,West Ham,Norwich,Loss,Away,1994-08-27,0,1,2,3,6,1,2,5,5,0,0,-2,1,0,13.0,12.0,1.0,1
17799,17799,1994-95,1994,1995,West Ham,Newcastle,Loss,Home,1994-08-31,0,0,1,2,3,6,9,12,12,-6,-8,-10,-9,1,13.0,3.0,10.0,1
17800,17800,1994-95,1994,1995,West Ham,Liverpool,Draw,Away,1994-09-10,1,0,0,1,2,6,9,9,9,-6,-9,-8,-7,0,13.0,8.0,5.0,2
17801,17801,1994-95,1994,1995,West Ham,Aston Villa,Win,Home,1994-09-17,3,1,1,1,2,6,7,8,9,-5,-6,-7,-7,1,13.0,10.0,3.0,2
17802,17802,1994-95,1994,1995,West Ham,Arsenal,Loss,Home,1994-09-25,0,4,4,4,4,1,2,2,2,3,2,2,2,1,13.0,4.0,9.0,2
17803,17803,1994-95,1994,1995,West Ham,Chelsea,Win,Away,1994-10-02,3,3,4,4,4,3,3,6,9,0,1,-2,-5,0,13.0,14.0,-1.0,3
17804,17804,1994-95,1994,1995,West Ham,Crystal Palace,Win,Home,1994-10-08,3,3,6,7,7,3,4,5,5,0,2,2,2,1,13.0,21.0,-8.0,3
17805,17805,1994-95,1994,1995,West Ham,Man United,Loss,Away,1994-10-15,0,6,6,9,10,3,3,6,6,3,3,3,4,0,13.0,1.0,12.0,3
17806,17806,1994-95,1994,1995,West Ham,Southampton,Win,Home,1994-10-22,3,3,6,6,9,3,6,9,10,0,0,-3,-1,1,13.0,18.0,-5.0,3
17807,17807,1994-95,1994,1995,West Ham,Tottenham,Loss,Away,1994-10-29,0,3,6,9,9,1,2,5,5,2,4,4,4,0,13.0,15.0,-2.0,3
17808,17808,1994-95,1994,1995,West Ham,Everton,Loss,Away,1994-11-01,0,3,3,6,9,1,1,1,1,2,2,5,8,0,13.0,17.0,-4.0,4
17809,17809,1994-95,1994,1995,West Ham,Leicester,Win,Home,1994-11-05,3,0,3,3,6,0,3,3,4,0,0,0,2,1,13.0,21.0,-8.0,4
17810,17810,1994-95,1994,1995,West Ham,Sheffield Weds,Loss,Away,1994-11-19,0,3,3,6,6,1,2,2,5,2,1,4,1,0,13.0,7.0,6.0,4
17811,17811,1994-95,1994,1995,West Ham,Coventry,Loss,Home,1994-11-26,0,3,3,3,6,4,4,7,7,-1,-1,-4,-1,1,13.0,11.0,2.0,4
17812,17812,1994-95,1994,1995,West Ham,QPR,Loss,Away,1994-12-04,0,0,3,3,3,3,3,6,9,-3,0,-3,-6,0,13.0,9.0,4.0,5
17813,17813,1994-95,1994,1995,West Ham,Leeds,Draw,Away,1994-12-10,1,0,0,3,3,3,3,6,6,-3,-3,-3,-3,0,13.0,5.0,8.0,5
17814,17814,1994-95,1994,1995,West Ham,Man City,Win,Home,1994-12-17,3,1,1,1,4,3,6,9,9,-2,-5,-8,-5,1,13.0,16.0,-3.0,5
17815,17815,1994-95,1994,1995,West Ham,Ipswich,Draw,Home,1994-12-26,1,4,4,4,4,1,1,2,2,3,3,2,2,1,13.0,19.0,-6.0,5
17816,17816,1994-95,1994,1995,West Ham,Wimbledon,Loss,Away,1994-12-28,0,4,5,5,5,4,7,7,7,0,-2,-2,-2,0,13.0,6.0,7.0,5
17817,17817,1994-95,1994,1995,West Ham,Nott'm Forest,Win,Home,1994-12-31,3,1,4,5,5,4,7,10,11,-3,-3,-5,-6,1,13.0,21.0,-8.0,5
17818,17818,1994-95,1994,1995,West Ham,Blackburn,Loss,Away,1995-01-02,0,3,4,7,8,6,7,10,13,-3,-3,-3,-5,0,13.0,2.0,11.0,6
17819,17819,1994-95,1994,1995,West Ham,Tottenham,Loss,Home,1995-01-14,0,3,3,4,7,6,7,10,11,-3,-4,-6,-4,1,13.0,15.0,-2.0,6
17820,17820,1994-95,1994,1995,West Ham,Sheffield Weds,Loss,Home,1995-01-23,0,0,3,3,4,2,3,6,9,-2,0,-3,-5,1,13.0,7.0,6.0,6
17821,17821,1994-95,1994,1995,West Ham,Leicester,Win,Away,1995-02-04,3,0,0,3,3,3,3,3,4,-3,-3,0,-1,0,13.0,21.0,-8.0,7
17822,17822,1994-95,1994,1995,West Ham,Everton,Draw,Home,1995-02-13,1,3,3,3,6,3,4,7,8,0,-1,-4,-2,1,13.0,17.0,-4.0,7
17823,17823,1994-95,1994,1995,West Ham,Coventry,Loss,Away,1995-02-18,0,4,4,4,4,4,5,5,6,0,-1,-1,-2,0,13.0,11.0,2.0,7
17824,17824,1994-95,1994,1995,West Ham,Chelsea,Loss,Home,1995-02-25,0,1,4,4,4,2,2,3,4,-1,2,1,0,1,13.0,14.0,-1.0,7
17825,17825,1994-95,1994,1995,West Ham,Arsenal,Win,Away,1995-03-05,3,0,1,4,4,6,7,7,8,-6,-6,-3,-4,0,13.0,4.0,9.0,8
17826,17826,1994-95,1994,1995,West Ham,Newcastle,Loss,Away,1995-03-08,0,3,3,4,7,3,6,9,9,0,-3,-5,-2,0,13.0,3.0,10.0,8
17827,17827,1994-95,1994,1995,West Ham,Norwich,Draw,Home,1995-03-11,1,3,3,3,4,2,3,3,4,1,0,0,0,1,13.0,12.0,1.0,8
17828,17828,1994-95,1994,1995,West Ham,Southampton,Draw,Away,1995-03-15,1,1,4,4,4,1,2,3,4,0,2,1,0,0,13.0,18.0,-5.0,8
17829,17829,1994-95,1994,1995,West Ham,Aston Villa,Win,Away,1995-03-18,3,2,2,5,5,1,1,2,5,1,1,3,0,0,13.0,10.0,3.0,8
17830,17830,1994-95,1994,1995,West Ham,Nott'm Forest,Draw,Away,1995-04-08,1,4,5,5,8,6,9,12,15,-2,-4,-7,-7,0,13.0,21.0,-8.0,9
17831,17831,1994-95,1994,1995,West Ham,Wimbledon,Win,Home,1995-04-13,3,4,5,6,6,4,7,10,13,0,-2,-4,-7,1,13.0,6.0,7.0,9
17832,17832,1994-95,1994,1995,West Ham,Ipswich,Draw,Away,1995-04-17,1,4,7,8,9,0,0,0,0,4,7,8,9,0,13.0,19.0,-6.0,9
17833,17833,1994-95,1994,1995,West Ham,Blackburn,Win,Home,1995-04-30,3,4,5,8,9,3,4,7,10,1,1,1,-1,1,13.0,2.0,11.0,9
17834,17834,1994-95,1994,1995,West Ham,QPR,Draw,Home,1995-05-03,1,4,7,8,11,0,0,3,6,4,7,5,5,1,13.0,9.0,4.0,10
17835,17835,1994-95,1994,1995,West Ham,Crystal Palace,Loss,Away,1995-05-06,0,4,5,8,9,0,0,3,4,4,5,5,5,0,13.0,21.0,-8.0,10
17836,17836,1994-95,1994,1995,West Ham,Liverpool,Win,Home,1995-05-10,3,1,4,5,8,1,4,7,7,0,0,-2,1,1,13.0,8.0,5.0,10
17837,17837,1994-95,1994,1995,West Ham,Man United,Draw,Home,1995-05-14,1,3,4,7,8,6,9,10,13,-3,-5,-3,-5,1,13.0,1.0,12.0,10
17838,17838,1995-96,1995,1996,West Ham,Leeds,Loss,Home,1995-08-19,0,4,4,5,8,4,7,10,13,0,-3,-5,-5,1,14.0,5.0,9.0,1
17839,17839,1995-96,1995,1996,West Ham,Man United,Loss,Away,1995-08-23,0,1,4,4,5,1,4,7,10,0,0,-3,-5,0,14.0,2.0,12.0,1
17840,17840,1995-96,1995,1996,West Ham,Nott'm Forest,Draw,Away,1995-08-26,1,0,1,4,4,4,5,8,11,-4,-4,-4,-7,0,14.0,3.0,11.0,1
17841,17841,1995-96,1995,1996,West Ham,Tottenham,Draw,Home,1995-08-30,1,1,1,2,5,0,1,2,2,1,0,0,3,1,14.0,7.0,7.0,1
17842,17842,1995-96,1995,1996,West Ham,Chelsea,Loss,Home,1995-09-11,0,2,2,2,3,1,2,3,6,1,0,-1,-3,1,14.0,11.0,3.0,2
17843,17843,1995-96,1995,1996,West Ham,Arsenal,Loss,Away,1995-09-16,0,1,2,2,2,4,5,8,9,-3,-3,-6,-7,0,14.0,12.0,2.0,2
17844,17844,1995-96,1995,1996,West Ham,Everton,Win,Home,1995-09-23,3,0,1,2,2,0,3,6,6,0,-2,-4,-4,1,14.0,15.0,-1.0,2
17845,17845,1995-96,1995,1996,West Ham,Southampton,Draw,Away,1995-10-02,1,3,3,4,5,0,1,4,5,3,2,0,0,0,14.0,10.0,4.0,3
17846,17846,1995-96,1995,1996,West Ham,Wimbledon,Win,Away,1995-10-16,3,4,4,4,5,0,0,3,4,4,4,1,1,0,14.0,9.0,5.0,3
17847,17847,1995-96,1995,1996,West Ham,Blackburn,Draw,Home,1995-10-21,1,4,7,7,7,3,6,6,7,1,1,1,0,1,14.0,1.0,13.0,3
17848,17848,1995-96,1995,1996,West Ham,Sheffield Weds,Win,Away,1995-10-28,3,4,5,8,8,3,3,4,4,1,2,4,4,0,14.0,13.0,1.0,3
17849,17849,1995-96,1995,1996,West Ham,Aston Villa,Loss,Home,1995-11-04,0,4,7,8,11,3,3,6,7,1,4,2,4,1,14.0,18.0,-4.0,4
17850,17850,1995-96,1995,1996,West Ham,Bolton,Win,Away,1995-11-18,3,3,4,7,8,3,3,4,4,0,1,3,4,0,14.0,21.0,-7.0,4
17851,17851,1995-96,1995,1996,West Ham,Liverpool,Draw,Home,1995-11-22,1,3,6,7,10,0,3,6,7,3,3,1,3,1,14.0,4.0,10.0,4
17852,17852,1995-96,1995,1996,West Ham,QPR,Win,Home,1995-11-25,3,4,4,7,8,1,1,2,2,3,3,5,6,1,14.0,8.0,6.0,4
17853,17853,1995-96,1995,1996,West Ham,Blackburn,Loss,Away,1995-12-02,0,4,7,7,10,4,4,4,7,0,3,3,3,0,14.0,1.0,13.0,5
17854,17854,1995-96,1995,1996,West Ham,Everton,Loss,Away,1995-12-11,0,3,4,7,7,2,5,8,11,1,-1,-1,-4,0,14.0,15.0,-1.0,5
17855,17855,1995-96,1995,1996,West Ham,Southampton,Win,Home,1995-12-16,3,0,3,4,7,2,5,5,5,-2,-2,-1,2,1,14.0,10.0,4.0,5
17856,17856,1995-96,1995,1996,West Ham,Middlesbrough,Loss,Away,1995-12-23,0,3,3,6,7,3,4,7,7,0,-1,-1,0,0,14.0,21.0,-7.0,5
17857,17857,1995-96,1995,1996,West Ham,Man City,Loss,Away,1996-01-01,0,3,3,3,6,0,1,1,4,3,2,2,2,0,14.0,17.0,-3.0,6
17858,17858,1995-96,1995,1996,West Ham,Leeds,Loss,Away,1996-01-13,0,0,3,3,3,1,4,7,7,-1,-1,-4,-4,0,14.0,5.0,9.0,6
17859,17859,1995-96,1995,1996,West Ham,Man United,Loss,Home,1996-01-23,0,0,0,3,3,1,4,7,7,-1,-4,-4,-4,1,14.0,2.0,12.0,6
17860,17860,1995-96,1995,1996,West Ham,Coventry,Win,Home,1996-01-31,3,0,0,0,3,1,2,5,8,-1,-2,-5,-5,1,14.0,16.0,-2.0,6
17861,17861,1995-96,1995,1996,West Ham,Nott'm Forest,Win,Home,1996-02-03,3,3,3,3,3,3,6,6,9,0,-3,-3,-6,1,14.0,3.0,11.0,7
17862,17862,1995-96,1995,1996,West Ham,Tottenham,Win,Away,1996-02-12,3,6,6,6,6,1,4,7,7,5,2,-1,-1,0,14.0,7.0,7.0,7
17863,17863,1995-96,1995,1996,West Ham,Chelsea,Win,Away,1996-02-17,3,6,9,9,9,3,6,7,10,3,3,2,-1,0,14.0,11.0,3.0,7
17864,17864,1995-96,1995,1996,West Ham,Newcastle,Win,Home,1996-02-21,3,6,9,12,12,6,9,12,15,0,0,0,-3,1,14.0,6.0,8.0,7
17865,17865,1995-96,1995,1996,West Ham,Arsenal,Loss,Home,1996-02-24,0,6,9,12,15,4,4,7,7,2,5,5,8,1,14.0,12.0,2.0,7
17866,17866,1995-96,1995,1996,West Ham,Coventry,Draw,Away,1996-03-02,1,3,6,9,12,4,5,5,6,-1,1,4,6,0,14.0,16.0,-2.0,8
17867,17867,1995-96,1995,1996,West Ham,Middlesbrough,Win,Home,1996-03-09,3,1,4,7,10,1,1,1,1,0,3,6,9,1,14.0,21.0,-7.0,8
17868,17868,1995-96,1995,1996,West Ham,Newcastle,Loss,Away,1996-03-18,0,4,4,7,10,1,1,4,7,3,3,3,3,0,14.0,6.0,8.0,8
17869,17869,1995-96,1995,1996,West Ham,Man City,Win,Home,1996-03-23,3,3,4,4,7,4,4,5,6,-1,0,-1,1,1,14.0,17.0,-3.0,8
17870,17870,1995-96,1995,1996,West Ham,Wimbledon,Draw,Home,1996-04-06,1,3,6,7,7,6,6,7,8,-3,0,0,-1,1,14.0,9.0,5.0,9
17871,17871,1995-96,1995,1996,West Ham,Liverpool,Loss,Away,1996-04-08,0,4,4,7,8,3,3,6,7,1,1,1,1,0,14.0,4.0,10.0,9
17872,17872,1995-96,1995,1996,West Ham,Bolton,Win,Home,1996-04-13,3,1,4,4,7,3,4,7,7,-2,0,-3,0,1,14.0,21.0,-7.0,9
17873,17873,1995-96,1995,1996,West Ham,Aston Villa,Draw,Away,1996-04-17,1,3,4,7,7,3,6,7,7,0,-2,0,0,0,14.0,18.0,-4.0,9
17874,17874,1995-96,1995,1996,West Ham,QPR,Loss,Away,1996-04-27,0,4,4,5,8,3,3,6,7,1,1,-1,1,0,14.0,8.0,6.0,9
17875,17875,1995-96,1995,1996,West Ham,Sheffield Weds,Draw,Home,1996-05-04,1,1,4,4,5,1,1,4,4,0,3,0,1,1,14.0,13.0,1.0,10
17876,17876,1996-97,1996,1997,West Ham,Arsenal,Loss,Away,1996-08-17,0,1,2,5,5,4,5,6,6,-3,-3,-1,-1,0,10.0,5.0,5.0,1
17877,17877,1996-97,1996,1997,West Ham,Coventry,Draw,Home,1996-08-21,1,1,1,2,5,1,4,5,8,0,-3,-3,-3,1,10.0,16.0,-6.0,1
17878,17878,1996-97,1996,1997,West Ham,Southampton,Win,Home,1996-08-24,3,1,2,2,3,1,2,5,5,0,0,-3,-2,1,10.0,17.0,-7.0,1
17879,17879,1996-97,1996,1997,West Ham,Middlesbrough,Loss,Away,1996-09-04,0,4,4,5,5,1,2,2,2,3,2,3,3,0,10.0,12.0,-2.0,2
17880,17880,1996-97,1996,1997,West Ham,Sunderland,Draw,Away,1996-09-08,1,3,4,4,5,1,4,5,5,2,0,-1,0,0,10.0,21.0,-11.0,2
17881,17881,1996-97,1996,1997,West Ham,Wimbledon,Loss,Home,1996-09-14,0,1,4,5,5,6,6,6,6,-5,-2,-1,-1,1,10.0,14.0,-4.0,2
17882,17882,1996-97,1996,1997,West Ham,Nott'm Forest,Win,Away,1996-09-21,3,1,1,4,5,1,2,3,3,0,-1,1,2,0,10.0,9.0,1.0,2
17883,17883,1996-97,1996,1997,West Ham,Liverpool,Loss,Home,1996-09-29,0,3,4,4,7,6,9,12,13,-3,-5,-8,-6,1,10.0,3.0,7.0,2
17884,17884,1996-97,1996,1997,West Ham,Everton,Loss,Away,1996-10-12,0,3,3,4,4,4,4,4,4,-1,-1,0,0,0,10.0,6.0,4.0,3
17885,17885,1996-97,1996,1997,West Ham,Leicester,Win,Home,1996-10-19,3,0,3,3,4,3,6,6,7,-3,-3,-3,-3,1,10.0,21.0,-11.0,3
17886,17886,1996-97,1996,1997,West Ham,Blackburn,Win,Home,1996-10-26,3,3,3,6,6,1,2,3,3,2,1,3,3,1,10.0,7.0,3.0,3
17887,17887,1996-97,1996,1997,West Ham,Tottenham,Loss,Away,1996-11-02,0,6,6,6,9,3,6,6,6,3,0,0,3,0,10.0,8.0,2.0,4
17888,17888,1996-97,1996,1997,West Ham,Newcastle,Draw,Away,1996-11-16,1,3,6,6,6,3,6,9,12,0,0,-3,-6,0,10.0,2.0,8.0,4
17889,17889,1996-97,1996,1997,West Ham,Derby,Draw,Home,1996-11-23,1,1,4,7,7,6,6,7,7,-5,-2,0,0,1,10.0,21.0,-11.0,4
17890,17890,1996-97,1996,1997,West Ham,Sheffield Weds,Draw,Away,1996-11-30,1,2,2,5,8,4,5,6,7,-2,-3,-1,1,0,10.0,15.0,-5.0,4
17891,17891,1996-97,1996,1997,West Ham,Aston Villa,Loss,Home,1996-12-04,0,2,3,3,6,6,6,9,9,-4,-3,-6,-3,1,10.0,4.0,6.0,5
17892,17892,1996-97,1996,1997,West Ham,Man United,Draw,Home,1996-12-08,1,1,2,3,3,4,7,7,7,-3,-5,-4,-4,1,10.0,1.0,9.0,5
17893,17893,1996-97,1996,1997,West Ham,Chelsea,Loss,Away,1996-12-21,0,1,2,3,4,1,1,2,3,0,1,1,1,0,10.0,11.0,-1.0,5
17894,17894,1996-97,1996,1997,West Ham,Sunderland,Win,Home,1996-12-28,3,1,1,2,3,3,6,6,9,-2,-5,-4,-6,1,10.0,21.0,-11.0,5
17895,17895,1996-97,1996,1997,West Ham,Nott'm Forest,Loss,Home,1997-01-01,0,3,4,4,5,1,4,4,5,2,0,0,0,1,10.0,9.0,1.0,6
17896,17896,1996-97,1996,1997,West Ham,Liverpool,Draw,Away,1997-01-11,1,3,3,4,4,3,4,5,8,0,-1,-1,-4,0,10.0,3.0,7.0,6
17897,17897,1996-97,1996,1997,West Ham,Leeds,Loss,Home,1997-01-20,0,1,4,4,5,3,3,3,4,-2,1,1,1,1,10.0,13.0,-3.0,6
17898,17898,1996-97,1996,1997,West Ham,Arsenal,Loss,Home,1997-01-29,0,1,1,4,4,3,6,7,8,-2,-5,-3,-4,1,10.0,5.0,5.0,6
17899,17899,1996-97,1996,1997,West Ham,Blackburn,Loss,Away,1997-02-01,0,0,1,1,4,1,4,7,8,-1,-3,-6,-4,0,10.0,7.0,3.0,7
17900,17900,1996-97,1996,1997,West Ham,Derby,Loss,Away,1997-02-15,0,0,0,1,1,1,1,2,3,-1,-1,-1,-2,0,10.0,21.0,-11.0,7
17901,17901,1996-97,1996,1997,West Ham,Tottenham,Win,Home,1997-02-24,3,0,0,0,1,1,4,4,4,-1,-4,-4,-3,1,10.0,8.0,2.0,7
17902,17902,1996-97,1996,1997,West Ham,Leeds,Loss,Away,1997-03-01,0,3,3,3,3,3,4,5,8,0,-1,-2,-5,0,10.0,13.0,-3.0,8
17903,17903,1996-97,1996,1997,West Ham,Chelsea,Win,Home,1997-03-12,3,3,3,3,3,1,2,5,8,2,1,-2,-5,1,10.0,11.0,-1.0,8
17904,17904,1996-97,1996,1997,West Ham,Aston Villa,Draw,Away,1997-03-15,1,3,6,6,6,3,4,7,10,0,2,-1,-4,0,10.0,4.0,6.0,8
17905,17905,1996-97,1996,1997,West Ham,Wimbledon,Draw,Away,1997-03-18,1,4,4,7,7,1,1,2,5,3,3,5,2,0,10.0,14.0,-4.0,8
17906,17906,1996-97,1996,1997,West Ham,Coventry,Win,Away,1997-03-22,3,2,5,5,8,1,2,2,3,1,3,3,5,0,10.0,16.0,-6.0,8
17907,17907,1996-97,1996,1997,West Ham,Middlesbrough,Draw,Home,1997-04-09,1,4,5,8,8,4,7,10,13,0,-2,-2,-5,1,10.0,12.0,-2.0,9
17908,17908,1996-97,1996,1997,West Ham,Southampton,Loss,Away,1997-04-12,0,4,5,6,9,4,5,5,5,0,0,1,4,0,10.0,17.0,-7.0,9
17909,17909,1996-97,1996,1997,West Ham,Everton,Draw,Home,1997-04-19,1,1,4,5,6,4,5,5,5,-3,-1,0,1,1,10.0,6.0,4.0,9
17910,17910,1996-97,1996,1997,West Ham,Leicester,Win,Away,1997-04-23,3,1,2,5,6,0,1,2,3,1,1,3,3,0,10.0,21.0,-11.0,9
17911,17911,1996-97,1996,1997,West Ham,Sheffield Weds,Win,Home,1997-05-03,3,4,4,5,8,3,4,7,8,1,0,-2,0,1,10.0,15.0,-5.0,10
17912,17912,1996-97,1996,1997,West Ham,Newcastle,Draw,Home,1997-05-06,1,6,7,7,8,6,9,10,11,0,-2,-3,-3,1,10.0,2.0,8.0,10
17913,17913,1996-97,1996,1997,West Ham,Man United,Loss,Away,1997-05-11,0,4,7,8,8,2,3,6,9,2,4,2,-1,0,10.0,1.0,9.0,10
17914,17914,1997-98,1997,1998,West Ham,Barnsley,Win,Away,1997-08-09,3,1,4,7,8,0,0,0,0,1,4,7,8,0,14.0,21.0,-7.0,1
17915,17915,1997-98,1997,1998,West Ham,Tottenham,Win,Home,1997-08-13,3,3,4,7,10,0,0,3,4,3,4,4,6,1,14.0,10.0,4.0,1
17916,17916,1997-98,1997,1998,West Ham,Everton,Loss,Away,1997-08-23,0,6,6,7,10,0,0,1,2,6,6,6,8,0,14.0,15.0,-1.0,1
17917,17917,1997-98,1997,1998,West Ham,Coventry,Draw,Away,1997-08-27,1,3,6,6,7,1,4,7,7,2,2,-1,0,0,14.0,17.0,-3.0,1
17918,17918,1997-98,1997,1998,West Ham,Wimbledon,Win,Home,1997-08-30,3,1,4,7,7,1,2,5,8,0,2,2,-1,1,14.0,8.0,6.0,1
17919,17919,1997-98,1997,1998,West Ham,Man United,Loss,Away,1997-09-13,0,4,4,7,10,6,7,10,13,-2,-3,-3,-3,0,14.0,1.0,13.0,2
17920,17920,1997-98,1997,1998,West Ham,Newcastle,Loss,Home,1997-09-20,0,3,4,4,7,3,6,9,10,0,-2,-5,-3,1,14.0,2.0,12.0,2
17921,17921,1997-98,1997,1998,West Ham,Arsenal,Loss,Away,1997-09-24,0,0,3,4,4,6,7,8,11,-6,-4,-4,-7,0,14.0,3.0,11.0,2
17922,17922,1997-98,1997,1998,West Ham,Liverpool,Win,Home,1997-09-27,3,0,0,3,4,4,7,10,11,-4,-7,-7,-7,1,14.0,4.0,10.0,2
17923,17923,1997-98,1997,1998,West Ham,Southampton,Loss,Away,1997-10-04,0,3,3,3,6,0,1,1,1,3,2,2,5,0,14.0,16.0,-2.0,3
17924,17924,1997-98,1997,1998,West Ham,Bolton,Win,Home,1997-10-18,3,3,3,3,3,1,2,3,3,2,1,0,0,1,14.0,21.0,-7.0,3
17925,17925,1997-98,1997,1998,West Ham,Leicester,Loss,Away,1997-10-27,0,3,6,6,6,0,3,4,7,3,3,2,-1,0,14.0,9.0,5.0,3
17926,17926,1997-98,1997,1998,West Ham,Chelsea,Loss,Away,1997-11-09,0,3,3,6,6,3,6,6,9,0,-3,0,-3,0,14.0,6.0,8.0,4
17927,17927,1997-98,1997,1998,West Ham,Leeds,Loss,Away,1997-11-23,0,0,3,3,6,6,6,9,10,-6,-3,-6,-4,0,14.0,11.0,3.0,4
17928,17928,1997-98,1997,1998,West Ham,Aston Villa,Win,Home,1997-11-29,3,0,0,3,3,4,4,5,5,-4,-4,-2,-2,1,14.0,5.0,9.0,4
17929,17929,1997-98,1997,1998,West Ham,Crystal Palace,Win,Home,1997-12-03,3,3,3,3,6,3,4,7,8,0,-1,-4,-2,1,14.0,21.0,-7.0,5
17930,17930,1997-98,1997,1998,West Ham,Derby,Loss,Away,1997-12-06,0,6,6,6,6,3,3,6,6,3,3,0,0,0,14.0,12.0,2.0,5
17931,17931,1997-98,1997,1998,West Ham,Sheffield Weds,Win,Home,1997-12-13,3,3,6,6,6,6,9,12,12,-3,-3,-6,-6,1,14.0,7.0,7.0,5
17932,17932,1997-98,1997,1998,West Ham,Blackburn,Loss,Away,1997-12-20,0,3,6,9,9,6,6,9,12,-3,0,0,-3,0,14.0,13.0,1.0,5
17933,17933,1997-98,1997,1998,West Ham,Coventry,Win,Home,1997-12-26,3,3,3,6,9,3,3,3,3,0,0,3,6,1,14.0,17.0,-3.0,5
17934,17934,1997-98,1997,1998,West Ham,Wimbledon,Win,Away,1997-12-28,3,3,6,6,9,2,5,5,5,1,1,1,4,0,14.0,8.0,6.0,5
17935,17935,1997-98,1997,1998,West Ham,Barnsley,Win,Home,1998-01-10,3,6,6,9,9,4,4,5,5,2,2,4,4,1,14.0,21.0,-7.0,6
17936,17936,1997-98,1997,1998,West Ham,Tottenham,Loss,Away,1998-01-17,0,6,9,9,12,1,1,4,4,5,8,5,8,0,14.0,10.0,4.0,6
17937,17937,1997-98,1997,1998,West Ham,Everton,Draw,Home,1998-01-31,1,3,6,9,9,6,9,9,12,-3,-3,0,-3,1,14.0,15.0,-1.0,6
17938,17938,1997-98,1997,1998,West Ham,Newcastle,Win,Away,1998-02-07,3,1,4,7,10,3,6,6,6,-2,-2,1,4,0,14.0,2.0,12.0,7
17939,17939,1997-98,1997,1998,West Ham,Bolton,Draw,Away,1998-02-21,1,4,4,7,10,1,1,2,2,3,3,5,8,0,14.0,21.0,-7.0,7
17940,17940,1997-98,1997,1998,West Ham,Arsenal,Draw,Home,1998-03-02,1,4,5,5,8,6,9,10,13,-2,-4,-5,-5,1,14.0,3.0,11.0,8
17941,17941,1997-98,1997,1998,West Ham,Man United,Draw,Home,1998-03-11,1,2,5,6,6,3,6,9,10,-1,-1,-3,-4,1,14.0,1.0,13.0,8
17942,17942,1997-98,1997,1998,West Ham,Chelsea,Win,Home,1998-03-14,3,2,3,6,7,3,3,3,3,-1,0,3,4,1,14.0,6.0,8.0,8
17943,17943,1997-98,1997,1998,West Ham,Leeds,Win,Home,1998-03-30,3,4,5,6,9,6,9,9,10,-2,-4,-3,-1,1,14.0,11.0,3.0,8
17944,17944,1997-98,1997,1998,West Ham,Aston Villa,Loss,Away,1998-04-04,0,6,7,8,9,6,6,9,12,0,1,-1,-3,0,14.0,5.0,9.0,9
17945,17945,1997-98,1997,1998,West Ham,Derby,Draw,Home,1998-04-11,1,3,6,7,8,0,0,3,3,3,6,4,5,1,14.0,12.0,2.0,9
17946,17946,1997-98,1997,1998,West Ham,Sheffield Weds,Draw,Away,1998-04-13,1,1,4,7,8,3,3,3,6,-2,1,4,2,0,14.0,7.0,7.0,9
17947,17947,1997-98,1997,1998,West Ham,Blackburn,Win,Home,1998-04-18,3,2,2,5,8,0,0,3,3,2,2,2,5,1,14.0,13.0,1.0,9
17948,17948,1997-98,1997,1998,West Ham,Southampton,Loss,Home,1998-04-25,0,4,5,5,8,1,1,1,4,3,4,4,4,1,14.0,16.0,-2.0,9
17949,17949,1997-98,1997,1998,West Ham,Liverpool,Loss,Away,1998-05-02,0,3,4,5,5,1,4,5,8,2,0,0,-3,0,14.0,4.0,10.0,10
17950,17950,1997-98,1997,1998,West Ham,Crystal Palace,Draw,Away,1998-05-05,1,0,3,4,5,0,3,3,3,0,0,1,2,0,14.0,21.0,-7.0,10
17951,17951,1997-98,1997,1998,West Ham,Leicester,Win,Home,1998-05-10,3,1,1,4,5,4,7,8,9,-3,-6,-4,-4,1,14.0,9.0,5.0,10
17952,17952,1998-99,1998,1999,West Ham,Sheffield Weds,Win,Away,1998-08-15,3,4,4,4,7,0,3,3,4,4,1,1,3,0,8.0,16.0,-8.0,1
17953,17953,1998-99,1998,1999,West Ham,Man United,Draw,Home,1998-08-22,1,6,7,7,7,4,7,10,11,2,0,-3,-4,1,8.0,2.0,6.0,1
17954,17954,1998-99,1998,1999,West Ham,Coventry,Draw,Away,1998-08-29,1,4,7,8,8,3,4,7,8,1,3,1,0,0,8.0,11.0,-3.0,1
17955,17955,1998-99,1998,1999,West Ham,Wimbledon,Loss,Home,1998-09-09,0,2,5,8,9,2,5,6,6,0,0,2,3,1,8.0,15.0,-7.0,2
17956,17956,1998-99,1998,1999,West Ham,Liverpool,Win,Home,1998-09-12,3,1,2,5,8,6,7,10,10,-5,-5,-5,-2,1,8.0,3.0,5.0,2
17957,17957,1998-99,1998,1999,West Ham,Nott'm Forest,Draw,Away,1998-09-19,1,3,4,5,8,0,3,6,6,3,1,-1,2,0,8.0,21.0,-13.0,2
17958,17958,1998-99,1998,1999,West Ham,Southampton,Win,Home,1998-09-28,3,4,4,5,6,1,1,1,1,3,3,4,5,1,8.0,12.0,-4.0,2
17959,17959,1998-99,1998,1999,West Ham,Blackburn,Loss,Away,1998-10-03,0,4,7,7,8,1,1,1,4,3,6,6,4,0,8.0,6.0,2.0,3
17960,17960,1998-99,1998,1999,West Ham,Aston Villa,Draw,Home,1998-10-17,1,3,4,7,7,6,7,10,13,-3,-3,-3,-6,1,8.0,7.0,1.0,3
17961,17961,1998-99,1998,1999,West Ham,Charlton,Loss,Away,1998-10-24,0,1,4,5,8,3,4,5,5,-2,0,0,3,0,8.0,21.0,-13.0,3
17962,17962,1998-99,1998,1999,West Ham,Newcastle,Win,Away,1998-10-31,3,1,1,4,5,3,3,6,9,-2,-2,-2,-4,0,8.0,13.0,-5.0,3
17963,17963,1998-99,1998,1999,West Ham,Chelsea,Draw,Home,1998-11-08,1,3,4,4,7,4,5,8,11,-1,-1,-4,-4,1,8.0,4.0,4.0,4
17964,17964,1998-99,1998,1999,West Ham,Leicester,Win,Home,1998-11-14,3,4,4,5,5,4,5,8,11,0,-1,-3,-6,1,8.0,10.0,-2.0,4
17965,17965,1998-99,1998,1999,West Ham,Derby,Win,Away,1998-11-22,3,4,7,7,8,4,5,6,6,0,2,1,2,0,8.0,9.0,-1.0,4
17966,17966,1998-99,1998,1999,West Ham,Tottenham,Win,Home,1998-11-28,3,6,7,10,10,4,4,5,8,2,3,5,2,1,8.0,14.0,-6.0,4
17967,17967,1998-99,1998,1999,West Ham,Leeds,Loss,Away,1998-12-05,0,6,9,10,13,3,6,9,10,3,3,1,3,0,8.0,5.0,3.0,5
17968,17968,1998-99,1998,1999,West Ham,Middlesbrough,Loss,Away,1998-12-12,0,3,6,9,10,2,5,6,7,1,1,3,3,0,8.0,21.0,-13.0,5
17969,17969,1998-99,1998,1999,West Ham,Everton,Win,Home,1998-12-19,3,0,3,6,9,4,7,10,10,-4,-4,-4,-1,1,8.0,17.0,-9.0,5
17970,17970,1998-99,1998,1999,West Ham,Arsenal,Loss,Away,1998-12-26,0,3,3,6,9,3,4,5,5,0,-1,1,4,0,8.0,1.0,7.0,5
17971,17971,1998-99,1998,1999,West Ham,Coventry,Win,Home,1998-12-28,3,3,3,3,6,2,2,2,3,1,1,1,3,1,8.0,11.0,-3.0,5
17972,17972,1998-99,1998,1999,West Ham,Man United,Loss,Away,1999-01-10,0,3,6,6,6,4,4,5,6,-1,2,1,0,0,8.0,2.0,6.0,6
17973,17973,1998-99,1998,1999,West Ham,Sheffield Weds,Loss,Home,1999-01-16,0,3,3,6,6,1,1,1,4,2,2,5,2,1,8.0,16.0,-8.0,6
17974,17974,1998-99,1998,1999,West Ham,Wimbledon,Draw,Away,1999-01-30,1,0,3,3,6,4,5,8,8,-4,-2,-5,-2,0,8.0,15.0,-7.0,6
17975,17975,1998-99,1998,1999,West Ham,Arsenal,Loss,Home,1999-02-06,0,1,1,4,4,6,7,10,13,-5,-6,-6,-9,1,8.0,1.0,7.0,7
17976,17976,1998-99,1998,1999,West Ham,Nott'm Forest,Win,Home,1999-02-13,3,1,1,1,4,3,3,3,4,-2,-2,-2,0,1,8.0,21.0,-13.0,7
17977,17977,1998-99,1998,1999,West Ham,Liverpool,Draw,Away,1999-02-20,1,3,4,4,4,3,3,6,7,0,1,-2,-3,0,8.0,3.0,5.0,7
17978,17978,1998-99,1998,1999,West Ham,Blackburn,Win,Home,1999-02-27,3,4,4,5,5,1,4,5,5,3,0,0,0,1,8.0,6.0,2.0,7
17979,17979,1998-99,1998,1999,West Ham,Southampton,Loss,Away,1999-03-06,0,4,7,7,8,0,3,3,6,4,4,4,2,0,8.0,12.0,-4.0,8
17980,17980,1998-99,1998,1999,West Ham,Chelsea,Win,Away,1999-03-13,3,3,4,7,7,6,7,10,10,-3,-3,-3,-3,0,8.0,4.0,4.0,8
17981,17981,1998-99,1998,1999,West Ham,Newcastle,Win,Home,1999-03-20,3,3,6,7,10,3,4,4,7,0,2,3,3,1,8.0,13.0,-5.0,8
17982,17982,1998-99,1998,1999,West Ham,Aston Villa,Draw,Away,1999-04-02,1,6,6,9,10,0,0,0,1,6,6,9,9,0,8.0,7.0,1.0,9
17983,17983,1998-99,1998,1999,West Ham,Charlton,Loss,Home,1999-04-05,0,4,7,7,10,1,1,2,5,3,6,5,5,1,8.0,21.0,-13.0,9
17984,17984,1998-99,1998,1999,West Ham,Leicester,Draw,Away,1999-04-10,1,1,4,7,7,4,5,8,8,-3,-1,-1,-1,0,8.0,10.0,-2.0,9
17985,17985,1998-99,1998,1999,West Ham,Derby,Win,Home,1999-04-17,3,1,2,5,8,3,3,6,9,-2,-1,-1,-1,1,8.0,9.0,-1.0,9
17986,17986,1998-99,1998,1999,West Ham,Tottenham,Win,Away,1999-04-24,3,4,4,5,8,6,7,7,10,-2,-3,-2,-2,0,8.0,14.0,-6.0,9
17987,17987,1998-99,1998,1999,West Ham,Leeds,Loss,Home,1999-05-01,0,6,7,7,8,2,3,6,9,4,4,1,-1,1,8.0,5.0,3.0,10
17988,17988,1998-99,1998,1999,West Ham,Everton,Loss,Away,1999-05-08,0,3,6,7,7,3,6,9,9,0,0,-2,-2,0,8.0,17.0,-9.0,10
17989,17989,1998-99,1998,1999,West Ham,Middlesbrough,Win,Home,1999-05-16,3,0,3,6,7,1,1,4,5,-1,2,2,2,1,8.0,21.0,-13.0,10
17990,17990,1999-00,1999,2000,West Ham,Tottenham,Win,Home,1999-08-07,3,3,3,6,9,1,1,1,1,2,2,5,8,1,5.0,11.0,-6.0,1
17991,17991,1999-00,1999,2000,West Ham,Aston Villa,Draw,Away,1999-08-16,1,6,6,6,9,6,6,6,6,0,0,0,3,0,5.0,6.0,-1.0,1
17992,17992,1999-00,1999,2000,West Ham,Leicester,Win,Home,1999-08-21,3,4,7,7,7,4,4,4,7,0,3,3,0,1,5.0,10.0,-5.0,1
17993,17993,1999-00,1999,2000,West Ham,Bradford,Win,Away,1999-08-28,3,4,7,10,10,0,1,4,4,4,6,6,6,0,5.0,21.0,-16.0,1
17994,17994,1999-00,1999,2000,West Ham,Watford,Win,Home,1999-09-11,3,6,7,10,13,0,3,6,6,6,4,4,7,1,5.0,21.0,-16.0,2
17995,17995,1999-00,1999,2000,West Ham,Everton,Loss,Away,1999-09-19,0,6,9,10,13,3,6,9,9,3,3,1,4,0,5.0,14.0,-9.0,2
17996,17996,1999-00,1999,2000,West Ham,Coventry,Loss,Away,1999-09-25,0,3,6,9,10,0,1,1,4,3,5,8,6,0,5.0,15.0,-10.0,2
17997,17997,1999-00,1999,2000,West Ham,Arsenal,Win,Home,1999-10-03,3,0,3,6,9,6,9,9,12,-6,-6,-3,-3,1,5.0,2.0,3.0,3
17998,17998,1999-00,1999,2000,West Ham,Middlesbrough,Loss,Away,1999-10-17,0,3,3,6,9,0,0,3,3,3,3,3,6,0,5.0,9.0,-4.0,3
17999,17999,1999-00,1999,2000,West Ham,Sunderland,Draw,Home,1999-10-24,1,3,3,3,6,6,9,12,15,-3,-6,-9,-9,1,5.0,21.0,-16.0,3
18000,18000,1999-00,1999,2000,West Ham,Liverpool,Loss,Away,1999-10-27,0,1,4,4,4,4,5,5,6,-3,-1,-1,-2,0,5.0,7.0,-2.0,3
18001,18001,1999-00,1999,2000,West Ham,Leeds,Loss,Away,1999-10-30,0,1,1,4,4,4,7,10,13,-3,-6,-6,-9,0,5.0,4.0,1.0,3
18002,18002,1999-00,1999,2000,West Ham,Chelsea,Draw,Away,1999-11-07,1,0,1,1,4,0,0,3,6,0,1,-2,-2,0,5.0,3.0,2.0,4
18003,18003,1999-00,1999,2000,West Ham,Sheffield Weds,Win,Home,1999-11-21,3,1,1,2,2,1,2,2,5,0,-1,0,-3,1,5.0,12.0,-7.0,4
18004,18004,1999-00,1999,2000,West Ham,Liverpool,Win,Home,1999-11-27,3,4,4,4,5,6,9,12,13,-2,-5,-8,-8,1,5.0,7.0,-2.0,4
18005,18005,1999-00,1999,2000,West Ham,Tottenham,Draw,Away,1999-12-06,1,6,7,7,7,3,6,6,9,3,1,1,-2,0,5.0,11.0,-6.0,5
18006,18006,1999-00,1999,2000,West Ham,Man United,Loss,Home,1999-12-18,0,4,7,8,8,6,9,12,12,-2,-2,-4,-4,1,5.0,1.0,4.0,5
18007,18007,1999-00,1999,2000,West Ham,Wimbledon,Draw,Away,1999-12-26,1,1,4,7,8,4,5,5,8,-3,-1,2,0,0,5.0,16.0,-11.0,5
18008,18008,1999-00,1999,2000,West Ham,Derby,Draw,Home,1999-12-28,1,1,2,5,8,3,3,3,3,-2,-1,2,5,1,5.0,8.0,-3.0,5
18009,18009,1999-00,1999,2000,West Ham,Newcastle,Draw,Away,2000-01-03,1,2,2,3,6,4,4,7,10,-2,-2,-4,-4,0,5.0,13.0,-8.0,6
18010,18010,1999-00,1999,2000,West Ham,Aston Villa,Draw,Home,2000-01-15,1,2,3,3,4,4,7,10,10,-2,-4,-7,-6,1,5.0,6.0,-1.0,6
18011,18011,1999-00,1999,2000,West Ham,Leicester,Win,Away,2000-01-22,3,2,3,4,4,2,2,2,2,0,1,2,2,0,5.0,10.0,-5.0,6
18012,18012,1999-00,1999,2000,West Ham,Southampton,Loss,Away,2000-02-05,0,4,5,6,7,3,6,6,6,1,-1,0,1,0,5.0,17.0,-12.0,7
18013,18013,1999-00,1999,2000,West Ham,Bradford,Win,Home,2000-02-12,3,3,4,5,6,6,6,7,7,-3,-2,-2,-1,1,5.0,21.0,-16.0,7
18014,18014,1999-00,1999,2000,West Ham,Everton,Loss,Home,2000-02-26,0,3,6,7,8,6,6,7,8,-3,0,0,0,1,5.0,14.0,-9.0,7
18015,18015,1999-00,1999,2000,West Ham,Watford,Win,Away,2000-03-04,3,3,3,6,7,1,1,1,1,2,2,5,6,0,5.0,21.0,-16.0,8
18016,18016,1999-00,1999,2000,West Ham,Southampton,Win,Home,2000-03-08,3,3,6,6,9,1,4,7,10,2,2,-1,-1,1,5.0,17.0,-12.0,8
18017,18017,1999-00,1999,2000,West Ham,Sheffield Weds,Loss,Away,2000-03-11,0,6,6,9,9,1,1,2,2,5,5,7,7,0,5.0,12.0,-7.0,8
18018,18018,1999-00,1999,2000,West Ham,Chelsea,Draw,Home,2000-03-18,1,3,6,6,9,4,7,10,13,-1,-1,-4,-4,1,5.0,3.0,2.0,8
18019,18019,1999-00,1999,2000,West Ham,Wimbledon,Win,Home,2000-03-26,3,1,4,7,7,3,3,4,4,-2,1,3,3,1,5.0,16.0,-11.0,8
18020,18020,1999-00,1999,2000,West Ham,Man United,Loss,Away,2000-04-01,0,4,4,7,10,6,9,10,11,-2,-5,-3,-1,0,5.0,1.0,4.0,9
18021,18021,1999-00,1999,2000,West Ham,Newcastle,Win,Home,2000-04-12,3,3,4,4,7,3,6,9,9,0,-2,-5,-2,1,5.0,13.0,-8.0,9
18022,18022,1999-00,1999,2000,West Ham,Derby,Win,Away,2000-04-15,3,3,6,7,7,4,4,4,4,-1,2,3,3,0,5.0,8.0,-3.0,9
18023,18023,1999-00,1999,2000,West Ham,Coventry,Win,Home,2000-04-22,3,6,6,9,10,3,3,3,6,3,3,6,4,1,5.0,15.0,-10.0,9
18024,18024,1999-00,1999,2000,West Ham,Middlesbrough,Loss,Home,2000-04-29,0,6,9,9,12,1,1,4,7,5,8,5,5,1,5.0,9.0,-4.0,9
18025,18025,1999-00,1999,2000,West Ham,Arsenal,Loss,Away,2000-05-02,0,3,6,9,9,6,9,12,15,-3,-3,-3,-6,0,5.0,2.0,3.0,10
18026,18026,1999-00,1999,2000,West Ham,Sunderland,Loss,Away,2000-05-06,0,0,3,6,9,1,4,4,7,-1,-1,2,2,0,5.0,21.0,-16.0,10
18027,18027,1999-00,1999,2000,West Ham,Leeds,Draw,Home,2000-05-14,1,0,0,3,6,4,7,8,8,-4,-7,-5,-2,1,5.0,4.0,1.0,10
18028,18028,2000-01,2000,2001,West Ham,Chelsea,Loss,Away,2000-08-19,0,1,1,1,4,3,6,6,7,-2,-5,-5,-3,0,9.0,5.0,4.0,1
18029,18029,2000-01,2000,2001,West Ham,Leicester,Loss,Home,2000-08-23,0,1,1,1,1,1,4,7,10,0,-3,-6,-9,1,9.0,8.0,1.0,1
18030,18030,2000-01,2000,2001,West Ham,Man United,Draw,Home,2000-08-26,1,0,1,1,1,4,7,10,13,-4,-6,-9,-12,1,9.0,1.0,8.0,1
18031,18031,2000-01,2000,2001,West Ham,Sunderland,Draw,Away,2000-09-05,1,1,1,2,2,0,3,3,6,1,-2,-1,-4,0,9.0,7.0,2.0,2
18032,18032,2000-01,2000,2001,West Ham,Tottenham,Loss,Away,2000-09-11,0,2,2,2,3,3,4,7,10,-1,-2,-5,-7,0,9.0,10.0,-1.0,2
18033,18033,2000-01,2000,2001,West Ham,Liverpool,Draw,Home,2000-09-17,1,1,2,2,2,6,7,7,10,-5,-5,-5,-8,1,9.0,4.0,5.0,2
18034,18034,2000-01,2000,2001,West Ham,Coventry,Win,Away,2000-09-23,3,1,2,3,3,1,1,4,7,0,1,-1,-4,0,9.0,14.0,-5.0,2
18035,18035,2000-01,2000,2001,West Ham,Bradford,Draw,Home,2000-09-30,1,4,4,5,6,0,1,1,2,4,3,4,4,1,9.0,17.0,-8.0,2
18036,18036,2000-01,2000,2001,West Ham,Ipswich,Draw,Away,2000-10-14,1,4,5,5,6,4,7,7,7,0,-2,-2,-1,0,9.0,21.0,-12.0,3
18037,18037,2000-01,2000,2001,West Ham,Arsenal,Loss,Home,2000-10-21,0,2,5,6,6,6,7,10,11,-4,-2,-4,-5,1,9.0,2.0,7.0,3
18038,18038,2000-01,2000,2001,West Ham,Newcastle,Win,Home,2000-10-28,3,1,2,5,6,3,6,6,6,-2,-4,-1,0,1,9.0,11.0,-2.0,3
18039,18039,2000-01,2000,2001,West Ham,Derby,Draw,Away,2000-11-06,1,3,4,5,8,0,0,0,1,3,4,5,7,0,9.0,16.0,-7.0,4
18040,18040,2000-01,2000,2001,West Ham,Man City,Win,Home,2000-11-11,3,4,4,5,6,0,3,6,6,4,1,-1,0,1,9.0,21.0,-12.0,4
18041,18041,2000-01,2000,2001,West Ham,Leeds,Win,Away,2000-11-18,3,4,7,7,8,4,5,5,8,0,2,2,0,0,9.0,3.0,6.0,4
18042,18042,2000-01,2000,2001,West Ham,Southampton,Win,Away,2000-11-25,3,6,7,10,10,4,7,7,7,2,0,3,3,0,9.0,15.0,-6.0,4
18043,18043,2000-01,2000,2001,West Ham,Middlesbrough,Win,Home,2000-12-02,3,6,9,10,13,1,1,1,1,5,8,9,12,1,9.0,12.0,-3.0,5
18044,18044,2000-01,2000,2001,West Ham,Aston Villa,Draw,Home,2000-12-09,1,6,9,12,13,2,2,5,8,4,7,7,5,1,9.0,6.0,3.0,5
18045,18045,2000-01,2000,2001,West Ham,Everton,Draw,Away,2000-12-16,1,4,7,10,13,0,3,6,9,4,4,4,4,0,9.0,13.0,-4.0,5
18046,18046,2000-01,2000,2001,West Ham,Leicester,Loss,Away,2000-12-23,0,2,5,8,11,3,6,6,9,-1,-1,2,2,0,9.0,8.0,1.0,5
18047,18047,2000-01,2000,2001,West Ham,Charlton,Win,Home,2000-12-26,3,1,2,5,8,3,4,4,4,-2,-2,1,4,1,9.0,21.0,-12.0,5
18048,18048,2000-01,2000,2001,West Ham,Man United,Loss,Away,2001-01-01,0,3,4,5,8,4,7,7,8,-1,-3,-2,0,0,9.0,1.0,8.0,6
18049,18049,2000-01,2000,2001,West Ham,Sunderland,Loss,Home,2001-01-13,0,3,3,4,5,4,7,10,10,-1,-4,-6,-5,1,9.0,7.0,2.0,6
18050,18050,2000-01,2000,2001,West Ham,Charlton,Draw,Away,2001-01-22,1,0,3,3,4,4,7,7,10,-4,-4,-4,-6,0,9.0,21.0,-12.0,6
18051,18051,2000-01,2000,2001,West Ham,Tottenham,Draw,Home,2001-01-31,1,1,1,4,4,2,5,5,5,-1,-4,-1,-1,1,9.0,10.0,-1.0,6
18052,18052,2000-01,2000,2001,West Ham,Liverpool,Loss,Away,2001-02-03,0,2,2,2,5,2,5,8,8,0,-3,-6,-3,0,9.0,4.0,5.0,7
18053,18053,2000-01,2000,2001,West Ham,Coventry,Draw,Home,2001-02-12,1,1,2,2,2,0,0,0,1,1,2,2,1,1,9.0,14.0,-5.0,7
18054,18054,2000-01,2000,2001,West Ham,Bradford,Win,Away,2001-02-24,3,1,2,3,3,0,0,1,1,1,2,2,2,0,9.0,17.0,-8.0,7
18055,18055,2000-01,2000,2001,West Ham,Arsenal,Loss,Away,2001-03-03,0,4,4,5,6,3,6,9,10,1,-2,-4,-4,0,9.0,2.0,7.0,8
18056,18056,2000-01,2000,2001,West Ham,Chelsea,Loss,Home,2001-03-07,0,3,4,4,5,2,2,5,8,1,2,-1,-3,1,9.0,5.0,4.0,8
18057,18057,2000-01,2000,2001,West Ham,Ipswich,Loss,Home,2001-03-17,0,0,3,4,4,3,6,6,6,-3,-3,-2,-2,1,9.0,21.0,-12.0,8
18058,18058,2000-01,2000,2001,West Ham,Everton,Loss,Home,2001-03-31,0,0,0,3,4,1,1,4,5,-1,-1,-1,-1,1,9.0,13.0,-4.0,8
18059,18059,2000-01,2000,2001,West Ham,Aston Villa,Draw,Away,2001-04-07,1,0,0,0,3,6,7,10,11,-6,-7,-10,-8,0,9.0,6.0,3.0,9
18060,18060,2000-01,2000,2001,West Ham,Derby,Win,Home,2001-04-14,3,1,1,1,1,0,1,4,7,1,0,-3,-6,1,9.0,16.0,-7.0,9
18061,18061,2000-01,2000,2001,West Ham,Newcastle,Loss,Away,2001-04-16,0,4,4,4,4,1,1,2,2,3,3,2,2,0,9.0,11.0,-2.0,9
18062,18062,2000-01,2000,2001,West Ham,Leeds,Loss,Home,2001-04-21,0,3,4,4,4,6,9,12,13,-3,-5,-8,-9,1,9.0,3.0,6.0,9
18063,18063,2000-01,2000,2001,West Ham,Man City,Loss,Away,2001-04-28,0,0,3,4,4,4,4,4,4,-4,-1,0,0,0,9.0,21.0,-12.0,9
18064,18064,2000-01,2000,2001,West Ham,Southampton,Win,Home,2001-05-05,3,0,0,3,4,1,2,2,2,-1,-2,1,2,1,9.0,15.0,-6.0,10
18065,18065,2000-01,2000,2001,West Ham,Middlesbrough,Loss,Away,2001-05-19,0,3,3,3,6,1,4,4,7,2,-1,-1,-1,0,9.0,12.0,-3.0,10
18066,18066,2001-02,2001,2002,West Ham,Liverpool,Loss,Away,2001-08-18,0,3,3,3,3,4,7,10,13,-1,-4,-7,-10,0,15.0,3.0,12.0,1
18067,18067,2001-02,2001,2002,West Ham,Leeds,Draw,Home,2001-08-25,1,0,3,3,3,6,9,12,12,-6,-6,-9,-9,1,15.0,4.0,11.0,1
18068,18068,2001-02,2001,2002,West Ham,Derby,Draw,Away,2001-09-08,1,1,1,4,4,1,4,5,8,0,-3,-1,-4,0,15.0,17.0,-2.0,2
18069,18069,2001-02,2001,2002,West Ham,Middlesbrough,Loss,Away,2001-09-15,0,2,2,2,5,0,0,0,3,2,2,2,2,0,15.0,14.0,1.0,2
18070,18070,2001-02,2001,2002,West Ham,Newcastle,Win,Home,2001-09-23,3,1,2,2,2,6,7,8,11,-5,-5,-6,-9,1,15.0,11.0,4.0,2
18071,18071,2001-02,2001,2002,West Ham,Everton,Loss,Away,2001-09-29,0,3,4,5,5,0,0,3,4,3,4,2,1,0,15.0,16.0,-1.0,2
18072,18072,2001-02,2001,2002,West Ham,Blackburn,Loss,Away,2001-10-14,0,3,3,4,5,3,4,5,5,0,-1,-1,0,0,15.0,21.0,-6.0,3
18073,18073,2001-02,2001,2002,West Ham,Southampton,Win,Home,2001-10-20,3,0,3,3,4,3,3,6,6,-3,0,-3,-2,1,15.0,10.0,5.0,3
18074,18074,2001-02,2001,2002,West Ham,Chelsea,Win,Home,2001-10-24,3,3,3,6,6,4,5,6,9,-1,-2,0,-3,1,15.0,6.0,9.0,3
18075,18075,2001-02,2001,2002,West Ham,Ipswich,Win,Away,2001-10-28,3,6,6,6,9,2,3,3,3,4,3,3,6,0,15.0,5.0,10.0,3
18076,18076,2001-02,2001,2002,West Ham,Fulham,Loss,Home,2001-11-03,0,6,9,9,9,4,4,5,6,2,5,4,3,1,15.0,21.0,-6.0,4
18077,18077,2001-02,2001,2002,West Ham,Charlton,Draw,Away,2001-11-19,1,3,6,9,9,3,3,4,5,0,3,5,4,0,15.0,9.0,6.0,4
18078,18078,2001-02,2001,2002,West Ham,Tottenham,Loss,Home,2001-11-24,0,1,4,7,10,1,4,7,10,0,0,0,0,1,15.0,12.0,3.0,4
18079,18079,2001-02,2001,2002,West Ham,Sunderland,Loss,Away,2001-12-01,0,1,1,4,7,3,3,4,4,-2,-2,0,3,0,15.0,7.0,8.0,5
18080,18080,2001-02,2001,2002,West Ham,Aston Villa,Draw,Home,2001-12-05,1,0,1,1,4,1,2,2,5,-1,-1,-1,-1,1,15.0,8.0,7.0,5
18081,18081,2001-02,2001,2002,West Ham,Man United,Win,Away,2001-12-08,3,1,1,2,2,0,3,3,4,1,-2,-1,-2,0,15.0,1.0,14.0,5
18082,18082,2001-02,2001,2002,West Ham,Arsenal,Draw,Home,2001-12-15,1,4,4,4,5,6,9,10,10,-2,-5,-6,-5,1,15.0,2.0,13.0,5
18083,18083,2001-02,2001,2002,West Ham,Leicester,Draw,Away,2001-12-22,1,4,5,5,5,1,4,5,5,3,1,0,0,0,15.0,13.0,2.0,5
18084,18084,2001-02,2001,2002,West Ham,Derby,Win,Home,2001-12-26,3,2,5,6,6,3,3,6,6,-1,2,0,0,1,15.0,17.0,-2.0,5
18085,18085,2001-02,2001,2002,West Ham,Liverpool,Draw,Home,2001-12-29,1,4,5,8,9,3,3,4,7,1,2,4,2,1,15.0,3.0,12.0,5
18086,18086,2001-02,2001,2002,West Ham,Leeds,Loss,Away,2002-01-01,0,4,5,6,9,6,6,9,10,-2,-1,-3,-1,0,15.0,4.0,11.0,6
18087,18087,2001-02,2001,2002,West Ham,Leicester,Win,Home,2002-01-12,3,1,4,5,6,1,2,3,3,0,2,2,3,1,15.0,13.0,2.0,6
18088,18088,2001-02,2001,2002,West Ham,Chelsea,Loss,Away,2002-01-20,0,3,4,7,8,1,4,4,7,2,0,3,1,0,15.0,6.0,9.0,6
18089,18089,2001-02,2001,2002,West Ham,Southampton,Loss,Away,2002-01-30,0,3,3,4,7,1,4,7,7,2,-1,-3,0,0,15.0,10.0,5.0,6
18090,18090,2001-02,2001,2002,West Ham,Blackburn,Win,Home,2002-02-02,3,0,3,3,4,0,3,3,3,0,0,0,1,1,15.0,21.0,-6.0,7
18091,18091,2001-02,2001,2002,West Ham,Bolton,Loss,Away,2002-02-09,0,3,3,6,6,0,1,2,3,3,2,4,3,0,15.0,21.0,-6.0,7
18092,18092,2001-02,2001,2002,West Ham,Middlesbrough,Win,Home,2002-02-23,3,3,3,3,6,4,5,8,9,-1,-2,-5,-3,1,15.0,14.0,1.0,7
18093,18093,2001-02,2001,2002,West Ham,Aston Villa,Loss,Away,2002-03-02,0,3,6,6,6,1,2,3,6,2,4,3,0,0,15.0,8.0,7.0,8
18094,18094,2001-02,2001,2002,West Ham,Everton,Win,Home,2002-03-06,3,3,3,6,6,2,2,2,3,1,1,4,3,1,15.0,16.0,-1.0,8
18095,18095,2001-02,2001,2002,West Ham,Man United,Loss,Home,2002-03-16,0,3,6,6,9,4,7,10,13,-1,-1,-4,-4,1,15.0,1.0,14.0,8
18096,18096,2001-02,2001,2002,West Ham,Ipswich,Win,Home,2002-03-30,3,3,3,6,6,2,2,2,2,1,1,4,4,1,15.0,5.0,10.0,8
18097,18097,2001-02,2001,2002,West Ham,Fulham,Win,Away,2002-04-01,3,3,6,6,9,1,1,1,1,2,5,5,8,0,15.0,21.0,-6.0,9
18098,18098,2001-02,2001,2002,West Ham,Charlton,Win,Home,2002-04-06,3,6,6,9,9,0,0,3,4,6,6,6,5,1,15.0,9.0,6.0,9
18099,18099,2001-02,2001,2002,West Ham,Tottenham,Draw,Away,2002-04-13,1,6,9,9,12,3,4,7,7,3,5,2,5,0,15.0,12.0,3.0,9
18100,18100,2001-02,2001,2002,West Ham,Sunderland,Win,Home,2002-04-20,3,4,7,10,10,0,3,3,4,4,4,7,6,1,15.0,7.0,8.0,9
18101,18101,2001-02,2001,2002,West Ham,Arsenal,Loss,Away,2002-04-24,0,4,7,10,13,6,9,12,15,-2,-2,-2,-2,0,15.0,2.0,13.0,9
18102,18102,2001-02,2001,2002,West Ham,Newcastle,Loss,Away,2002-04-27,0,3,4,7,10,4,7,8,9,-1,-3,-1,1,0,15.0,11.0,4.0,9
18103,18103,2001-02,2001,2002,West Ham,Bolton,Win,Home,2002-05-11,3,0,3,4,7,0,1,4,4,0,2,0,3,1,15.0,21.0,-6.0,10
18104,18104,2002-03,2002,2003,West Ham,Newcastle,Loss,Away,2002-08-19,0,3,3,6,7,3,4,7,10,0,-1,-1,-3,0,7.0,4.0,3.0,1
18105,18105,2002-03,2002,2003,West Ham,Arsenal,Draw,Home,2002-08-24,1,3,3,3,6,6,9,12,15,-3,-6,-9,-9,1,7.0,1.0,6.0,1
18106,18106,2002-03,2002,2003,West Ham,Charlton,Loss,Home,2002-08-31,0,1,4,4,4,3,3,4,5,-2,1,0,-1,1,7.0,14.0,-7.0,1
18107,18107,2002-03,2002,2003,West Ham,West Brom,Loss,Home,2002-09-11,0,1,1,4,4,3,3,3,3,-2,-2,1,1,1,7.0,21.0,-14.0,2
18108,18108,2002-03,2002,2003,West Ham,Tottenham,Loss,Away,2002-09-15,0,0,1,1,4,3,6,9,10,-3,-5,-8,-6,0,7.0,9.0,-2.0,2
18109,18109,2002-03,2002,2003,West Ham,Man City,Draw,Home,2002-09-21,1,0,0,1,1,1,4,4,7,-1,-4,-3,-6,1,7.0,21.0,-14.0,2
18110,18110,2002-03,2002,2003,West Ham,Chelsea,Win,Away,2002-09-28,3,1,1,1,2,4,7,8,9,-3,-6,-7,-7,0,7.0,6.0,1.0,2
18111,18111,2002-03,2002,2003,West Ham,Birmingham,Loss,Home,2002-10-05,0,4,4,4,4,0,3,4,7,4,1,0,-3,1,7.0,21.0,-14.0,3
18112,18112,2002-03,2002,2003,West Ham,Sunderland,Win,Away,2002-10-19,3,3,4,4,4,3,3,3,3,0,1,1,1,0,7.0,17.0,-10.0,3
18113,18113,2002-03,2002,2003,West Ham,Fulham,Win,Away,2002-10-23,3,3,6,7,7,4,4,5,8,-1,2,2,-1,0,7.0,13.0,-6.0,3
18114,18114,2002-03,2002,2003,West Ham,Everton,Loss,Home,2002-10-27,0,6,6,9,10,3,6,6,9,3,0,3,1,1,7.0,15.0,-8.0,3
18115,18115,2002-03,2002,2003,West Ham,Liverpool,Loss,Away,2002-11-02,0,3,6,6,9,6,9,12,15,-3,-3,-6,-6,0,7.0,2.0,5.0,4
18116,18116,2002-03,2002,2003,West Ham,Leeds,Loss,Home,2002-11-10,0,0,3,6,6,1,1,2,2,-1,2,4,4,1,7.0,5.0,2.0,4
18117,18117,2002-03,2002,2003,West Ham,Man United,Draw,Home,2002-11-17,1,0,0,3,6,3,4,5,8,-3,-4,-2,-2,1,7.0,3.0,4.0,4
18118,18118,2002-03,2002,2003,West Ham,Aston Villa,Loss,Away,2002-11-23,0,1,1,1,4,4,5,6,6,-3,-4,-5,-2,0,7.0,8.0,-1.0,4
18119,18119,2002-03,2002,2003,West Ham,Southampton,Loss,Home,2002-12-02,0,1,1,1,1,3,4,4,7,-2,-3,-3,-6,1,7.0,11.0,-4.0,5
18120,18120,2002-03,2002,2003,West Ham,Middlesbrough,Draw,Away,2002-12-07,1,0,1,1,1,3,3,6,6,-3,-2,-5,-5,0,7.0,12.0,-5.0,5
18121,18121,2002-03,2002,2003,West Ham,Man United,Loss,Away,2002-12-14,0,1,1,2,2,6,9,10,10,-5,-8,-8,-8,0,7.0,3.0,4.0,5
18122,18122,2002-03,2002,2003,West Ham,Bolton,Draw,Home,2002-12-21,1,1,1,1,2,1,1,2,5,0,0,-1,-3,1,7.0,16.0,-9.0,5
18123,18123,2002-03,2002,2003,West Ham,Fulham,Draw,Home,2002-12-26,1,1,2,2,2,0,3,3,6,1,-1,-1,-4,1,7.0,13.0,-6.0,5
18124,18124,2002-03,2002,2003,West Ham,Blackburn,Draw,Away,2002-12-28,1,2,2,3,3,4,4,5,8,-2,-2,-2,-5,0,7.0,10.0,-3.0,5
18125,18125,2002-03,2002,2003,West Ham,Newcastle,Draw,Home,2003-01-11,1,2,3,3,4,6,6,9,10,-4,-3,-6,-6,1,7.0,4.0,3.0,6
18126,18126,2002-03,2002,2003,West Ham,Arsenal,Loss,Away,2003-01-19,0,2,3,4,4,6,7,10,13,-4,-4,-6,-9,0,7.0,1.0,6.0,6
18127,18127,2002-03,2002,2003,West Ham,Charlton,Loss,Away,2003-01-22,0,1,2,3,4,1,4,5,6,0,-2,-2,-2,0,7.0,14.0,-7.0,6
18128,18128,2002-03,2002,2003,West Ham,Blackburn,Win,Home,2003-01-29,3,0,1,2,3,2,5,6,7,-2,-4,-4,-4,1,7.0,10.0,-3.0,6
18129,18129,2002-03,2002,2003,West Ham,Liverpool,Loss,Home,2003-02-02,0,3,3,4,5,4,5,5,6,-1,-2,-1,-1,1,7.0,2.0,5.0,7
18130,18130,2002-03,2002,2003,West Ham,Leeds,Loss,Away,2003-02-08,0,3,3,3,4,0,1,1,4,3,2,2,0,0,7.0,5.0,2.0,7
18131,18131,2002-03,2002,2003,West Ham,West Brom,Win,Away,2003-02-23,3,0,3,3,3,1,4,4,5,-1,-1,-1,-2,0,7.0,21.0,-14.0,7
18132,18132,2002-03,2002,2003,West Ham,Tottenham,Win,Home,2003-03-01,3,3,3,6,6,4,5,5,8,-1,-2,1,-2,1,7.0,9.0,-2.0,8
18133,18133,2002-03,2002,2003,West Ham,Everton,Draw,Away,2003-03-15,1,6,6,6,9,4,4,7,10,2,2,-1,-1,0,7.0,15.0,-8.0,8
18134,18134,2002-03,2002,2003,West Ham,Sunderland,Win,Home,2003-03-22,3,4,7,7,7,0,0,0,0,4,7,7,7,1,7.0,17.0,-10.0,8
18135,18135,2002-03,2002,2003,West Ham,Southampton,Draw,Away,2003-04-05,1,4,7,10,10,2,5,5,5,2,2,5,5,0,7.0,11.0,-4.0,9
18136,18136,2002-03,2002,2003,West Ham,Aston Villa,Draw,Home,2003-04-12,1,4,5,8,11,2,2,2,2,2,3,6,9,1,7.0,8.0,-1.0,9
18137,18137,2002-03,2002,2003,West Ham,Bolton,Loss,Away,2003-04-19,0,2,5,6,9,3,6,9,9,-1,-1,-3,0,0,7.0,16.0,-9.0,9
18138,18138,2002-03,2002,2003,West Ham,Middlesbrough,Win,Home,2003-04-21,3,1,2,5,6,1,4,5,8,0,-2,0,-2,1,7.0,12.0,-5.0,9
18139,18139,2002-03,2002,2003,West Ham,Man City,Win,Away,2003-04-27,3,3,4,5,8,6,7,7,7,-3,-3,-2,1,0,7.0,21.0,-14.0,9
18140,18140,2002-03,2002,2003,West Ham,Chelsea,Win,Home,2003-05-03,3,6,6,7,8,4,4,7,10,2,2,0,-2,1,7.0,6.0,1.0,10
18141,18141,2002-03,2002,2003,West Ham,Birmingham,Draw,Away,2003-05-11,1,6,9,9,10,3,6,9,12,3,3,0,-2,0,7.0,21.0,-14.0,10
18142,18142,2005-06,2005,2006,West Ham,Blackburn,Win,Home,2005-08-13,3,4,7,10,10,1,1,2,3,3,6,8,7,1,21.0,15.0,6.0,1
18143,18143,2005-06,2005,2006,West Ham,Newcastle,Draw,Away,2005-08-20,1,4,7,10,13,1,1,4,5,3,6,6,8,0,21.0,14.0,7.0,1
18144,18144,2005-06,2005,2006,West Ham,Bolton,Loss,Home,2005-08-27,0,4,5,8,11,3,4,7,8,1,1,1,3,1,21.0,6.0,15.0,1
18145,18145,2005-06,2005,2006,West Ham,Aston Villa,Win,Home,2005-09-12,3,1,4,5,8,4,4,5,5,-3,0,0,3,1,21.0,10.0,11.0,2
18146,18146,2005-06,2005,2006,West Ham,Fulham,Win,Away,2005-09-17,3,3,4,7,8,4,4,4,5,-1,0,3,3,0,21.0,13.0,8.0,2
18147,18147,2005-06,2005,2006,West Ham,Arsenal,Draw,Home,2005-09-24,1,6,6,7,10,3,6,6,9,3,0,1,1,1,21.0,2.0,19.0,2
18148,18148,2005-06,2005,2006,West Ham,Sunderland,Draw,Away,2005-10-01,1,4,7,7,8,4,4,4,4,0,3,3,4,0,21.0,21.0,0.0,3
18149,18149,2005-06,2005,2006,West Ham,Man City,Loss,Away,2005-10-16,0,2,5,8,8,3,3,4,7,-1,2,4,1,0,21.0,8.0,13.0,3
18150,18150,2005-06,2005,2006,West Ham,Middlesbrough,Win,Home,2005-10-23,3,1,2,5,8,4,4,5,8,-3,-2,0,0,1,21.0,7.0,14.0,3
18151,18151,2005-06,2005,2006,West Ham,Liverpool,Loss,Away,2005-10-29,0,3,4,5,8,3,3,4,5,0,1,1,3,0,21.0,5.0,16.0,3
18152,18152,2005-06,2005,2006,West Ham,West Brom,Win,Home,2005-11-05,3,3,3,4,5,0,3,3,3,3,0,1,2,1,21.0,17.0,4.0,4
18153,18153,2005-06,2005,2006,West Ham,Tottenham,Draw,Away,2005-11-20,1,3,6,6,7,1,2,5,8,2,4,1,-1,0,21.0,9.0,12.0,4
18154,18154,2005-06,2005,2006,West Ham,Man United,Loss,Home,2005-11-27,0,4,4,7,7,6,6,7,10,-2,-2,0,-3,1,21.0,3.0,18.0,4
18155,18155,2005-06,2005,2006,West Ham,Birmingham,Win,Away,2005-12-05,3,1,4,4,7,3,3,3,3,-2,1,1,4,0,21.0,12.0,9.0,5
18156,18156,2005-06,2005,2006,West Ham,Blackburn,Loss,Away,2005-12-10,0,3,4,7,7,0,1,4,4,3,3,3,3,0,21.0,15.0,6.0,5
18157,18157,2005-06,2005,2006,West Ham,Everton,Win,Away,2005-12-14,3,3,3,4,7,4,7,7,10,-1,-4,-3,-3,0,21.0,4.0,17.0,5
18158,18158,2005-06,2005,2006,West Ham,Newcastle,Loss,Home,2005-12-17,0,3,6,6,7,4,4,4,7,-1,2,2,0,1,21.0,14.0,7.0,5
18159,18159,2005-06,2005,2006,West Ham,Portsmouth,Draw,Away,2005-12-26,1,3,3,6,6,3,3,3,3,0,0,3,3,0,21.0,16.0,5.0,5
18160,18160,2005-06,2005,2006,West Ham,Wigan,Loss,Home,2005-12-28,0,1,4,4,7,6,6,6,6,-5,-2,-2,1,1,21.0,21.0,0.0,5
18161,18161,2005-06,2005,2006,West Ham,Charlton,Loss,Away,2005-12-31,0,1,1,4,4,0,3,3,3,1,-2,1,1,0,21.0,11.0,10.0,5
18162,18162,2005-06,2005,2006,West Ham,Chelsea,Loss,Home,2006-01-02,0,0,1,1,4,6,9,12,15,-6,-8,-11,-11,1,21.0,1.0,20.0,6
18163,18163,2005-06,2005,2006,West Ham,Aston Villa,Win,Away,2006-01-14,3,0,0,1,1,4,5,8,8,-4,-5,-7,-7,0,21.0,10.0,11.0,6
18164,18164,2005-06,2005,2006,West Ham,Fulham,Win,Home,2006-01-23,3,3,3,3,4,6,6,7,7,-3,-3,-4,-3,1,21.0,13.0,8.0,6
18165,18165,2005-06,2005,2006,West Ham,Arsenal,Win,Away,2006-02-01,3,6,6,6,6,3,4,5,8,3,2,1,-2,0,21.0,2.0,19.0,7
18166,18166,2005-06,2005,2006,West Ham,Sunderland,Win,Home,2006-02-04,3,6,9,9,9,3,3,3,3,3,6,6,6,1,21.0,21.0,0.0,7
18167,18167,2005-06,2005,2006,West Ham,Birmingham,Win,Home,2006-02-13,3,6,9,12,12,1,4,4,7,5,5,8,5,1,21.0,12.0,9.0,7
18168,18168,2005-06,2005,2006,West Ham,Everton,Draw,Home,2006-03-04,1,6,9,12,15,3,6,7,10,3,3,5,5,1,21.0,4.0,17.0,8
18169,18169,2005-06,2005,2006,West Ham,Bolton,Loss,Away,2006-03-11,0,4,7,10,13,3,4,5,6,1,3,5,7,0,21.0,6.0,15.0,8
18170,18170,2005-06,2005,2006,West Ham,Portsmouth,Loss,Home,2006-03-18,0,1,4,7,10,3,3,3,3,-2,1,4,7,1,21.0,16.0,5.0,8
18171,18171,2005-06,2005,2006,West Ham,Wigan,Win,Away,2006-03-25,3,0,1,4,7,6,6,7,7,-6,-5,-3,0,0,21.0,21.0,0.0,8
18172,18172,2005-06,2005,2006,West Ham,Man United,Loss,Away,2006-03-29,0,3,3,4,7,6,9,12,15,-3,-6,-8,-8,0,21.0,3.0,18.0,8
18173,18173,2005-06,2005,2006,West Ham,Charlton,Draw,Home,2006-04-02,1,3,3,3,4,3,6,7,8,0,-3,-4,-4,1,21.0,11.0,10.0,9
18174,18174,2005-06,2005,2006,West Ham,Chelsea,Loss,Away,2006-04-09,0,1,4,4,4,4,4,7,10,-3,0,-3,-6,0,21.0,1.0,20.0,9
18175,18175,2005-06,2005,2006,West Ham,Man City,Win,Home,2006-04-15,3,1,1,4,4,0,0,0,0,1,1,4,4,1,21.0,8.0,13.0,9
18176,18176,2005-06,2005,2006,West Ham,Middlesbrough,Loss,Away,2006-04-17,0,3,4,4,7,0,3,6,6,3,1,-2,1,0,21.0,7.0,14.0,9
18177,18177,2005-06,2005,2006,West Ham,Liverpool,Loss,Home,2006-04-26,0,3,3,4,4,6,9,12,15,-3,-6,-8,-11,1,21.0,5.0,16.0,9
18178,18178,2005-06,2005,2006,West Ham,West Brom,Win,Away,2006-05-01,3,0,3,3,4,1,1,2,2,-1,2,1,2,0,21.0,17.0,4.0,10
18179,18179,2005-06,2005,2006,West Ham,Tottenham,Win,Home,2006-05-07,3,3,3,6,6,4,4,7,10,-1,-1,-1,-4,1,21.0,9.0,12.0,10
18180,18180,2006-07,2006,2007,West Ham,Charlton,Win,Home,2006-08-19,3,6,6,6,9,0,0,3,3,6,6,3,6,1,9.0,13.0,-4.0,1
18181,18181,2006-07,2006,2007,West Ham,Watford,Draw,Away,2006-08-22,1,6,9,9,9,3,4,4,4,3,5,5,5,0,9.0,21.0,-12.0,1
18182,18182,2006-07,2006,2007,West Ham,Liverpool,Loss,Away,2006-08-26,0,4,7,10,10,4,7,10,13,0,0,0,-3,0,9.0,3.0,6.0,1
18183,18183,2006-07,2006,2007,West Ham,Aston Villa,Draw,Home,2006-09-10,1,1,4,7,10,6,7,10,10,-5,-3,-3,0,1,9.0,16.0,-7.0,2
18184,18184,2006-07,2006,2007,West Ham,Newcastle,Loss,Home,2006-09-17,0,1,2,5,8,0,3,6,7,1,-1,-1,1,1,9.0,7.0,2.0,2
18185,18185,2006-07,2006,2007,West Ham,Man City,Loss,Away,2006-09-23,0,1,1,2,5,0,3,4,4,1,-2,-2,1,0,9.0,15.0,-6.0,2
18186,18186,2006-07,2006,2007,West Ham,Reading,Loss,Home,2006-10-01,0,0,1,1,2,4,7,7,7,-4,-6,-6,-5,1,9.0,21.0,-12.0,3
18187,18187,2006-07,2006,2007,West Ham,Portsmouth,Loss,Away,2006-10-14,0,0,0,1,1,0,3,6,9,0,-3,-5,-8,0,9.0,17.0,-8.0,3
18188,18188,2006-07,2006,2007,West Ham,Tottenham,Loss,Away,2006-10-22,0,0,0,0,1,4,4,5,5,-4,-4,-5,-4,0,9.0,5.0,4.0,3
18189,18189,2006-07,2006,2007,West Ham,Blackburn,Win,Home,2006-10-29,3,0,0,0,0,1,4,7,10,-1,-4,-7,-10,1,9.0,6.0,3.0,3
18190,18190,2006-07,2006,2007,West Ham,Arsenal,Win,Home,2006-11-05,3,3,3,3,3,4,7,10,13,-1,-4,-7,-10,1,9.0,4.0,5.0,4
18191,18191,2006-07,2006,2007,West Ham,Middlesbrough,Loss,Away,2006-11-11,0,6,6,6,6,0,3,6,6,6,3,0,0,0,9.0,14.0,-5.0,4
18192,18192,2006-07,2006,2007,West Ham,Chelsea,Loss,Away,2006-11-18,0,3,6,6,6,3,6,9,12,0,0,-3,-6,0,9.0,1.0,8.0,4
18193,18193,2006-07,2006,2007,West Ham,Sheffield United,Win,Home,2006-11-25,3,0,3,6,6,1,4,4,4,-1,-1,2,2,1,9.0,21.0,-12.0,4
18194,18194,2006-07,2006,2007,West Ham,Everton,Loss,Away,2006-12-03,0,3,3,6,9,1,4,4,4,2,-1,2,5,0,9.0,11.0,-2.0,5
18195,18195,2006-07,2006,2007,West Ham,Wigan,Loss,Home,2006-12-06,0,3,3,3,6,0,1,4,7,3,2,-1,-1,1,9.0,10.0,-1.0,5
18196,18196,2006-07,2006,2007,West Ham,Bolton,Loss,Away,2006-12-09,0,0,3,3,3,0,3,3,4,0,0,0,-1,0,9.0,8.0,1.0,5
18197,18197,2006-07,2006,2007,West Ham,Man United,Win,Home,2006-12-17,3,0,0,3,3,6,9,10,13,-6,-9,-7,-10,1,9.0,2.0,7.0,5
18198,18198,2006-07,2006,2007,West Ham,Fulham,Draw,Away,2006-12-23,1,3,3,3,6,3,3,6,6,0,0,-3,0,0,9.0,12.0,-3.0,5
18199,18199,2006-07,2006,2007,West Ham,Portsmouth,Loss,Home,2006-12-26,0,4,4,4,4,4,7,8,9,0,-3,-4,-5,1,9.0,17.0,-8.0,5
18200,18200,2006-07,2006,2007,West Ham,Man City,Loss,Home,2006-12-30,0,1,4,4,4,3,3,3,4,-2,1,1,0,1,9.0,15.0,-6.0,5
18201,18201,2006-07,2006,2007,West Ham,Reading,Loss,Away,2007-01-01,0,0,1,4,4,1,1,1,2,-1,0,3,2,0,9.0,21.0,-12.0,6
18202,18202,2006-07,2006,2007,West Ham,Fulham,Draw,Home,2007-01-13,1,0,0,1,4,2,3,4,7,-2,-3,-3,-3,1,9.0,12.0,-3.0,6
18203,18203,2006-07,2006,2007,West Ham,Newcastle,Draw,Away,2007-01-20,1,1,1,1,2,4,4,4,7,-3,-3,-3,-5,0,9.0,7.0,2.0,6
18204,18204,2006-07,2006,2007,West Ham,Liverpool,Loss,Home,2007-01-30,0,2,2,2,2,6,9,12,12,-4,-7,-10,-10,1,9.0,3.0,6.0,6
18205,18205,2006-07,2006,2007,West Ham,Aston Villa,Loss,Away,2007-02-03,0,1,2,2,2,3,3,4,4,-2,-1,-2,-2,0,9.0,16.0,-7.0,7
18206,18206,2006-07,2006,2007,West Ham,Watford,Loss,Home,2007-02-10,0,0,1,2,2,0,3,3,3,0,-2,-1,-1,1,9.0,21.0,-12.0,7
18207,18207,2006-07,2006,2007,West Ham,Charlton,Loss,Away,2007-02-24,0,0,0,1,2,0,1,4,4,0,-1,-3,-2,0,9.0,13.0,-4.0,7
18208,18208,2006-07,2006,2007,West Ham,Tottenham,Loss,Home,2007-03-04,0,0,0,0,1,6,6,6,7,-6,-6,-6,-6,1,9.0,5.0,4.0,8
18209,18209,2006-07,2006,2007,West Ham,Blackburn,Win,Away,2007-03-17,3,0,0,0,0,6,6,9,9,-6,-6,-9,-9,0,9.0,6.0,3.0,8
18210,18210,2006-07,2006,2007,West Ham,Middlesbrough,Win,Home,2007-03-31,3,3,3,3,3,1,4,4,5,2,-1,-1,-2,1,9.0,14.0,-5.0,8
18211,18211,2006-07,2006,2007,West Ham,Arsenal,Win,Away,2007-04-07,3,6,6,6,6,0,3,6,9,6,3,0,-3,0,9.0,4.0,5.0,9
18212,18212,2006-07,2006,2007,West Ham,Sheffield United,Loss,Away,2007-04-14,0,6,9,9,9,0,0,1,1,6,9,8,8,0,9.0,21.0,-12.0,9
18213,18213,2006-07,2006,2007,West Ham,Chelsea,Loss,Home,2007-04-18,0,3,6,9,9,6,9,12,15,-3,-3,-3,-6,1,9.0,1.0,8.0,9
18214,18214,2006-07,2006,2007,West Ham,Everton,Win,Home,2007-04-21,3,0,3,6,9,4,7,8,11,-4,-4,-2,-2,1,9.0,11.0,-2.0,9
18215,18215,2006-07,2006,2007,West Ham,Wigan,Win,Away,2007-04-28,3,3,3,6,9,1,2,2,2,2,1,4,7,0,9.0,10.0,-1.0,9
18216,18216,2006-07,2006,2007,West Ham,Bolton,Win,Home,2007-05-05,3,6,6,6,9,1,1,2,5,5,5,4,4,1,9.0,8.0,1.0,10
18217,18217,2006-07,2006,2007,West Ham,Man United,Win,Away,2007-05-13,3,6,9,9,9,4,7,8,11,2,2,1,-2,0,9.0,2.0,7.0,10
18218,18218,2007-08,2007,2008,West Ham,Man City,Loss,Home,2007-08-11,0,6,9,12,12,0,0,1,1,6,9,11,11,1,15.0,14.0,1.0,1
18219,18219,2007-08,2007,2008,West Ham,Birmingham,Win,Away,2007-08-18,3,3,6,9,12,1,1,2,3,2,5,7,9,0,15.0,21.0,-6.0,1
18220,18220,2007-08,2007,2008,West Ham,Wigan,Draw,Home,2007-08-25,1,3,6,9,12,6,6,9,9,-3,0,0,3,1,15.0,17.0,-2.0,1
18221,18221,2007-08,2007,2008,West Ham,Reading,Win,Away,2007-09-01,3,4,4,7,10,3,3,4,5,1,1,3,5,0,15.0,8.0,7.0,2
18222,18222,2007-08,2007,2008,West Ham,Middlesbrough,Win,Home,2007-09-15,3,4,7,7,10,4,7,7,7,0,0,0,3,1,15.0,12.0,3.0,2
18223,18223,2007-08,2007,2008,West Ham,Newcastle,Loss,Away,2007-09-23,0,6,7,10,10,3,4,5,8,3,3,5,2,0,15.0,13.0,2.0,2
18224,18224,2007-08,2007,2008,West Ham,Arsenal,Loss,Home,2007-09-29,0,3,6,7,10,6,9,12,13,-3,-3,-5,-3,1,15.0,4.0,11.0,2
18225,18225,2007-08,2007,2008,West Ham,Aston Villa,Loss,Away,2007-10-06,0,0,3,6,7,4,4,7,10,-4,-1,-1,-3,0,15.0,11.0,4.0,3
18226,18226,2007-08,2007,2008,West Ham,Sunderland,Win,Home,2007-10-21,3,0,0,3,6,0,1,4,4,0,-1,-1,2,1,15.0,21.0,-6.0,3
18227,18227,2007-08,2007,2008,West Ham,Portsmouth,Draw,Away,2007-10-27,1,3,3,3,6,6,9,12,13,-3,-6,-9,-7,0,15.0,9.0,6.0,3
18228,18228,2007-08,2007,2008,West Ham,Bolton,Draw,Home,2007-11-04,1,4,4,4,4,1,1,2,3,3,3,2,1,1,15.0,7.0,8.0,4
18229,18229,2007-08,2007,2008,West Ham,Derby,Win,Away,2007-11-10,3,2,5,5,5,0,1,1,2,2,4,4,3,0,15.0,21.0,-6.0,4
18230,18230,2007-08,2007,2008,West Ham,Tottenham,Draw,Home,2007-11-25,1,4,5,8,8,4,4,4,5,0,1,4,3,1,15.0,5.0,10.0,4
18231,18231,2007-08,2007,2008,West Ham,Chelsea,Loss,Away,2007-12-01,0,4,5,6,9,4,7,10,13,0,-2,-4,-4,0,15.0,2.0,13.0,5
18232,18232,2007-08,2007,2008,West Ham,Blackburn,Win,Away,2007-12-09,3,1,4,5,6,3,4,4,5,-2,0,1,1,0,15.0,10.0,5.0,5
18233,18233,2007-08,2007,2008,West Ham,Everton,Loss,Home,2007-12-15,0,3,4,7,8,4,7,8,11,-1,-3,-1,-3,1,15.0,6.0,9.0,5
18234,18234,2007-08,2007,2008,West Ham,Middlesbrough,Win,Away,2007-12-22,3,3,3,4,7,6,7,7,8,-3,-4,-3,-1,0,15.0,12.0,3.0,5
18235,18235,2007-08,2007,2008,West Ham,Reading,Draw,Home,2007-12-26,1,3,6,6,7,4,7,8,8,-1,-1,-2,-1,1,15.0,8.0,7.0,5
18236,18236,2007-08,2007,2008,West Ham,Man United,Win,Home,2007-12-29,3,4,4,7,7,6,9,12,15,-2,-5,-5,-8,1,15.0,1.0,14.0,5
18237,18237,2007-08,2007,2008,West Ham,Arsenal,Loss,Away,2008-01-01,0,4,7,7,10,4,7,10,10,0,0,-3,0,0,15.0,4.0,11.0,6
18238,18238,2007-08,2007,2008,West Ham,Fulham,Win,Home,2008-01-12,3,3,4,7,7,1,1,2,2,2,3,5,5,1,15.0,16.0,-1.0,6
18239,18239,2007-08,2007,2008,West Ham,Man City,Draw,Away,2008-01-20,1,3,6,7,10,3,4,5,6,0,2,2,4,0,15.0,14.0,1.0,6
18240,18240,2007-08,2007,2008,West Ham,Liverpool,Win,Home,2008-01-30,3,4,4,7,8,2,3,4,7,2,1,3,1,1,15.0,3.0,12.0,6
18241,18241,2007-08,2007,2008,West Ham,Wigan,Loss,Away,2008-02-02,0,4,7,7,10,0,3,4,4,4,4,3,6,0,15.0,17.0,-2.0,7
18242,18242,2007-08,2007,2008,West Ham,Birmingham,Draw,Home,2008-02-09,1,3,4,7,7,1,1,2,2,2,3,5,5,1,15.0,21.0,-6.0,7
18243,18243,2007-08,2007,2008,West Ham,Fulham,Win,Away,2008-02-23,3,1,4,5,8,3,4,4,4,-2,0,1,4,0,15.0,16.0,-1.0,7
18244,18244,2007-08,2007,2008,West Ham,Chelsea,Loss,Home,2008-03-01,0,4,4,7,8,2,5,8,11,2,-1,-1,-3,1,15.0,2.0,13.0,8
18245,18245,2007-08,2007,2008,West Ham,Liverpool,Loss,Away,2008-03-05,0,3,4,4,7,6,7,10,10,-3,-3,-6,-3,0,15.0,3.0,12.0,8
18246,18246,2007-08,2007,2008,West Ham,Tottenham,Loss,Away,2008-03-09,0,0,3,4,4,3,4,5,8,-3,-1,-1,-4,0,15.0,5.0,10.0,8
18247,18247,2007-08,2007,2008,West Ham,Blackburn,Win,Home,2008-03-15,3,0,0,3,4,4,7,7,8,-4,-7,-4,-4,1,15.0,10.0,5.0,8
18248,18248,2007-08,2007,2008,West Ham,Everton,Draw,Away,2008-03-22,1,3,3,3,6,3,6,9,12,0,-3,-6,-6,0,15.0,6.0,9.0,8
18249,18249,2007-08,2007,2008,West Ham,Sunderland,Loss,Away,2008-03-29,0,4,4,4,4,3,3,4,4,1,1,0,0,0,15.0,21.0,-6.0,8
18250,18250,2007-08,2007,2008,West Ham,Portsmouth,Loss,Home,2008-04-08,0,1,4,4,4,3,6,9,9,-2,-2,-5,-5,1,15.0,9.0,6.0,9
18251,18251,2007-08,2007,2008,West Ham,Bolton,Loss,Away,2008-04-12,0,0,1,4,4,0,1,1,1,0,0,3,3,0,15.0,7.0,8.0,9
18252,18252,2007-08,2007,2008,West Ham,Derby,Win,Home,2008-04-19,3,0,0,1,4,0,1,1,1,0,-1,0,3,1,15.0,21.0,-6.0,9
18253,18253,2007-08,2007,2008,West Ham,Newcastle,Draw,Home,2008-04-26,1,3,3,3,4,4,7,10,13,-1,-4,-7,-9,1,15.0,13.0,2.0,9
18254,18254,2007-08,2007,2008,West Ham,Man United,Loss,Away,2008-05-03,0,4,4,4,4,1,4,5,8,3,0,-1,-4,0,15.0,1.0,14.0,10
18255,18255,2007-08,2007,2008,West Ham,Aston Villa,Draw,Home,2008-05-11,1,1,4,4,4,1,4,7,10,0,0,-3,-6,1,15.0,11.0,4.0,10
18256,18256,2008-09,2008,2009,West Ham,Wigan,Win,Home,2008-08-16,3,1,2,5,5,3,4,5,6,-2,-2,0,-1,1,10.0,14.0,-4.0,1
18257,18257,2008-09,2008,2009,West Ham,Man City,Loss,Away,2008-08-24,0,4,4,5,8,0,0,0,3,4,4,5,5,0,10.0,9.0,1.0,1
18258,18258,2008-09,2008,2009,West Ham,Blackburn,Win,Home,2008-08-30,3,3,4,4,5,4,4,7,10,-1,0,-3,-5,1,10.0,7.0,3.0,1
18259,18259,2008-09,2008,2009,West Ham,West Brom,Loss,Away,2008-09-13,0,3,6,7,7,1,1,2,2,2,5,5,5,0,10.0,21.0,-11.0,2
18260,18260,2008-09,2008,2009,West Ham,Newcastle,Win,Home,2008-09-20,3,3,3,6,7,0,3,4,4,3,0,2,3,1,10.0,12.0,-2.0,2
18261,18261,2008-09,2008,2009,West Ham,Fulham,Win,Away,2008-09-27,3,3,6,6,9,3,6,6,9,0,0,0,0,0,10.0,17.0,-7.0,2
18262,18262,2008-09,2008,2009,West Ham,Bolton,Loss,Home,2008-10-05,0,6,6,9,9,0,0,1,1,6,6,8,8,1,10.0,16.0,-6.0,3
18263,18263,2008-09,2008,2009,West Ham,Hull,Loss,Away,2008-10-19,0,3,6,6,9,6,7,10,10,-3,-1,-4,-1,0,10.0,21.0,-11.0,3
18264,18264,2008-09,2008,2009,West Ham,Arsenal,Loss,Home,2008-10-26,0,0,3,6,6,4,4,7,10,-4,-1,-1,-4,1,10.0,3.0,7.0,3
18265,18265,2008-09,2008,2009,West Ham,Man United,Loss,Away,2008-10-29,0,0,0,3,6,4,7,10,11,-4,-7,-7,-5,0,10.0,1.0,9.0,3
18266,18266,2008-09,2008,2009,West Ham,Middlesbrough,Draw,Away,2008-11-01,1,0,0,0,3,4,4,7,7,-4,-4,-7,-4,0,10.0,13.0,-3.0,4
18267,18267,2008-09,2008,2009,West Ham,Everton,Loss,Home,2008-11-08,0,1,1,1,1,6,7,7,8,-5,-6,-6,-7,1,10.0,5.0,5.0,4
18268,18268,2008-09,2008,2009,West Ham,Portsmouth,Draw,Home,2008-11-15,1,1,1,1,1,3,3,4,5,-2,-2,-3,-4,1,10.0,8.0,2.0,4
18269,18269,2008-09,2008,2009,West Ham,Sunderland,Win,Away,2008-11-23,3,1,2,2,2,3,3,3,6,-2,-1,-1,-4,0,10.0,15.0,-5.0,4
18270,18270,2008-09,2008,2009,West Ham,Liverpool,Draw,Away,2008-12-01,1,4,4,5,5,4,7,7,10,0,-3,-2,-5,0,10.0,4.0,6.0,5
18271,18271,2008-09,2008,2009,West Ham,Tottenham,Loss,Home,2008-12-08,0,4,5,5,6,3,3,6,9,1,2,-1,-3,1,10.0,11.0,-1.0,5
18272,18272,2008-09,2008,2009,West Ham,Chelsea,Draw,Away,2008-12-14,1,1,4,5,5,3,4,7,10,-2,0,-2,-5,0,10.0,2.0,8.0,5
18273,18273,2008-09,2008,2009,West Ham,Aston Villa,Loss,Home,2008-12-20,0,1,2,5,6,6,7,8,11,-5,-5,-3,-5,1,10.0,6.0,4.0,5
18274,18274,2008-09,2008,2009,West Ham,Portsmouth,Win,Away,2008-12-26,3,1,1,2,5,0,1,4,5,1,0,-2,0,0,10.0,8.0,2.0,5
18275,18275,2008-09,2008,2009,West Ham,Stoke,Win,Home,2008-12-28,3,3,4,4,5,0,1,2,3,3,3,2,2,1,10.0,21.0,-11.0,5
18276,18276,2008-09,2008,2009,West Ham,Newcastle,Draw,Away,2009-01-10,1,6,6,7,7,0,3,6,7,6,3,1,0,0,10.0,12.0,-2.0,6
18277,18277,2008-09,2008,2009,West Ham,Fulham,Win,Home,2009-01-18,3,4,7,7,8,2,5,6,7,2,2,1,1,1,10.0,17.0,-7.0,6
18278,18278,2008-09,2008,2009,West Ham,Hull,Win,Home,2009-01-28,3,4,7,10,10,0,0,0,0,4,7,10,10,1,10.0,21.0,-11.0,6
18279,18279,2008-09,2008,2009,West Ham,Arsenal,Draw,Away,2009-01-31,1,6,7,10,13,4,7,10,11,2,0,0,2,0,10.0,3.0,7.0,6
18280,18280,2008-09,2008,2009,West Ham,Man United,Loss,Home,2009-02-08,0,4,7,8,11,6,9,12,15,-2,-2,-4,-4,1,10.0,1.0,9.0,7
18281,18281,2008-09,2008,2009,West Ham,Bolton,Loss,Away,2009-02-21,0,1,4,7,8,3,4,4,4,-2,0,3,4,0,10.0,16.0,-6.0,7
18282,18282,2008-09,2008,2009,West Ham,Man City,Win,Home,2009-03-01,3,0,1,4,7,1,4,4,7,-1,-3,0,0,1,10.0,9.0,1.0,8
18283,18283,2008-09,2008,2009,West Ham,Wigan,Win,Away,2009-03-04,3,3,3,4,7,1,2,3,4,2,1,1,3,0,10.0,14.0,-4.0,8
18284,18284,2008-09,2008,2009,West Ham,West Brom,Draw,Home,2009-03-16,1,6,6,6,7,0,0,0,1,6,6,6,6,1,10.0,21.0,-11.0,8
18285,18285,2008-09,2008,2009,West Ham,Blackburn,Draw,Away,2009-03-21,1,4,7,7,7,3,4,7,7,1,3,0,0,0,10.0,7.0,3.0,8
18286,18286,2008-09,2008,2009,West Ham,Sunderland,Win,Home,2009-04-04,3,2,5,8,8,0,1,1,2,2,4,7,6,1,10.0,15.0,-5.0,9
18287,18287,2008-09,2008,2009,West Ham,Tottenham,Loss,Away,2009-04-11,0,4,5,8,11,3,6,7,10,1,-1,1,1,0,10.0,11.0,-1.0,9
18288,18288,2008-09,2008,2009,West Ham,Aston Villa,Draw,Away,2009-04-18,1,3,4,5,8,1,1,1,1,2,3,4,7,0,10.0,6.0,4.0,9
18289,18289,2008-09,2008,2009,West Ham,Chelsea,Loss,Home,2009-04-25,0,1,4,5,6,4,7,7,10,-3,-3,-2,-4,1,10.0,2.0,8.0,9
18290,18290,2008-09,2008,2009,West Ham,Stoke,Win,Away,2009-05-02,3,1,1,4,5,3,4,7,10,-2,-3,-3,-5,0,10.0,21.0,-11.0,10
18291,18291,2008-09,2008,2009,West Ham,Liverpool,Loss,Home,2009-05-09,0,3,4,4,7,6,7,10,13,-3,-3,-6,-6,1,10.0,4.0,6.0,10
18292,18292,2008-09,2008,2009,West Ham,Everton,Loss,Away,2009-05-16,0,3,3,4,4,4,4,5,6,-1,-1,-1,-2,0,10.0,5.0,5.0,10
18293,18293,2008-09,2008,2009,West Ham,Middlesbrough,Win,Home,2009-05-24,3,0,3,3,4,1,1,1,2,-1,2,2,2,1,10.0,13.0,-3.0,10
18294,18294,2009-10,2009,2010,West Ham,Wolves,Win,Away,2009-08-15,3,3,3,6,6,1,4,5,8,2,-1,1,-2,0,9.0,21.0,-12.0,1
18295,18295,2009-10,2009,2010,West Ham,Tottenham,Loss,Home,2009-08-23,0,6,6,6,9,6,6,9,10,0,0,-3,-1,1,9.0,8.0,1.0,1
18296,18296,2009-10,2009,2010,West Ham,Blackburn,Draw,Away,2009-08-29,1,3,6,6,6,0,1,1,4,3,5,5,2,0,9.0,15.0,-6.0,1
18297,18297,2009-10,2009,2010,West Ham,Wigan,Loss,Away,2009-09-12,0,1,4,7,7,0,0,3,6,1,4,4,1,0,9.0,11.0,-2.0,2
18298,18298,2009-10,2009,2010,West Ham,Liverpool,Loss,Home,2009-09-19,0,1,1,4,7,6,6,9,9,-5,-5,-5,-2,1,9.0,2.0,7.0,2
18299,18299,2009-10,2009,2010,West Ham,Man City,Loss,Away,2009-09-28,0,0,1,1,4,3,6,9,12,-3,-5,-8,-8,0,9.0,10.0,-1.0,2
18300,18300,2009-10,2009,2010,West Ham,Fulham,Draw,Home,2009-10-04,1,0,0,1,1,0,3,3,3,0,-3,-2,-2,1,9.0,7.0,2.0,3
18301,18301,2009-10,2009,2010,West Ham,Stoke,Loss,Away,2009-10-17,0,1,1,1,2,1,2,2,5,0,-1,-1,-3,0,9.0,12.0,-3.0,3
18302,18302,2009-10,2009,2010,West Ham,Arsenal,Draw,Home,2009-10-25,1,1,1,1,1,6,9,12,12,-5,-8,-11,-11,1,9.0,4.0,5.0,3
18303,18303,2009-10,2009,2010,West Ham,Sunderland,Draw,Away,2009-10-31,1,1,2,2,2,3,4,7,7,-2,-2,-5,-5,0,9.0,16.0,-7.0,3
18304,18304,2009-10,2009,2010,West Ham,Aston Villa,Win,Home,2009-11-04,3,2,2,3,3,2,5,6,6,0,-3,-3,-3,1,9.0,6.0,3.0,4
18305,18305,2009-10,2009,2010,West Ham,Everton,Loss,Home,2009-11-08,0,4,5,5,6,1,2,3,6,3,3,2,0,1,9.0,5.0,4.0,4
18306,18306,2009-10,2009,2010,West Ham,Hull,Draw,Away,2009-11-21,1,3,4,5,5,3,4,4,7,0,0,1,-2,0,9.0,17.0,-8.0,4
18307,18307,2009-10,2009,2010,West Ham,Burnley,Win,Home,2009-11-28,3,1,4,5,6,2,5,5,5,-1,-1,0,1,1,9.0,21.0,-12.0,4
18308,18308,2009-10,2009,2010,West Ham,Man United,Loss,Home,2009-12-05,0,4,4,7,8,6,6,9,9,-2,-2,-2,-1,1,9.0,1.0,8.0,5
18309,18309,2009-10,2009,2010,West Ham,Birmingham,Loss,Away,2009-12-12,0,3,4,4,7,6,9,10,11,-3,-5,-6,-4,0,9.0,21.0,-12.0,5
18310,18310,2009-10,2009,2010,West Ham,Bolton,Loss,Away,2009-12-15,0,0,3,4,4,1,2,2,2,-1,1,2,2,0,9.0,13.0,-4.0,5
18311,18311,2009-10,2009,2010,West Ham,Chelsea,Draw,Home,2009-12-20,1,0,0,3,4,4,4,7,10,-4,-4,-4,-6,1,9.0,3.0,6.0,5
18312,18312,2009-10,2009,2010,West Ham,Portsmouth,Win,Home,2009-12-26,3,1,1,1,4,3,4,7,7,-2,-3,-6,-3,1,9.0,14.0,-5.0,5
18313,18313,2009-10,2009,2010,West Ham,Tottenham,Loss,Away,2009-12-28,0,4,4,4,4,4,7,7,8,0,-3,-3,-4,0,9.0,8.0,1.0,5
18314,18314,2009-10,2009,2010,West Ham,Aston Villa,Draw,Away,2010-01-17,1,3,4,4,4,0,3,6,9,3,1,-2,-5,0,9.0,6.0,3.0,6
18315,18315,2009-10,2009,2010,West Ham,Portsmouth,Draw,Away,2010-01-26,1,1,4,5,5,0,3,3,4,1,1,2,1,0,9.0,14.0,-5.0,6
18316,18316,2009-10,2009,2010,West Ham,Blackburn,Draw,Home,2010-01-30,1,2,2,5,6,6,6,7,8,-4,-4,-2,-2,1,9.0,15.0,-6.0,6
18317,18317,2009-10,2009,2010,West Ham,Burnley,Loss,Away,2010-02-06,0,2,3,3,6,0,0,0,1,2,3,3,5,0,9.0,21.0,-12.0,7
18318,18318,2009-10,2009,2010,West Ham,Birmingham,Win,Home,2010-02-10,3,1,2,3,3,4,4,5,8,-3,-2,-2,-5,1,9.0,21.0,-12.0,7
18319,18319,2009-10,2009,2010,West Ham,Hull,Win,Home,2010-02-20,3,3,4,5,6,3,4,5,5,0,0,0,1,1,9.0,17.0,-8.0,7
18320,18320,2009-10,2009,2010,West Ham,Man United,Loss,Away,2010-02-23,0,6,6,7,8,1,4,7,10,5,2,0,-2,0,9.0,1.0,8.0,7
18321,18321,2009-10,2009,2010,West Ham,Bolton,Loss,Home,2010-03-06,0,3,6,6,7,3,4,4,5,0,2,2,2,1,9.0,13.0,-4.0,8
18322,18322,2009-10,2009,2010,West Ham,Chelsea,Loss,Away,2010-03-13,0,0,3,6,6,3,3,6,7,-3,0,0,-1,0,9.0,3.0,6.0,8
18323,18323,2009-10,2009,2010,West Ham,Arsenal,Loss,Away,2010-03-20,0,0,0,3,6,6,9,12,15,-6,-9,-9,-9,0,9.0,4.0,5.0,8
18324,18324,2009-10,2009,2010,West Ham,Wolves,Loss,Home,2010-03-23,0,0,0,0,3,4,4,4,4,-4,-4,-4,-1,1,9.0,21.0,-12.0,8
18325,18325,2009-10,2009,2010,West Ham,Stoke,Loss,Home,2010-03-27,0,0,0,0,0,1,2,2,5,-1,-2,-2,-5,1,9.0,12.0,-3.0,8
18326,18326,2009-10,2009,2010,West Ham,Everton,Draw,Away,2010-04-04,1,0,0,0,0,4,7,8,11,-4,-7,-8,-11,0,9.0,5.0,4.0,9
18327,18327,2009-10,2009,2010,West Ham,Sunderland,Win,Home,2010-04-10,3,1,1,1,1,3,4,7,8,-2,-3,-6,-7,1,9.0,16.0,-7.0,9
18328,18328,2009-10,2009,2010,West Ham,Liverpool,Loss,Away,2010-04-19,0,4,4,4,4,2,5,5,8,2,-1,-1,-4,0,9.0,2.0,7.0,9
18329,18329,2009-10,2009,2010,West Ham,Wigan,Win,Home,2010-04-24,3,3,4,4,4,4,4,4,7,-1,0,0,-3,1,9.0,11.0,-2.0,9
18330,18330,2009-10,2009,2010,West Ham,Fulham,Loss,Away,2010-05-02,0,3,6,7,7,1,2,5,5,2,4,2,2,0,9.0,7.0,2.0,10
18331,18331,2009-10,2009,2010,West Ham,Man City,Draw,Home,2010-05-09,1,3,3,6,7,3,4,4,7,0,-1,2,0,1,9.0,10.0,-1.0,10
18332,18332,2010-11,2010,2011,West Ham,Aston Villa,Loss,Away,2010-08-14,0,1,4,4,7,0,3,6,9,1,1,-2,-2,0,17.0,6.0,11.0,1
18333,18333,2010-11,2010,2011,West Ham,Bolton,Loss,Home,2010-08-21,0,1,1,4,4,4,4,5,8,-3,-3,-1,-4,1,17.0,14.0,3.0,1
18334,18334,2010-11,2010,2011,West Ham,Man United,Loss,Away,2010-08-28,0,0,1,1,4,4,7,10,13,-4,-6,-9,-9,0,17.0,2.0,15.0,1
18335,18335,2010-11,2010,2011,West Ham,Chelsea,Loss,Home,2010-09-11,0,0,0,1,1,6,9,12,15,-6,-9,-11,-14,1,17.0,1.0,16.0,2
18336,18336,2010-11,2010,2011,West Ham,Stoke,Draw,Away,2010-09-18,1,0,0,0,1,3,3,3,3,-3,-3,-3,-2,0,17.0,11.0,6.0,2
18337,18337,2010-11,2010,2011,West Ham,Tottenham,Win,Home,2010-09-25,3,1,1,1,1,4,4,7,8,-3,-3,-6,-7,1,17.0,4.0,13.0,2
18338,18338,2010-11,2010,2011,West Ham,Fulham,Draw,Home,2010-10-02,1,4,4,4,4,2,5,6,7,2,-1,-2,-3,1,17.0,12.0,5.0,3
18339,18339,2010-11,2010,2011,West Ham,Wolves,Draw,Away,2010-10-16,1,4,5,5,5,0,0,0,1,4,5,5,4,0,17.0,15.0,2.0,3
18340,18340,2010-11,2010,2011,West Ham,Newcastle,Loss,Home,2010-10-23,0,2,5,6,6,1,1,4,4,1,4,2,2,1,17.0,21.0,-4.0,3
18341,18341,2010-11,2010,2011,West Ham,Arsenal,Loss,Away,2010-10-30,0,1,2,5,6,6,6,6,7,-5,-4,-1,-1,0,17.0,3.0,14.0,3
18342,18342,2010-11,2010,2011,West Ham,Birmingham,Draw,Away,2010-11-06,1,0,1,2,5,4,4,4,5,-4,-3,-2,0,0,17.0,9.0,8.0,4
18343,18343,2010-11,2010,2011,West Ham,West Brom,Draw,Home,2010-11-10,1,1,1,2,3,0,3,4,5,1,-2,-2,-2,1,17.0,21.0,-4.0,4
18344,18344,2010-11,2010,2011,West Ham,Blackpool,Draw,Home,2010-11-13,1,2,2,2,3,1,4,4,4,1,-2,-2,-1,1,17.0,21.0,-4.0,4
18345,18345,2010-11,2010,2011,West Ham,Liverpool,Loss,Away,2010-11-20,0,2,3,3,3,1,4,7,10,1,-1,-4,-7,0,17.0,7.0,10.0,4
18346,18346,2010-11,2010,2011,West Ham,Wigan,Win,Home,2010-11-27,3,1,2,3,3,3,4,4,4,-2,-2,-1,-1,1,17.0,16.0,1.0,4
18347,18347,2010-11,2010,2011,West Ham,Sunderland,Loss,Away,2010-12-05,0,3,4,5,6,1,4,5,8,2,0,0,-2,0,17.0,13.0,4.0,5
18348,18348,2010-11,2010,2011,West Ham,Man City,Loss,Home,2010-12-11,0,3,3,4,5,4,7,8,9,-1,-4,-4,-4,1,17.0,5.0,12.0,5
18349,18349,2010-11,2010,2011,West Ham,Blackburn,Draw,Away,2010-12-18,1,0,3,3,4,3,3,6,6,-3,0,-3,-2,0,17.0,10.0,7.0,5
18350,18350,2010-11,2010,2011,West Ham,Fulham,Win,Away,2010-12-26,3,1,1,4,4,1,2,2,3,0,-1,2,1,0,17.0,12.0,5.0,5
18351,18351,2010-11,2010,2011,West Ham,Everton,Draw,Home,2010-12-28,1,4,4,4,7,4,5,5,6,0,-1,-1,1,1,17.0,8.0,9.0,5
18352,18352,2010-11,2010,2011,West Ham,Wolves,Win,Home,2011-01-01,3,4,5,5,5,3,6,6,9,1,-1,-1,-4,1,17.0,15.0,2.0,6
18353,18353,2010-11,2010,2011,West Ham,Newcastle,Loss,Away,2011-01-05,0,4,7,8,8,3,3,6,6,1,4,2,2,0,17.0,21.0,-4.0,6
18354,18354,2010-11,2010,2011,West Ham,Arsenal,Loss,Home,2011-01-15,0,3,4,7,8,4,5,8,8,-1,-1,-1,0,1,17.0,3.0,14.0,6
18355,18355,2010-11,2010,2011,West Ham,Everton,Draw,Away,2011-01-22,1,0,3,4,7,4,4,5,8,-4,-1,-1,-1,0,17.0,8.0,9.0,6
18356,18356,2010-11,2010,2011,West Ham,Blackpool,Win,Away,2011-02-02,3,1,1,4,5,0,0,3,3,1,1,1,2,0,17.0,21.0,-4.0,7
18357,18357,2010-11,2010,2011,West Ham,Birmingham,Loss,Home,2011-02-06,0,4,4,4,7,1,2,5,5,3,2,-1,2,1,17.0,9.0,8.0,7
18358,18358,2010-11,2010,2011,West Ham,West Brom,Draw,Away,2011-02-12,1,3,4,4,4,1,1,4,4,2,3,0,0,0,17.0,21.0,-4.0,7
18359,18359,2010-11,2010,2011,West Ham,Liverpool,Win,Home,2011-02-27,3,1,4,5,5,4,7,10,13,-3,-3,-5,-8,1,17.0,7.0,10.0,7
18360,18360,2010-11,2010,2011,West Ham,Stoke,Win,Home,2011-03-05,3,4,4,7,8,1,1,4,4,3,3,3,4,1,17.0,11.0,6.0,8
18361,18361,2010-11,2010,2011,West Ham,Tottenham,Draw,Away,2011-03-19,1,6,7,7,10,1,4,7,10,5,3,0,0,0,17.0,4.0,13.0,8
18362,18362,2010-11,2010,2011,West Ham,Man United,Loss,Home,2011-04-02,0,4,7,8,8,3,3,6,9,1,4,2,-1,1,17.0,2.0,15.0,9
18363,18363,2010-11,2010,2011,West Ham,Bolton,Loss,Away,2011-04-09,0,1,4,7,8,0,3,4,7,1,1,3,1,0,17.0,14.0,3.0,9
18364,18364,2010-11,2010,2011,West Ham,Aston Villa,Loss,Home,2011-04-16,0,0,1,4,7,4,4,4,7,-4,-3,0,0,1,17.0,6.0,11.0,9
18365,18365,2010-11,2010,2011,West Ham,Chelsea,Loss,Away,2011-04-23,0,0,0,1,4,6,9,10,13,-6,-9,-9,-9,0,17.0,1.0,16.0,9
18366,18366,2010-11,2010,2011,West Ham,Man City,Loss,Away,2011-05-01,0,0,0,0,1,3,6,6,9,-3,-6,-6,-8,0,17.0,5.0,12.0,10
18367,18367,2010-11,2010,2011,West Ham,Blackburn,Draw,Home,2011-05-07,1,0,0,0,0,3,3,4,5,-3,-3,-4,-5,1,17.0,10.0,7.0,10
18368,18368,2010-11,2010,2011,West Ham,Wigan,Loss,Away,2011-05-15,0,1,1,1,1,2,2,5,5,-1,-1,-4,-4,0,17.0,16.0,1.0,10
18369,18369,2010-11,2010,2011,West Ham,Sunderland,Loss,Home,2011-05-22,0,1,1,1,1,3,3,6,6,-2,-2,-5,-5,1,17.0,13.0,4.0,10
18370,18370,2012-13,2012,2013,West Ham,Aston Villa,Win,Home,2012-08-18,3,0,1,1,1,1,2,2,3,-1,-1,-1,-2,1,21.0,16.0,5.0,1
18371,18371,2012-13,2012,2013,West Ham,Swansea,Loss,Away,2012-08-25,0,3,3,4,4,6,6,7,8,-3,-3,-3,-4,0,21.0,11.0,10.0,1
18372,18372,2012-13,2012,2013,West Ham,Fulham,Win,Home,2012-09-01,3,3,3,3,4,3,3,6,9,0,0,-3,-5,1,21.0,9.0,12.0,2
18373,18373,2012-13,2012,2013,West Ham,Norwich,Draw,Away,2012-09-15,1,3,6,6,6,2,2,5,6,1,4,1,0,0,21.0,12.0,9.0,2
18374,18374,2012-13,2012,2013,West Ham,Sunderland,Draw,Home,2012-09-22,1,4,4,7,7,2,3,3,3,2,1,4,4,1,21.0,13.0,8.0,2
18375,18375,2012-13,2012,2013,West Ham,QPR,Win,Away,2012-10-01,3,2,5,5,8,1,1,2,2,1,4,3,6,0,21.0,17.0,4.0,3
18376,18376,2012-13,2012,2013,West Ham,Arsenal,Loss,Home,2012-10-06,0,4,5,8,8,1,4,7,8,3,1,1,0,1,21.0,3.0,18.0,3
18377,18377,2012-13,2012,2013,West Ham,Southampton,Win,Home,2012-10-20,3,3,4,5,8,1,4,4,4,2,0,1,4,1,21.0,21.0,0.0,3
18378,18378,2012-13,2012,2013,West Ham,Wigan,Loss,Away,2012-10-27,0,3,6,7,8,1,1,1,1,2,5,6,7,0,21.0,15.0,6.0,3
18379,18379,2012-13,2012,2013,West Ham,Man City,Draw,Home,2012-11-03,1,3,3,6,7,6,9,12,13,-3,-6,-6,-6,1,21.0,1.0,20.0,4
18380,18380,2012-13,2012,2013,West Ham,Newcastle,Win,Away,2012-11-11,3,1,4,4,7,4,5,5,6,-3,-1,-1,1,0,21.0,5.0,16.0,4
18381,18381,2012-13,2012,2013,West Ham,Stoke,Draw,Home,2012-11-19,1,4,4,7,7,3,4,4,5,1,0,3,2,1,21.0,14.0,7.0,4
18382,18382,2012-13,2012,2013,West Ham,Tottenham,Loss,Away,2012-11-25,0,4,5,5,8,0,0,3,3,4,5,2,5,0,21.0,4.0,17.0,4
18383,18383,2012-13,2012,2013,West Ham,Man United,Loss,Away,2012-11-28,0,1,4,5,5,3,6,9,12,-2,-2,-4,-7,0,21.0,2.0,19.0,4
18384,18384,2012-13,2012,2013,West Ham,Chelsea,Win,Home,2012-12-01,3,0,1,4,5,2,2,3,4,-2,-1,1,1,1,21.0,6.0,15.0,5
18385,18385,2012-13,2012,2013,West Ham,Liverpool,Loss,Home,2012-12-09,0,3,3,4,7,3,4,7,8,0,-1,-3,-1,1,21.0,8.0,13.0,5
18386,18386,2012-13,2012,2013,West Ham,West Brom,Draw,Away,2012-12-16,1,3,3,3,4,0,0,3,6,3,3,0,-2,0,21.0,10.0,11.0,5
18387,18387,2012-13,2012,2013,West Ham,Everton,Loss,Home,2012-12-22,0,1,4,4,4,4,5,6,7,-3,-1,-2,-3,1,21.0,7.0,14.0,5
18388,18388,2012-13,2012,2013,West Ham,Reading,Loss,Away,2012-12-29,0,1,1,4,4,1,1,1,1,0,0,3,3,0,21.0,21.0,0.0,5
18389,18389,2012-13,2012,2013,West Ham,Norwich,Win,Home,2013-01-01,3,0,1,1,4,0,0,3,6,0,1,-2,-2,1,21.0,12.0,9.0,6
18390,18390,2012-13,2012,2013,West Ham,Sunderland,Loss,Away,2013-01-12,0,3,3,4,4,0,3,6,6,3,0,-2,-2,0,21.0,13.0,8.0,6
18391,18391,2012-13,2012,2013,West Ham,QPR,Draw,Home,2013-01-19,1,3,3,3,4,4,4,4,4,-1,-1,-1,0,1,21.0,17.0,4.0,6
18392,18392,2012-13,2012,2013,West Ham,Arsenal,Loss,Away,2013-01-23,0,1,4,4,4,0,1,4,7,1,3,0,-3,0,21.0,3.0,18.0,6
18393,18393,2012-13,2012,2013,West Ham,Fulham,Loss,Away,2013-01-30,0,1,1,4,4,1,4,4,5,0,-3,0,-1,0,21.0,9.0,12.0,6
18394,18394,2012-13,2012,2013,West Ham,Swansea,Win,Home,2013-02-02,3,0,1,1,4,4,5,6,9,-4,-4,-5,-5,1,21.0,11.0,10.0,7
18395,18395,2012-13,2012,2013,West Ham,Aston Villa,Loss,Away,2013-02-10,0,3,3,4,4,1,2,2,3,2,1,2,1,0,21.0,16.0,5.0,7
18396,18396,2012-13,2012,2013,West Ham,Tottenham,Loss,Home,2013-02-25,0,3,3,3,4,6,7,8,9,-3,-4,-5,-5,1,21.0,4.0,17.0,7
18397,18397,2012-13,2012,2013,West Ham,Stoke,Win,Away,2013-03-02,3,0,3,3,3,3,3,4,4,-3,0,-1,-1,0,21.0,14.0,7.0,8
18398,18398,2012-13,2012,2013,West Ham,Chelsea,Loss,Away,2013-03-17,0,3,3,6,6,3,6,6,7,0,-3,0,-1,0,21.0,6.0,15.0,8
18399,18399,2012-13,2012,2013,West Ham,West Brom,Win,Home,2013-03-30,3,3,3,3,6,4,4,7,10,-1,-1,-4,-4,1,21.0,10.0,11.0,8
18400,18400,2012-13,2012,2013,West Ham,Liverpool,Draw,Away,2013-04-07,1,3,6,6,6,3,6,9,12,0,0,-3,-6,0,21.0,8.0,13.0,9
18401,18401,2012-13,2012,2013,West Ham,Southampton,Draw,Away,2013-04-13,1,4,4,7,7,6,9,10,10,-2,-5,-3,-3,0,21.0,21.0,0.0,9
18402,18402,2012-13,2012,2013,West Ham,Man United,Draw,Home,2013-04-17,1,2,5,5,8,3,6,9,12,-1,-1,-4,-4,1,21.0,2.0,19.0,9
18403,18403,2012-13,2012,2013,West Ham,Wigan,Win,Home,2013-04-20,3,2,3,6,6,1,4,7,7,1,-1,-1,-1,1,21.0,15.0,6.0,9
18404,18404,2012-13,2012,2013,West Ham,Man City,Loss,Away,2013-04-27,0,4,5,6,9,3,6,9,9,1,-1,-3,0,0,21.0,1.0,20.0,9
18405,18405,2012-13,2012,2013,West Ham,Newcastle,Draw,Home,2013-05-04,1,3,4,5,6,1,1,4,4,2,3,1,2,1,21.0,5.0,16.0,10
18406,18406,2012-13,2012,2013,West Ham,Everton,Loss,Away,2013-05-12,0,1,4,5,6,4,4,5,8,-3,0,0,-2,0,21.0,7.0,14.0,10
18407,18407,2012-13,2012,2013,West Ham,Reading,Win,Home,2013-05-19,3,1,1,4,5,3,4,4,5,-2,-3,0,0,1,21.0,21.0,0.0,10
18408,18408,2013-14,2013,2014,West Ham,Cardiff,Win,Home,2013-08-17,3,3,4,4,7,0,0,0,0,3,4,4,7,1,10.0,21.0,-11.0,1
18409,18409,2013-14,2013,2014,West Ham,Newcastle,Draw,Away,2013-08-24,1,6,6,7,7,0,3,4,4,6,3,3,3,0,10.0,16.0,-6.0,1
18410,18410,2013-14,2013,2014,West Ham,Stoke,Loss,Home,2013-08-31,0,4,7,7,8,3,4,4,5,1,3,3,3,1,10.0,13.0,-3.0,1
18411,18411,2013-14,2013,2014,West Ham,Southampton,Draw,Away,2013-09-15,1,1,4,7,7,1,4,5,6,0,0,2,1,0,10.0,14.0,-4.0,2
18412,18412,2013-14,2013,2014,West Ham,Everton,Loss,Home,2013-09-21,0,1,2,5,8,4,5,6,6,-3,-3,-1,2,1,10.0,6.0,4.0,2
18413,18413,2013-14,2013,2014,West Ham,Hull,Loss,Away,2013-09-28,0,1,1,2,5,4,4,7,7,-3,-3,-5,-2,0,10.0,21.0,-11.0,2
18414,18414,2013-14,2013,2014,West Ham,Tottenham,Win,Away,2013-10-06,3,0,1,1,2,4,7,7,10,-4,-6,-6,-8,0,10.0,5.0,5.0,3
18415,18415,2013-14,2013,2014,West Ham,Man City,Loss,Home,2013-10-19,0,3,3,4,4,3,6,7,10,0,-3,-3,-6,1,10.0,2.0,8.0,3
18416,18416,2013-14,2013,2014,West Ham,Swansea,Draw,Away,2013-10-27,1,3,3,3,4,3,3,6,7,0,0,-3,-3,0,10.0,9.0,1.0,3
18417,18417,2013-14,2013,2014,West Ham,Aston Villa,Draw,Home,2013-11-02,1,1,4,4,4,0,1,4,7,1,3,0,-3,1,10.0,15.0,-5.0,4
18418,18418,2013-14,2013,2014,West Ham,Norwich,Loss,Away,2013-11-09,0,2,2,5,5,1,1,1,4,1,1,4,1,0,10.0,11.0,-1.0,4
18419,18419,2013-14,2013,2014,West Ham,Chelsea,Loss,Home,2013-11-23,0,1,2,2,5,1,4,7,10,0,-2,-5,-5,1,10.0,3.0,7.0,4
18420,18420,2013-14,2013,2014,West Ham,Fulham,Win,Home,2013-11-30,3,0,1,2,2,0,0,0,3,0,1,2,-1,1,10.0,12.0,-2.0,4
18421,18421,2013-14,2013,2014,West Ham,Crystal Palace,Loss,Away,2013-12-03,0,3,3,4,5,3,4,4,4,0,-1,0,1,0,10.0,21.0,-11.0,5
18422,18422,2013-14,2013,2014,West Ham,Liverpool,Loss,Away,2013-12-07,0,3,3,3,4,3,4,7,7,0,-1,-4,-3,0,10.0,7.0,3.0,5
18423,18423,2013-14,2013,2014,West Ham,Sunderland,Draw,Home,2013-12-14,1,0,3,3,3,0,1,1,4,0,2,2,-1,1,10.0,17.0,-7.0,5
18424,18424,2013-14,2013,2014,West Ham,Man United,Loss,Away,2013-12-21,0,1,1,4,4,3,3,4,5,-2,-2,0,-1,0,10.0,1.0,9.0,5
18425,18425,2013-14,2013,2014,West Ham,Arsenal,Loss,Home,2013-12-26,0,1,1,1,4,1,2,5,8,0,-1,-4,-4,1,10.0,4.0,6.0,5
18426,18426,2013-14,2013,2014,West Ham,West Brom,Draw,Home,2013-12-28,1,0,1,1,1,2,2,2,2,-2,-1,-1,-1,1,10.0,8.0,2.0,5
18427,18427,2013-14,2013,2014,West Ham,Fulham,Loss,Away,2014-01-01,0,1,1,2,2,3,3,3,6,-2,-2,-1,-4,0,10.0,12.0,-2.0,6
18428,18428,2013-14,2013,2014,West Ham,Cardiff,Win,Away,2014-01-11,3,1,1,1,2,1,1,1,4,0,0,0,-2,0,10.0,21.0,-11.0,6
18429,18429,2013-14,2013,2014,West Ham,Newcastle,Loss,Home,2014-01-18,0,3,4,4,4,0,0,3,6,3,4,1,-2,1,10.0,16.0,-6.0,6
18430,18430,2013-14,2013,2014,West Ham,Chelsea,Draw,Away,2014-01-29,1,3,3,4,4,6,9,12,15,-3,-6,-8,-11,0,10.0,3.0,7.0,6
18431,18431,2013-14,2013,2014,West Ham,Swansea,Win,Home,2014-02-01,3,1,4,4,5,3,3,3,4,-2,1,1,1,1,10.0,9.0,1.0,7
18432,18432,2013-14,2013,2014,West Ham,Aston Villa,Win,Away,2014-02-08,3,4,4,7,7,3,4,4,7,1,0,3,0,0,10.0,15.0,-5.0,7
18433,18433,2013-14,2013,2014,West Ham,Norwich,Win,Home,2014-02-11,3,6,7,7,10,1,2,5,5,5,5,2,5,1,10.0,11.0,-1.0,7
18434,18434,2013-14,2013,2014,West Ham,Southampton,Win,Home,2014-02-22,3,6,9,10,10,4,7,8,9,2,2,2,1,1,10.0,14.0,-4.0,7
18435,18435,2013-14,2013,2014,West Ham,Everton,Loss,Away,2014-03-01,0,6,9,12,13,0,3,3,4,6,6,9,9,0,10.0,6.0,4.0,8
18436,18436,2013-14,2013,2014,West Ham,Stoke,Loss,Away,2014-03-15,0,3,6,9,12,4,4,5,6,-1,2,4,6,0,10.0,13.0,-3.0,8
18437,18437,2013-14,2013,2014,West Ham,Man United,Loss,Home,2014-03-22,0,0,3,6,9,3,6,7,8,-3,-3,-1,1,1,10.0,1.0,9.0,8
18438,18438,2013-14,2013,2014,West Ham,Hull,Win,Home,2014-03-26,3,0,0,3,6,3,3,6,6,-3,-3,-3,0,1,10.0,21.0,-11.0,8
18439,18439,2013-14,2013,2014,West Ham,Sunderland,Win,Away,2014-03-31,3,3,3,3,6,0,1,1,1,3,2,2,5,0,10.0,17.0,-7.0,8
18440,18440,2013-14,2013,2014,West Ham,Liverpool,Loss,Home,2014-04-06,0,6,6,6,6,6,9,12,15,0,-3,-6,-9,1,10.0,7.0,3.0,9
18441,18441,2013-14,2013,2014,West Ham,Arsenal,Loss,Away,2014-04-15,0,3,6,6,6,1,2,2,5,2,4,4,1,0,10.0,4.0,6.0,9
18442,18442,2013-14,2013,2014,West Ham,Crystal Palace,Loss,Home,2014-04-19,0,0,3,6,6,6,9,12,12,-6,-6,-6,-6,1,10.0,21.0,-11.0,9
18443,18443,2013-14,2013,2014,West Ham,West Brom,Loss,Away,2014-04-26,0,0,0,3,6,1,4,5,5,-1,-4,-2,1,0,10.0,8.0,2.0,9
18444,18444,2013-14,2013,2014,West Ham,Tottenham,Win,Home,2014-05-03,3,0,0,0,3,6,7,10,10,-6,-7,-10,-7,1,10.0,5.0,5.0,10
18445,18445,2013-14,2013,2014,West Ham,Man City,Loss,Away,2014-05-11,0,3,3,3,3,6,9,12,13,-3,-6,-9,-10,0,10.0,2.0,8.0,10
18446,18446,2014-15,2014,2015,West Ham,Tottenham,Loss,Home,2014-08-16,0,3,3,3,3,3,6,9,10,0,-3,-6,-7,1,13.0,6.0,7.0,1
18447,18447,2014-15,2014,2015,West Ham,Crystal Palace,Win,Away,2014-08-23,3,0,3,3,3,1,2,2,5,-1,1,1,-2,0,13.0,11.0,2.0,1
18448,18448,2014-15,2014,2015,West Ham,Southampton,Loss,Home,2014-08-30,0,3,3,6,6,1,2,5,8,2,1,1,-2,1,13.0,8.0,5.0,1
18449,18449,2014-15,2014,2015,West Ham,Hull,Draw,Away,2014-09-15,1,3,3,3,6,1,4,4,4,2,-1,-1,2,0,13.0,16.0,-3.0,2
18450,18450,2014-15,2014,2015,West Ham,Liverpool,Win,Home,2014-09-20,3,1,4,4,4,3,3,6,9,-2,1,-2,-5,1,13.0,2.0,11.0,2
18451,18451,2014-15,2014,2015,West Ham,Man United,Loss,Away,2014-09-27,0,4,4,7,7,3,4,5,5,1,0,2,2,0,13.0,7.0,6.0,2
18452,18452,2014-15,2014,2015,West Ham,QPR,Win,Home,2014-10-05,3,3,4,4,7,1,1,4,4,2,3,0,3,1,13.0,21.0,-8.0,3
18453,18453,2014-15,2014,2015,West Ham,Burnley,Win,Away,2014-10-18,3,3,6,7,7,1,2,3,4,2,4,4,3,0,13.0,21.0,-8.0,3
18454,18454,2014-15,2014,2015,West Ham,Man City,Win,Home,2014-10-25,3,6,6,9,10,6,9,10,11,0,-3,-1,-1,1,13.0,1.0,12.0,3
18455,18455,2014-15,2014,2015,West Ham,Stoke,Draw,Away,2014-11-01,1,6,9,9,12,3,3,6,7,3,6,3,5,0,13.0,9.0,4.0,4
18456,18456,2014-15,2014,2015,West Ham,Aston Villa,Draw,Home,2014-11-08,1,4,7,10,10,0,0,0,0,4,7,10,10,1,13.0,15.0,-2.0,4
18457,18457,2014-15,2014,2015,West Ham,Everton,Loss,Away,2014-11-22,0,2,5,8,11,2,5,8,8,0,0,0,3,0,13.0,5.0,8.0,4
18458,18458,2014-15,2014,2015,West Ham,Newcastle,Win,Home,2014-11-29,3,1,2,5,8,6,9,12,15,-5,-7,-7,-7,1,13.0,10.0,3.0,4
18459,18459,2014-15,2014,2015,West Ham,West Brom,Win,Away,2014-12-02,3,3,4,5,8,0,0,3,4,3,4,2,4,0,13.0,17.0,-4.0,5
18460,18460,2014-15,2014,2015,West Ham,Swansea,Win,Home,2014-12-07,3,6,6,7,8,4,4,7,8,2,2,0,0,1,13.0,12.0,1.0,5
18461,18461,2014-15,2014,2015,West Ham,Sunderland,Draw,Away,2014-12-13,1,6,9,9,10,1,2,3,4,5,7,6,6,0,13.0,14.0,-1.0,5
18462,18462,2014-15,2014,2015,West Ham,Leicester,Win,Home,2014-12-20,3,4,7,10,10,0,0,0,1,4,7,10,9,1,13.0,21.0,-8.0,5
18463,18463,2014-15,2014,2015,West Ham,Chelsea,Loss,Away,2014-12-26,0,4,7,10,13,6,6,9,10,-2,1,1,3,0,13.0,3.0,10.0,5
18464,18464,2014-15,2014,2015,West Ham,Arsenal,Loss,Home,2014-12-28,0,3,4,7,10,4,7,7,10,-1,-3,0,0,1,13.0,4.0,9.0,5
18465,18465,2014-15,2014,2015,West Ham,West Brom,Draw,Home,2015-01-01,1,0,3,4,7,0,0,3,4,0,3,1,3,1,13.0,17.0,-4.0,6
18466,18466,2014-15,2014,2015,West Ham,Swansea,Draw,Away,2015-01-10,1,1,1,4,5,1,4,7,7,0,-3,-3,-2,0,13.0,12.0,1.0,6
18467,18467,2014-15,2014,2015,West Ham,Hull,Win,Home,2015-01-18,3,2,2,2,5,3,3,6,6,-1,-1,-4,-1,1,13.0,16.0,-3.0,6
18468,18468,2014-15,2014,2015,West Ham,Liverpool,Loss,Away,2015-01-31,0,4,5,5,5,6,7,10,13,-2,-2,-5,-8,0,13.0,2.0,11.0,6
18469,18469,2014-15,2014,2015,West Ham,Man United,Draw,Home,2015-02-08,1,3,4,5,5,6,6,7,8,-3,-2,-2,-3,1,13.0,7.0,6.0,7
18470,18470,2014-15,2014,2015,West Ham,Southampton,Draw,Away,2015-02-11,1,1,4,5,6,3,6,9,12,-2,-2,-4,-6,0,13.0,8.0,5.0,7
18471,18471,2014-15,2014,2015,West Ham,Tottenham,Draw,Away,2015-02-22,1,2,2,5,6,3,6,9,9,-1,-4,-4,-3,0,13.0,6.0,7.0,7
18472,18472,2014-15,2014,2015,West Ham,Crystal Palace,Loss,Home,2015-02-28,0,2,3,3,6,1,4,4,7,1,-1,-1,-1,1,13.0,11.0,2.0,7
18473,18473,2014-15,2014,2015,West Ham,Chelsea,Loss,Home,2015-03-04,0,1,2,3,3,4,7,8,11,-3,-5,-5,-8,1,13.0,3.0,10.0,8
18474,18474,2014-15,2014,2015,West Ham,Arsenal,Loss,Away,2015-03-14,0,0,1,2,3,6,9,12,12,-6,-8,-10,-9,0,13.0,4.0,9.0,8
18475,18475,2014-15,2014,2015,West Ham,Sunderland,Win,Home,2015-03-21,3,0,0,1,2,1,1,2,2,-1,-1,-1,0,1,13.0,14.0,-1.0,8
18476,18476,2014-15,2014,2015,West Ham,Leicester,Loss,Away,2015-04-04,0,3,3,3,4,1,1,2,2,2,2,1,2,0,13.0,21.0,-8.0,9
18477,18477,2014-15,2014,2015,West Ham,Stoke,Draw,Home,2015-04-11,1,3,3,3,3,0,0,3,6,3,3,0,-3,1,13.0,9.0,4.0,9
18478,18478,2014-15,2014,2015,West Ham,Man City,Loss,Away,2015-04-19,0,1,4,4,4,0,3,3,6,1,1,1,-2,0,13.0,1.0,12.0,9
18479,18479,2014-15,2014,2015,West Ham,QPR,Draw,Away,2015-04-25,1,1,1,4,4,1,4,4,4,0,-3,0,0,0,13.0,21.0,-8.0,9
18480,18480,2014-15,2014,2015,West Ham,Burnley,Win,Home,2015-05-02,3,1,2,2,5,0,0,1,1,1,2,1,4,1,13.0,21.0,-8.0,10
18481,18481,2014-15,2014,2015,West Ham,Aston Villa,Loss,Away,2015-05-09,0,4,4,5,5,3,6,7,7,1,-2,-2,-2,0,13.0,15.0,-2.0,10
18482,18482,2014-15,2014,2015,West Ham,Everton,Loss,Home,2015-05-16,0,3,4,4,5,0,3,6,7,3,1,-2,-2,1,13.0,5.0,8.0,10
18483,18483,2014-15,2014,2015,West Ham,Newcastle,Loss,Away,2015-05-24,0,0,3,4,4,1,1,1,1,-1,2,3,3,0,13.0,10.0,3.0,10
18484,18484,2015-16,2015,2016,West Ham,Arsenal,Win,Away,2015-08-09,3,0,0,3,4,4,5,5,8,-4,-5,-2,-4,0,12.0,3.0,9.0,1
18485,18485,2015-16,2015,2016,West Ham,Leicester,Loss,Home,2015-08-15,0,3,3,3,6,6,7,10,13,-3,-4,-7,-7,1,12.0,14.0,-2.0,1
18486,18486,2015-16,2015,2016,West Ham,Bournemouth,Loss,Home,2015-08-22,0,3,3,3,3,0,0,0,0,3,3,3,3,1,12.0,21.0,-9.0,1
18487,18487,2015-16,2015,2016,West Ham,Liverpool,Win,Away,2015-08-29,3,0,3,3,3,4,7,7,7,-4,-4,-4,-4,0,12.0,6.0,6.0,1
18488,18488,2015-16,2015,2016,West Ham,Newcastle,Win,Home,2015-09-14,3,3,3,6,6,1,1,2,5,2,2,4,1,1,12.0,15.0,-3.0,2
18489,18489,2015-16,2015,2016,West Ham,Man City,Win,Away,2015-09-19,3,6,6,6,9,6,9,12,15,0,-3,-6,-6,0,12.0,2.0,10.0,2
18490,18490,2015-16,2015,2016,West Ham,Norwich,Draw,Home,2015-09-26,1,6,9,9,9,4,4,5,8,2,5,4,1,1,12.0,21.0,-9.0,2
18491,18491,2015-16,2015,2016,West Ham,Sunderland,Draw,Away,2015-10-03,1,4,7,10,10,0,0,1,2,4,7,9,8,0,12.0,16.0,-4.0,3
18492,18492,2015-16,2015,2016,West Ham,Crystal Palace,Win,Away,2015-10-17,3,2,5,8,11,6,6,6,9,-4,-1,2,2,0,12.0,10.0,2.0,3
18493,18493,2015-16,2015,2016,West Ham,Chelsea,Win,Home,2015-10-24,3,4,5,8,11,3,4,7,7,1,1,1,4,1,12.0,1.0,11.0,3
18494,18494,2015-16,2015,2016,West Ham,Watford,Loss,Away,2015-10-31,0,6,7,8,11,3,4,4,7,3,3,4,4,0,12.0,21.0,-9.0,3
18495,18495,2015-16,2015,2016,West Ham,Everton,Draw,Home,2015-11-07,1,3,6,7,8,3,3,4,7,0,3,3,1,1,12.0,11.0,1.0,4
18496,18496,2015-16,2015,2016,West Ham,Tottenham,Loss,Away,2015-11-22,0,1,4,7,8,4,7,8,9,-3,-3,-1,-1,0,12.0,5.0,7.0,4
18497,18497,2015-16,2015,2016,West Ham,West Brom,Draw,Home,2015-11-29,1,1,1,4,7,3,3,6,9,-2,-2,-2,-2,1,12.0,13.0,-1.0,4
18498,18498,2015-16,2015,2016,West Ham,Man United,Draw,Away,2015-12-05,1,1,2,2,5,4,7,8,9,-3,-5,-6,-4,0,12.0,4.0,8.0,5
18499,18499,2015-16,2015,2016,West Ham,Stoke,Draw,Home,2015-12-12,1,2,2,3,3,3,6,9,10,-1,-4,-6,-7,1,12.0,9.0,3.0,5
18500,18500,2015-16,2015,2016,West Ham,Swansea,Draw,Away,2015-12-20,1,2,3,3,4,0,0,1,1,2,3,2,3,0,12.0,8.0,4.0,5
18501,18501,2015-16,2015,2016,West Ham,Aston Villa,Draw,Away,2015-12-26,1,2,3,4,4,1,2,2,2,1,1,2,2,0,12.0,17.0,-5.0,5
18502,18502,2015-16,2015,2016,West Ham,Southampton,Win,Home,2015-12-28,3,2,3,4,5,3,3,4,4,-1,0,0,1,1,12.0,7.0,5.0,5
18503,18503,2015-16,2015,2016,West Ham,Liverpool,Win,Home,2016-01-02,3,4,5,6,7,6,6,7,7,-2,-1,-1,0,1,12.0,6.0,6.0,6
18504,18504,2015-16,2015,2016,West Ham,Bournemouth,Win,Away,2016-01-12,3,6,7,8,9,1,2,5,8,5,5,3,1,0,12.0,21.0,-9.0,6
18505,18505,2015-16,2015,2016,West Ham,Newcastle,Loss,Away,2016-01-16,0,6,9,10,11,1,1,1,2,5,8,9,9,0,12.0,15.0,-3.0,6
18506,18506,2015-16,2015,2016,West Ham,Man City,Draw,Home,2016-01-23,1,3,6,9,10,4,7,8,11,-1,-1,1,-1,1,12.0,2.0,10.0,6
18507,18507,2015-16,2015,2016,West Ham,Aston Villa,Win,Home,2016-02-02,3,1,4,7,10,2,5,5,5,-1,-1,2,5,1,12.0,17.0,-5.0,7
18508,18508,2015-16,2015,2016,West Ham,Southampton,Loss,Away,2016-02-06,0,4,4,7,10,4,7,10,10,0,-3,-3,0,0,12.0,7.0,5.0,7
18509,18509,2015-16,2015,2016,West Ham,Norwich,Draw,Away,2016-02-13,1,3,4,4,7,0,0,0,0,3,4,4,7,0,12.0,21.0,-9.0,7
18510,18510,2015-16,2015,2016,West Ham,Sunderland,Win,Home,2016-02-27,3,1,4,5,5,4,4,5,5,-3,0,0,0,1,12.0,16.0,-4.0,7
18511,18511,2015-16,2015,2016,West Ham,Tottenham,Win,Home,2016-03-02,3,4,4,7,8,6,9,12,15,-2,-5,-5,-7,1,12.0,5.0,7.0,8
18512,18512,2015-16,2015,2016,West Ham,Everton,Win,Away,2016-03-05,3,6,7,7,10,3,6,9,9,3,1,-2,1,0,12.0,11.0,1.0,8
18513,18513,2015-16,2015,2016,West Ham,Chelsea,Draw,Away,2016-03-19,1,6,9,10,10,4,7,10,11,2,2,0,-1,0,12.0,1.0,11.0,8
18514,18514,2015-16,2015,2016,West Ham,Crystal Palace,Draw,Home,2016-04-02,1,4,7,10,11,0,1,1,1,4,6,9,10,1,12.0,10.0,2.0,9
18515,18515,2015-16,2015,2016,West Ham,Arsenal,Draw,Home,2016-04-09,1,2,5,8,11,6,7,7,7,-4,-2,1,4,1,12.0,3.0,9.0,9
18516,18516,2015-16,2015,2016,West Ham,Leicester,Draw,Away,2016-04-17,1,2,3,6,9,6,9,12,15,-4,-6,-6,-6,0,12.0,14.0,-2.0,9
18517,18517,2015-16,2015,2016,West Ham,Watford,Win,Home,2016-04-20,3,2,3,4,7,4,4,4,4,-2,-1,0,3,1,12.0,21.0,-9.0,9
18518,18518,2015-16,2015,2016,West Ham,West Brom,Win,Away,2016-04-30,3,4,5,6,7,1,1,1,2,3,4,5,5,0,12.0,13.0,-1.0,9
18519,18519,2015-16,2015,2016,West Ham,Swansea,Loss,Home,2016-05-07,0,6,7,8,9,3,3,6,7,3,4,2,2,1,12.0,8.0,4.0,10
18520,18520,2015-16,2015,2016,West Ham,Man United,Win,Home,2016-05-10,3,3,6,7,8,4,7,10,10,-1,-1,-3,-2,1,12.0,4.0,8.0,10
18521,18521,2015-16,2015,2016,West Ham,Stoke,Loss,Away,2016-05-15,0,3,6,9,10,1,1,1,1,2,5,8,9,0,12.0,9.0,3.0,10
18522,18522,2016-17,2016,2017,West Ham,Chelsea,Loss,Away,2016-08-15,0,3,3,6,9,2,2,3,6,1,1,3,3,0,7.0,10.0,-3.0,1
18523,18523,2016-17,2016,2017,West Ham,Bournemouth,Win,Home,2016-08-21,3,0,3,3,6,0,1,1,1,0,2,2,5,1,7.0,16.0,-9.0,1
18524,18524,2016-17,2016,2017,West Ham,Man City,Loss,Away,2016-08-28,0,3,3,6,6,6,7,8,8,-3,-4,-2,-2,0,7.0,4.0,3.0,1
18525,18525,2016-17,2016,2017,West Ham,Watford,Loss,Home,2016-09-10,0,3,3,3,6,0,1,2,2,3,2,1,4,1,7.0,13.0,-6.0,2
18526,18526,2016-17,2016,2017,West Ham,West Brom,Loss,Away,2016-09-17,0,0,3,3,3,1,1,4,5,-1,2,-1,-2,0,7.0,14.0,-7.0,2
18527,18527,2016-17,2016,2017,West Ham,Southampton,Loss,Home,2016-09-25,0,0,0,3,3,3,4,4,5,-3,-4,-1,-2,1,7.0,6.0,1.0,2
18528,18528,2016-17,2016,2017,West Ham,Middlesbrough,Draw,Home,2016-10-01,1,0,0,0,3,0,0,1,4,0,0,-1,-1,1,7.0,21.0,-14.0,3
18529,18529,2016-17,2016,2017,West Ham,Crystal Palace,Win,Away,2016-10-15,3,1,1,1,1,4,7,10,11,-3,-6,-9,-10,0,7.0,15.0,-8.0,3
18530,18530,2016-17,2016,2017,West Ham,Sunderland,Win,Home,2016-10-22,3,4,4,4,4,1,1,1,1,3,3,3,3,1,7.0,17.0,-10.0,3
18531,18531,2016-17,2016,2017,West Ham,Everton,Loss,Away,2016-10-30,0,6,7,7,7,1,2,2,5,5,5,5,2,0,7.0,11.0,-4.0,3
18532,18532,2016-17,2016,2017,West Ham,Stoke,Draw,Home,2016-11-05,1,3,6,7,7,6,9,10,11,-3,-3,-3,-4,1,7.0,9.0,-2.0,4
18533,18533,2016-17,2016,2017,West Ham,Tottenham,Loss,Away,2016-11-19,0,1,4,7,8,2,3,4,7,-1,1,3,1,0,7.0,3.0,4.0,4
18534,18534,2016-17,2016,2017,West Ham,Man United,Draw,Away,2016-11-27,1,1,1,4,7,4,5,5,6,-3,-4,-1,1,0,7.0,5.0,2.0,4
18535,18535,2016-17,2016,2017,West Ham,Arsenal,Loss,Home,2016-12-03,0,1,2,2,5,4,5,8,9,-3,-3,-6,-4,1,7.0,2.0,5.0,5
18536,18536,2016-17,2016,2017,West Ham,Liverpool,Draw,Away,2016-12-11,1,1,1,2,2,3,4,7,10,-2,-3,-5,-8,0,7.0,8.0,-1.0,5
18537,18537,2016-17,2016,2017,West Ham,Burnley,Win,Home,2016-12-14,3,1,2,2,3,3,3,3,6,-2,-1,-1,-3,1,7.0,21.0,-14.0,5
18538,18538,2016-17,2016,2017,West Ham,Hull,Win,Home,2016-12-17,3,4,4,5,5,1,1,2,2,3,3,3,3,1,7.0,21.0,-14.0,5
18539,18539,2016-17,2016,2017,West Ham,Swansea,Win,Away,2016-12-26,3,6,7,7,8,0,3,3,6,6,4,4,2,0,7.0,12.0,-5.0,5
18540,18540,2016-17,2016,2017,West Ham,Leicester,Loss,Away,2016-12-31,0,6,9,10,10,1,1,4,4,5,8,6,6,0,7.0,1.0,6.0,5
18541,18541,2016-17,2016,2017,West Ham,Man United,Loss,Home,2017-01-02,0,3,6,9,10,6,9,12,15,-3,-3,-3,-5,1,7.0,5.0,2.0,6
18542,18542,2016-17,2016,2017,West Ham,Crystal Palace,Win,Home,2017-01-14,3,0,3,6,9,0,1,1,1,0,2,5,8,1,7.0,15.0,-8.0,6
18543,18543,2016-17,2016,2017,West Ham,Middlesbrough,Win,Away,2017-01-21,3,3,3,6,9,2,2,2,5,1,1,4,4,0,7.0,21.0,-14.0,6
18544,18544,2016-17,2016,2017,West Ham,Man City,Loss,Home,2017-02-01,0,6,6,6,9,1,4,4,7,5,2,2,2,1,7.0,4.0,3.0,7
18545,18545,2016-17,2016,2017,West Ham,Southampton,Win,Away,2017-02-04,3,3,6,6,6,3,3,3,3,0,3,3,3,0,7.0,6.0,1.0,7
18546,18546,2016-17,2016,2017,West Ham,West Brom,Draw,Home,2017-02-11,1,3,6,9,9,4,7,7,10,-1,-1,2,-1,1,7.0,14.0,-7.0,7
18547,18547,2016-17,2016,2017,West Ham,Watford,Draw,Away,2017-02-25,1,4,4,7,10,3,6,7,8,1,-2,0,2,0,7.0,13.0,-6.0,7
18548,18548,2016-17,2016,2017,West Ham,Chelsea,Loss,Home,2017-03-06,0,2,5,5,8,4,7,8,11,-2,-2,-3,-3,1,7.0,10.0,-3.0,8
18549,18549,2016-17,2016,2017,West Ham,Bournemouth,Loss,Away,2017-03-11,0,1,2,5,5,1,1,1,1,0,1,4,4,0,7.0,16.0,-9.0,8
18550,18550,2016-17,2016,2017,West Ham,Leicester,Loss,Home,2017-03-18,0,0,1,2,5,6,6,6,6,-6,-5,-4,-1,1,7.0,1.0,6.0,8
18551,18551,2016-17,2016,2017,West Ham,Hull,Loss,Away,2017-04-01,0,0,0,1,2,3,3,4,4,-3,-3,-3,-2,0,7.0,21.0,-14.0,9
18552,18552,2016-17,2016,2017,West Ham,Arsenal,Loss,Away,2017-04-05,0,0,0,0,1,1,1,4,4,-1,-1,-4,-3,0,7.0,2.0,5.0,9
18553,18553,2016-17,2016,2017,West Ham,Swansea,Win,Home,2017-04-08,3,0,0,0,0,1,1,1,4,-1,-1,-1,-4,1,7.0,12.0,-5.0,9
18554,18554,2016-17,2016,2017,West Ham,Sunderland,Draw,Away,2017-04-15,1,3,3,3,3,0,0,1,1,3,3,2,2,0,7.0,17.0,-10.0,9
18555,18555,2016-17,2016,2017,West Ham,Everton,Draw,Home,2017-04-22,1,4,4,4,4,6,7,7,10,-2,-3,-3,-6,1,7.0,11.0,-4.0,9
18556,18556,2016-17,2016,2017,West Ham,Stoke,Draw,Away,2017-04-29,1,2,5,5,5,3,3,3,3,-1,2,2,2,0,7.0,9.0,-2.0,9
18557,18557,2016-17,2016,2017,West Ham,Tottenham,Win,Home,2017-05-05,3,2,3,6,6,6,9,12,15,-4,-6,-6,-9,1,7.0,3.0,4.0,10
18558,18558,2016-17,2016,2017,West Ham,Liverpool,Loss,Home,2017-05-14,0,4,5,6,9,4,4,7,10,0,1,-1,-1,1,7.0,8.0,-1.0,10
18559,18559,2016-17,2016,2017,West Ham,Burnley,Win,Away,2017-05-21,3,3,4,5,6,1,4,4,4,2,0,1,2,0,7.0,21.0,-14.0,10
18560,18560,2017-18,2017,2018,West Ham,Man United,Loss,Away,2017-08-13,0,3,6,7,8,4,4,4,5,-1,2,3,3,0,11.0,6.0,5.0,1
18561,18561,2017-18,2017,2018,West Ham,Southampton,Loss,Away,2017-08-19,0,3,3,6,7,1,2,5,5,2,1,1,2,0,11.0,8.0,3.0,1
18562,18562,2017-18,2017,2018,West Ham,Newcastle,Loss,Away,2017-08-26,0,0,3,3,6,0,3,4,7,0,0,-1,-1,0,11.0,21.0,-10.0,1
18563,18563,2017-18,2017,2018,West Ham,Huddersfield,Win,Home,2017-09-11,3,0,0,3,3,4,7,7,7,-4,-7,-4,-4,1,11.0,21.0,-10.0,2
18564,18564,2017-18,2017,2018,West Ham,West Brom,Draw,Away,2017-09-16,1,3,3,3,6,1,4,7,7,2,-1,-4,-1,0,11.0,10.0,1.0,2
18565,18565,2017-18,2017,2018,West Ham,Tottenham,Loss,Home,2017-09-23,0,4,4,4,4,4,5,5,8,0,-1,-1,-4,1,11.0,2.0,9.0,2
18566,18566,2017-18,2017,2018,West Ham,Swansea,Win,Home,2017-09-30,3,1,4,4,4,1,1,4,4,0,3,0,0,1,11.0,15.0,-4.0,2
18567,18567,2017-18,2017,2018,West Ham,Burnley,Draw,Away,2017-10-14,1,3,4,7,7,4,5,8,9,-1,-1,-1,-2,0,11.0,16.0,-5.0,3
18568,18568,2017-18,2017,2018,West Ham,Brighton,Loss,Home,2017-10-20,0,4,4,5,8,1,4,4,7,3,0,1,1,1,11.0,21.0,-10.0,3
18569,18569,2017-18,2017,2018,West Ham,Crystal Palace,Draw,Away,2017-10-28,1,1,4,4,5,3,3,3,3,-2,1,1,2,0,11.0,14.0,-3.0,3
18570,18570,2017-18,2017,2018,West Ham,Liverpool,Loss,Home,2017-11-04,0,1,2,5,5,3,4,5,8,-2,-2,0,-3,1,11.0,4.0,7.0,4
18571,18571,2017-18,2017,2018,West Ham,Watford,Loss,Away,2017-11-19,0,1,1,2,5,0,0,3,4,1,1,-1,1,0,11.0,17.0,-6.0,4
18572,18572,2017-18,2017,2018,West Ham,Leicester,Draw,Home,2017-11-24,1,0,1,1,2,1,4,7,8,-1,-3,-6,-6,1,11.0,12.0,-1.0,4
18573,18573,2017-18,2017,2018,West Ham,Everton,Loss,Away,2017-11-29,0,1,1,2,2,1,4,4,4,0,-3,-2,-2,0,11.0,7.0,4.0,4
18574,18574,2017-18,2017,2018,West Ham,Man City,Loss,Away,2017-12-03,0,1,1,1,2,6,9,12,15,-5,-8,-11,-13,0,11.0,3.0,8.0,5
18575,18575,2017-18,2017,2018,West Ham,Chelsea,Win,Home,2017-12-09,3,0,1,1,1,6,7,10,13,-6,-6,-9,-12,1,11.0,1.0,10.0,5
18576,18576,2017-18,2017,2018,West Ham,Arsenal,Draw,Home,2017-12-13,1,3,3,4,4,1,4,7,10,2,-1,-3,-6,1,11.0,5.0,6.0,5
18577,18577,2017-18,2017,2018,West Ham,Stoke,Win,Away,2017-12-16,3,4,4,4,5,0,3,3,3,4,1,1,2,0,11.0,13.0,-2.0,5
18578,18578,2017-18,2017,2018,West Ham,Newcastle,Loss,Home,2017-12-23,0,4,7,7,7,0,0,0,1,4,7,7,6,1,11.0,21.0,-10.0,5
18579,18579,2017-18,2017,2018,West Ham,Bournemouth,Draw,Away,2017-12-26,1,3,4,7,7,0,0,1,2,3,4,6,5,0,11.0,9.0,2.0,5
18580,18580,2017-18,2017,2018,West Ham,West Brom,Win,Home,2018-01-02,3,1,4,5,8,2,2,2,3,-1,2,3,5,1,11.0,10.0,1.0,6
18581,18581,2017-18,2017,2018,West Ham,Tottenham,Draw,Away,2018-01-04,1,4,4,7,8,6,9,9,12,-2,-5,-2,-4,0,11.0,2.0,9.0,6
18582,18582,2017-18,2017,2018,West Ham,Huddersfield,Win,Away,2018-01-13,3,4,5,5,8,1,2,3,6,3,3,2,2,0,11.0,21.0,-10.0,6
18583,18583,2017-18,2017,2018,West Ham,Bournemouth,Draw,Home,2018-01-20,1,4,7,8,8,4,7,8,8,0,0,0,0,1,11.0,9.0,2.0,6
18584,18584,2017-18,2017,2018,West Ham,Crystal Palace,Draw,Home,2018-01-30,1,4,5,8,9,3,6,7,7,1,-1,1,2,1,11.0,14.0,-3.0,6
18585,18585,2017-18,2017,2018,West Ham,Brighton,Loss,Away,2018-02-03,0,2,5,6,9,1,1,2,3,1,4,4,6,0,11.0,21.0,-10.0,7
18586,18586,2017-18,2017,2018,West Ham,Watford,Win,Home,2018-02-10,3,1,2,5,6,4,4,5,5,-3,-2,0,1,1,11.0,17.0,-6.0,7
18587,18587,2017-18,2017,2018,West Ham,Liverpool,Loss,Away,2018-02-24,0,3,4,5,8,4,7,7,10,-1,-3,-2,-2,0,11.0,4.0,7.0,7
18588,18588,2017-18,2017,2018,West Ham,Swansea,Loss,Away,2018-03-03,0,3,3,4,5,3,4,7,10,0,-1,-3,-5,0,11.0,15.0,-4.0,8
18589,18589,2017-18,2017,2018,West Ham,Burnley,Loss,Home,2018-03-10,0,0,3,3,4,4,4,5,6,-4,-1,-2,-2,1,11.0,16.0,-5.0,8
18590,18590,2017-18,2017,2018,West Ham,Southampton,Win,Home,2018-03-31,3,0,0,3,3,1,2,2,5,-1,-2,1,-2,1,11.0,8.0,3.0,8
18591,18591,2017-18,2017,2018,West Ham,Chelsea,Draw,Away,2018-04-08,1,3,3,3,6,3,3,3,6,0,0,0,0,0,11.0,1.0,10.0,9
18592,18592,2017-18,2017,2018,West Ham,Stoke,Draw,Home,2018-04-16,1,4,4,4,4,0,0,0,1,4,4,4,3,1,11.0,13.0,-2.0,9
18593,18593,2017-18,2017,2018,West Ham,Arsenal,Loss,Away,2018-04-22,0,2,5,5,5,3,6,9,9,-1,-1,-4,-4,0,11.0,5.0,6.0,9
18594,18594,2017-18,2017,2018,West Ham,Man City,Loss,Home,2018-04-29,0,1,2,5,5,6,6,9,12,-5,-4,-4,-7,1,11.0,3.0,8.0,9
18595,18595,2017-18,2017,2018,West Ham,Leicester,Win,Away,2018-05-05,3,0,1,2,5,1,1,1,4,-1,0,1,1,0,11.0,12.0,-1.0,10
18596,18596,2017-18,2017,2018,West Ham,Man United,Draw,Home,2018-05-10,1,3,3,4,5,3,6,6,9,0,-3,-2,-4,1,11.0,6.0,5.0,10
18597,18597,2017-18,2017,2018,West Ham,Everton,Win,Home,2018-05-13,3,4,4,4,5,4,7,8,9,0,-3,-4,-4,1,11.0,7.0,4.0,10
18598,18598,2005-06,2005,2006,Wigan,Chelsea,Loss,Home,2005-08-14,0,0,0,0,0,4,7,10,13,-4,-7,-10,-13,1,21.0,1.0,20.0,1
18599,18599,2005-06,2005,2006,Wigan,Charlton,Loss,Away,2005-08-20,0,0,0,0,0,4,4,4,4,-4,-4,-4,-4,0,21.0,11.0,10.0,1
18600,18600,2005-06,2005,2006,Wigan,Sunderland,Win,Home,2005-08-27,3,0,0,0,0,0,0,0,0,0,0,0,0,1,21.0,21.0,0.0,1
18601,18601,2005-06,2005,2006,Wigan,West Brom,Win,Away,2005-09-10,3,3,3,3,3,0,3,4,7,3,0,-1,-4,0,21.0,17.0,4.0,2
18602,18602,2005-06,2005,2006,Wigan,Middlesbrough,Draw,Home,2005-09-18,1,6,6,6,6,3,6,6,7,3,0,0,-1,1,21.0,7.0,14.0,2
18603,18603,2005-06,2005,2006,Wigan,Everton,Win,Away,2005-09-24,3,4,7,7,7,0,0,3,3,4,7,4,4,0,21.0,4.0,17.0,2
18604,18604,2005-06,2005,2006,Wigan,Bolton,Win,Home,2005-10-02,3,4,7,10,10,6,7,10,13,-2,0,0,-3,1,21.0,6.0,15.0,3
18605,18605,2005-06,2005,2006,Wigan,Newcastle,Win,Home,2005-10-15,3,6,7,10,13,4,7,8,8,2,0,2,5,1,21.0,14.0,7.0,3
18606,18606,2005-06,2005,2006,Wigan,Aston Villa,Win,Away,2005-10-22,3,6,9,10,13,3,3,4,4,3,6,6,9,0,21.0,10.0,11.0,3
18607,18607,2005-06,2005,2006,Wigan,Fulham,Win,Home,2005-10-29,3,6,9,12,13,4,4,4,4,2,5,8,9,1,21.0,13.0,8.0,3
18608,18608,2005-06,2005,2006,Wigan,Portsmouth,Win,Away,2005-11-05,3,6,9,12,15,3,4,5,5,3,5,7,10,0,21.0,16.0,5.0,4
18609,18609,2005-06,2005,2006,Wigan,Arsenal,Loss,Home,2005-11-19,0,6,9,12,15,4,7,7,10,2,2,5,5,1,21.0,2.0,19.0,4
18610,18610,2005-06,2005,2006,Wigan,Tottenham,Loss,Home,2005-11-26,0,3,6,9,12,1,2,3,6,2,4,6,6,1,21.0,9.0,12.0,4
18611,18611,2005-06,2005,2006,Wigan,Liverpool,Loss,Away,2005-12-03,0,0,3,6,9,6,9,12,15,-6,-6,-6,-6,0,21.0,5.0,16.0,5
18612,18612,2005-06,2005,2006,Wigan,Chelsea,Loss,Away,2005-12-10,0,0,0,3,6,6,9,9,12,-6,-9,-6,-6,0,21.0,1.0,20.0,5
18613,18613,2005-06,2005,2006,Wigan,Man United,Loss,Away,2005-12-14,0,0,0,0,3,4,7,10,13,-4,-7,-10,-10,0,21.0,3.0,18.0,5
18614,18614,2005-06,2005,2006,Wigan,Charlton,Win,Home,2005-12-17,3,0,0,0,0,3,3,3,3,-3,-3,-3,-3,1,21.0,11.0,10.0,5
18615,18615,2005-06,2005,2006,Wigan,Man City,Win,Home,2005-12-26,3,3,3,3,3,3,6,6,7,0,-3,-3,-4,1,21.0,8.0,13.0,5
18616,18616,2005-06,2005,2006,Wigan,West Ham,Win,Away,2005-12-28,3,6,6,6,6,1,4,4,7,5,2,2,-1,0,21.0,21.0,0.0,5
18617,18617,2005-06,2005,2006,Wigan,Blackburn,Loss,Home,2005-12-31,0,6,9,9,9,3,6,6,6,3,3,3,3,1,21.0,15.0,6.0,5
18618,18618,2005-06,2005,2006,Wigan,Birmingham,Loss,Away,2006-01-02,0,3,6,9,9,1,1,1,4,2,5,8,5,0,21.0,12.0,9.0,6
18619,18619,2005-06,2005,2006,Wigan,West Brom,Loss,Home,2006-01-15,0,0,3,6,9,0,3,3,3,0,0,3,6,1,21.0,17.0,4.0,6
18620,18620,2005-06,2005,2006,Wigan,Middlesbrough,Win,Away,2006-01-21,3,0,0,3,6,1,2,2,3,-1,-2,1,3,0,21.0,7.0,14.0,6
18621,18621,2005-06,2005,2006,Wigan,Everton,Draw,Home,2006-01-31,1,3,3,3,6,6,9,12,12,-3,-6,-9,-6,1,21.0,4.0,17.0,6
18622,18622,2005-06,2005,2006,Wigan,Bolton,Draw,Away,2006-02-04,1,4,4,4,4,4,5,6,6,0,-1,-2,-2,0,21.0,6.0,15.0,7
18623,18623,2005-06,2005,2006,Wigan,Liverpool,Loss,Home,2006-02-11,0,2,5,5,5,0,1,1,4,2,4,4,1,1,21.0,5.0,16.0,7
18624,18624,2005-06,2005,2006,Wigan,Tottenham,Draw,Away,2006-02-19,1,1,2,5,5,4,4,5,5,-3,-2,0,0,0,21.0,9.0,12.0,7
18625,18625,2005-06,2005,2006,Wigan,Man United,Loss,Home,2006-03-06,0,1,2,3,6,6,6,9,9,-5,-4,-6,-3,1,21.0,3.0,18.0,8
18626,18626,2005-06,2005,2006,Wigan,Sunderland,Win,Away,2006-03-11,3,1,1,2,3,0,0,1,1,1,1,1,2,0,21.0,21.0,0.0,8
18627,18627,2005-06,2005,2006,Wigan,Man City,Win,Away,2006-03-18,3,3,4,4,5,3,3,6,6,0,1,-2,-1,0,21.0,8.0,13.0,8
18628,18628,2005-06,2005,2006,Wigan,West Ham,Loss,Home,2006-03-25,0,6,6,7,7,0,1,4,7,6,5,3,0,1,21.0,21.0,0.0,8
18629,18629,2005-06,2005,2006,Wigan,Blackburn,Draw,Away,2006-04-03,1,3,6,6,7,6,9,9,12,-3,-3,-3,-5,0,21.0,15.0,6.0,9
18630,18630,2005-06,2005,2006,Wigan,Birmingham,Draw,Home,2006-04-08,1,1,4,7,7,4,4,4,5,-3,0,3,2,1,21.0,12.0,9.0,9
18631,18631,2005-06,2005,2006,Wigan,Newcastle,Loss,Away,2006-04-15,0,2,2,5,8,6,6,6,6,-4,-4,-1,2,0,21.0,14.0,7.0,9
18632,18632,2005-06,2005,2006,Wigan,Aston Villa,Win,Home,2006-04-18,3,1,2,2,5,4,4,5,5,-3,-2,-3,0,1,21.0,10.0,11.0,9
18633,18633,2005-06,2005,2006,Wigan,Fulham,Loss,Away,2006-04-24,0,3,4,5,5,3,4,7,7,0,0,-2,-2,0,21.0,13.0,8.0,9
18634,18634,2005-06,2005,2006,Wigan,Portsmouth,Loss,Home,2006-04-29,0,3,3,4,5,3,6,7,8,0,-3,-3,-3,1,21.0,16.0,5.0,9
18635,18635,2005-06,2005,2006,Wigan,Arsenal,Loss,Away,2006-05-07,0,0,3,3,4,6,7,10,11,-6,-4,-7,-7,0,21.0,2.0,19.0,10
18636,18636,2006-07,2006,2007,Wigan,Newcastle,Loss,Away,2006-08-19,0,0,0,3,3,4,7,10,13,-4,-7,-7,-10,0,10.0,7.0,3.0,1
18637,18637,2006-07,2006,2007,Wigan,Reading,Win,Home,2006-08-26,3,0,0,0,3,3,3,3,3,-3,-3,-3,0,1,10.0,21.0,-11.0,1
18638,18638,2006-07,2006,2007,Wigan,Portsmouth,Loss,Away,2006-09-09,0,3,3,3,3,4,7,7,10,-1,-4,-4,-7,0,10.0,17.0,-7.0,2
18639,18639,2006-07,2006,2007,Wigan,Everton,Draw,Away,2006-09-16,1,3,3,3,3,6,7,10,11,-3,-4,-7,-8,0,10.0,11.0,-1.0,2
18640,18640,2006-07,2006,2007,Wigan,Watford,Draw,Home,2006-09-23,1,1,4,4,4,1,1,2,2,0,3,2,2,1,10.0,21.0,-11.0,2
18641,18641,2006-07,2006,2007,Wigan,Blackburn,Loss,Away,2006-10-01,0,2,2,5,5,6,7,7,8,-4,-5,-2,-3,0,10.0,6.0,4.0,3
18642,18642,2006-07,2006,2007,Wigan,Man United,Loss,Home,2006-10-14,0,1,2,2,5,4,4,7,10,-3,-2,-5,-5,1,10.0,2.0,8.0,3
18643,18643,2006-07,2006,2007,Wigan,Man City,Win,Home,2006-10-21,3,0,1,2,2,2,5,5,5,-2,-4,-3,-3,1,10.0,15.0,-5.0,3
18644,18644,2006-07,2006,2007,Wigan,Fulham,Win,Away,2006-10-28,3,3,3,4,5,4,5,5,6,-1,-2,-1,-1,0,10.0,12.0,-2.0,3
18645,18645,2006-07,2006,2007,Wigan,Bolton,Win,Away,2006-11-04,3,6,6,6,7,3,6,9,12,3,0,-3,-5,0,10.0,8.0,2.0,4
18646,18646,2006-07,2006,2007,Wigan,Charlton,Win,Home,2006-11-11,3,6,9,9,9,4,5,5,5,2,4,4,4,1,10.0,13.0,-3.0,4
18647,18647,2006-07,2006,2007,Wigan,Aston Villa,Draw,Home,2006-11-19,1,6,9,12,12,6,6,7,8,0,3,5,4,1,10.0,16.0,-6.0,4
18648,18648,2006-07,2006,2007,Wigan,Tottenham,Loss,Away,2006-11-26,0,4,7,10,13,1,4,5,8,3,3,5,5,0,10.0,5.0,5.0,4
18649,18649,2006-07,2006,2007,Wigan,Liverpool,Loss,Home,2006-12-02,0,1,4,7,10,4,5,5,8,-3,-1,2,2,1,10.0,3.0,7.0,5
18650,18650,2006-07,2006,2007,Wigan,West Ham,Win,Away,2006-12-06,3,0,1,4,7,3,3,3,6,-3,-2,1,1,0,10.0,9.0,1.0,5
18651,18651,2006-07,2006,2007,Wigan,Middlesbrough,Draw,Away,2006-12-09,1,3,3,4,7,0,1,2,5,3,2,2,2,0,10.0,14.0,-4.0,5
18652,18652,2006-07,2006,2007,Wigan,Arsenal,Loss,Home,2006-12-13,0,4,4,4,5,4,4,4,5,0,0,0,0,1,10.0,4.0,6.0,5
18653,18653,2006-07,2006,2007,Wigan,Sheffield United,Loss,Home,2006-12-16,0,1,4,4,4,4,7,7,7,-3,-3,-3,-3,1,10.0,21.0,-11.0,5
18654,18654,2006-07,2006,2007,Wigan,Chelsea,Loss,Home,2006-12-23,0,0,1,4,4,6,7,10,11,-6,-6,-6,-7,1,10.0,1.0,9.0,5
18655,18655,2006-07,2006,2007,Wigan,Man United,Loss,Away,2006-12-26,0,0,0,1,4,3,6,9,12,-3,-6,-8,-8,0,10.0,2.0,8.0,5
18656,18656,2006-07,2006,2007,Wigan,Blackburn,Loss,Home,2007-01-01,0,0,0,0,1,6,6,9,9,-6,-6,-9,-8,1,10.0,6.0,4.0,6
18657,18657,2006-07,2006,2007,Wigan,Chelsea,Loss,Away,2007-01-13,0,0,0,0,0,2,3,6,9,-2,-3,-6,-9,0,10.0,1.0,9.0,6
18658,18658,2006-07,2006,2007,Wigan,Everton,Loss,Home,2007-01-21,0,0,0,0,0,1,4,5,8,-1,-4,-5,-8,1,10.0,11.0,-1.0,6
18659,18659,2006-07,2006,2007,Wigan,Reading,Loss,Away,2007-01-30,0,0,0,0,0,4,7,7,8,-4,-7,-7,-8,0,10.0,21.0,-11.0,6
18660,18660,2006-07,2006,2007,Wigan,Portsmouth,Win,Home,2007-02-03,3,0,0,0,0,1,2,3,3,-1,-2,-3,-3,1,10.0,17.0,-7.0,7
18661,18661,2006-07,2006,2007,Wigan,Arsenal,Loss,Away,2007-02-11,0,3,3,3,3,4,7,10,10,-1,-4,-7,-7,0,10.0,4.0,6.0,7
18662,18662,2006-07,2006,2007,Wigan,Watford,Draw,Away,2007-02-21,1,3,3,3,3,3,3,6,6,0,0,-3,-3,0,10.0,21.0,-11.0,7
18663,18663,2006-07,2006,2007,Wigan,Newcastle,Win,Home,2007-02-25,3,1,4,4,4,3,6,7,10,-2,-2,-3,-6,1,10.0,7.0,3.0,7
18664,18664,2006-07,2006,2007,Wigan,Man City,Win,Away,2007-03-03,3,4,4,7,7,0,0,1,4,4,4,6,3,0,10.0,15.0,-5.0,8
18665,18665,2006-07,2006,2007,Wigan,Fulham,Draw,Home,2007-03-17,1,6,7,7,10,1,1,4,4,5,6,3,6,1,10.0,12.0,-2.0,8
18666,18666,2006-07,2006,2007,Wigan,Charlton,Loss,Away,2007-03-31,0,4,7,8,8,4,7,7,7,0,0,1,1,0,10.0,13.0,-3.0,8
18667,18667,2006-07,2006,2007,Wigan,Bolton,Loss,Home,2007-04-07,0,1,4,7,8,3,3,3,6,-2,1,4,2,1,10.0,8.0,2.0,9
18668,18668,2006-07,2006,2007,Wigan,Aston Villa,Draw,Away,2007-04-09,1,0,1,4,7,4,5,5,6,-4,-4,-1,1,0,10.0,16.0,-6.0,9
18669,18669,2006-07,2006,2007,Wigan,Tottenham,Draw,Home,2007-04-15,1,1,1,2,5,3,6,9,12,-2,-5,-7,-7,1,10.0,5.0,5.0,9
18670,18670,2006-07,2006,2007,Wigan,Liverpool,Loss,Away,2007-04-21,0,2,2,2,3,4,7,10,11,-2,-5,-8,-8,0,10.0,3.0,7.0,9
18671,18671,2006-07,2006,2007,Wigan,West Ham,Loss,Home,2007-04-28,0,1,2,2,2,3,3,6,9,-2,-1,-4,-7,1,10.0,9.0,1.0,9
18672,18672,2006-07,2006,2007,Wigan,Middlesbrough,Loss,Home,2007-05-05,0,0,1,2,2,1,1,1,4,-1,0,1,-2,1,10.0,14.0,-4.0,10
18673,18673,2006-07,2006,2007,Wigan,Sheffield United,Win,Away,2007-05-13,3,0,0,1,2,3,4,4,7,-3,-4,-3,-5,0,10.0,21.0,-11.0,10
18674,18674,2007-08,2007,2008,Wigan,Everton,Loss,Away,2007-08-11,0,3,3,3,4,4,4,4,7,-1,-1,-1,-3,0,17.0,6.0,11.0,1
18675,18675,2007-08,2007,2008,Wigan,Middlesbrough,Win,Home,2007-08-15,3,3,3,3,3,3,6,6,7,0,-3,-3,-4,1,17.0,12.0,5.0,1
18676,18676,2007-08,2007,2008,Wigan,Sunderland,Win,Home,2007-08-18,3,3,6,6,6,4,4,7,7,-1,2,-1,-1,1,17.0,21.0,-4.0,1
18677,18677,2007-08,2007,2008,Wigan,West Ham,Draw,Away,2007-08-25,1,6,6,9,9,3,6,9,12,3,0,0,-3,0,17.0,15.0,2.0,1
18678,18678,2007-08,2007,2008,Wigan,Newcastle,Loss,Away,2007-09-01,0,4,7,7,10,2,5,6,6,2,2,1,4,0,17.0,13.0,4.0,2
18679,18679,2007-08,2007,2008,Wigan,Fulham,Draw,Home,2007-09-15,1,1,4,7,7,1,1,4,4,0,3,3,3,1,17.0,16.0,1.0,2
18680,18680,2007-08,2007,2008,Wigan,Reading,Loss,Away,2007-09-22,0,1,2,5,8,0,0,3,3,1,2,2,5,0,17.0,8.0,9.0,2
18681,18681,2007-08,2007,2008,Wigan,Liverpool,Loss,Home,2007-09-29,0,1,1,2,5,2,5,8,9,-1,-4,-6,-4,1,17.0,3.0,14.0,2
18682,18682,2007-08,2007,2008,Wigan,Man United,Loss,Away,2007-10-06,0,0,1,1,2,6,9,12,15,-6,-8,-11,-13,0,17.0,1.0,16.0,3
18683,18683,2007-08,2007,2008,Wigan,Portsmouth,Loss,Home,2007-10-20,0,0,0,1,1,6,9,10,10,-6,-9,-9,-9,1,17.0,9.0,8.0,3
18684,18684,2007-08,2007,2008,Wigan,Birmingham,Loss,Away,2007-10-27,0,0,0,0,1,0,0,1,4,0,0,-1,-3,0,17.0,21.0,-4.0,3
18685,18685,2007-08,2007,2008,Wigan,Chelsea,Loss,Home,2007-11-03,0,0,0,0,0,6,9,10,10,-6,-9,-10,-10,1,17.0,2.0,15.0,4
18686,18686,2007-08,2007,2008,Wigan,Tottenham,Loss,Away,2007-11-11,0,0,0,0,0,1,1,2,3,-1,-1,-2,-3,0,17.0,5.0,12.0,4
18687,18687,2007-08,2007,2008,Wigan,Arsenal,Loss,Away,2007-11-24,0,0,0,0,0,4,5,8,11,-4,-5,-8,-11,0,17.0,4.0,13.0,4
18688,18688,2007-08,2007,2008,Wigan,Man City,Draw,Home,2007-12-01,1,0,0,0,0,4,7,7,10,-4,-7,-7,-10,1,17.0,14.0,3.0,5
18689,18689,2007-08,2007,2008,Wigan,Bolton,Loss,Away,2007-12-09,0,1,1,1,1,3,4,5,6,-2,-3,-4,-5,0,17.0,7.0,10.0,5
18690,18690,2007-08,2007,2008,Wigan,Blackburn,Win,Home,2007-12-15,3,1,1,1,1,3,3,4,4,-2,-2,-3,-3,1,17.0,10.0,7.0,5
18691,18691,2007-08,2007,2008,Wigan,Fulham,Draw,Away,2007-12-22,1,3,4,4,4,0,0,1,1,3,4,3,3,0,17.0,16.0,1.0,5
18692,18692,2007-08,2007,2008,Wigan,Newcastle,Win,Home,2007-12-26,3,4,4,5,5,4,7,8,8,0,-3,-3,-3,1,17.0,13.0,4.0,5
18693,18693,2007-08,2007,2008,Wigan,Aston Villa,Loss,Home,2007-12-29,0,4,7,7,8,2,3,3,3,2,4,4,5,1,17.0,11.0,6.0,5
18694,18694,2007-08,2007,2008,Wigan,Liverpool,Draw,Away,2008-01-02,1,3,4,7,7,4,7,7,7,-1,-3,0,0,0,17.0,3.0,14.0,6
18695,18695,2007-08,2007,2008,Wigan,Derby,Win,Away,2008-01-12,3,1,4,5,8,0,0,1,1,1,4,4,7,0,17.0,21.0,-4.0,6
18696,18696,2007-08,2007,2008,Wigan,Everton,Loss,Home,2008-01-20,0,4,4,7,8,6,6,9,9,-2,-2,-2,-1,1,17.0,6.0,11.0,6
18697,18697,2007-08,2007,2008,Wigan,Middlesbrough,Loss,Away,2008-01-29,0,3,4,4,7,2,2,5,5,1,2,-1,2,0,17.0,12.0,5.0,6
18698,18698,2007-08,2007,2008,Wigan,West Ham,Win,Home,2008-02-02,3,0,3,4,4,4,7,7,10,-4,-4,-3,-6,1,17.0,15.0,2.0,7
18699,18699,2007-08,2007,2008,Wigan,Sunderland,Loss,Away,2008-02-09,0,3,3,6,7,3,3,6,6,0,0,0,1,0,17.0,21.0,-4.0,7
18700,18700,2007-08,2007,2008,Wigan,Derby,Win,Home,2008-02-23,3,3,3,3,6,1,2,2,2,2,1,1,4,1,17.0,21.0,-4.0,7
18701,18701,2007-08,2007,2008,Wigan,Man City,Draw,Away,2008-03-01,1,3,6,6,6,3,3,4,5,0,3,2,1,0,17.0,14.0,3.0,8
18702,18702,2007-08,2007,2008,Wigan,Arsenal,Draw,Home,2008-03-09,1,4,4,7,7,2,5,8,11,2,-1,-1,-4,1,17.0,4.0,13.0,8
18703,18703,2007-08,2007,2008,Wigan,Bolton,Win,Home,2008-03-16,3,2,5,5,8,0,0,3,4,2,5,2,4,1,17.0,7.0,10.0,8
18704,18704,2007-08,2007,2008,Wigan,Blackburn,Loss,Away,2008-03-22,0,4,5,8,8,1,4,7,7,3,1,1,1,0,17.0,10.0,7.0,8
18705,18705,2007-08,2007,2008,Wigan,Portsmouth,Loss,Away,2008-03-29,0,3,4,5,8,3,6,6,9,0,-2,-1,-1,0,17.0,9.0,8.0,8
18706,18706,2007-08,2007,2008,Wigan,Birmingham,Win,Home,2008-04-05,3,0,3,4,5,3,4,4,7,-3,-1,0,-2,1,17.0,21.0,-4.0,9
18707,18707,2007-08,2007,2008,Wigan,Chelsea,Draw,Away,2008-04-14,1,3,3,6,7,6,9,10,13,-3,-6,-4,-6,0,17.0,2.0,15.0,9
18708,18708,2007-08,2007,2008,Wigan,Tottenham,Draw,Home,2008-04-19,1,4,4,4,7,2,2,5,6,2,2,-1,1,1,17.0,5.0,12.0,9
18709,18709,2007-08,2007,2008,Wigan,Reading,Draw,Home,2008-04-26,1,2,5,5,5,0,0,1,4,2,5,4,1,1,17.0,8.0,9.0,9
18710,18710,2007-08,2007,2008,Wigan,Aston Villa,Win,Away,2008-05-03,3,2,3,6,6,4,7,10,10,-2,-4,-4,-4,0,17.0,11.0,6.0,10
18711,18711,2007-08,2007,2008,Wigan,Man United,Loss,Home,2008-05-11,0,4,5,6,9,3,4,7,8,1,1,-1,1,1,17.0,1.0,16.0,10
18712,18712,2008-09,2008,2009,Wigan,West Ham,Loss,Away,2008-08-16,0,3,4,5,6,1,2,5,5,2,2,0,1,0,14.0,10.0,4.0,1
18713,18713,2008-09,2008,2009,Wigan,Chelsea,Loss,Home,2008-08-24,0,0,3,4,5,4,7,10,13,-4,-4,-6,-8,1,14.0,2.0,12.0,1
18714,18714,2008-09,2008,2009,Wigan,Hull,Win,Away,2008-08-30,3,0,0,3,4,4,4,4,4,-4,-4,-1,0,0,14.0,21.0,-7.0,1
18715,18715,2008-09,2008,2009,Wigan,Sunderland,Draw,Home,2008-09-13,1,3,3,3,6,3,3,3,3,0,0,0,3,1,14.0,15.0,-1.0,2
18716,18716,2008-09,2008,2009,Wigan,Tottenham,Draw,Away,2008-09-21,1,4,4,4,4,1,1,1,1,3,3,3,3,0,14.0,11.0,3.0,2
18717,18717,2008-09,2008,2009,Wigan,Man City,Win,Home,2008-09-28,3,2,5,5,5,3,6,9,9,-1,-1,-4,-4,1,14.0,9.0,5.0,2
18718,18718,2008-09,2008,2009,Wigan,Middlesbrough,Loss,Home,2008-10-04,0,4,5,8,8,0,0,3,3,4,5,5,5,1,14.0,13.0,1.0,3
18719,18719,2008-09,2008,2009,Wigan,Liverpool,Loss,Away,2008-10-18,0,3,4,5,8,6,7,10,11,-3,-3,-5,-3,0,14.0,4.0,10.0,3
18720,18720,2008-09,2008,2009,Wigan,Aston Villa,Loss,Home,2008-10-26,0,0,3,4,5,1,4,7,10,-1,-1,-3,-5,1,14.0,6.0,8.0,3
18721,18721,2008-09,2008,2009,Wigan,Fulham,Loss,Away,2008-10-29,0,0,0,3,4,2,2,2,2,-2,-2,1,2,0,14.0,17.0,-3.0,3
18722,18722,2008-09,2008,2009,Wigan,Portsmouth,Win,Away,2008-11-01,3,0,0,0,3,1,2,5,8,-1,-2,-5,-5,0,14.0,8.0,6.0,4
18723,18723,2008-09,2008,2009,Wigan,Stoke,Draw,Home,2008-11-08,1,3,3,3,3,6,6,9,9,-3,-3,-6,-6,1,14.0,21.0,-7.0,4
18724,18724,2008-09,2008,2009,Wigan,Newcastle,Draw,Away,2008-11-15,1,4,4,4,4,3,6,6,7,1,-2,-2,-3,0,14.0,12.0,2.0,4
18725,18725,2008-09,2008,2009,Wigan,Everton,Win,Home,2008-11-24,3,2,5,5,5,4,7,10,11,-2,-2,-5,-6,1,14.0,5.0,9.0,4
18726,18726,2008-09,2008,2009,Wigan,West Brom,Win,Home,2008-11-29,3,4,5,8,8,0,0,1,1,4,5,7,7,1,14.0,21.0,-7.0,4
18727,18727,2008-09,2008,2009,Wigan,Arsenal,Loss,Away,2008-12-06,0,6,7,8,11,3,3,6,6,3,4,2,5,0,14.0,3.0,11.0,5
18728,18728,2008-09,2008,2009,Wigan,Blackburn,Win,Home,2008-12-13,3,3,6,7,8,0,0,0,0,3,6,7,8,1,14.0,7.0,7.0,5
18729,18729,2008-09,2008,2009,Wigan,Newcastle,Win,Home,2008-12-26,3,3,6,9,10,6,7,8,9,-3,-1,1,1,1,14.0,12.0,2.0,5
18730,18730,2008-09,2008,2009,Wigan,Bolton,Win,Away,2008-12-28,3,6,6,9,12,3,3,3,6,3,3,6,6,0,14.0,16.0,-2.0,5
18731,18731,2008-09,2008,2009,Wigan,Tottenham,Win,Home,2009-01-11,3,6,9,9,12,1,1,2,5,5,8,7,7,1,14.0,11.0,3.0,6
18732,18732,2008-09,2008,2009,Wigan,Man United,Loss,Away,2009-01-14,0,6,9,12,12,6,9,10,13,0,0,2,-1,0,14.0,1.0,13.0,6
18733,18733,2008-09,2008,2009,Wigan,Man City,Loss,Away,2009-01-17,0,3,6,9,12,4,4,4,5,-1,2,5,7,0,14.0,9.0,5.0,6
18734,18734,2008-09,2008,2009,Wigan,Liverpool,Draw,Home,2009-01-28,1,0,3,6,9,2,5,8,9,-2,-2,-2,0,1,14.0,4.0,10.0,6
18735,18735,2008-09,2008,2009,Wigan,Aston Villa,Draw,Away,2009-01-31,1,1,1,4,7,6,9,12,13,-5,-8,-8,-6,0,14.0,6.0,8.0,6
18736,18736,2008-09,2008,2009,Wigan,Fulham,Draw,Home,2009-02-07,1,2,2,2,5,3,3,4,5,-1,-1,-2,0,1,14.0,17.0,-3.0,7
18737,18737,2008-09,2008,2009,Wigan,Middlesbrough,Draw,Away,2009-02-21,1,2,3,3,3,1,1,1,2,1,2,2,1,0,14.0,13.0,1.0,7
18738,18738,2008-09,2008,2009,Wigan,Chelsea,Loss,Away,2009-02-28,0,2,3,4,4,4,4,7,10,-2,-1,-3,-6,0,14.0,2.0,12.0,7
18739,18739,2008-09,2008,2009,Wigan,West Ham,Loss,Home,2009-03-04,0,1,2,3,4,3,3,4,7,-2,-1,-1,-3,1,14.0,10.0,4.0,8
18740,18740,2008-09,2008,2009,Wigan,Sunderland,Win,Away,2009-03-14,3,0,1,2,3,1,2,5,6,-1,-1,-3,-3,0,14.0,15.0,-1.0,8
18741,18741,2008-09,2008,2009,Wigan,Hull,Win,Home,2009-03-22,3,3,3,4,5,4,4,4,5,-1,-1,0,0,1,14.0,21.0,-7.0,8
18742,18742,2008-09,2008,2009,Wigan,Everton,Loss,Away,2009-04-05,0,6,6,6,7,3,4,7,8,3,2,-1,-1,0,14.0,5.0,9.0,9
18743,18743,2008-09,2008,2009,Wigan,Arsenal,Loss,Home,2009-04-11,0,3,6,6,6,6,9,12,13,-3,-3,-6,-7,1,14.0,3.0,11.0,9
18744,18744,2008-09,2008,2009,Wigan,Blackburn,Loss,Away,2009-04-26,0,0,3,6,6,0,3,4,4,0,0,2,2,0,14.0,7.0,7.0,9
18745,18745,2008-09,2008,2009,Wigan,Bolton,Draw,Home,2009-05-02,1,0,0,3,6,1,1,4,5,-1,-1,-1,1,1,14.0,16.0,-2.0,10
18746,18746,2008-09,2008,2009,Wigan,West Brom,Loss,Away,2009-05-09,0,1,1,1,4,3,3,4,4,-2,-2,-3,0,0,14.0,21.0,-7.0,10
18747,18747,2008-09,2008,2009,Wigan,Man United,Loss,Home,2009-05-13,0,1,1,1,1,6,9,12,15,-5,-8,-11,-14,1,14.0,1.0,13.0,10
18748,18748,2008-09,2008,2009,Wigan,Stoke,Loss,Away,2009-05-16,0,0,1,1,1,3,3,6,7,-3,-2,-5,-6,0,14.0,21.0,-7.0,10
18749,18749,2008-09,2008,2009,Wigan,Portsmouth,Win,Home,2009-05-24,3,0,0,1,1,3,3,4,4,-3,-3,-3,-3,1,14.0,8.0,6.0,10
18750,18750,2009-10,2009,2010,Wigan,Aston Villa,Win,Away,2009-08-15,3,3,3,3,4,4,4,7,8,-1,-1,-4,-4,0,11.0,6.0,5.0,1
18751,18751,2009-10,2009,2010,Wigan,Wolves,Loss,Home,2009-08-18,0,6,6,6,6,0,1,4,5,6,5,2,1,1,11.0,21.0,-10.0,1
18752,18752,2009-10,2009,2010,Wigan,Man United,Loss,Home,2009-08-22,0,3,6,6,6,3,6,7,10,0,0,-1,-4,1,11.0,1.0,10.0,1
18753,18753,2009-10,2009,2010,Wigan,Everton,Loss,Away,2009-08-30,0,0,3,6,6,0,3,6,7,0,0,0,-1,0,11.0,5.0,6.0,1
18754,18754,2009-10,2009,2010,Wigan,West Ham,Win,Home,2009-09-12,3,0,0,3,6,1,4,7,7,-1,-4,-4,-1,1,11.0,9.0,2.0,2
18755,18755,2009-10,2009,2010,Wigan,Arsenal,Loss,Away,2009-09-19,0,3,3,3,6,0,3,6,9,3,0,-3,-3,0,11.0,4.0,7.0,2
18756,18756,2009-10,2009,2010,Wigan,Chelsea,Win,Home,2009-09-26,3,3,3,3,3,6,9,12,15,-3,-6,-9,-12,1,11.0,3.0,8.0,2
18757,18757,2009-10,2009,2010,Wigan,Hull,Loss,Away,2009-10-03,0,3,6,6,6,0,0,1,4,3,6,5,2,0,11.0,17.0,-6.0,3
18758,18758,2009-10,2009,2010,Wigan,Man City,Draw,Home,2009-10-18,1,3,3,6,6,4,4,7,10,-1,-1,-1,-4,1,11.0,10.0,1.0,3
18759,18759,2009-10,2009,2010,Wigan,Burnley,Win,Away,2009-10-24,3,1,4,4,7,3,3,6,6,-2,1,-2,1,0,11.0,21.0,-10.0,3
18760,18760,2009-10,2009,2010,Wigan,Portsmouth,Loss,Away,2009-10-31,0,4,4,7,7,1,4,4,4,3,0,3,3,0,11.0,14.0,-3.0,3
18761,18761,2009-10,2009,2010,Wigan,Fulham,Draw,Home,2009-11-08,1,3,4,4,7,4,7,8,8,-1,-3,-4,-1,1,11.0,7.0,4.0,4
18762,18762,2009-10,2009,2010,Wigan,Tottenham,Loss,Away,2009-11-22,0,1,4,5,5,3,3,6,7,-2,1,-1,-2,0,11.0,8.0,3.0,4
18763,18763,2009-10,2009,2010,Wigan,Sunderland,Win,Home,2009-11-28,3,1,1,4,5,3,4,4,7,-2,-3,0,-2,1,11.0,16.0,-5.0,4
18764,18764,2009-10,2009,2010,Wigan,Birmingham,Loss,Home,2009-12-05,0,3,4,4,7,6,7,8,11,-3,-3,-4,-4,1,11.0,21.0,-10.0,5
18765,18765,2009-10,2009,2010,Wigan,Stoke,Draw,Away,2009-12-12,1,3,3,4,4,1,4,4,5,2,-1,0,-1,0,11.0,12.0,-1.0,5
18766,18766,2009-10,2009,2010,Wigan,Liverpool,Loss,Away,2009-12-16,0,1,4,4,5,1,4,5,6,0,0,-1,-1,0,11.0,2.0,9.0,5
18767,18767,2009-10,2009,2010,Wigan,Blackburn,Draw,Home,2009-12-26,1,1,1,4,4,0,1,2,3,1,0,2,1,1,11.0,15.0,-4.0,5
18768,18768,2009-10,2009,2010,Wigan,Man United,Loss,Away,2009-12-30,0,1,2,2,5,3,6,6,9,-2,-4,-4,-4,0,11.0,1.0,10.0,5
18769,18769,2009-10,2009,2010,Wigan,Wolves,Win,Away,2010-01-16,3,1,1,2,2,0,3,3,6,1,-2,-1,-4,0,11.0,21.0,-10.0,6
18770,18770,2009-10,2009,2010,Wigan,Blackburn,Loss,Away,2010-01-27,0,3,4,4,5,3,4,5,5,0,0,-1,0,0,11.0,15.0,-4.0,6
18771,18771,2009-10,2009,2010,Wigan,Everton,Loss,Home,2010-01-30,0,3,3,4,4,6,7,10,11,-3,-4,-6,-7,1,11.0,5.0,6.0,6
18772,18772,2009-10,2009,2010,Wigan,Sunderland,Draw,Away,2010-02-06,1,0,3,3,4,1,1,2,3,-1,2,1,1,0,11.0,16.0,-5.0,7
18773,18773,2009-10,2009,2010,Wigan,Stoke,Draw,Home,2010-02-09,1,1,1,4,4,4,5,8,8,-3,-4,-4,-4,1,11.0,12.0,-1.0,7
18774,18774,2009-10,2009,2010,Wigan,Bolton,Draw,Home,2010-02-17,1,2,2,2,5,1,1,4,4,1,1,-2,1,1,11.0,13.0,-2.0,7
18775,18775,2009-10,2009,2010,Wigan,Tottenham,Loss,Home,2010-02-21,0,2,3,3,3,1,2,5,5,1,1,-2,-2,1,11.0,8.0,3.0,7
18776,18776,2009-10,2009,2010,Wigan,Birmingham,Loss,Away,2010-02-27,0,1,2,3,3,0,3,4,4,1,-1,-1,-1,0,11.0,21.0,-10.0,7
18777,18777,2009-10,2009,2010,Wigan,Liverpool,Win,Home,2010-03-08,3,0,1,2,3,4,4,7,10,-4,-3,-5,-7,1,11.0,2.0,9.0,8
18778,18778,2009-10,2009,2010,Wigan,Bolton,Loss,Away,2010-03-13,0,3,3,4,5,3,6,6,7,0,-3,-2,-2,0,11.0,13.0,-2.0,8
18779,18779,2009-10,2009,2010,Wigan,Aston Villa,Loss,Home,2010-03-16,0,3,3,3,4,4,5,6,9,-1,-2,-3,-5,1,11.0,6.0,5.0,8
18780,18780,2009-10,2009,2010,Wigan,Burnley,Win,Home,2010-03-20,3,0,3,3,3,1,1,1,1,-1,2,2,2,1,11.0,21.0,-10.0,8
18781,18781,2009-10,2009,2010,Wigan,Man City,Loss,Away,2010-03-29,0,3,3,6,6,3,4,7,8,0,-1,-1,-2,0,11.0,10.0,1.0,8
18782,18782,2009-10,2009,2010,Wigan,Fulham,Loss,Away,2010-04-04,0,3,3,3,6,0,0,1,4,3,3,2,2,0,11.0,7.0,4.0,9
18783,18783,2009-10,2009,2010,Wigan,Portsmouth,Draw,Home,2010-04-14,1,0,3,3,3,1,1,4,4,-1,2,-1,-1,1,11.0,14.0,-3.0,9
18784,18784,2009-10,2009,2010,Wigan,Arsenal,Win,Home,2010-04-18,3,1,1,4,4,3,4,7,10,-2,-3,-3,-6,1,11.0,4.0,7.0,9
18785,18785,2009-10,2009,2010,Wigan,West Ham,Loss,Away,2010-04-24,0,4,4,4,7,3,4,4,4,1,0,0,3,0,11.0,9.0,2.0,9
18786,18786,2009-10,2009,2010,Wigan,Hull,Draw,Home,2010-05-03,1,3,4,4,4,0,1,1,1,3,3,3,3,1,11.0,17.0,-6.0,10
18787,18787,2009-10,2009,2010,Wigan,Chelsea,Loss,Away,2010-05-09,0,1,4,5,5,6,6,9,12,-5,-2,-4,-7,0,11.0,3.0,8.0,10
18788,18788,2010-11,2010,2011,Wigan,Blackpool,Loss,Home,2010-08-14,0,1,1,4,5,0,0,0,0,1,1,4,5,1,16.0,21.0,-5.0,1
18789,18789,2010-11,2010,2011,Wigan,Chelsea,Loss,Home,2010-08-21,0,0,1,1,4,6,9,12,12,-6,-8,-11,-8,1,16.0,1.0,15.0,1
18790,18790,2010-11,2010,2011,Wigan,Tottenham,Win,Away,2010-08-28,3,0,0,1,1,4,4,7,10,-4,-4,-6,-9,0,16.0,4.0,12.0,1
18791,18791,2010-11,2010,2011,Wigan,Sunderland,Draw,Home,2010-09-11,1,3,3,3,4,3,4,4,4,0,-1,-1,0,1,16.0,13.0,3.0,2
18792,18792,2010-11,2010,2011,Wigan,Man City,Loss,Home,2010-09-19,0,4,4,4,4,1,4,5,6,3,0,-1,-2,1,16.0,5.0,11.0,2
18793,18793,2010-11,2010,2011,Wigan,Birmingham,Draw,Away,2010-09-25,1,1,4,4,4,1,2,5,6,0,2,-1,-2,0,16.0,9.0,7.0,2
18794,18794,2010-11,2010,2011,Wigan,Wolves,Win,Home,2010-10-02,3,1,2,5,5,0,0,1,2,1,2,4,3,1,16.0,15.0,1.0,3
18795,18795,2010-11,2010,2011,Wigan,Newcastle,Draw,Away,2010-10-16,1,4,4,5,8,0,3,3,4,4,1,2,4,0,16.0,21.0,-5.0,3
18796,18796,2010-11,2010,2011,Wigan,Bolton,Draw,Home,2010-10-23,1,4,5,5,6,4,5,6,6,0,0,-1,0,1,16.0,14.0,2.0,3
18797,18797,2010-11,2010,2011,Wigan,Fulham,Loss,Away,2010-10-30,0,2,5,6,6,0,1,2,3,2,4,4,3,0,16.0,12.0,4.0,3
18798,18798,2010-11,2010,2011,Wigan,Blackburn,Loss,Away,2010-11-06,0,1,2,5,6,0,1,1,4,1,1,4,2,0,16.0,10.0,6.0,4
18799,18799,2010-11,2010,2011,Wigan,Liverpool,Draw,Home,2010-11-10,1,0,1,2,5,6,9,9,9,-6,-8,-7,-4,1,16.0,7.0,9.0,4
18800,18800,2010-11,2010,2011,Wigan,West Brom,Win,Home,2010-11-13,3,1,1,2,3,1,1,4,5,0,0,-2,-2,1,16.0,21.0,-5.0,4
18801,18801,2010-11,2010,2011,Wigan,Man United,Loss,Away,2010-11-20,0,4,4,4,5,2,5,8,11,2,-1,-4,-6,0,16.0,2.0,14.0,4
18802,18802,2010-11,2010,2011,Wigan,West Ham,Loss,Away,2010-11-27,0,3,4,4,4,1,2,3,3,2,2,1,1,0,16.0,17.0,-1.0,4
18803,18803,2010-11,2010,2011,Wigan,Stoke,Draw,Home,2010-12-04,1,0,3,4,4,4,7,10,10,-4,-4,-6,-6,1,16.0,11.0,5.0,5
18804,18804,2010-11,2010,2011,Wigan,Everton,Draw,Away,2010-12-11,1,1,1,4,5,1,2,2,3,0,-1,2,2,0,16.0,8.0,8.0,5
18805,18805,2010-11,2010,2011,Wigan,Wolves,Win,Away,2010-12-26,3,2,2,2,5,3,6,6,6,-1,-4,-4,-1,0,16.0,15.0,1.0,5
18806,18806,2010-11,2010,2011,Wigan,Arsenal,Draw,Home,2010-12-29,1,4,5,5,5,3,6,9,9,1,-1,-4,-4,1,16.0,3.0,13.0,5
18807,18807,2010-11,2010,2011,Wigan,Newcastle,Loss,Home,2011-01-02,0,4,5,6,6,0,3,3,4,4,2,3,2,1,16.0,21.0,-5.0,6
18808,18808,2010-11,2010,2011,Wigan,Bolton,Draw,Away,2011-01-05,1,1,4,5,6,0,3,3,6,1,1,2,0,0,16.0,14.0,2.0,6
18809,18809,2010-11,2010,2011,Wigan,Fulham,Draw,Home,2011-01-15,1,1,2,5,6,3,6,6,7,-2,-4,-1,-1,1,16.0,12.0,4.0,6
18810,18810,2010-11,2010,2011,Wigan,Arsenal,Loss,Away,2011-01-22,0,2,2,3,6,4,7,8,11,-2,-5,-5,-5,0,16.0,3.0,13.0,6
18811,18811,2010-11,2010,2011,Wigan,Aston Villa,Loss,Home,2011-01-25,0,1,2,2,3,4,4,5,5,-3,-2,-3,-2,1,16.0,6.0,10.0,6
18812,18812,2010-11,2010,2011,Wigan,West Brom,Draw,Away,2011-02-01,1,0,1,2,2,3,3,3,3,-3,-2,-1,-1,0,16.0,21.0,-5.0,7
18813,18813,2010-11,2010,2011,Wigan,Blackburn,Win,Home,2011-02-05,3,1,1,2,3,3,3,6,6,-2,-2,-4,-3,1,16.0,10.0,6.0,7
18814,18814,2010-11,2010,2011,Wigan,Liverpool,Draw,Away,2011-02-12,1,4,4,4,5,6,9,12,13,-2,-5,-8,-8,0,16.0,7.0,9.0,7
18815,18815,2010-11,2010,2011,Wigan,Man United,Loss,Home,2011-02-26,0,4,5,5,5,3,6,9,12,1,-1,-4,-7,1,16.0,2.0,14.0,7
18816,18816,2010-11,2010,2011,Wigan,Man City,Loss,Away,2011-03-05,0,1,4,5,5,1,4,5,5,0,0,0,0,0,16.0,5.0,11.0,8
18817,18817,2010-11,2010,2011,Wigan,Birmingham,Win,Home,2011-03-19,3,0,1,4,5,1,1,4,7,-1,0,0,-2,1,16.0,9.0,7.0,8
18818,18818,2010-11,2010,2011,Wigan,Tottenham,Draw,Home,2011-04-02,1,3,3,4,7,2,2,5,8,1,1,-1,-1,1,16.0,4.0,12.0,9
18819,18819,2010-11,2010,2011,Wigan,Chelsea,Loss,Away,2011-04-09,0,4,4,4,5,4,7,10,11,0,-3,-6,-6,0,16.0,1.0,15.0,9
18820,18820,2010-11,2010,2011,Wigan,Blackpool,Win,Away,2011-04-16,3,1,4,4,4,0,1,1,1,1,3,3,3,0,16.0,21.0,-5.0,9
18821,18821,2010-11,2010,2011,Wigan,Sunderland,Loss,Away,2011-04-23,0,3,4,7,7,0,0,0,1,3,4,7,6,0,16.0,13.0,3.0,9
18822,18822,2010-11,2010,2011,Wigan,Everton,Draw,Home,2011-04-30,1,3,3,4,7,3,6,7,10,0,-3,-3,-3,1,16.0,8.0,8.0,9
18823,18823,2010-11,2010,2011,Wigan,Aston Villa,Draw,Away,2011-05-07,1,1,4,4,5,1,4,7,8,0,0,-3,-3,0,16.0,6.0,10.0,10
18824,18824,2010-11,2010,2011,Wigan,West Ham,Win,Home,2011-05-15,3,2,2,5,5,1,1,1,1,1,1,4,4,1,16.0,17.0,-1.0,10
18825,18825,2010-11,2010,2011,Wigan,Stoke,Win,Away,2011-05-22,3,4,5,5,8,3,4,7,8,1,1,-2,0,0,16.0,11.0,5.0,10
18826,18826,2011-12,2011,2012,Wigan,Norwich,Draw,Home,2011-08-13,1,6,7,8,8,3,3,6,9,3,4,2,-1,1,16.0,21.0,-5.0,1
18827,18827,2011-12,2011,2012,Wigan,Swansea,Draw,Away,2011-08-20,1,4,7,8,9,0,0,0,0,4,7,8,9,0,16.0,21.0,-5.0,1
18828,18828,2011-12,2011,2012,Wigan,QPR,Win,Home,2011-08-27,3,2,5,8,9,3,3,6,6,-1,2,2,3,1,16.0,21.0,-5.0,1
18829,18829,2011-12,2011,2012,Wigan,Man City,Loss,Away,2011-09-10,0,4,5,8,11,6,9,12,15,-2,-4,-4,-4,0,16.0,3.0,13.0,2
18830,18830,2011-12,2011,2012,Wigan,Everton,Loss,Away,2011-09-17,0,3,4,5,8,4,4,7,7,-1,0,-2,1,0,16.0,7.0,9.0,2
18831,18831,2011-12,2011,2012,Wigan,Tottenham,Loss,Home,2011-09-24,0,0,3,4,5,6,6,6,9,-6,-3,-2,-4,1,16.0,5.0,11.0,2
18832,18832,2011-12,2011,2012,Wigan,Aston Villa,Loss,Away,2011-10-01,0,0,0,3,4,2,3,4,7,-2,-3,-1,-3,0,16.0,9.0,7.0,3
18833,18833,2011-12,2011,2012,Wigan,Bolton,Loss,Home,2011-10-15,0,0,0,0,3,0,0,0,0,0,0,0,3,1,16.0,14.0,2.0,3
18834,18834,2011-12,2011,2012,Wigan,Newcastle,Loss,Away,2011-10-22,0,0,0,0,0,4,7,8,9,-4,-7,-8,-9,0,16.0,12.0,4.0,3
18835,18835,2011-12,2011,2012,Wigan,Fulham,Loss,Home,2011-10-29,0,0,0,0,0,0,3,4,5,0,-3,-4,-5,1,16.0,8.0,8.0,3
18836,18836,2011-12,2011,2012,Wigan,Wolves,Loss,Away,2011-11-06,0,0,0,0,0,1,1,1,1,-1,-1,-1,-1,0,16.0,17.0,-1.0,4
18837,18837,2011-12,2011,2012,Wigan,Blackburn,Draw,Home,2011-11-19,1,0,0,0,0,1,1,2,2,-1,-1,-2,-2,1,16.0,15.0,1.0,4
18838,18838,2011-12,2011,2012,Wigan,Sunderland,Win,Away,2011-11-26,3,1,1,1,1,1,2,5,5,0,-1,-4,-4,0,16.0,10.0,6.0,4
18839,18839,2011-12,2011,2012,Wigan,Arsenal,Loss,Home,2011-12-03,0,4,4,4,4,4,7,10,13,0,-3,-6,-9,1,16.0,4.0,12.0,5
18840,18840,2011-12,2011,2012,Wigan,West Brom,Win,Away,2011-12-10,3,3,4,4,4,1,4,4,4,2,0,0,0,0,16.0,11.0,5.0,5
18841,18841,2011-12,2011,2012,Wigan,Chelsea,Draw,Home,2011-12-17,1,3,6,7,7,6,9,9,12,-3,-3,-2,-5,1,16.0,2.0,14.0,5
18842,18842,2011-12,2011,2012,Wigan,Liverpool,Draw,Home,2011-12-21,1,4,4,7,8,6,6,7,10,-2,-2,0,-2,1,16.0,6.0,10.0,5
18843,18843,2011-12,2011,2012,Wigan,Man United,Loss,Away,2011-12-26,0,2,5,5,8,6,9,12,13,-4,-4,-7,-5,0,16.0,1.0,15.0,5
18844,18844,2011-12,2011,2012,Wigan,Stoke,Draw,Away,2011-12-31,1,1,2,5,5,1,4,7,10,0,-2,-2,-5,0,16.0,13.0,3.0,5
18845,18845,2011-12,2011,2012,Wigan,Sunderland,Loss,Home,2012-01-03,0,1,2,3,6,4,7,7,10,-3,-5,-4,-4,1,16.0,10.0,6.0,6
18846,18846,2011-12,2011,2012,Wigan,Man City,Loss,Home,2012-01-16,0,1,1,2,3,3,4,7,10,-2,-3,-5,-7,1,16.0,3.0,13.0,6
18847,18847,2011-12,2011,2012,Wigan,QPR,Loss,Away,2012-01-21,0,0,1,1,2,0,0,1,1,0,1,0,1,0,16.0,21.0,-5.0,6
18848,18848,2011-12,2011,2012,Wigan,Tottenham,Loss,Away,2012-01-31,0,0,0,1,1,1,4,7,8,-1,-4,-6,-7,0,16.0,5.0,11.0,6
18849,18849,2011-12,2011,2012,Wigan,Everton,Draw,Home,2012-02-04,1,0,0,0,1,4,5,5,5,-4,-5,-5,-4,1,16.0,7.0,9.0,7
18850,18850,2011-12,2011,2012,Wigan,Bolton,Win,Away,2012-02-11,3,1,1,1,1,1,4,4,7,0,-3,-3,-6,0,16.0,14.0,2.0,7
18851,18851,2011-12,2011,2012,Wigan,Aston Villa,Draw,Home,2012-02-25,1,4,4,4,4,0,1,4,5,4,3,0,-1,1,16.0,9.0,7.0,7
18852,18852,2011-12,2011,2012,Wigan,Swansea,Loss,Home,2012-03-03,0,4,5,5,5,0,3,4,4,4,2,1,1,1,16.0,21.0,-5.0,8
18853,18853,2011-12,2011,2012,Wigan,Norwich,Draw,Away,2012-03-11,1,1,4,5,5,0,3,6,6,1,1,-1,-1,0,16.0,21.0,-5.0,8
18854,18854,2011-12,2011,2012,Wigan,West Brom,Draw,Home,2012-03-17,1,1,2,5,6,3,6,9,9,-2,-4,-4,-3,1,16.0,11.0,5.0,8
18855,18855,2011-12,2011,2012,Wigan,Liverpool,Win,Away,2012-03-24,3,2,2,3,6,3,3,3,3,-1,-1,0,3,0,16.0,6.0,10.0,8
18856,18856,2011-12,2011,2012,Wigan,Stoke,Win,Home,2012-03-31,3,4,5,5,6,2,2,5,8,2,3,0,-2,1,16.0,13.0,3.0,8
18857,18857,2011-12,2011,2012,Wigan,Chelsea,Loss,Away,2012-04-07,0,6,7,8,8,4,4,7,7,2,3,1,1,0,16.0,2.0,14.0,9
18858,18858,2011-12,2011,2012,Wigan,Man United,Win,Home,2012-04-11,3,3,6,7,8,6,9,12,15,-3,-3,-5,-7,1,16.0,1.0,15.0,9
18859,18859,2011-12,2011,2012,Wigan,Arsenal,Win,Away,2012-04-16,3,3,6,9,10,6,6,9,12,-3,0,0,-2,0,16.0,4.0,12.0,9
18860,18860,2011-12,2011,2012,Wigan,Fulham,Loss,Away,2012-04-21,0,6,6,9,12,4,7,7,7,2,-1,2,5,0,16.0,8.0,8.0,9
18861,18861,2011-12,2011,2012,Wigan,Newcastle,Win,Home,2012-04-28,3,3,6,6,9,6,9,12,15,-3,-3,-6,-6,1,16.0,12.0,4.0,9
18862,18862,2011-12,2011,2012,Wigan,Blackburn,Win,Away,2012-05-07,3,3,6,9,9,3,3,3,3,0,3,6,6,0,16.0,15.0,1.0,10
18863,18863,2011-12,2011,2012,Wigan,Wolves,Win,Home,2012-05-13,3,6,6,9,12,2,2,3,3,4,4,6,9,1,16.0,17.0,-1.0,10
18864,18864,2012-13,2012,2013,Wigan,Chelsea,Loss,Home,2012-08-19,0,6,9,9,12,3,3,6,7,3,6,3,5,1,15.0,6.0,9.0,1
18865,18865,2012-13,2012,2013,Wigan,Southampton,Win,Away,2012-08-25,3,3,6,9,9,0,1,4,4,3,5,5,5,0,15.0,21.0,-6.0,1
18866,18866,2012-13,2012,2013,Wigan,Stoke,Draw,Home,2012-09-01,1,3,6,9,12,2,3,3,4,1,3,6,8,1,15.0,14.0,1.0,2
18867,18867,2012-13,2012,2013,Wigan,Man United,Loss,Away,2012-09-15,0,4,4,7,10,6,6,9,12,-2,-2,-2,-2,0,15.0,2.0,13.0,2
18868,18868,2012-13,2012,2013,Wigan,Fulham,Loss,Home,2012-09-22,0,1,4,4,7,3,3,6,6,-2,1,-2,1,1,15.0,9.0,6.0,2
18869,18869,2012-13,2012,2013,Wigan,Sunderland,Loss,Away,2012-09-29,0,0,1,4,4,2,3,4,4,-2,-2,0,0,0,15.0,13.0,2.0,2
18870,18870,2012-13,2012,2013,Wigan,Everton,Draw,Home,2012-10-06,1,0,0,1,4,6,7,7,10,-6,-7,-6,-6,1,15.0,7.0,8.0,3
18871,18871,2012-13,2012,2013,Wigan,Swansea,Loss,Away,2012-10-20,0,1,1,1,2,1,1,1,2,0,0,0,0,0,15.0,11.0,4.0,3
18872,18872,2012-13,2012,2013,Wigan,West Ham,Win,Home,2012-10-27,3,1,1,1,1,3,6,7,8,-2,-5,-6,-7,1,15.0,21.0,-6.0,3
18873,18873,2012-13,2012,2013,Wigan,Tottenham,Win,Away,2012-11-03,3,3,4,4,4,3,6,9,12,0,-2,-5,-8,0,15.0,4.0,11.0,4
18874,18874,2012-13,2012,2013,Wigan,West Brom,Loss,Home,2012-11-10,0,6,6,7,7,3,3,6,7,3,3,1,0,1,15.0,10.0,5.0,4
18875,18875,2012-13,2012,2013,Wigan,Liverpool,Loss,Away,2012-11-17,0,3,6,6,7,2,3,6,7,1,3,0,0,0,15.0,8.0,7.0,4
18876,18876,2012-13,2012,2013,Wigan,Reading,Win,Home,2012-11-24,3,0,3,6,6,4,5,6,6,-4,-2,0,0,1,15.0,21.0,-6.0,4
18877,18877,2012-13,2012,2013,Wigan,Man City,Loss,Home,2012-11-28,0,3,3,6,9,4,7,8,11,-1,-4,-2,-2,1,15.0,1.0,14.0,4
18878,18878,2012-13,2012,2013,Wigan,Newcastle,Loss,Away,2012-12-03,0,3,3,3,6,0,0,0,1,3,3,3,5,0,15.0,5.0,10.0,5
18879,18879,2012-13,2012,2013,Wigan,QPR,Draw,Home,2012-12-08,1,0,3,3,3,2,2,2,2,-2,1,1,1,1,15.0,17.0,-2.0,5
18880,18880,2012-13,2012,2013,Wigan,Norwich,Loss,Away,2012-12-15,0,1,1,4,4,6,7,8,11,-5,-6,-4,-7,0,15.0,12.0,3.0,5
18881,18881,2012-13,2012,2013,Wigan,Arsenal,Loss,Home,2012-12-22,0,1,1,1,4,6,6,7,8,-5,-5,-6,-4,1,15.0,3.0,12.0,5
18882,18882,2012-13,2012,2013,Wigan,Everton,Loss,Away,2012-12-26,0,0,1,1,1,4,7,8,9,-4,-6,-7,-8,0,15.0,7.0,8.0,5
18883,18883,2012-13,2012,2013,Wigan,Aston Villa,Win,Away,2012-12-29,3,0,0,1,1,0,3,4,5,0,-3,-3,-4,0,15.0,16.0,-1.0,5
18884,18884,2012-13,2012,2013,Wigan,Man United,Loss,Home,2013-01-01,0,3,3,3,4,6,7,10,13,-3,-4,-7,-9,1,15.0,2.0,13.0,6
18885,18885,2012-13,2012,2013,Wigan,Fulham,Draw,Away,2013-01-12,1,3,3,3,3,3,4,4,4,0,-1,-1,-1,0,15.0,9.0,6.0,6
18886,18886,2012-13,2012,2013,Wigan,Sunderland,Loss,Home,2013-01-19,0,1,4,4,4,3,3,6,9,-2,1,-2,-5,1,15.0,13.0,2.0,6
18887,18887,2012-13,2012,2013,Wigan,Stoke,Draw,Away,2013-01-29,1,1,1,4,4,0,0,1,4,1,1,3,0,0,15.0,14.0,1.0,6
18888,18888,2012-13,2012,2013,Wigan,Southampton,Draw,Home,2013-02-02,1,1,2,2,5,1,2,5,6,0,0,-3,-1,1,15.0,21.0,-6.0,7
18889,18889,2012-13,2012,2013,Wigan,Chelsea,Loss,Away,2013-02-09,0,2,2,3,3,1,4,5,8,1,-2,-2,-5,0,15.0,6.0,9.0,7
18890,18890,2012-13,2012,2013,Wigan,Reading,Win,Away,2013-02-23,3,1,2,2,3,3,4,7,10,-2,-2,-5,-7,0,15.0,21.0,-6.0,7
18891,18891,2012-13,2012,2013,Wigan,Liverpool,Loss,Home,2013-03-02,0,3,4,5,5,3,4,5,8,0,0,0,-3,1,15.0,8.0,7.0,8
18892,18892,2012-13,2012,2013,Wigan,Newcastle,Win,Home,2013-03-17,3,3,3,4,5,3,6,6,9,0,-3,-2,-4,1,15.0,5.0,10.0,8
18893,18893,2012-13,2012,2013,Wigan,Norwich,Win,Home,2013-03-30,3,3,6,6,7,2,2,5,6,1,4,1,1,1,15.0,12.0,3.0,8
18894,18894,2012-13,2012,2013,Wigan,QPR,Draw,Away,2013-04-07,1,6,6,9,9,0,3,6,6,6,3,3,3,0,15.0,17.0,-2.0,9
18895,18895,2012-13,2012,2013,Wigan,Man City,Loss,Away,2013-04-17,0,4,7,7,10,6,6,9,12,-2,1,-2,-2,0,15.0,1.0,14.0,9
18896,18896,2012-13,2012,2013,Wigan,West Ham,Loss,Away,2013-04-20,0,1,4,7,7,2,3,6,6,-1,1,1,1,0,15.0,21.0,-6.0,9
18897,18897,2012-13,2012,2013,Wigan,Tottenham,Draw,Home,2013-04-27,1,0,1,4,7,4,7,7,7,-4,-6,-3,0,1,15.0,4.0,11.0,9
18898,18898,2012-13,2012,2013,Wigan,West Brom,Win,Away,2013-05-04,3,1,1,2,5,4,4,4,5,-3,-3,-2,0,0,15.0,10.0,5.0,10
18899,18899,2012-13,2012,2013,Wigan,Swansea,Loss,Home,2013-05-07,0,4,4,4,5,1,2,3,3,3,2,1,2,1,15.0,11.0,4.0,10
18900,18900,2012-13,2012,2013,Wigan,Arsenal,Loss,Away,2013-05-14,0,3,4,4,4,4,7,8,11,-1,-3,-4,-7,0,15.0,3.0,12.0,10
18901,18901,2012-13,2012,2013,Wigan,Aston Villa,Draw,Home,2013-05-19,1,0,3,4,4,3,6,6,7,-3,-3,-2,-3,1,15.0,16.0,-1.0,10
18902,18902,1993-94,1993,1994,Wimbledon,West Ham,Win,Away,1993-08-14,3,0,0,0,0,0,0,0,0,0,0,0,0,0,12.0,21.0,-9.0,1
18903,18903,1993-94,1993,1994,Wimbledon,Chelsea,Draw,Home,1993-08-17,1,3,3,3,3,0,0,0,0,3,3,3,3,1,12.0,11.0,1.0,1
18904,18904,1993-94,1993,1994,Wimbledon,Aston Villa,Draw,Home,1993-08-21,1,4,4,4,4,4,4,4,4,0,0,0,0,1,12.0,2.0,10.0,1
18905,18905,1993-94,1993,1994,Wimbledon,Sheffield United,Loss,Away,1993-08-24,0,2,5,5,5,0,3,3,3,2,2,2,2,0,12.0,14.0,-2.0,1
18906,18906,1993-94,1993,1994,Wimbledon,Oldham,Draw,Away,1993-08-28,1,1,2,5,5,1,4,4,4,0,-2,1,1,0,12.0,19.0,-7.0,1
18907,18907,1993-94,1993,1994,Wimbledon,Southampton,Win,Home,1993-08-31,3,1,2,3,6,3,3,3,3,-2,-1,0,3,1,12.0,18.0,-6.0,1
18908,18908,1993-94,1993,1994,Wimbledon,Norwich,Win,Away,1993-09-11,3,4,4,5,6,2,5,8,11,2,-1,-3,-5,0,12.0,3.0,9.0,2
18909,18909,1993-94,1993,1994,Wimbledon,Man City,Win,Home,1993-09-20,3,6,7,7,8,6,7,7,7,0,0,0,1,1,12.0,9.0,3.0,2
18910,18910,1993-94,1993,1994,Wimbledon,QPR,Draw,Home,1993-09-27,1,6,9,10,10,1,4,7,7,5,5,3,3,1,12.0,5.0,7.0,2
18911,18911,1993-94,1993,1994,Wimbledon,Leeds,Loss,Away,1993-10-02,0,4,7,10,11,6,9,12,12,-2,-2,-2,-1,0,12.0,17.0,-5.0,3
18912,18912,1993-94,1993,1994,Wimbledon,Sheffield Weds,Draw,Away,1993-10-16,1,1,4,7,10,1,4,4,5,0,0,3,5,0,12.0,7.0,5.0,3
18913,18913,1993-94,1993,1994,Wimbledon,Ipswich,Loss,Home,1993-10-25,0,1,2,5,8,1,2,2,2,0,0,3,6,1,12.0,16.0,-4.0,3
18914,18914,1993-94,1993,1994,Wimbledon,Newcastle,Loss,Away,1993-10-30,0,1,1,2,5,0,3,6,7,1,-2,-4,-2,0,12.0,21.0,-9.0,3
18915,18915,1993-94,1993,1994,Wimbledon,Swindon,Win,Home,1993-11-06,3,0,1,1,2,1,2,2,2,-1,-1,-1,0,1,12.0,21.0,-9.0,4
18916,18916,1993-94,1993,1994,Wimbledon,Man United,Loss,Away,1993-11-20,0,3,3,4,4,6,9,12,15,-3,-6,-8,-11,0,12.0,1.0,11.0,4
18917,18917,1993-94,1993,1994,Wimbledon,Tottenham,Draw,Away,1993-11-24,1,3,3,3,4,1,1,2,2,2,2,1,2,0,12.0,8.0,4.0,4
18918,18918,1993-94,1993,1994,Wimbledon,Everton,Draw,Home,1993-11-27,1,1,4,4,4,1,1,4,4,0,3,0,0,1,12.0,13.0,-1.0,4
18919,18919,1993-94,1993,1994,Wimbledon,West Ham,Loss,Home,1993-12-04,0,2,2,5,5,4,7,7,10,-2,-5,-2,-5,1,12.0,21.0,-9.0,5
18920,18920,1993-94,1993,1994,Wimbledon,Aston Villa,Win,Away,1993-12-11,3,1,2,2,5,2,2,2,5,-1,0,0,0,0,12.0,2.0,10.0,5
18921,18921,1993-94,1993,1994,Wimbledon,Sheffield United,Win,Home,1993-12-18,3,3,4,5,5,1,2,5,5,2,2,0,0,1,12.0,14.0,-2.0,5
18922,18922,1993-94,1993,1994,Wimbledon,Coventry,Loss,Home,1993-12-26,0,6,6,7,8,1,4,4,4,5,2,3,4,1,12.0,15.0,-3.0,5
18923,18923,1993-94,1993,1994,Wimbledon,Liverpool,Draw,Away,1993-12-28,1,3,6,6,7,2,3,6,6,1,3,0,1,0,12.0,6.0,6.0,5
18924,18924,1993-94,1993,1994,Wimbledon,Arsenal,Loss,Home,1994-01-01,0,1,4,7,7,6,6,9,10,-5,-2,-2,-3,1,12.0,10.0,2.0,6
18925,18925,1993-94,1993,1994,Wimbledon,Sheffield Weds,Win,Home,1994-01-15,3,1,1,4,7,6,7,10,13,-5,-6,-6,-6,1,12.0,7.0,5.0,6
18926,18926,1993-94,1993,1994,Wimbledon,Ipswich,Draw,Away,1994-01-22,1,3,4,4,7,1,2,5,6,2,2,-1,1,0,12.0,16.0,-4.0,6
18927,18927,1993-94,1993,1994,Wimbledon,Blackburn,Loss,Away,1994-02-05,0,4,4,5,5,6,9,12,13,-2,-5,-7,-8,0,12.0,4.0,8.0,7
18928,18928,1993-94,1993,1994,Wimbledon,Newcastle,Win,Home,1994-02-12,3,1,4,4,5,3,6,9,9,-2,-2,-5,-4,1,12.0,21.0,-9.0,7
18929,18929,1993-94,1993,1994,Wimbledon,Southampton,Loss,Away,1994-02-26,0,3,4,7,7,3,6,9,9,0,-2,-2,-2,0,12.0,18.0,-6.0,7
18930,18930,1993-94,1993,1994,Wimbledon,Norwich,Win,Home,1994-03-05,3,3,3,4,7,2,3,4,5,1,0,0,2,1,12.0,3.0,9.0,8
18931,18931,1993-94,1993,1994,Wimbledon,Man City,Win,Away,1994-03-12,3,3,6,6,7,4,5,5,6,-1,1,1,1,0,12.0,9.0,3.0,8
18932,18932,1993-94,1993,1994,Wimbledon,Chelsea,Loss,Away,1994-03-16,0,6,6,9,9,6,6,6,7,0,0,3,2,0,12.0,11.0,1.0,8
18933,18933,1993-94,1993,1994,Wimbledon,QPR,Loss,Away,1994-03-19,0,3,6,6,9,4,5,5,8,-1,1,1,1,0,12.0,5.0,7.0,8
18934,18934,1993-94,1993,1994,Wimbledon,Leeds,Win,Home,1994-03-27,3,0,3,6,6,6,7,8,9,-6,-4,-2,-3,1,12.0,17.0,-5.0,8
18935,18935,1993-94,1993,1994,Wimbledon,Blackburn,Win,Home,1994-03-29,3,3,3,6,9,6,9,9,10,-3,-6,-3,-1,1,12.0,4.0,8.0,8
18936,18936,1993-94,1993,1994,Wimbledon,Coventry,Win,Away,1994-04-02,3,6,6,6,9,3,3,3,3,3,3,3,6,0,12.0,15.0,-3.0,9
18937,18937,1993-94,1993,1994,Wimbledon,Liverpool,Draw,Home,1994-04-04,1,6,9,9,9,0,0,3,6,6,9,6,3,1,12.0,6.0,6.0,9
18938,18938,1993-94,1993,1994,Wimbledon,Man United,Win,Home,1994-04-16,3,4,7,10,10,3,6,7,8,1,1,3,2,1,12.0,1.0,11.0,9
18939,18939,1993-94,1993,1994,Wimbledon,Arsenal,Draw,Away,1994-04-19,1,4,7,10,13,4,5,8,9,0,2,2,4,0,12.0,10.0,2.0,9
18940,18940,1993-94,1993,1994,Wimbledon,Swindon,Win,Away,1994-04-23,3,4,5,8,11,1,2,2,3,3,3,6,8,0,12.0,21.0,-9.0,9
18941,18941,1993-94,1993,1994,Wimbledon,Oldham,Win,Home,1994-04-26,3,4,7,8,11,0,0,3,6,4,7,5,5,1,12.0,19.0,-7.0,9
18942,18942,1993-94,1993,1994,Wimbledon,Tottenham,Win,Home,1994-04-30,3,6,7,10,11,3,3,3,6,3,4,7,5,1,12.0,8.0,4.0,9
18943,18943,1993-94,1993,1994,Wimbledon,Everton,Loss,Away,1994-05-07,0,6,9,10,13,1,1,4,4,5,8,6,9,0,12.0,13.0,-1.0,10
18944,18944,1994-95,1994,1995,Wimbledon,Coventry,Draw,Away,1994-08-20,1,3,6,9,10,4,7,8,9,-1,-1,1,1,0,6.0,11.0,-5.0,1
18945,18945,1994-95,1994,1995,Wimbledon,Ipswich,Draw,Home,1994-08-23,1,1,4,7,10,1,1,1,2,0,3,6,8,1,6.0,19.0,-13.0,1
18946,18946,1994-95,1994,1995,Wimbledon,Sheffield Weds,Loss,Home,1994-08-27,0,2,2,5,8,0,1,2,3,2,1,3,5,1,6.0,7.0,-1.0,1
18947,18947,1994-95,1994,1995,Wimbledon,Man United,Loss,Away,1994-08-31,0,1,2,2,5,4,7,8,11,-3,-5,-6,-6,0,6.0,1.0,5.0,1
18948,18948,1994-95,1994,1995,Wimbledon,Leicester,Win,Home,1994-09-10,3,0,1,2,2,1,1,1,1,-1,0,1,1,1,6.0,21.0,-15.0,2
18949,18949,1994-95,1994,1995,Wimbledon,Crystal Palace,Draw,Away,1994-09-17,1,3,3,4,5,1,2,3,3,2,1,1,2,0,6.0,21.0,-15.0,2
18950,18950,1994-95,1994,1995,Wimbledon,QPR,Win,Away,1994-09-24,3,4,4,4,5,2,3,3,6,2,1,1,-1,0,6.0,9.0,-3.0,2
18951,18951,1994-95,1994,1995,Wimbledon,Tottenham,Loss,Home,1994-10-01,0,4,7,7,7,0,0,3,3,4,7,4,4,1,6.0,15.0,-9.0,3
18952,18952,1994-95,1994,1995,Wimbledon,Arsenal,Loss,Home,1994-10-08,0,3,4,7,7,3,3,4,5,0,1,3,2,1,6.0,4.0,2.0,3
18953,18953,1994-95,1994,1995,Wimbledon,Nott'm Forest,Loss,Away,1994-10-17,0,0,3,4,7,4,7,8,11,-4,-4,-4,-4,0,6.0,21.0,-15.0,3
18954,18954,1994-95,1994,1995,Wimbledon,Liverpool,Loss,Away,1994-10-22,0,0,0,3,4,3,6,7,7,-3,-6,-4,-3,0,6.0,8.0,-2.0,3
18955,18955,1994-95,1994,1995,Wimbledon,Norwich,Win,Home,1994-10-30,3,0,0,0,3,4,7,10,10,-4,-7,-10,-7,1,6.0,12.0,-6.0,3
18956,18956,1994-95,1994,1995,Wimbledon,Leeds,Loss,Away,1994-11-05,0,3,3,3,3,3,6,7,7,0,-3,-4,-4,0,6.0,5.0,1.0,4
18957,18957,1994-95,1994,1995,Wimbledon,Aston Villa,Win,Home,1994-11-09,3,3,3,3,3,0,0,1,1,3,3,2,2,1,6.0,10.0,-4.0,4
18958,18958,1994-95,1994,1995,Wimbledon,Newcastle,Win,Home,1994-11-19,3,3,6,6,6,4,4,7,10,-1,2,-1,-4,1,6.0,3.0,3.0,4
18959,18959,1994-95,1994,1995,Wimbledon,Man City,Loss,Away,1994-11-26,0,6,6,9,9,3,4,4,7,3,2,5,2,0,6.0,16.0,-10.0,4
18960,18960,1994-95,1994,1995,Wimbledon,Blackburn,Loss,Home,1994-12-03,0,3,6,6,9,6,9,12,15,-3,-3,-6,-6,1,6.0,2.0,4.0,5
18961,18961,1994-95,1994,1995,Wimbledon,Coventry,Win,Home,1994-12-10,3,0,3,6,6,4,7,8,8,-4,-4,-2,-2,1,6.0,11.0,-5.0,5
18962,18962,1994-95,1994,1995,Wimbledon,Ipswich,Draw,Away,1994-12-16,1,3,3,6,9,0,1,1,1,3,2,5,8,0,6.0,19.0,-13.0,5
18963,18963,1994-95,1994,1995,Wimbledon,Southampton,Win,Away,1994-12-26,3,4,4,4,7,3,3,4,7,1,1,0,0,0,6.0,18.0,-12.0,5
18964,18964,1994-95,1994,1995,Wimbledon,West Ham,Win,Home,1994-12-28,3,4,7,7,7,4,5,5,5,0,2,2,2,1,6.0,13.0,-7.0,5
18965,18965,1994-95,1994,1995,Wimbledon,Chelsea,Draw,Away,1994-12-31,1,6,7,10,10,0,1,1,4,6,6,9,6,0,6.0,14.0,-8.0,5
18966,18966,1994-95,1994,1995,Wimbledon,Everton,Win,Home,1995-01-02,3,4,7,8,11,3,4,5,8,1,3,3,3,1,6.0,17.0,-11.0,6
18967,18967,1994-95,1994,1995,Wimbledon,Norwich,Win,Away,1995-01-14,3,4,7,10,11,3,3,3,6,1,4,7,5,0,6.0,12.0,-6.0,6
18968,18968,1994-95,1994,1995,Wimbledon,Newcastle,Loss,Away,1995-01-25,0,6,7,10,13,2,3,3,4,4,4,7,9,0,6.0,3.0,3.0,6
18969,18969,1994-95,1994,1995,Wimbledon,Leeds,Draw,Home,1995-02-04,1,3,6,7,10,4,5,6,6,-1,1,1,4,1,6.0,5.0,1.0,7
18970,18970,1994-95,1994,1995,Wimbledon,Aston Villa,Loss,Away,1995-02-11,0,1,4,7,8,3,6,9,10,-2,-2,-2,-2,0,6.0,10.0,-4.0,7
18971,18971,1994-95,1994,1995,Wimbledon,Blackburn,Loss,Away,1995-02-22,0,1,1,4,7,3,4,7,7,-2,-3,-3,0,0,6.0,2.0,4.0,7
18972,18972,1994-95,1994,1995,Wimbledon,Tottenham,Win,Away,1995-02-25,3,0,1,1,4,4,4,7,10,-4,-3,-6,-6,0,6.0,15.0,-9.0,7
18973,18973,1994-95,1994,1995,Wimbledon,QPR,Loss,Home,1995-03-04,0,3,3,4,4,2,5,5,5,1,-2,-1,-1,1,6.0,9.0,-3.0,8
18974,18974,1994-95,1994,1995,Wimbledon,Man United,Loss,Home,1995-03-07,0,3,3,3,4,3,6,9,12,0,-3,-6,-8,1,6.0,1.0,5.0,8
18975,18975,1994-95,1994,1995,Wimbledon,Sheffield Weds,Win,Away,1995-03-11,3,0,3,3,3,4,4,4,4,-4,-1,-1,-1,0,6.0,7.0,-1.0,8
18976,18976,1994-95,1994,1995,Wimbledon,Crystal Palace,Win,Home,1995-03-18,3,3,3,6,6,4,4,4,7,-1,-1,2,-1,1,6.0,21.0,-15.0,8
18977,18977,1994-95,1994,1995,Wimbledon,Man City,Win,Home,1995-03-21,3,6,6,6,9,4,4,5,6,2,2,1,3,1,6.0,16.0,-10.0,8
18978,18978,1994-95,1994,1995,Wimbledon,Leicester,Win,Away,1995-04-01,3,6,9,9,9,0,0,0,1,6,9,9,8,0,6.0,21.0,-15.0,9
18979,18979,1994-95,1994,1995,Wimbledon,Chelsea,Draw,Home,1995-04-10,1,6,9,12,12,1,1,1,4,5,8,11,8,1,6.0,14.0,-8.0,9
18980,18980,1994-95,1994,1995,Wimbledon,West Ham,Loss,Away,1995-04-13,0,4,7,10,13,4,5,6,6,0,2,4,7,0,6.0,13.0,-7.0,9
18981,18981,1994-95,1994,1995,Wimbledon,Southampton,Loss,Home,1995-04-17,0,1,4,7,10,6,6,9,12,-5,-2,-2,-2,1,6.0,18.0,-12.0,9
18982,18982,1994-95,1994,1995,Wimbledon,Everton,Draw,Away,1995-04-29,1,0,1,4,7,4,4,7,8,-4,-3,-3,-1,0,6.0,17.0,-11.0,9
18983,18983,1994-95,1994,1995,Wimbledon,Liverpool,Draw,Home,1995-05-02,1,1,1,2,5,6,6,9,9,-5,-5,-7,-4,1,6.0,8.0,-2.0,10
18984,18984,1994-95,1994,1995,Wimbledon,Arsenal,Draw,Away,1995-05-04,1,2,2,2,3,4,7,7,7,-2,-5,-5,-4,0,6.0,4.0,2.0,10
18985,18985,1994-95,1994,1995,Wimbledon,Nott'm Forest,Draw,Home,1995-05-13,1,2,3,3,3,6,9,12,13,-4,-6,-9,-10,1,6.0,21.0,-15.0,10
18986,18986,1995-96,1995,1996,Wimbledon,Bolton,Win,Home,1995-08-19,3,2,3,4,4,0,0,0,0,2,3,4,4,1,9.0,21.0,-12.0,1
18987,18987,1995-96,1995,1996,Wimbledon,QPR,Win,Away,1995-08-23,3,4,5,6,7,3,6,7,7,1,-1,-1,0,0,9.0,8.0,1.0,1
18988,18988,1995-96,1995,1996,Wimbledon,Man United,Loss,Away,1995-08-26,0,6,7,8,9,3,4,7,10,3,3,1,-1,0,9.0,2.0,7.0,1
18989,18989,1995-96,1995,1996,Wimbledon,Sheffield Weds,Draw,Home,1995-08-30,1,3,6,7,8,3,3,6,6,0,3,1,2,1,9.0,13.0,-4.0,1
18990,18990,1995-96,1995,1996,Wimbledon,Liverpool,Win,Home,1995-09-09,3,1,4,7,8,6,6,9,12,-5,-2,-2,-4,1,9.0,4.0,5.0,2
18991,18991,1995-96,1995,1996,Wimbledon,Aston Villa,Loss,Away,1995-09-16,0,4,4,7,10,4,4,7,10,0,0,0,0,0,9.0,18.0,-9.0,2
18992,18992,1995-96,1995,1996,Wimbledon,Leeds,Loss,Home,1995-09-23,0,3,4,4,7,0,1,4,7,3,3,0,0,1,9.0,5.0,4.0,2
18993,18993,1995-96,1995,1996,Wimbledon,Tottenham,Loss,Away,1995-09-30,0,0,3,4,4,6,9,10,10,-6,-6,-6,-6,0,9.0,7.0,2.0,2
18994,18994,1995-96,1995,1996,Wimbledon,West Ham,Loss,Home,1995-10-16,0,0,0,3,4,4,4,4,5,-4,-4,-1,-1,1,9.0,14.0,-5.0,3
18995,18995,1995-96,1995,1996,Wimbledon,Newcastle,Loss,Away,1995-10-21,0,0,0,0,3,6,9,12,12,-6,-9,-12,-9,0,9.0,6.0,3.0,3
18996,18996,1995-96,1995,1996,Wimbledon,Southampton,Loss,Home,1995-10-28,0,0,0,0,0,0,1,1,1,0,-1,-1,-1,1,9.0,10.0,-1.0,3
18997,18997,1995-96,1995,1996,Wimbledon,Nott'm Forest,Loss,Away,1995-11-06,0,0,0,0,0,4,7,10,11,-4,-7,-10,-11,0,9.0,3.0,6.0,4
18998,18998,1995-96,1995,1996,Wimbledon,Middlesbrough,Draw,Home,1995-11-18,1,0,0,0,0,1,4,7,10,-1,-4,-7,-10,1,9.0,21.0,-12.0,4
18999,18999,1995-96,1995,1996,Wimbledon,Man City,Loss,Away,1995-11-22,0,1,1,1,1,4,4,5,5,-3,-3,-4,-4,0,9.0,17.0,-8.0,4
19000,19000,1995-96,1995,1996,Wimbledon,Coventry,Draw,Away,1995-11-25,1,1,1,1,1,1,1,1,1,0,0,0,0,0,9.0,16.0,-7.0,4
19001,19001,1995-96,1995,1996,Wimbledon,Newcastle,Draw,Home,1995-12-03,1,1,2,2,2,4,7,10,11,-3,-5,-8,-9,1,9.0,6.0,3.0,5
19002,19002,1995-96,1995,1996,Wimbledon,Leeds,Draw,Away,1995-12-09,1,2,2,3,3,0,3,4,7,2,-1,-1,-4,0,9.0,5.0,4.0,5
19003,19003,1995-96,1995,1996,Wimbledon,Tottenham,Loss,Home,1995-12-16,0,2,3,3,4,4,5,8,11,-2,-2,-5,-7,1,9.0,7.0,2.0,5
19004,19004,1995-96,1995,1996,Wimbledon,Blackburn,Draw,Home,1995-12-23,1,1,2,3,3,3,6,7,10,-2,-4,-4,-7,1,9.0,1.0,8.0,5
19005,19005,1995-96,1995,1996,Wimbledon,Chelsea,Win,Away,1995-12-26,3,1,2,3,4,4,7,8,9,-3,-5,-5,-5,0,9.0,11.0,-2.0,5
19006,19006,1995-96,1995,1996,Wimbledon,Arsenal,Win,Away,1995-12-30,3,4,4,5,6,3,4,5,6,1,0,0,0,0,9.0,12.0,-3.0,5
19007,19007,1995-96,1995,1996,Wimbledon,Everton,Loss,Home,1996-01-01,0,6,7,7,8,6,6,6,9,0,1,1,-1,1,9.0,15.0,-6.0,6
19008,19008,1995-96,1995,1996,Wimbledon,Bolton,Loss,Away,1996-01-13,0,3,6,7,7,0,0,1,1,3,6,6,6,0,9.0,21.0,-12.0,6
19009,19009,1995-96,1995,1996,Wimbledon,QPR,Win,Home,1996-01-20,3,0,3,6,7,0,0,0,3,0,3,6,4,1,9.0,8.0,1.0,6
19010,19010,1995-96,1995,1996,Wimbledon,Man United,Loss,Home,1996-02-03,0,3,3,6,9,4,4,7,10,-1,-1,-1,-1,1,9.0,2.0,7.0,7
19011,19011,1995-96,1995,1996,Wimbledon,Sheffield Weds,Loss,Away,1996-02-10,0,3,3,3,6,0,1,4,4,3,2,-1,2,0,9.0,13.0,-4.0,7
19012,19012,1995-96,1995,1996,Wimbledon,Aston Villa,Draw,Home,1996-02-24,1,0,3,3,3,6,6,9,10,-6,-3,-6,-7,1,9.0,18.0,-9.0,7
19013,19013,1995-96,1995,1996,Wimbledon,Chelsea,Draw,Home,1996-03-02,1,1,1,4,4,3,3,6,9,-2,-2,-2,-5,1,9.0,11.0,-2.0,8
19014,19014,1995-96,1995,1996,Wimbledon,Liverpool,Draw,Away,1996-03-13,1,2,2,2,5,6,9,10,13,-4,-7,-8,-8,0,9.0,4.0,5.0,8
19015,19015,1995-96,1995,1996,Wimbledon,Arsenal,Loss,Home,1996-03-16,0,2,3,3,3,4,7,10,11,-2,-4,-7,-8,1,9.0,12.0,-3.0,8
19016,19016,1995-96,1995,1996,Wimbledon,Everton,Win,Away,1996-03-23,3,1,2,3,3,2,5,8,8,-1,-3,-5,-5,0,9.0,15.0,-6.0,8
19017,19017,1995-96,1995,1996,Wimbledon,Nott'm Forest,Win,Home,1996-03-30,3,3,4,5,6,4,7,7,7,-1,-3,-2,-1,1,9.0,3.0,6.0,8
19018,19018,1995-96,1995,1996,Wimbledon,West Ham,Draw,Away,1996-04-06,1,6,6,7,8,3,6,7,7,3,0,0,1,0,9.0,14.0,-5.0,9
19019,19019,1995-96,1995,1996,Wimbledon,Man City,Win,Home,1996-04-08,3,4,7,7,8,1,1,4,5,3,6,3,3,1,9.0,17.0,-8.0,9
19020,19020,1995-96,1995,1996,Wimbledon,Middlesbrough,Win,Away,1996-04-13,3,4,7,10,10,4,7,8,9,0,0,2,1,0,9.0,21.0,-12.0,9
19021,19021,1995-96,1995,1996,Wimbledon,Blackburn,Loss,Away,1996-04-17,0,6,7,10,13,6,6,6,9,0,1,4,4,0,9.0,1.0,8.0,9
19022,19022,1995-96,1995,1996,Wimbledon,Coventry,Loss,Home,1996-04-27,0,3,6,7,10,4,4,7,7,-1,2,0,3,1,9.0,16.0,-7.0,9
19023,19023,1995-96,1995,1996,Wimbledon,Southampton,Draw,Away,1996-05-04,1,0,3,6,7,3,6,6,9,-3,-3,0,-2,0,9.0,10.0,-1.0,10
19024,19024,1996-97,1996,1997,Wimbledon,Man United,Loss,Home,1996-08-17,0,1,1,4,7,6,9,9,12,-5,-8,-5,-5,1,14.0,1.0,13.0,1
19025,19025,1996-97,1996,1997,Wimbledon,Newcastle,Loss,Away,1996-08-21,0,1,1,1,4,1,2,5,8,0,-1,-4,-4,0,14.0,2.0,12.0,1
19026,19026,1996-97,1996,1997,Wimbledon,Leeds,Loss,Away,1996-08-26,0,0,1,1,1,1,2,2,2,-1,-1,-1,-1,0,14.0,13.0,1.0,1
19027,19027,1996-97,1996,1997,Wimbledon,Tottenham,Win,Home,1996-09-04,3,0,0,1,1,2,5,6,9,-2,-5,-5,-8,1,14.0,8.0,6.0,2
19028,19028,1996-97,1996,1997,Wimbledon,Everton,Win,Home,1996-09-07,3,3,3,3,4,1,2,5,8,2,1,-2,-4,1,14.0,6.0,8.0,2
19029,19029,1996-97,1996,1997,Wimbledon,West Ham,Win,Away,1996-09-14,3,6,6,6,6,1,4,5,5,5,2,1,1,0,14.0,10.0,4.0,2
19030,19030,1996-97,1996,1997,Wimbledon,Southampton,Win,Home,1996-09-23,3,6,9,9,9,0,1,1,1,6,8,8,8,1,14.0,17.0,-3.0,2
19031,19031,1996-97,1996,1997,Wimbledon,Derby,Win,Away,1996-09-28,3,6,9,12,12,4,7,8,8,2,2,4,4,0,14.0,21.0,-7.0,2
19032,19032,1996-97,1996,1997,Wimbledon,Sheffield Weds,Win,Home,1996-10-12,3,6,9,12,15,1,1,1,4,5,8,11,11,1,14.0,15.0,-1.0,3
19033,19033,1996-97,1996,1997,Wimbledon,Chelsea,Win,Away,1996-10-19,3,6,9,12,15,4,4,5,8,2,5,7,7,0,14.0,11.0,3.0,3
19034,19034,1996-97,1996,1997,Wimbledon,Middlesbrough,Draw,Away,1996-10-26,1,6,9,12,15,1,1,1,4,5,8,11,11,0,14.0,12.0,2.0,3
19035,19035,1996-97,1996,1997,Wimbledon,Arsenal,Draw,Home,1996-11-02,1,4,7,10,13,4,7,10,13,0,0,0,0,1,14.0,5.0,9.0,4
19036,19036,1996-97,1996,1997,Wimbledon,Coventry,Draw,Home,1996-11-16,1,2,5,8,11,2,3,4,5,0,2,4,6,1,14.0,16.0,-2.0,4
19037,19037,1996-97,1996,1997,Wimbledon,Liverpool,Draw,Away,1996-11-23,1,2,3,6,9,4,4,7,7,-2,-1,-1,2,0,14.0,3.0,11.0,4
19038,19038,1996-97,1996,1997,Wimbledon,Nott'm Forest,Win,Home,1996-11-30,3,2,3,4,7,1,1,1,2,1,2,3,5,1,14.0,9.0,5.0,4
19039,19039,1996-97,1996,1997,Wimbledon,Sunderland,Win,Away,1996-12-07,3,4,5,6,7,4,4,4,7,0,1,2,0,0,14.0,21.0,-7.0,5
19040,19040,1996-97,1996,1997,Wimbledon,Blackburn,Win,Home,1996-12-14,3,6,7,8,9,4,5,6,9,2,2,2,0,1,14.0,7.0,7.0,5
19041,19041,1996-97,1996,1997,Wimbledon,Aston Villa,Loss,Away,1996-12-22,0,6,9,10,11,6,9,12,12,0,0,-2,-1,0,14.0,4.0,10.0,5
19042,19042,1996-97,1996,1997,Wimbledon,Everton,Win,Away,1996-12-28,3,3,6,9,10,1,4,5,5,2,2,4,5,0,14.0,6.0,8.0,5
19043,19043,1996-97,1996,1997,Wimbledon,Derby,Draw,Home,1997-01-11,1,3,6,9,12,1,1,1,2,2,5,8,10,1,14.0,21.0,-7.0,6
19044,19044,1996-97,1996,1997,Wimbledon,Leicester,Loss,Away,1997-01-18,0,4,4,7,10,1,2,2,3,3,2,5,7,0,14.0,21.0,-7.0,6
19045,19045,1996-97,1996,1997,Wimbledon,Man United,Loss,Away,1997-01-29,0,1,4,4,7,6,7,10,13,-5,-3,-6,-6,0,14.0,1.0,13.0,6
19046,19046,1996-97,1996,1997,Wimbledon,Middlesbrough,Draw,Home,1997-02-01,1,0,1,4,4,3,3,3,6,-3,-2,1,-2,1,14.0,12.0,2.0,7
19047,19047,1996-97,1996,1997,Wimbledon,Arsenal,Win,Away,1997-02-23,3,1,1,2,5,1,2,5,8,0,-1,-3,-3,0,14.0,5.0,9.0,7
19048,19048,1996-97,1996,1997,Wimbledon,Southampton,Draw,Away,1997-02-26,1,4,4,4,5,0,1,4,4,4,3,0,1,0,14.0,17.0,-3.0,7
19049,19049,1996-97,1996,1997,Wimbledon,Leicester,Loss,Home,1997-03-01,0,4,5,5,5,3,4,7,7,1,1,-2,-2,1,14.0,21.0,-7.0,8
19050,19050,1996-97,1996,1997,Wimbledon,Coventry,Draw,Away,1997-03-03,1,1,4,5,5,1,1,2,5,0,3,3,0,0,14.0,16.0,-2.0,8
19051,19051,1996-97,1996,1997,Wimbledon,Blackburn,Loss,Away,1997-03-15,0,1,2,5,6,2,5,6,9,-1,-3,-1,-3,0,14.0,7.0,7.0,8
19052,19052,1996-97,1996,1997,Wimbledon,West Ham,Draw,Home,1997-03-18,1,1,1,2,5,4,4,7,7,-3,-3,-5,-2,1,14.0,10.0,4.0,8
19053,19053,1996-97,1996,1997,Wimbledon,Newcastle,Draw,Home,1997-03-23,1,1,2,2,3,3,3,6,9,-2,-1,-4,-6,1,14.0,2.0,12.0,8
19054,19054,1996-97,1996,1997,Wimbledon,Tottenham,Loss,Away,1997-04-05,0,2,2,3,3,1,4,7,7,1,-2,-4,-4,0,14.0,8.0,6.0,9
19055,19055,1996-97,1996,1997,Wimbledon,Aston Villa,Loss,Home,1997-04-09,0,1,2,2,3,6,7,7,10,-5,-5,-5,-7,1,14.0,4.0,10.0,9
19056,19056,1996-97,1996,1997,Wimbledon,Leeds,Win,Home,1997-04-16,3,0,1,2,2,2,2,3,6,-2,-1,-1,-4,1,14.0,13.0,1.0,9
19057,19057,1996-97,1996,1997,Wimbledon,Sheffield Weds,Loss,Away,1997-04-19,0,3,3,4,5,4,5,5,8,-1,-2,-1,-3,0,14.0,15.0,-1.0,9
19058,19058,1996-97,1996,1997,Wimbledon,Chelsea,Loss,Home,1997-04-22,0,3,3,3,4,3,3,3,3,0,0,0,1,1,14.0,11.0,3.0,9
19059,19059,1996-97,1996,1997,Wimbledon,Nott'm Forest,Draw,Away,1997-05-03,1,0,3,3,3,2,2,3,4,-2,1,0,-1,0,14.0,9.0,5.0,10
19060,19060,1996-97,1996,1997,Wimbledon,Liverpool,Win,Home,1997-05-06,3,1,1,4,4,3,4,7,7,-2,-3,-3,-3,1,14.0,3.0,11.0,10
19061,19061,1996-97,1996,1997,Wimbledon,Sunderland,Win,Home,1997-05-11,3,4,4,4,7,3,6,6,7,1,-2,-2,0,1,14.0,21.0,-7.0,10
19062,19062,1997-98,1997,1998,Wimbledon,Liverpool,Draw,Home,1997-08-09,1,6,7,7,7,1,4,4,5,5,3,3,2,1,8.0,4.0,4.0,1
19063,19063,1997-98,1997,1998,Wimbledon,Sheffield Weds,Draw,Home,1997-08-23,1,4,7,8,8,0,1,1,1,4,6,7,7,1,8.0,7.0,1.0,1
19064,19064,1997-98,1997,1998,Wimbledon,Chelsea,Loss,Home,1997-08-27,0,2,5,8,9,3,6,7,10,-1,-1,1,-1,1,8.0,6.0,2.0,1
19065,19065,1997-98,1997,1998,Wimbledon,West Ham,Loss,Away,1997-08-30,0,1,2,5,8,1,4,7,7,0,-2,-2,1,0,8.0,14.0,-6.0,1
19066,19066,1997-98,1997,1998,Wimbledon,Newcastle,Win,Away,1997-09-13,3,0,1,2,5,6,9,10,11,-6,-8,-8,-6,0,8.0,2.0,6.0,2
19067,19067,1997-98,1997,1998,Wimbledon,Crystal Palace,Loss,Home,1997-09-20,0,3,3,4,5,0,0,3,3,3,3,1,2,1,8.0,21.0,-13.0,2
19068,19068,1997-98,1997,1998,Wimbledon,Barnsley,Win,Home,1997-09-23,3,3,3,3,4,0,0,3,3,3,3,0,1,1,8.0,21.0,-13.0,2
19069,19069,1997-98,1997,1998,Wimbledon,Tottenham,Draw,Away,1997-09-27,1,3,6,6,6,2,2,3,6,1,4,3,0,0,8.0,10.0,-2.0,2
19070,19070,1997-98,1997,1998,Wimbledon,Blackburn,Loss,Home,1997-10-04,0,4,4,7,7,2,3,3,6,2,1,4,1,1,8.0,13.0,-5.0,3
19071,19071,1997-98,1997,1998,Wimbledon,Aston Villa,Win,Away,1997-10-18,3,1,4,4,7,4,4,7,10,-3,0,-3,-3,0,8.0,5.0,3.0,3
19072,19072,1997-98,1997,1998,Wimbledon,Derby,Draw,Away,1997-10-22,1,3,4,7,7,4,7,10,10,-1,-3,-3,-3,0,8.0,12.0,-4.0,3
19073,19073,1997-98,1997,1998,Wimbledon,Leeds,Win,Home,1997-10-25,3,4,4,5,8,4,7,10,10,0,-3,-5,-2,1,8.0,11.0,-3.0,3
19074,19074,1997-98,1997,1998,Wimbledon,Coventry,Loss,Home,1997-11-01,0,4,7,7,8,1,2,3,4,3,5,4,4,1,8.0,17.0,-9.0,4
19075,19075,1997-98,1997,1998,Wimbledon,Leicester,Win,Away,1997-11-10,3,3,4,7,7,4,4,4,7,-1,0,3,0,0,8.0,9.0,-1.0,4
19076,19076,1997-98,1997,1998,Wimbledon,Man United,Loss,Home,1997-11-22,0,3,6,7,10,3,6,7,10,0,0,0,0,1,8.0,1.0,7.0,4
19077,19077,1997-98,1997,1998,Wimbledon,Bolton,Loss,Away,1997-11-29,0,3,3,6,7,1,2,5,5,2,1,1,2,0,8.0,21.0,-13.0,4
19078,19078,1997-98,1997,1998,Wimbledon,Southampton,Win,Home,1997-12-07,3,0,3,3,6,0,3,6,9,0,0,-3,-3,1,8.0,16.0,-8.0,5
19079,19079,1997-98,1997,1998,Wimbledon,Everton,Draw,Away,1997-12-13,1,3,3,6,6,1,1,1,1,2,2,5,5,0,8.0,15.0,-7.0,5
19080,19080,1997-98,1997,1998,Wimbledon,Chelsea,Draw,Away,1997-12-26,1,4,4,4,7,4,7,10,13,0,-3,-6,-6,0,8.0,6.0,2.0,5
19081,19081,1997-98,1997,1998,Wimbledon,West Ham,Loss,Home,1997-12-28,0,2,5,5,5,3,6,6,9,-1,-1,-1,-4,1,8.0,14.0,-6.0,5
19082,19082,1997-98,1997,1998,Wimbledon,Liverpool,Loss,Away,1998-01-10,0,1,2,5,5,6,9,12,12,-5,-7,-7,-7,0,8.0,4.0,4.0,6
19083,19083,1997-98,1997,1998,Wimbledon,Derby,Draw,Home,1998-01-17,1,0,1,2,5,3,6,7,8,-3,-5,-5,-3,1,8.0,12.0,-4.0,6
19084,19084,1997-98,1997,1998,Wimbledon,Sheffield Weds,Draw,Away,1998-01-31,1,1,1,2,3,6,7,8,8,-5,-6,-6,-5,0,8.0,7.0,1.0,6
19085,19085,1997-98,1997,1998,Wimbledon,Crystal Palace,Win,Away,1998-02-09,3,2,2,2,3,0,0,1,2,2,2,1,1,0,8.0,21.0,-13.0,7
19086,19086,1997-98,1997,1998,Wimbledon,Aston Villa,Win,Home,1998-02-21,3,4,5,5,5,3,3,3,4,1,2,2,1,1,8.0,5.0,3.0,7
19087,19087,1997-98,1997,1998,Wimbledon,Barnsley,Loss,Away,1998-02-28,0,6,7,8,8,1,1,4,4,5,6,4,4,0,8.0,21.0,-13.0,7
19088,19088,1997-98,1997,1998,Wimbledon,Arsenal,Loss,Home,1998-03-11,0,3,6,7,8,4,7,10,11,-1,-1,-3,-3,1,8.0,3.0,5.0,8
19089,19089,1997-98,1997,1998,Wimbledon,Leicester,Win,Home,1998-03-14,3,0,3,6,7,3,4,7,10,-3,-1,-1,-3,1,8.0,9.0,-1.0,8
19090,19090,1997-98,1997,1998,Wimbledon,Man United,Loss,Away,1998-03-28,0,3,3,6,9,1,1,4,7,2,2,2,2,0,8.0,1.0,7.0,8
19091,19091,1997-98,1997,1998,Wimbledon,Newcastle,Draw,Home,1998-03-31,1,3,3,3,6,0,1,2,3,3,2,1,3,1,8.0,2.0,6.0,8
19092,19092,1997-98,1997,1998,Wimbledon,Bolton,Draw,Home,1998-04-04,1,1,4,4,4,3,6,6,6,-2,-2,-2,-2,1,8.0,21.0,-13.0,9
19093,19093,1997-98,1997,1998,Wimbledon,Southampton,Win,Away,1998-04-11,3,2,2,5,5,3,3,6,9,-1,-1,-1,-4,0,8.0,16.0,-8.0,9
19094,19094,1997-98,1997,1998,Wimbledon,Everton,Draw,Home,1998-04-13,1,4,5,5,8,4,4,7,7,0,1,-2,1,1,8.0,15.0,-7.0,9
19095,19095,1997-98,1997,1998,Wimbledon,Arsenal,Loss,Away,1998-04-18,0,4,5,6,6,6,9,12,15,-2,-4,-6,-9,0,8.0,3.0,5.0,9
19096,19096,1997-98,1997,1998,Wimbledon,Blackburn,Draw,Away,1998-04-25,1,1,4,5,6,0,0,0,3,1,4,5,3,0,8.0,13.0,-5.0,9
19097,19097,1997-98,1997,1998,Wimbledon,Coventry,Draw,Away,1998-04-29,1,1,2,5,6,2,3,3,4,-1,-1,2,2,0,8.0,17.0,-9.0,9
19098,19098,1997-98,1997,1998,Wimbledon,Tottenham,Loss,Home,1998-05-02,0,2,2,3,6,4,5,5,6,-2,-3,-2,0,1,8.0,10.0,-2.0,10
19099,19099,1997-98,1997,1998,Wimbledon,Leeds,Draw,Away,1998-05-10,1,1,2,2,3,1,4,4,7,0,-2,-2,-4,0,8.0,11.0,-3.0,10
19100,19100,1998-99,1998,1999,Wimbledon,Tottenham,Win,Home,1998-08-15,3,1,2,3,3,4,7,8,9,-3,-5,-5,-6,1,15.0,14.0,1.0,1
19101,19101,1998-99,1998,1999,Wimbledon,Derby,Draw,Away,1998-08-22,1,4,4,5,6,4,7,7,7,0,-3,-2,-1,0,15.0,9.0,6.0,1
19102,19102,1998-99,1998,1999,Wimbledon,Leeds,Draw,Home,1998-08-29,1,4,5,5,6,4,5,5,6,0,0,0,0,1,15.0,5.0,10.0,1
19103,19103,1998-99,1998,1999,Wimbledon,West Ham,Win,Away,1998-09-09,3,2,5,6,6,2,5,8,9,0,0,-2,-3,0,15.0,8.0,7.0,2
19104,19104,1998-99,1998,1999,Wimbledon,Aston Villa,Loss,Away,1998-09-12,0,4,5,8,9,6,9,10,13,-2,-4,-2,-4,0,15.0,7.0,8.0,2
19105,19105,1998-99,1998,1999,Wimbledon,Sheffield Weds,Win,Home,1998-09-19,3,3,4,5,8,3,3,6,6,0,1,-1,2,1,15.0,16.0,-1.0,2
19106,19106,1998-99,1998,1999,Wimbledon,Leicester,Draw,Away,1998-09-27,1,3,6,7,8,1,1,1,4,2,5,6,4,0,15.0,10.0,5.0,2
19107,19107,1998-99,1998,1999,Wimbledon,Everton,Loss,Home,1998-10-03,0,4,4,7,8,2,3,6,6,2,1,1,2,1,15.0,17.0,-2.0,3
19108,19108,1998-99,1998,1999,Wimbledon,Man United,Loss,Away,1998-10-17,0,1,4,4,7,6,6,9,12,-5,-2,-5,-5,0,15.0,2.0,13.0,3
19109,19109,1998-99,1998,1999,Wimbledon,Middlesbrough,Draw,Home,1998-10-24,1,0,1,4,4,6,6,7,10,-6,-5,-3,-6,1,15.0,21.0,-6.0,3
19110,19110,1998-99,1998,1999,Wimbledon,Blackburn,Draw,Home,1998-10-31,1,1,1,2,5,0,3,4,4,1,-2,-2,1,1,15.0,6.0,9.0,3
19111,19111,1998-99,1998,1999,Wimbledon,Nott'm Forest,Win,Away,1998-11-07,3,2,2,2,3,1,2,2,2,1,0,0,1,0,15.0,21.0,-6.0,4
19112,19112,1998-99,1998,1999,Wimbledon,Chelsea,Loss,Away,1998-11-14,0,4,5,5,5,2,5,6,9,2,0,-1,-4,0,15.0,4.0,11.0,4
19113,19113,1998-99,1998,1999,Wimbledon,Arsenal,Win,Home,1998-11-21,3,3,4,5,5,4,7,10,11,-1,-3,-5,-6,1,15.0,1.0,14.0,4
19114,19114,1998-99,1998,1999,Wimbledon,Newcastle,Loss,Away,1998-11-28,0,3,6,7,8,1,2,2,2,2,4,5,6,0,15.0,13.0,2.0,4
19115,19115,1998-99,1998,1999,Wimbledon,Coventry,Win,Home,1998-12-05,3,3,3,6,7,1,4,7,7,2,-1,-1,0,1,15.0,11.0,4.0,5
19116,19116,1998-99,1998,1999,Wimbledon,Liverpool,Win,Home,1998-12-13,3,3,6,6,9,3,6,6,6,0,0,0,3,1,15.0,3.0,12.0,5
19117,19117,1998-99,1998,1999,Wimbledon,Southampton,Loss,Away,1998-12-19,0,6,6,9,9,0,0,3,3,6,6,6,6,0,15.0,12.0,3.0,5
19118,19118,1998-99,1998,1999,Wimbledon,Charlton,Win,Home,1998-12-26,3,3,6,6,9,0,0,0,0,3,6,6,9,1,15.0,21.0,-6.0,5
19119,19119,1998-99,1998,1999,Wimbledon,Leeds,Draw,Away,1998-12-29,1,3,6,9,9,3,6,9,9,0,0,0,0,0,15.0,5.0,10.0,5
19120,19120,1998-99,1998,1999,Wimbledon,Derby,Win,Home,1999-01-09,3,4,4,7,10,4,5,6,7,0,-1,1,3,1,15.0,9.0,6.0,6
19121,19121,1998-99,1998,1999,Wimbledon,Tottenham,Draw,Away,1999-01-16,1,4,7,7,10,4,5,5,6,0,2,2,4,0,15.0,14.0,1.0,6
19122,19122,1998-99,1998,1999,Wimbledon,West Ham,Draw,Home,1999-01-30,1,4,5,8,8,0,3,3,6,4,2,5,2,1,15.0,8.0,7.0,6
19123,19123,1998-99,1998,1999,Wimbledon,Charlton,Loss,Away,1999-02-08,0,2,5,6,9,1,1,1,1,1,4,5,8,0,15.0,21.0,-6.0,7
19124,19124,1998-99,1998,1999,Wimbledon,Aston Villa,Draw,Home,1999-02-21,1,1,2,5,6,0,0,3,4,1,2,2,2,1,15.0,7.0,8.0,7
19125,19125,1998-99,1998,1999,Wimbledon,Everton,Draw,Away,1999-02-27,1,1,2,3,6,3,3,3,3,-2,-1,0,3,0,15.0,17.0,-2.0,7
19126,19126,1998-99,1998,1999,Wimbledon,Sheffield Weds,Win,Away,1999-03-03,3,2,2,3,4,6,9,9,12,-4,-7,-6,-8,0,15.0,16.0,-1.0,8
19127,19127,1998-99,1998,1999,Wimbledon,Leicester,Loss,Home,1999-03-06,0,4,5,5,6,0,0,1,1,4,5,4,5,1,15.0,10.0,5.0,8
19128,19128,1998-99,1998,1999,Wimbledon,Nott'm Forest,Loss,Home,1999-03-13,0,3,4,5,5,1,1,1,1,2,3,4,4,1,15.0,21.0,-6.0,8
19129,19129,1998-99,1998,1999,Wimbledon,Blackburn,Loss,Away,1999-03-20,0,0,3,4,5,1,1,1,2,-1,2,3,3,0,15.0,6.0,9.0,8
19130,19130,1998-99,1998,1999,Wimbledon,Man United,Draw,Home,1999-04-03,1,0,0,3,4,6,9,12,13,-6,-9,-9,-9,1,15.0,2.0,13.0,9
19131,19131,1998-99,1998,1999,Wimbledon,Middlesbrough,Loss,Away,1999-04-05,0,1,1,1,4,4,7,7,8,-3,-6,-6,-4,0,15.0,21.0,-6.0,9
19132,19132,1998-99,1998,1999,Wimbledon,Chelsea,Loss,Home,1999-04-11,0,1,1,1,1,6,6,9,12,-5,-5,-8,-11,1,15.0,4.0,11.0,9
19133,19133,1998-99,1998,1999,Wimbledon,Arsenal,Loss,Away,1999-04-19,0,0,1,1,1,4,7,10,13,-4,-6,-9,-12,0,15.0,1.0,14.0,9
19134,19134,1998-99,1998,1999,Wimbledon,Newcastle,Draw,Home,1999-04-24,1,0,0,1,1,1,2,5,5,-1,-2,-4,-4,1,15.0,13.0,2.0,9
19135,19135,1998-99,1998,1999,Wimbledon,Coventry,Loss,Away,1999-05-01,0,1,1,1,2,0,0,3,6,1,1,-2,-4,0,15.0,11.0,4.0,10
19136,19136,1998-99,1998,1999,Wimbledon,Southampton,Loss,Home,1999-05-08,0,1,1,1,1,4,5,5,5,-3,-4,-4,-4,1,15.0,12.0,3.0,10
19137,19137,1998-99,1998,1999,Wimbledon,Liverpool,Loss,Away,1999-05-16,0,0,1,1,1,1,4,7,7,-1,-3,-6,-6,0,15.0,3.0,12.0,10
19138,19138,1999-00,1999,2000,Wimbledon,Watford,Win,Away,1999-08-07,3,0,0,1,1,0,0,0,0,0,0,1,1,0,16.0,21.0,-5.0,1
19139,19139,1999-00,1999,2000,Wimbledon,Middlesbrough,Loss,Home,1999-08-10,0,3,3,3,4,0,0,1,1,3,3,2,3,1,16.0,9.0,7.0,1
19140,19140,1999-00,1999,2000,Wimbledon,Coventry,Draw,Home,1999-08-14,1,3,3,3,3,0,1,2,5,3,2,1,-2,1,16.0,15.0,1.0,1
19141,19141,1999-00,1999,2000,Wimbledon,Newcastle,Draw,Away,1999-08-21,1,1,4,4,4,0,0,1,1,1,4,3,3,0,16.0,13.0,3.0,1
19142,19142,1999-00,1999,2000,Wimbledon,Everton,Loss,Away,1999-08-25,0,2,2,5,5,3,3,4,4,-1,-1,1,1,0,16.0,14.0,2.0,1
19143,19143,1999-00,1999,2000,Wimbledon,Chelsea,Loss,Home,1999-08-28,0,1,2,2,5,4,7,10,11,-3,-5,-8,-6,1,16.0,3.0,13.0,1
19144,19144,1999-00,1999,2000,Wimbledon,Derby,Draw,Home,1999-09-11,1,0,1,2,2,6,6,6,6,-6,-5,-4,-4,1,16.0,8.0,8.0,2
19145,19145,1999-00,1999,2000,Wimbledon,Man United,Draw,Away,1999-09-18,1,1,1,2,3,6,9,12,15,-5,-8,-10,-12,0,16.0,1.0,15.0,2
19146,19146,1999-00,1999,2000,Wimbledon,Tottenham,Draw,Home,1999-09-26,1,2,2,2,3,4,4,7,10,-2,-2,-5,-7,1,16.0,11.0,5.0,2
19147,19147,1999-00,1999,2000,Wimbledon,Sheffield Weds,Loss,Away,1999-10-02,0,2,3,3,3,0,0,0,0,2,3,3,3,0,16.0,12.0,4.0,3
19148,19148,1999-00,1999,2000,Wimbledon,Bradford,Win,Home,1999-10-16,3,1,2,3,3,3,3,4,4,-2,-1,-1,-1,1,16.0,21.0,-5.0,3
19149,19149,1999-00,1999,2000,Wimbledon,Aston Villa,Draw,Away,1999-10-23,1,3,4,5,6,1,1,4,4,2,3,1,2,0,16.0,6.0,10.0,3
19150,19150,1999-00,1999,2000,Wimbledon,Southampton,Draw,Home,1999-10-30,1,4,4,5,6,1,2,3,3,3,2,2,3,1,16.0,17.0,-1.0,3
19151,19151,1999-00,1999,2000,Wimbledon,Leeds,Win,Home,1999-11-07,3,2,5,5,6,4,7,10,13,-2,-2,-5,-7,1,16.0,4.0,12.0,4
19152,19152,1999-00,1999,2000,Wimbledon,Leicester,Loss,Away,1999-11-20,0,4,5,8,8,3,3,6,9,1,2,2,-1,0,16.0,10.0,6.0,4
19153,19153,1999-00,1999,2000,Wimbledon,Middlesbrough,Draw,Away,1999-11-27,1,3,4,5,8,1,4,7,10,2,0,-2,-2,0,16.0,9.0,7.0,4
19154,19154,1999-00,1999,2000,Wimbledon,Watford,Win,Home,1999-12-04,3,1,4,5,6,1,2,2,2,0,2,3,4,1,16.0,21.0,-5.0,5
19155,19155,1999-00,1999,2000,Wimbledon,Arsenal,Draw,Away,1999-12-18,1,4,4,7,8,6,9,9,10,-2,-5,-2,-2,0,16.0,2.0,14.0,5
19156,19156,1999-00,1999,2000,Wimbledon,West Ham,Draw,Home,1999-12-26,1,4,5,5,8,1,4,7,8,3,1,-2,0,1,16.0,5.0,11.0,5
19157,19157,1999-00,1999,2000,Wimbledon,Liverpool,Loss,Away,1999-12-28,0,2,5,6,6,4,7,7,10,-2,-2,-1,-4,0,16.0,7.0,9.0,5
19158,19158,1999-00,1999,2000,Wimbledon,Sunderland,Win,Home,2000-01-03,3,1,2,5,6,1,4,7,10,0,-2,-2,-4,1,16.0,21.0,-5.0,6
19159,19159,1999-00,1999,2000,Wimbledon,Coventry,Loss,Away,2000-01-15,0,3,4,5,8,4,4,5,5,-1,0,0,3,0,16.0,15.0,1.0,6
19160,19160,1999-00,1999,2000,Wimbledon,Newcastle,Win,Home,2000-01-22,3,3,3,4,5,4,7,8,8,-1,-4,-4,-3,1,16.0,13.0,3.0,6
19161,19161,1999-00,1999,2000,Wimbledon,Everton,Loss,Home,2000-02-06,0,3,6,6,7,1,2,3,6,2,4,3,1,1,16.0,14.0,2.0,7
19162,19162,1999-00,1999,2000,Wimbledon,Chelsea,Loss,Away,2000-02-12,0,3,3,6,6,4,5,8,9,-1,-2,-2,-3,0,16.0,3.0,13.0,7
19163,19163,1999-00,1999,2000,Wimbledon,Man United,Draw,Home,2000-02-26,1,0,3,3,6,3,6,9,12,-3,-3,-6,-6,1,16.0,1.0,15.0,7
19164,19164,1999-00,1999,2000,Wimbledon,Derby,Loss,Away,2000-03-04,0,1,1,4,4,1,2,3,6,0,-1,1,-2,0,16.0,8.0,8.0,8
19165,19165,1999-00,1999,2000,Wimbledon,Leicester,Win,Home,2000-03-11,3,1,1,1,4,4,7,7,8,-3,-6,-6,-4,1,16.0,10.0,6.0,8
19166,19166,1999-00,1999,2000,Wimbledon,Leeds,Loss,Away,2000-03-19,0,3,4,4,4,6,7,7,10,-3,-3,-3,-6,0,16.0,4.0,12.0,8
19167,19167,1999-00,1999,2000,Wimbledon,West Ham,Loss,Away,2000-03-26,0,3,3,4,4,1,4,7,7,2,-1,-3,-3,0,16.0,5.0,11.0,8
19168,19168,1999-00,1999,2000,Wimbledon,Arsenal,Loss,Home,2000-04-01,0,0,3,3,4,6,6,7,10,-6,-3,-4,-6,1,16.0,2.0,14.0,9
19169,19169,1999-00,1999,2000,Wimbledon,Sunderland,Loss,Away,2000-04-08,0,0,0,3,3,6,7,8,8,-6,-7,-5,-5,0,16.0,21.0,-5.0,9
19170,19170,1999-00,1999,2000,Wimbledon,Sheffield Weds,Loss,Home,2000-04-12,0,0,0,0,3,0,0,3,4,0,0,-3,-1,1,16.0,12.0,4.0,9
19171,19171,1999-00,1999,2000,Wimbledon,Liverpool,Loss,Home,2000-04-16,0,0,0,0,0,6,9,12,13,-6,-9,-12,-13,1,16.0,7.0,9.0,9
19172,19172,1999-00,1999,2000,Wimbledon,Tottenham,Loss,Away,2000-04-22,0,0,0,0,0,3,3,3,4,-3,-3,-3,-4,0,16.0,11.0,5.0,9
19173,19173,1999-00,1999,2000,Wimbledon,Bradford,Loss,Away,2000-04-30,0,0,0,0,0,4,4,4,4,-4,-4,-4,-4,0,16.0,21.0,-5.0,9
19174,19174,1999-00,1999,2000,Wimbledon,Aston Villa,Draw,Home,2000-05-06,1,0,0,0,0,2,5,8,11,-2,-5,-8,-11,1,16.0,6.0,10.0,10
19175,19175,1999-00,1999,2000,Wimbledon,Southampton,Loss,Away,2000-05-14,0,1,1,1,1,1,1,1,4,0,0,0,-3,0,16.0,17.0,-1.0,10
19176,19176,2003-04,2003,2004,Wolves,Blackburn,Loss,Away,2003-08-16,0,0,0,0,0,4,7,8,8,-4,-7,-8,-8,0,21.0,6.0,15.0,1
19177,19177,2003-04,2003,2004,Wolves,Charlton,Loss,Home,2003-08-23,0,0,0,0,0,0,0,3,3,0,0,-3,-3,1,21.0,12.0,9.0,1
19178,19178,2003-04,2003,2004,Wolves,Man United,Loss,Away,2003-08-27,0,0,0,0,0,6,9,12,15,-6,-9,-12,-15,0,21.0,1.0,20.0,1
19179,19179,2003-04,2003,2004,Wolves,Portsmouth,Draw,Home,2003-08-30,1,0,0,0,0,4,7,7,7,-4,-7,-7,-7,1,21.0,21.0,0.0,1
19180,19180,2003-04,2003,2004,Wolves,Southampton,Loss,Away,2003-09-13,0,1,1,1,1,4,5,6,9,-3,-4,-5,-8,0,21.0,8.0,13.0,2
19181,19181,2003-04,2003,2004,Wolves,Chelsea,Loss,Home,2003-09-20,0,1,1,1,1,4,7,10,13,-3,-6,-9,-12,1,21.0,4.0,17.0,2
19182,19182,2003-04,2003,2004,Wolves,Bolton,Draw,Away,2003-09-27,1,0,1,1,1,4,5,5,6,-4,-4,-4,-5,0,21.0,17.0,4.0,2
19183,19183,2003-04,2003,2004,Wolves,Man City,Win,Home,2003-10-04,3,1,1,2,2,2,5,5,8,-1,-4,-3,-6,1,21.0,9.0,12.0,3
19184,19184,2003-04,2003,2004,Wolves,Fulham,Draw,Away,2003-10-18,1,4,4,4,5,6,7,8,11,-2,-3,-4,-6,0,21.0,14.0,7.0,3
19185,19185,2003-04,2003,2004,Wolves,Leicester,Win,Home,2003-10-25,3,4,5,5,5,0,0,0,3,4,5,5,2,1,21.0,21.0,0.0,3
19186,19186,2003-04,2003,2004,Wolves,Middlesbrough,Loss,Away,2003-11-01,0,4,7,8,8,1,1,4,7,3,6,4,1,0,21.0,11.0,10.0,4
19187,19187,2003-04,2003,2004,Wolves,Birmingham,Draw,Home,2003-11-08,1,3,4,7,8,3,4,5,5,0,0,2,3,1,21.0,13.0,8.0,4
19188,19188,2003-04,2003,2004,Wolves,Everton,Loss,Away,2003-11-22,0,1,4,5,8,0,1,2,2,1,3,3,6,0,21.0,7.0,14.0,4
19189,19189,2003-04,2003,2004,Wolves,Newcastle,Draw,Home,2003-11-29,1,1,1,4,5,3,4,7,10,-2,-3,-3,-5,1,21.0,3.0,18.0,4
19190,19190,2003-04,2003,2004,Wolves,Tottenham,Loss,Away,2003-12-06,0,1,2,2,5,3,3,3,4,-2,-1,-1,1,0,21.0,10.0,11.0,5
19191,19191,2003-04,2003,2004,Wolves,Aston Villa,Loss,Away,2003-12-14,0,1,1,2,2,3,3,3,4,-2,-2,-1,-2,0,21.0,16.0,5.0,5
19192,19192,2003-04,2003,2004,Wolves,Arsenal,Loss,Away,2003-12-26,0,0,1,1,2,4,5,6,9,-4,-4,-5,-7,0,21.0,2.0,19.0,5
19193,19193,2003-04,2003,2004,Wolves,Leeds,Win,Home,2003-12-28,3,0,0,1,1,2,5,6,9,-2,-5,-5,-8,1,21.0,15.0,6.0,5
19194,19194,2003-04,2003,2004,Wolves,Blackburn,Draw,Home,2004-01-07,1,3,3,3,4,4,4,4,7,-1,-1,-1,-3,1,21.0,6.0,15.0,6
19195,19195,2003-04,2003,2004,Wolves,Charlton,Loss,Away,2004-01-10,0,4,4,4,4,4,7,8,9,0,-3,-4,-5,0,21.0,12.0,9.0,6
19196,19196,2003-04,2003,2004,Wolves,Man United,Win,Home,2004-01-17,3,1,4,4,4,4,7,10,13,-3,-3,-6,-9,1,21.0,1.0,20.0,6
19197,19197,2003-04,2003,2004,Wolves,Liverpool,Draw,Home,2004-01-21,1,3,4,7,7,3,6,7,10,0,-2,0,-3,1,21.0,5.0,16.0,6
19198,19198,2003-04,2003,2004,Wolves,Portsmouth,Draw,Away,2004-01-31,1,4,4,5,8,3,3,3,6,1,1,2,2,0,21.0,21.0,0.0,6
19199,19199,2003-04,2003,2004,Wolves,Arsenal,Loss,Home,2004-02-07,0,2,5,5,6,6,9,10,13,-4,-4,-5,-7,1,21.0,2.0,19.0,7
19200,19200,2003-04,2003,2004,Wolves,Leeds,Loss,Away,2004-02-10,0,1,2,5,5,0,0,0,0,1,2,5,5,0,21.0,15.0,6.0,7
19201,19201,2003-04,2003,2004,Wolves,Fulham,Win,Home,2004-02-21,3,0,1,2,5,1,4,4,7,-1,-3,-2,-2,1,21.0,14.0,7.0,7
19202,19202,2003-04,2003,2004,Wolves,Leicester,Draw,Away,2004-02-28,1,3,3,4,5,2,2,2,3,1,1,2,2,0,21.0,21.0,0.0,7
19203,19203,2003-04,2003,2004,Wolves,Aston Villa,Loss,Home,2004-03-14,0,4,4,4,5,1,4,7,10,3,0,-3,-5,1,21.0,16.0,5.0,8
19204,19204,2003-04,2003,2004,Wolves,Liverpool,Loss,Away,2004-03-20,0,1,4,4,4,3,4,7,8,-2,0,-3,-4,0,21.0,5.0,16.0,8
19205,19205,2003-04,2003,2004,Wolves,Chelsea,Loss,Away,2004-03-27,0,0,1,4,4,6,9,9,12,-6,-8,-5,-8,0,21.0,4.0,17.0,8
19206,19206,2003-04,2003,2004,Wolves,Southampton,Loss,Home,2004-04-03,0,0,0,1,4,3,6,7,8,-3,-6,-6,-4,1,21.0,8.0,13.0,9
19207,19207,2003-04,2003,2004,Wolves,Man City,Draw,Away,2004-04-10,1,0,0,0,1,2,2,5,5,-2,-2,-5,-4,0,21.0,9.0,12.0,9
19208,19208,2003-04,2003,2004,Wolves,Bolton,Loss,Home,2004-04-12,0,1,1,1,1,1,4,4,4,0,-3,-3,-3,1,21.0,17.0,4.0,9
19209,19209,2003-04,2003,2004,Wolves,Middlesbrough,Win,Home,2004-04-17,3,1,1,1,1,4,7,8,11,-3,-6,-7,-10,1,21.0,11.0,10.0,9
19210,19210,2003-04,2003,2004,Wolves,Birmingham,Draw,Away,2004-04-25,1,3,4,4,4,1,1,2,5,2,3,2,-1,0,21.0,13.0,8.0,9
19211,19211,2003-04,2003,2004,Wolves,Everton,Win,Home,2004-05-01,3,4,4,5,5,1,2,5,5,3,2,0,0,1,21.0,7.0,14.0,10
19212,19212,2003-04,2003,2004,Wolves,Newcastle,Draw,Away,2004-05-09,1,4,7,7,8,3,4,5,8,1,3,2,0,0,21.0,3.0,18.0,10
19213,19213,2003-04,2003,2004,Wolves,Tottenham,Loss,Home,2004-05-15,0,4,5,8,8,3,4,4,5,1,1,4,3,1,21.0,10.0,11.0,10
19214,19214,2009-10,2009,2010,Wolves,West Ham,Loss,Home,2009-08-15,0,1,4,5,8,3,3,6,6,-2,1,-1,2,1,21.0,9.0,12.0,1
19215,19215,2009-10,2009,2010,Wolves,Wigan,Win,Away,2009-08-18,3,0,1,4,5,6,6,6,6,-6,-5,-2,-1,0,21.0,11.0,10.0,1
19216,19216,2009-10,2009,2010,Wolves,Man City,Loss,Away,2009-08-22,0,3,3,4,7,6,6,6,9,-3,-3,-2,-2,0,21.0,10.0,11.0,1
19217,19217,2009-10,2009,2010,Wolves,Hull,Draw,Home,2009-08-29,1,3,3,3,4,3,3,3,4,0,0,0,0,1,21.0,17.0,4.0,1
19218,19218,2009-10,2009,2010,Wolves,Blackburn,Loss,Away,2009-09-12,0,1,4,4,4,1,1,2,2,0,3,2,2,0,21.0,15.0,6.0,2
19219,19219,2009-10,2009,2010,Wolves,Fulham,Win,Home,2009-09-20,3,1,1,4,4,3,3,6,6,-2,-2,-2,-2,1,21.0,7.0,14.0,2
19220,19220,2009-10,2009,2010,Wolves,Sunderland,Loss,Away,2009-09-27,0,3,4,4,7,3,3,6,6,0,1,-2,1,0,21.0,16.0,5.0,2
19221,19221,2009-10,2009,2010,Wolves,Portsmouth,Loss,Home,2009-10-03,0,3,3,4,4,0,0,0,0,3,3,4,4,1,21.0,14.0,7.0,3
19222,19222,2009-10,2009,2010,Wolves,Everton,Draw,Away,2009-10-17,1,0,3,3,4,4,7,7,10,-4,-4,-4,-6,0,21.0,5.0,16.0,3
19223,19223,2009-10,2009,2010,Wolves,Aston Villa,Draw,Home,2009-10-24,1,1,1,4,4,4,4,7,10,-3,-3,-3,-6,1,21.0,6.0,15.0,3
19224,19224,2009-10,2009,2010,Wolves,Stoke,Draw,Away,2009-10-31,1,2,2,2,5,6,7,7,8,-4,-5,-5,-3,0,21.0,12.0,9.0,3
19225,19225,2009-10,2009,2010,Wolves,Arsenal,Loss,Home,2009-11-07,0,2,3,3,3,4,7,10,13,-2,-4,-7,-10,1,21.0,4.0,17.0,4
19226,19226,2009-10,2009,2010,Wolves,Chelsea,Loss,Away,2009-11-21,0,1,2,3,3,6,9,9,12,-5,-7,-6,-9,0,21.0,3.0,18.0,4
19227,19227,2009-10,2009,2010,Wolves,Birmingham,Loss,Home,2009-11-29,0,0,1,2,3,4,5,8,8,-4,-4,-6,-5,1,21.0,21.0,0.0,4
19228,19228,2009-10,2009,2010,Wolves,Bolton,Win,Home,2009-12-05,3,0,0,1,2,1,1,1,4,-1,-1,0,-2,1,21.0,13.0,8.0,5
19229,19229,2009-10,2009,2010,Wolves,Tottenham,Win,Away,2009-12-12,3,3,3,3,4,2,5,8,8,1,-2,-5,-4,0,21.0,8.0,13.0,5
19230,19230,2009-10,2009,2010,Wolves,Man United,Loss,Away,2009-12-15,0,6,6,6,6,3,6,9,9,3,0,-3,-3,0,21.0,1.0,20.0,5
19231,19231,2009-10,2009,2010,Wolves,Burnley,Win,Home,2009-12-20,3,3,6,6,6,2,2,2,3,1,4,4,3,1,21.0,21.0,0.0,5
19232,19232,2009-10,2009,2010,Wolves,Liverpool,Loss,Away,2009-12-26,0,3,6,9,9,3,3,4,7,0,3,5,2,0,21.0,2.0,19.0,5
19233,19233,2009-10,2009,2010,Wolves,Man City,Loss,Home,2009-12-28,0,3,3,6,9,6,6,7,10,-3,-3,-1,-1,1,21.0,10.0,11.0,5
19234,19234,2009-10,2009,2010,Wolves,Wigan,Loss,Home,2010-01-16,0,0,3,3,6,1,1,2,2,-1,2,1,4,1,21.0,11.0,10.0,6
19235,19235,2009-10,2009,2010,Wolves,Liverpool,Draw,Home,2010-01-26,1,0,0,3,3,4,7,10,10,-4,-7,-7,-7,1,21.0,2.0,19.0,6
19236,19236,2009-10,2009,2010,Wolves,Hull,Draw,Away,2010-01-30,1,1,1,1,4,1,2,2,2,0,-1,-1,2,0,21.0,17.0,4.0,6
19237,19237,2009-10,2009,2010,Wolves,Birmingham,Loss,Away,2010-02-07,0,2,2,2,2,1,2,5,6,1,0,-3,-4,0,21.0,21.0,0.0,7
19238,19238,2009-10,2009,2010,Wolves,Tottenham,Win,Home,2010-02-10,3,1,2,2,2,2,5,5,6,-1,-3,-3,-4,1,21.0,8.0,13.0,7
19239,19239,2009-10,2009,2010,Wolves,Chelsea,Loss,Home,2010-02-20,0,3,4,5,5,3,4,7,10,0,0,-2,-5,1,21.0,3.0,18.0,7
19240,19240,2009-10,2009,2010,Wolves,Bolton,Loss,Away,2010-02-27,0,3,3,4,5,1,1,2,2,2,2,2,3,0,21.0,13.0,8.0,7
19241,19241,2009-10,2009,2010,Wolves,Man United,Loss,Home,2010-03-06,0,0,3,3,4,3,4,7,10,-3,-1,-4,-6,1,21.0,1.0,20.0,8
19242,19242,2009-10,2009,2010,Wolves,Burnley,Win,Away,2010-03-13,3,0,0,3,3,1,1,1,1,-1,-1,2,2,0,21.0,21.0,0.0,8
19243,19243,2009-10,2009,2010,Wolves,Aston Villa,Draw,Away,2010-03-20,1,3,3,3,6,4,7,8,9,-1,-4,-5,-3,0,21.0,6.0,15.0,8
19244,19244,2009-10,2009,2010,Wolves,West Ham,Win,Away,2010-03-23,3,4,4,4,4,0,0,0,3,4,4,4,1,0,21.0,9.0,12.0,8
19245,19245,2009-10,2009,2010,Wolves,Everton,Draw,Home,2010-03-27,1,4,7,7,7,6,7,10,10,-2,0,-3,-3,1,21.0,5.0,16.0,8
19246,19246,2009-10,2009,2010,Wolves,Arsenal,Loss,Away,2010-04-03,0,4,5,8,8,4,7,10,13,0,-2,-2,-5,0,21.0,4.0,17.0,9
19247,19247,2009-10,2009,2010,Wolves,Stoke,Draw,Home,2010-04-11,1,1,4,5,8,6,6,7,8,-5,-2,-2,0,1,21.0,12.0,9.0,9
19248,19248,2009-10,2009,2010,Wolves,Fulham,Draw,Away,2010-04-17,1,1,2,5,6,4,4,4,4,-3,-2,1,2,0,21.0,7.0,14.0,9
19249,19249,2009-10,2009,2010,Wolves,Blackburn,Draw,Home,2010-04-24,1,2,2,3,6,1,2,5,8,1,0,-2,-2,1,21.0,15.0,6.0,9
19250,19250,2009-10,2009,2010,Wolves,Portsmouth,Loss,Away,2010-05-01,0,2,3,3,4,1,2,3,3,1,1,0,1,0,21.0,14.0,7.0,10
19251,19251,2009-10,2009,2010,Wolves,Sunderland,Win,Home,2010-05-09,3,1,2,3,3,3,6,6,9,-2,-4,-3,-6,1,21.0,16.0,5.0,10
19252,19252,2010-11,2010,2011,Wolves,Stoke,Win,Home,2010-08-14,3,3,4,5,6,3,4,4,4,0,0,1,2,1,15.0,11.0,4.0,1
19253,19253,2010-11,2010,2011,Wolves,Everton,Draw,Away,2010-08-21,1,6,6,7,8,3,4,7,10,3,2,0,-2,0,15.0,8.0,7.0,1
19254,19254,2010-11,2010,2011,Wolves,Newcastle,Draw,Home,2010-08-28,1,4,7,7,8,3,3,3,6,1,4,4,2,1,15.0,21.0,-6.0,1
19255,19255,2010-11,2010,2011,Wolves,Fulham,Loss,Away,2010-09-11,0,2,5,8,8,2,3,3,3,0,2,5,5,0,15.0,12.0,3.0,2
19256,19256,2010-11,2010,2011,Wolves,Tottenham,Loss,Away,2010-09-18,0,1,2,5,8,1,4,5,5,0,-2,0,3,0,15.0,4.0,11.0,2
19257,19257,2010-11,2010,2011,Wolves,Aston Villa,Loss,Home,2010-09-26,0,0,1,2,5,1,4,4,7,-1,-3,-2,-2,1,15.0,6.0,9.0,2
19258,19258,2010-11,2010,2011,Wolves,Wigan,Loss,Away,2010-10-02,0,0,0,1,2,1,2,5,5,-1,-2,-4,-3,0,15.0,16.0,-1.0,3
19259,19259,2010-11,2010,2011,Wolves,West Ham,Draw,Home,2010-10-16,1,0,0,0,1,4,5,5,5,-4,-5,-5,-4,1,15.0,17.0,-2.0,3
19260,19260,2010-11,2010,2011,Wolves,Chelsea,Loss,Away,2010-10-23,0,1,1,1,1,4,4,7,10,-3,-3,-6,-9,0,15.0,1.0,14.0,3
19261,19261,2010-11,2010,2011,Wolves,Man City,Win,Home,2010-10-30,3,1,1,1,1,3,6,9,12,-2,-5,-8,-11,1,15.0,5.0,10.0,3
19262,19262,2010-11,2010,2011,Wolves,Man United,Loss,Away,2010-11-06,0,3,4,4,4,6,7,8,9,-3,-3,-4,-5,0,15.0,2.0,13.0,4
19263,19263,2010-11,2010,2011,Wolves,Arsenal,Loss,Home,2010-11-10,0,3,3,4,4,3,6,9,9,0,-3,-5,-5,1,15.0,3.0,12.0,4
19264,19264,2010-11,2010,2011,Wolves,Bolton,Loss,Home,2010-11-13,0,0,3,3,4,4,4,5,8,-4,-1,-2,-4,1,15.0,14.0,1.0,4
19265,19265,2010-11,2010,2011,Wolves,Blackpool,Loss,Away,2010-11-20,0,0,0,3,3,1,2,5,5,-1,-2,-2,-2,0,15.0,21.0,-6.0,4
19266,19266,2010-11,2010,2011,Wolves,Sunderland,Win,Home,2010-11-27,3,0,0,0,3,4,5,8,8,-4,-5,-8,-5,1,15.0,13.0,2.0,4
19267,19267,2010-11,2010,2011,Wolves,Blackburn,Loss,Away,2010-12-04,0,3,3,3,3,3,3,6,9,0,0,-3,-6,0,15.0,10.0,5.0,5
19268,19268,2010-11,2010,2011,Wolves,Birmingham,Win,Home,2010-12-12,3,3,3,3,3,2,5,6,6,1,-2,-3,-3,1,15.0,9.0,6.0,5
19269,19269,2010-11,2010,2011,Wolves,Wigan,Loss,Home,2010-12-26,0,3,6,6,6,2,2,2,5,1,4,4,1,1,15.0,16.0,-1.0,5
19270,19270,2010-11,2010,2011,Wolves,Liverpool,Win,Away,2010-12-29,3,3,3,6,6,3,3,6,6,0,0,0,0,0,15.0,7.0,8.0,5
19271,19271,2010-11,2010,2011,Wolves,West Ham,Loss,Away,2011-01-01,0,3,6,6,9,4,5,5,5,-1,1,1,4,0,15.0,17.0,-2.0,6
19272,19272,2010-11,2010,2011,Wolves,Chelsea,Win,Home,2011-01-05,3,3,3,6,6,4,4,5,6,-1,-1,1,0,1,15.0,1.0,14.0,6
19273,19273,2010-11,2010,2011,Wolves,Man City,Loss,Away,2011-01-15,0,3,6,6,9,4,7,10,10,-1,-1,-4,-1,0,15.0,5.0,10.0,6
19274,19274,2010-11,2010,2011,Wolves,Liverpool,Loss,Home,2011-01-22,0,3,3,6,6,1,1,4,4,2,2,2,2,1,15.0,7.0,8.0,6
19275,19275,2010-11,2010,2011,Wolves,Bolton,Loss,Away,2011-02-02,0,0,3,3,6,0,1,1,1,0,2,2,5,0,15.0,14.0,1.0,7
19276,19276,2010-11,2010,2011,Wolves,Man United,Win,Home,2011-02-05,3,0,0,3,3,6,9,10,13,-6,-9,-7,-10,1,15.0,2.0,13.0,7
19277,19277,2010-11,2010,2011,Wolves,Arsenal,Loss,Away,2011-02-12,0,3,3,3,6,4,7,10,11,-1,-4,-7,-5,0,15.0,3.0,12.0,7
19278,19278,2010-11,2010,2011,Wolves,West Brom,Draw,Away,2011-02-20,1,3,3,3,3,1,2,2,5,2,1,1,-2,0,15.0,21.0,-6.0,7
19279,19279,2010-11,2010,2011,Wolves,Blackpool,Win,Home,2011-02-26,3,1,4,4,4,4,4,4,4,-3,0,0,0,1,15.0,21.0,-6.0,7
19280,19280,2010-11,2010,2011,Wolves,Tottenham,Draw,Home,2011-03-06,1,4,4,7,7,3,6,9,10,1,-2,-2,-3,1,15.0,4.0,11.0,8
19281,19281,2010-11,2010,2011,Wolves,Aston Villa,Win,Away,2011-03-19,3,4,5,5,8,3,4,5,5,1,1,0,3,0,15.0,6.0,9.0,8
19282,19282,2010-11,2010,2011,Wolves,Newcastle,Loss,Away,2011-04-02,0,4,7,8,8,0,1,4,5,4,6,4,3,0,15.0,21.0,-6.0,9
19283,19283,2010-11,2010,2011,Wolves,Everton,Loss,Home,2011-04-09,0,3,4,7,8,4,5,8,11,-1,-1,-1,-3,1,15.0,8.0,7.0,9
19284,19284,2010-11,2010,2011,Wolves,Fulham,Draw,Home,2011-04-23,1,0,3,4,7,3,3,6,7,-3,0,-2,0,1,15.0,12.0,3.0,9
19285,19285,2010-11,2010,2011,Wolves,Stoke,Loss,Away,2011-04-26,0,1,1,4,5,1,2,5,5,0,-1,-1,0,0,15.0,11.0,4.0,9
19286,19286,2010-11,2010,2011,Wolves,Birmingham,Draw,Away,2011-05-01,1,1,1,1,4,0,3,4,7,1,-2,-3,-3,0,15.0,9.0,6.0,10
19287,19287,2010-11,2010,2011,Wolves,West Brom,Win,Home,2011-05-08,3,1,2,2,2,4,4,7,10,-3,-2,-5,-8,1,15.0,21.0,-6.0,10
19288,19288,2010-11,2010,2011,Wolves,Sunderland,Win,Away,2011-05-14,3,4,4,5,5,3,6,6,6,1,-2,-1,-1,0,15.0,13.0,2.0,10
19289,19289,2010-11,2010,2011,Wolves,Blackburn,Loss,Home,2011-05-22,0,6,7,7,8,2,5,5,5,4,2,2,3,1,15.0,10.0,5.0,10
19290,19290,2011-12,2011,2012,Wolves,Blackburn,Win,Away,2011-08-13,3,3,6,7,7,4,5,8,8,-1,1,-1,-1,0,17.0,15.0,2.0,1
19291,19291,2011-12,2011,2012,Wolves,Fulham,Win,Home,2011-08-21,3,3,6,9,10,2,5,5,8,1,1,4,2,1,17.0,8.0,9.0,1
19292,19292,2011-12,2011,2012,Wolves,Aston Villa,Draw,Away,2011-08-27,1,6,6,9,12,4,7,10,11,2,-1,-1,1,0,17.0,9.0,8.0,1
19293,19293,2011-12,2011,2012,Wolves,Tottenham,Loss,Home,2011-09-10,0,4,7,7,10,0,3,6,6,4,4,1,4,1,17.0,5.0,12.0,2
19294,19294,2011-12,2011,2012,Wolves,QPR,Loss,Home,2011-09-17,0,1,4,7,7,1,4,4,4,0,0,3,3,1,17.0,21.0,-4.0,2
19295,19295,2011-12,2011,2012,Wolves,Liverpool,Loss,Away,2011-09-24,0,0,1,4,7,0,3,6,7,0,-2,-2,0,0,17.0,6.0,11.0,2
19296,19296,2011-12,2011,2012,Wolves,Newcastle,Loss,Home,2011-10-01,0,0,0,1,4,4,5,8,11,-4,-5,-7,-7,1,17.0,12.0,5.0,3
19297,19297,2011-12,2011,2012,Wolves,West Brom,Loss,Away,2011-10-16,0,0,0,0,1,2,2,5,5,-2,-2,-5,-4,0,17.0,11.0,6.0,3
19298,19298,2011-12,2011,2012,Wolves,Swansea,Draw,Home,2011-10-22,1,0,0,0,0,3,3,6,6,-3,-3,-6,-6,1,17.0,21.0,-4.0,3
19299,19299,2011-12,2011,2012,Wolves,Man City,Loss,Away,2011-10-29,0,1,1,1,1,6,9,12,13,-5,-8,-11,-12,0,17.0,3.0,14.0,3
19300,19300,2011-12,2011,2012,Wolves,Wigan,Win,Home,2011-11-06,3,1,1,1,1,0,0,0,0,1,1,1,1,1,17.0,16.0,1.0,4
19301,19301,2011-12,2011,2012,Wolves,Everton,Loss,Away,2011-11-19,0,3,4,4,4,0,3,3,3,3,1,1,1,0,17.0,7.0,10.0,4
19302,19302,2011-12,2011,2012,Wolves,Chelsea,Loss,Away,2011-11-26,0,3,3,4,4,3,3,3,6,0,0,1,-2,0,17.0,2.0,15.0,4
19303,19303,2011-12,2011,2012,Wolves,Sunderland,Win,Home,2011-12-04,3,0,3,3,4,1,1,2,5,-1,2,1,-1,1,17.0,10.0,7.0,5
19304,19304,2011-12,2011,2012,Wolves,Man United,Loss,Away,2011-12-10,0,3,3,6,6,4,7,10,13,-1,-4,-4,-7,0,17.0,1.0,16.0,5
19305,19305,2011-12,2011,2012,Wolves,Stoke,Loss,Home,2011-12-17,0,3,3,3,6,6,9,9,9,-3,-6,-6,-3,1,17.0,13.0,4.0,5
19306,19306,2011-12,2011,2012,Wolves,Norwich,Draw,Home,2011-12-20,1,0,3,3,3,4,4,7,7,-4,-1,-4,-4,1,17.0,21.0,-4.0,5
19307,19307,2011-12,2011,2012,Wolves,Arsenal,Draw,Away,2011-12-27,1,1,1,4,4,3,6,9,10,-2,-5,-5,-6,0,17.0,4.0,13.0,5
19308,19308,2011-12,2011,2012,Wolves,Bolton,Draw,Away,2011-12-31,1,2,2,2,5,3,3,3,3,-1,-1,-1,2,0,17.0,14.0,3.0,5
19309,19309,2011-12,2011,2012,Wolves,Chelsea,Loss,Home,2012-01-02,0,2,3,3,3,1,2,3,6,1,1,0,-3,1,17.0,2.0,15.0,6
19310,19310,2011-12,2011,2012,Wolves,Tottenham,Draw,Away,2012-01-14,1,1,2,3,3,6,7,10,11,-5,-5,-7,-8,0,17.0,5.0,12.0,6
19311,19311,2011-12,2011,2012,Wolves,Aston Villa,Loss,Home,2012-01-21,0,1,2,3,4,1,4,5,5,0,-2,-2,-1,1,17.0,9.0,8.0,6
19312,19312,2011-12,2011,2012,Wolves,Liverpool,Loss,Home,2012-01-31,0,1,1,2,3,1,1,4,5,0,0,-2,-2,1,17.0,6.0,11.0,6
19313,19313,2011-12,2011,2012,Wolves,QPR,Win,Away,2012-02-04,3,0,1,1,2,4,4,4,4,-4,-3,-3,-2,0,17.0,21.0,-4.0,7
19314,19314,2011-12,2011,2012,Wolves,West Brom,Loss,Home,2012-02-12,0,3,3,4,4,1,4,4,4,2,-1,0,0,1,17.0,11.0,6.0,7
19315,19315,2011-12,2011,2012,Wolves,Newcastle,Draw,Away,2012-02-25,1,3,3,3,4,3,6,6,9,0,-3,-3,-5,0,17.0,12.0,5.0,7
19316,19316,2011-12,2011,2012,Wolves,Fulham,Loss,Away,2012-03-04,0,1,4,4,4,6,6,7,10,-5,-2,-3,-6,0,17.0,8.0,9.0,8
19317,19317,2011-12,2011,2012,Wolves,Blackburn,Loss,Home,2012-03-10,0,1,1,4,4,1,4,4,4,0,-3,0,0,1,17.0,15.0,2.0,8
19318,19318,2011-12,2011,2012,Wolves,Man United,Loss,Home,2012-03-18,0,0,1,1,4,6,9,12,13,-6,-8,-11,-9,1,17.0,1.0,16.0,8
19319,19319,2011-12,2011,2012,Wolves,Norwich,Loss,Away,2012-03-24,0,0,0,1,1,1,1,1,4,-1,-1,0,-3,0,17.0,21.0,-4.0,8
19320,19320,2011-12,2011,2012,Wolves,Bolton,Loss,Home,2012-03-31,0,0,0,0,1,6,6,6,6,-6,-6,-6,-5,1,17.0,14.0,3.0,8
19321,19321,2011-12,2011,2012,Wolves,Stoke,Loss,Away,2012-04-07,0,0,0,0,0,1,2,2,5,-1,-2,-2,-5,0,17.0,13.0,4.0,9
19322,19322,2011-12,2011,2012,Wolves,Arsenal,Loss,Home,2012-04-11,0,0,0,0,0,3,6,9,12,-3,-6,-9,-12,1,17.0,4.0,13.0,9
19323,19323,2011-12,2011,2012,Wolves,Sunderland,Draw,Away,2012-04-14,1,0,0,0,0,1,2,5,5,-1,-2,-5,-5,0,17.0,10.0,7.0,9
19324,19324,2011-12,2011,2012,Wolves,Man City,Loss,Home,2012-04-22,0,1,1,1,1,6,6,7,8,-5,-5,-6,-7,1,17.0,3.0,14.0,9
19325,19325,2011-12,2011,2012,Wolves,Swansea,Draw,Away,2012-04-28,1,1,1,1,1,4,4,4,4,-3,-3,-3,-3,0,17.0,21.0,-4.0,9
19326,19326,2011-12,2011,2012,Wolves,Everton,Draw,Home,2012-05-06,1,1,2,2,2,4,5,8,9,-3,-3,-6,-7,1,17.0,7.0,10.0,10
19327,19327,2011-12,2011,2012,Wolves,Wigan,Loss,Away,2012-05-13,0,2,2,3,3,6,6,9,12,-4,-4,-6,-9,0,17.0,16.0,1.0,10
